date,geography,geography code,Welsh speaking ability: Total: All usual residents aged 3 years and over,Welsh speaking ability: Cannot speak Welsh,Welsh speaking ability: Can speak Welsh
2021,Isle of Anglesey 001A,W01000003,2370,959,1411
2021,Isle of Anglesey 001B,W01000004,1229,608,621
2021,Isle of Anglesey 005A,W01000005,1585,1001,584
2021,Isle of Anglesey 006A,W01000006,1494,417,1077
2021,Isle of Anglesey 009A,W01000007,1738,624,1114
2021,Isle of Anglesey 008A,W01000008,1417,385,1032
2021,Isle of Anglesey 007C,W01000009,1818,571,1247
2021,Isle of Anglesey 002A,W01000010,1775,910,865
2021,Isle of Anglesey 008B,W01000011,999,542,457
2021,Isle of Anglesey 006B,W01000012,1656,454,1202
2021,Isle of Anglesey 005B,W01000013,2130,905,1225
2021,Isle of Anglesey 006C,W01000014,2128,455,1673
2021,Isle of Anglesey 008C,W01000015,1431,456,975
2021,Isle of Anglesey 003A,W01000016,1157,723,434
2021,Isle of Anglesey 003B,W01000017,1636,887,749
2021,Isle of Anglesey 001C,W01000018,1148,607,541
2021,Isle of Anglesey 005C,W01000019,1325,802,523
2021,Isle of Anglesey 002C,W01000021,2266,1075,1191
2021,Isle of Anglesey 004A,W01000022,1576,616,960
2021,Isle of Anglesey 007D,W01000023,1525,528,997
2021,Isle of Anglesey 007E,W01000024,1293,812,481
2021,Isle of Anglesey 009B,W01000025,2097,520,1577
2021,Isle of Anglesey 005D,W01000026,1229,661,568
2021,Isle of Anglesey 009C,W01000027,1812,656,1156
2021,Isle of Anglesey 001D,W01000028,1920,631,1289
2021,Isle of Anglesey 003C,W01000029,1541,825,716
2021,Isle of Anglesey 003D,W01000030,2236,1320,916
2021,Isle of Anglesey 001E,W01000031,1512,658,854
2021,Isle of Anglesey 003E,W01000033,1504,936,568
2021,Isle of Anglesey 004B,W01000034,1399,721,678
2021,Isle of Anglesey 005E,W01000035,1743,796,947
2021,Isle of Anglesey 003F,W01000036,1070,681,389
2021,Isle of Anglesey 003G,W01000037,1126,625,501
2021,Isle of Anglesey 009D,W01000038,2179,846,1333
2021,Isle of Anglesey 004D,W01000040,1041,677,364
2021,Isle of Anglesey 006D,W01000041,1529,385,1144
2021,Isle of Anglesey 008D,W01000042,1982,828,1154
2021,Isle of Anglesey 004F,W01000044,1070,553,517
2021,Gwynedd 011A,W01000047,1233,277,956
2021,Gwynedd 003A,W01000050,1400,591,809
2021,Gwynedd 015A,W01000051,1945,535,1410
2021,Gwynedd 004A,W01000052,1061,150,911
2021,Gwynedd 004B,W01000053,1144,354,790
2021,Gwynedd 007A,W01000054,988,172,816
2021,Gwynedd 009A,W01000056,1720,407,1313
2021,Gwynedd 016C,W01000057,1358,543,815
2021,Gwynedd 006A,W01000059,2027,385,1642
2021,Gwynedd 015B,W01000060,1227,626,601
2021,Gwynedd 011B,W01000061,1697,671,1026
2021,Gwynedd 001A,W01000062,1964,1579,385
2021,Gwynedd 005A,W01000063,1847,494,1353
2021,Gwynedd 002A,W01000064,1943,937,1006
2021,Gwynedd 009B,W01000065,995,268,727
2021,Gwynedd 010A,W01000066,1143,393,750
2021,Gwynedd 016D,W01000067,1165,467,698
2021,Gwynedd 016E,W01000068,1375,532,843
2021,Gwynedd 012A,W01000070,1263,347,916
2021,Gwynedd 003B,W01000071,2174,583,1591
2021,Gwynedd 002B,W01000072,1632,767,865
2021,Gwynedd 008A,W01000073,1620,373,1247
2021,Gwynedd 013B,W01000074,1770,803,967
2021,Gwynedd 002C,W01000075,1367,843,524
2021,Gwynedd 001B,W01000076,1273,853,420
2021,Gwynedd 001C,W01000077,1146,743,403
2021,Gwynedd 011C,W01000078,1517,455,1062
2021,Gwynedd 014C,W01000080,1424,645,779
2021,Gwynedd 005B,W01000081,1958,597,1361
2021,Gwynedd 015C,W01000082,1067,375,692
2021,Gwynedd 015D,W01000083,1320,256,1064
2021,Gwynedd 014D,W01000084,1046,398,648
2021,Gwynedd 017C,W01000085,1888,1129,759
2021,Gwynedd 008B,W01000086,2113,605,1508
2021,Gwynedd 004C,W01000087,1780,249,1531
2021,Gwynedd 007B,W01000088,2009,380,1629
2021,Gwynedd 011D,W01000089,1870,477,1393
2021,Gwynedd 002D,W01000090,1315,638,677
2021,Gwynedd 001D,W01000091,1048,542,506
2021,Gwynedd 001E,W01000092,3034,2353,681
2021,Gwynedd 006B,W01000093,2184,472,1712
2021,Gwynedd 012B,W01000094,1188,329,859
2021,Gwynedd 012C,W01000095,1261,338,923
2021,Gwynedd 003C,W01000096,1220,229,991
2021,Gwynedd 003D,W01000097,1104,286,818
2021,Gwynedd 006C,W01000098,2422,373,2049
2021,Gwynedd 005C,W01000099,1617,525,1092
2021,Gwynedd 010B,W01000100,1032,312,720
2021,Gwynedd 013D,W01000101,1329,338,991
2021,Gwynedd 002E,W01000102,1832,690,1142
2021,Gwynedd 005D,W01000103,1141,487,654
2021,Gwynedd 008C,W01000104,1743,296,1447
2021,Gwynedd 010C,W01000105,1689,395,1294
2021,Gwynedd 010D,W01000106,1475,652,823
2021,Gwynedd 010E,W01000107,1168,401,767
2021,Gwynedd 012D,W01000108,2032,484,1548
2021,Gwynedd 012E,W01000109,1815,460,1355
2021,Gwynedd 006D,W01000110,1544,212,1332
2021,Gwynedd 007C,W01000111,1530,365,1165
2021,Gwynedd 008D,W01000112,1877,566,1311
2021,Gwynedd 009C,W01000113,1790,456,1334
2021,Gwynedd 009D,W01000114,1378,376,1002
2021,Gwynedd 003E,W01000115,2066,667,1399
2021,Gwynedd 017D,W01000116,1650,1054,596
2021,Gwynedd 017E,W01000117,1437,859,578
2021,Gwynedd 007D,W01000118,1653,436,1217
2021,Gwynedd 004D,W01000119,2257,715,1542
2021,Conwy 015A,W01000121,1124,595,529
2021,Conwy 014A,W01000122,1916,1120,796
2021,Conwy 013A,W01000123,1700,979,721
2021,Conwy 012A,W01000124,1906,1158,748
2021,Conwy 013B,W01000125,1494,1025,469
2021,Conwy 009A,W01000126,1641,1285,356
2021,Conwy 009B,W01000127,1334,1145,189
2021,Conwy 009C,W01000128,1452,1163,289
2021,Conwy 012B,W01000129,1151,878,273
2021,Conwy 012C,W01000130,1389,1067,322
2021,Conwy 012D,W01000131,1624,1076,548
2021,Conwy 001A,W01000132,1500,1234,266
2021,Conwy 002A,W01000133,1753,1421,332
2021,Conwy 015B,W01000134,1990,848,1142
2021,Conwy 006A,W01000135,1965,1583,382
2021,Conwy 006B,W01000136,1723,1332,391
2021,Conwy 015C,W01000137,1510,699,811
2021,Conwy 008A,W01000138,1892,1450,442
2021,Conwy 007A,W01000139,1573,1212,361
2021,Conwy 010B,W01000140,1721,1324,397
2021,Conwy 010C,W01000141,1501,1213,288
2021,Conwy 010D,W01000142,1493,1141,352
2021,Conwy 007B,W01000143,1524,1204,320
2021,Conwy 007C,W01000144,1594,1338,256
2021,Conwy 008B,W01000145,1259,960,299
2021,Conwy 001B,W01000146,2002,1704,298
2021,Conwy 001C,W01000147,1473,1254,219
2021,Conwy 015D,W01000148,1046,411,635
2021,Conwy 005A,W01000149,1454,1326,128
2021,Conwy 005B,W01000150,1451,1276,175
2021,Conwy 005C,W01000151,1475,1294,181
2021,Conwy 005D,W01000152,1383,1222,161
2021,Conwy 009D,W01000153,1572,1261,311
2021,Conwy 003A,W01000154,1376,1117,259
2021,Conwy 004A,W01000155,1378,1129,249
2021,Conwy 004B,W01000156,1470,1246,224
2021,Conwy 004C,W01000157,1378,1163,215
2021,Conwy 004D,W01000158,1530,1242,288
2021,Conwy 014B,W01000159,1388,529,859
2021,Conwy 014C,W01000162,1772,717,1055
2021,Conwy 009E,W01000163,1325,1071,254
2021,Conwy 009F,W01000164,1315,1044,271
2021,Conwy 006C,W01000165,1827,1360,467
2021,Conwy 006D,W01000166,2664,1918,746
2021,Conwy 011C,W01000167,1933,1536,397
2021,Conwy 002B,W01000168,1776,1461,315
2021,Conwy 001D,W01000169,1737,1446,291
2021,Conwy 013C,W01000170,1753,956,797
2021,Conwy 013D,W01000171,1453,1000,453
2021,Conwy 013E,W01000172,1220,811,409
2021,Conwy 003B,W01000173,1419,1092,327
2021,Conwy 003C,W01000174,1557,1210,347
2021,Conwy 003D,W01000175,1502,1224,278
2021,Conwy 011D,W01000176,1556,1108,448
2021,Conwy 011E,W01000177,1392,993,399
2021,Conwy 010E,W01000178,1947,1548,399
2021,Conwy 010F,W01000179,1949,1565,384
2021,Conwy 008C,W01000180,1477,1187,290
2021,Conwy 008D,W01000181,1425,1105,320
2021,Conwy 007D,W01000182,2036,1727,309
2021,Conwy 008E,W01000183,1445,1189,256
2021,Conwy 005E,W01000184,2223,1975,248
2021,Conwy 015E,W01000185,1205,692,513
2021,Conwy 001E,W01000186,1552,1285,267
2021,Conwy 002C,W01000187,1465,1179,286
2021,Conwy 002D,W01000188,1549,1257,292
2021,Conwy 015F,W01000189,1428,545,883
2021,Conwy 014D,W01000190,1359,485,874
2021,Denbighshire 009A,W01000191,2027,1692,335
2021,Denbighshire 016A,W01000192,975,562,413
2021,Denbighshire 015A,W01000193,1220,703,517
2021,Denbighshire 011A,W01000194,1849,1350,499
2021,Denbighshire 012A,W01000195,1412,784,628
2021,Denbighshire 012B,W01000196,1360,853,507
2021,Denbighshire 012C,W01000197,1647,1073,574
2021,Denbighshire 011B,W01000198,1324,1032,292
2021,Denbighshire 011C,W01000199,1661,1103,558
2021,Denbighshire 008A,W01000200,1256,1024,232
2021,Denbighshire 008B,W01000201,1667,1408,259
2021,Denbighshire 015B,W01000202,1597,847,750
2021,Denbighshire 013A,W01000203,2388,1871,517
2021,Denbighshire 013B,W01000204,1424,951,473
2021,Denbighshire 016B,W01000205,1172,527,645
2021,Denbighshire 013C,W01000206,2171,1413,758
2021,Denbighshire 015C,W01000207,2243,1259,984
2021,Denbighshire 016C,W01000208,1257,1040,217
2021,Denbighshire 016D,W01000209,1373,1103,270
2021,Denbighshire 016E,W01000210,1306,1017,289
2021,Denbighshire 012D,W01000211,1760,927,833
2021,Denbighshire 003A,W01000212,2132,1713,419
2021,Denbighshire 002A,W01000213,1277,1093,184
2021,Denbighshire 002B,W01000214,1124,976,148
2021,Denbighshire 002C,W01000215,1437,1208,229
2021,Denbighshire 002D,W01000216,1258,1072,186
2021,Denbighshire 008C,W01000217,1948,1641,307
2021,Denbighshire 001A,W01000218,1548,1364,184
2021,Denbighshire 001B,W01000219,2546,2183,363
2021,Denbighshire 001C,W01000220,1611,1454,157
2021,Denbighshire 003B,W01000221,1305,1136,169
2021,Denbighshire 003C,W01000222,1749,1498,251
2021,Denbighshire 009B,W01000223,1271,1073,198
2021,Denbighshire 009C,W01000224,1521,1233,288
2021,Denbighshire 009D,W01000225,1404,1146,258
2021,Denbighshire 004A,W01000226,1485,1333,152
2021,Denbighshire 004B,W01000227,1454,1263,191
2021,Denbighshire 004C,W01000228,1596,1423,173
2021,Denbighshire 017E,W01000229,1496,1274,222
2021,Denbighshire 017F,W01000230,1866,1555,311
2021,Denbighshire 017A,W01000231,1297,1114,183
2021,Denbighshire 017B,W01000232,1582,1331,251
2021,Denbighshire 017C,W01000233,1261,1090,171
2021,Denbighshire 017G,W01000234,2182,1870,312
2021,Denbighshire 017D,W01000235,1290,1068,222
2021,Denbighshire 006A,W01000236,1902,1657,245
2021,Denbighshire 006B,W01000237,1704,1551,153
2021,Denbighshire 006C,W01000238,1733,1501,232
2021,Denbighshire 004D,W01000239,1653,1488,165
2021,Denbighshire 004E,W01000240,1590,1425,165
2021,Denbighshire 004F,W01000241,1449,1279,170
2021,Denbighshire 014A,W01000242,1909,1269,640
2021,Denbighshire 014B,W01000243,2047,1377,670
2021,Denbighshire 014C,W01000244,1567,787,780
2021,Denbighshire 010A,W01000245,1795,1375,420
2021,Denbighshire 010B,W01000246,1600,1314,286
2021,Denbighshire 010C,W01000247,1781,1276,505
2021,Denbighshire 008D,W01000248,1600,1166,434
2021,Flintshire 014A,W01000249,1167,1022,145
2021,Flintshire 014B,W01000250,1396,1195,201
2021,Flintshire 013A,W01000251,1503,1367,136
2021,Flintshire 010A,W01000252,1601,1475,126
2021,Flintshire 003A,W01000253,1786,1590,196
2021,Flintshire 003B,W01000254,2052,1827,225
2021,Flintshire 015A,W01000255,2207,2020,187
2021,Flintshire 015B,W01000256,1499,1382,117
2021,Flintshire 015C,W01000257,2612,2429,183
2021,Flintshire 006A,W01000258,2061,1741,320
2021,Flintshire 017A,W01000259,1628,1459,169
2021,Flintshire 017B,W01000260,1673,1506,167
2021,Flintshire 014C,W01000261,1377,1231,146
2021,Flintshire 017C,W01000262,1376,1241,135
2021,Flintshire 017D,W01000263,1298,1208,90
2021,Flintshire 012A,W01000264,1663,1473,190
2021,Flintshire 012B,W01000265,1447,1303,144
2021,Flintshire 017E,W01000266,1597,1411,186
2021,Flintshire 017F,W01000267,1978,1771,207
2021,Flintshire 013B,W01000268,1618,1441,177
2021,Flintshire 020A,W01000269,1522,1347,175
2021,Flintshire 006B,W01000270,1217,991,226
2021,Flintshire 006C,W01000271,1217,992,225
2021,Flintshire 006D,W01000272,1757,1463,294
2021,Flintshire 007A,W01000273,1499,1374,125
2021,Flintshire 007B,W01000274,1836,1705,131
2021,Flintshire 007C,W01000275,1159,1069,90
2021,Flintshire 008A,W01000276,1165,1059,106
2021,Flintshire 008B,W01000277,1327,1187,140
2021,Flintshire 007D,W01000278,1418,1324,94
2021,Flintshire 008C,W01000279,1151,1066,85
2021,Flintshire 010B,W01000280,1687,1518,169
2021,Flintshire 008D,W01000281,1143,1049,94
2021,Flintshire 010C,W01000282,1589,1449,140
2021,Flintshire 008E,W01000283,2252,2094,158
2021,Flintshire 013C,W01000284,1683,1524,159
2021,Flintshire 013D,W01000285,1566,1434,132
2021,Flintshire 013E,W01000286,2132,1903,229
2021,Flintshire 001A,W01000287,1820,1512,308
2021,Flintshire 004A,W01000288,2113,1901,212
2021,Flintshire 005A,W01000289,1300,1143,157
2021,Flintshire 004B,W01000290,1240,1135,105
2021,Flintshire 005B,W01000291,1265,1117,148
2021,Flintshire 004C,W01000292,1419,1261,158
2021,Flintshire 004D,W01000293,2558,2240,318
2021,Flintshire 005C,W01000294,1844,1613,231
2021,Flintshire 005D,W01000295,1537,1368,169
2021,Flintshire 003C,W01000296,1490,1331,159
2021,Flintshire 003D,W01000297,1196,1045,151
2021,Flintshire 001B,W01000298,1439,1232,207
2021,Flintshire 019A,W01000299,1859,1608,251
2021,Flintshire 019B,W01000300,1591,1307,284
2021,Flintshire 006E,W01000301,1688,1388,300
2021,Flintshire 013F,W01000302,1895,1706,189
2021,Flintshire 018A,W01000303,1682,1510,172
2021,Flintshire 003E,W01000304,2008,1777,231
2021,Flintshire 003F,W01000305,1854,1591,263
2021,Flintshire 002A,W01000306,2360,1999,361
2021,Flintshire 020B,W01000307,1392,1245,147
2021,Flintshire 020C,W01000308,1157,1018,139
2021,Flintshire 019C,W01000309,2059,1817,242
2021,Flintshire 020D,W01000310,1851,1570,281
2021,Flintshire 011A,W01000311,1634,1507,127
2021,Flintshire 011B,W01000312,1567,1468,99
2021,Flintshire 016A,W01000313,1554,1281,273
2021,Flintshire 016B,W01000314,1100,917,183
2021,Flintshire 016C,W01000315,1904,1620,284
2021,Flintshire 016D,W01000316,1199,909,290
2021,Flintshire 016E,W01000317,1562,1123,439
2021,Flintshire 016F,W01000318,1163,1022,141
2021,Flintshire 016G,W01000319,1397,1190,207
2021,Flintshire 002B,W01000320,1831,1559,272
2021,Flintshire 014D,W01000321,1598,1395,203
2021,Flintshire 014E,W01000322,1344,1166,178
2021,Flintshire 012C,W01000323,1536,1320,216
2021,Flintshire 012D,W01000324,1472,1259,213
2021,Flintshire 010D,W01000325,1760,1572,188
2021,Flintshire 018B,W01000326,2151,1888,263
2021,Flintshire 018C,W01000327,2385,2125,260
2021,Flintshire 011C,W01000328,1866,1745,121
2021,Flintshire 015D,W01000329,1555,1453,102
2021,Flintshire 015E,W01000330,2016,1915,101
2021,Flintshire 015F,W01000331,1421,1339,82
2021,Flintshire 009A,W01000332,1766,1641,125
2021,Flintshire 009B,W01000333,1425,1332,93
2021,Flintshire 009C,W01000334,1702,1566,136
2021,Flintshire 009D,W01000335,1144,1066,78
2021,Flintshire 009E,W01000336,1390,1275,115
2021,Flintshire 009F,W01000337,2095,1923,172
2021,Flintshire 001C,W01000338,1724,1386,338
2021,Flintshire 019D,W01000339,1636,1297,339
2021,Flintshire 002C,W01000340,2190,1803,387
2021,Wrexham 023C,W01000341,1508,1366,142
2021,Wrexham 023E,W01000342,1487,1337,150
2021,Wrexham 023B,W01000343,1012,905,107
2021,Wrexham 023A,W01000344,1221,1098,123
2021,Wrexham 018A,W01000345,1559,1428,131
2021,Wrexham 018B,W01000346,1460,1371,89
2021,Wrexham 006A,W01000347,2700,2316,384
2021,Wrexham 006B,W01000348,1374,1240,134
2021,Wrexham 011A,W01000349,2203,1924,279
2021,Wrexham 011B,W01000350,1759,1600,159
2021,Wrexham 005A,W01000351,1998,1782,216
2021,Wrexham 017A,W01000354,1604,1413,191
2021,Wrexham 017B,W01000355,1687,1481,206
2021,Wrexham 017C,W01000356,1574,1414,160
2021,Wrexham 019C,W01000359,1159,1040,119
2021,Wrexham 019D,W01000360,1193,1110,83
2021,Wrexham 019E,W01000361,1925,1742,183
2021,Wrexham 006C,W01000362,1443,1220,223
2021,Wrexham 006D,W01000363,1429,1164,265
2021,Wrexham 006E,W01000364,1429,1165,264
2021,Wrexham 011C,W01000365,1985,1681,304
2021,Wrexham 014A,W01000366,1418,1282,136
2021,Wrexham 014B,W01000367,1248,1116,132
2021,Wrexham 008A,W01000368,1935,1704,231
2021,Wrexham 021B,W01000369,1238,1124,114
2021,Wrexham 021D,W01000370,1507,1350,157
2021,Wrexham 008B,W01000371,1029,901,128
2021,Wrexham 008C,W01000372,1484,1339,145
2021,Wrexham 005B,W01000373,1698,1522,176
2021,Wrexham 003A,W01000374,1327,1176,151
2021,Wrexham 003B,W01000375,2034,1776,258
2021,Wrexham 003C,W01000376,1305,1122,183
2021,Wrexham 004A,W01000377,1497,1290,207
2021,Wrexham 004B,W01000378,1249,1129,120
2021,Wrexham 004C,W01000379,1559,1384,175
2021,Wrexham 004D,W01000380,1418,1178,240
2021,Wrexham 012A,W01000381,1084,956,128
2021,Wrexham 012B,W01000382,1338,1149,189
2021,Wrexham 022C,W01000384,1067,971,96
2021,Wrexham 014C,W01000385,1692,1433,259
2021,Wrexham 015A,W01000386,1390,1231,159
2021,Wrexham 008D,W01000387,1105,1007,98
2021,Wrexham 008E,W01000388,1073,958,115
2021,Wrexham 017D,W01000389,1943,1688,255
2021,Wrexham 021A,W01000390,1695,1519,176
2021,Wrexham 003D,W01000391,1403,1240,163
2021,Wrexham 003E,W01000392,1562,1412,150
2021,Wrexham 023G,W01000393,1889,1659,230
2021,Wrexham 016A,W01000394,1136,1033,103
2021,Wrexham 016B,W01000395,1015,897,118
2021,Wrexham 013A,W01000398,1188,988,200
2021,Wrexham 013B,W01000399,1061,877,184
2021,Wrexham 005C,W01000400,1775,1567,208
2021,Wrexham 005D,W01000401,1944,1706,238
2021,Wrexham 011D,W01000402,2467,2192,275
2021,Wrexham 018C,W01000403,1284,1182,102
2021,Wrexham 018D,W01000404,1956,1781,175
2021,Wrexham 015B,W01000405,2204,1726,478
2021,Wrexham 013C,W01000406,2095,1726,369
2021,Wrexham 016C,W01000407,1361,1186,175
2021,Wrexham 013D,W01000408,1193,982,211
2021,Wrexham 017E,W01000409,1782,1622,160
2021,Wrexham 014D,W01000410,1644,1281,363
2021,Wrexham 015C,W01000411,1470,1168,302
2021,Wrexham 015D,W01000412,1446,1074,372
2021,Wrexham 010C,W01000413,1251,1137,114
2021,Wrexham 010D,W01000414,1153,1060,93
2021,Wrexham 023F,W01000415,1392,1252,140
2021,Wrexham 023D,W01000416,1142,1037,105
2021,Wrexham 022B,W01000417,1499,1371,128
2021,Wrexham 022A,W01000418,1703,1543,160
2021,Wrexham 016D,W01000419,1388,1199,189
2021,Wrexham 016E,W01000420,1483,1294,189
2021,Wrexham 008F,W01000422,2093,1876,217
2021,Wrexham 012D,W01000423,2104,1831,273
2021,Wrexham 012E,W01000424,1237,1090,147
2021,Wrexham 010E,W01000425,1969,1812,157
2021,Powys 021A,W01000426,1385,933,452
2021,Powys 011A,W01000427,1310,1197,113
2021,Powys 005A,W01000428,1298,1126,172
2021,Powys 010A,W01000429,2272,1806,466
2021,Powys 015A,W01000430,1290,1149,141
2021,Powys 014A,W01000431,1226,1054,172
2021,Powys 014B,W01000432,1178,1025,153
2021,Powys 006A,W01000433,2219,1664,555
2021,Powys 007A,W01000434,1704,1625,79
2021,Powys 012A,W01000438,1203,1110,93
2021,Powys 007B,W01000439,1984,1733,251
2021,Powys 020A,W01000440,1286,1113,173
2021,Powys 005B,W01000441,1493,1355,138
2021,Powys 004A,W01000442,1999,910,1089
2021,Powys 015B,W01000443,2237,2046,191
2021,Powys 002A,W01000444,2200,1909,291
2021,Powys 015C,W01000445,1456,1375,81
2021,Powys 015D,W01000446,1642,1538,104
2021,Powys 007C,W01000447,1953,1757,196
2021,Powys 011B,W01000448,1349,1265,84
2021,Powys 011C,W01000449,1495,1390,105
2021,Powys 014C,W01000450,1364,1181,183
2021,Powys 012B,W01000451,1160,1054,106
2021,Powys 004B,W01000452,1964,1085,879
2021,Powys 010B,W01000453,1352,1138,214
2021,Powys 013A,W01000454,1242,1114,128
2021,Powys 013B,W01000455,2125,1896,229
2021,Powys 013C,W01000456,2119,1909,210
2021,Powys 002B,W01000457,2098,1883,215
2021,Powys 002C,W01000458,1814,1615,199
2021,Powys 014D,W01000459,1184,1055,129
2021,Powys 006B,W01000460,1668,1097,571
2021,Powys 001A,W01000461,1550,1061,489
2021,Powys 011D,W01000464,1155,1071,84
2021,Powys 018E,W01000465,1018,910,108
2021,Powys 010C,W01000466,1288,1091,197
2021,Powys 010D,W01000467,1422,1216,206
2021,Powys 001D,W01000470,1948,1608,340
2021,Powys 014E,W01000471,1723,1459,264
2021,Powys 012C,W01000472,1160,1025,135
2021,Powys 004C,W01000473,2092,1100,992
2021,Powys 020B,W01000474,1707,1302,405
2021,Powys 001E,W01000475,2349,1688,661
2021,Powys 005C,W01000476,1250,1139,111
2021,Powys 012D,W01000477,1487,1338,149
2021,Powys 009A,W01000478,1797,1593,204
2021,Powys 009B,W01000479,1401,1224,177
2021,Powys 008A,W01000480,2037,1803,234
2021,Powys 008B,W01000481,2139,1873,266
2021,Powys 008C,W01000482,1852,1598,254
2021,Powys 009C,W01000483,1771,1559,212
2021,Powys 011E,W01000484,1650,1536,114
2021,Powys 011F,W01000485,1553,1463,90
2021,Powys 011G,W01000486,1039,966,73
2021,Powys 012E,W01000487,2029,1774,255
2021,Powys 006C,W01000488,2124,1696,428
2021,Powys 017A,W01000489,1741,1539,202
2021,Powys 017D,W01000492,1492,1326,166
2021,Powys 017E,W01000493,1693,1513,180
2021,Powys 015E,W01000494,1661,1487,174
2021,Powys 021B,W01000496,2038,1575,463
2021,Powys 005D,W01000497,1339,1223,116
2021,Powys 003A,W01000498,1439,1293,146
2021,Powys 003B,W01000499,1208,1089,119
2021,Powys 003C,W01000500,1644,1439,205
2021,Powys 003D,W01000501,2157,1900,257
2021,Powys 021C,W01000502,2023,1316,707
2021,Powys 020C,W01000503,1034,887,147
2021,Powys 021D,W01000504,1098,829,269
2021,Powys 021E,W01000505,1400,903,497
2021,Ceredigion 005A,W01000506,1250,512,738
2021,Ceredigion 009A,W01000507,1112,602,510
2021,Ceredigion 009B,W01000508,1009,552,457
2021,Ceredigion 009C,W01000509,1819,822,997
2021,Ceredigion 009D,W01000510,1149,605,544
2021,Ceredigion 009E,W01000511,1134,664,470
2021,Ceredigion 002A,W01000512,1341,757,584
2021,Ceredigion 002B,W01000513,2085,1568,517
2021,Ceredigion 003A,W01000515,1276,858,418
2021,Ceredigion 003B,W01000516,1580,1076,504
2021,Ceredigion 002D,W01000517,1157,897,260
2021,Ceredigion 003C,W01000518,991,659,332
2021,Ceredigion 010A,W01000519,1721,855,866
2021,Ceredigion 010B,W01000522,1181,627,554
2021,Ceredigion 001C,W01000523,1836,875,961
2021,Ceredigion 005B,W01000524,1877,899,978
2021,Ceredigion 011A,W01000525,1209,645,564
2021,Ceredigion 008A,W01000527,1131,629,502
2021,Ceredigion 008B,W01000528,1312,622,690
2021,Ceredigion 010C,W01000531,1721,861,860
2021,Ceredigion 010D,W01000533,1313,566,747
2021,Ceredigion 011B,W01000534,1485,695,790
2021,Ceredigion 008C,W01000535,1996,943,1053
2021,Ceredigion 011E,W01000536,1336,703,633
2021,Ceredigion 008D,W01000537,1366,767,599
2021,Ceredigion 005C,W01000538,1508,717,791
2021,Ceredigion 005D,W01000539,1153,617,536
2021,Ceredigion 005E,W01000540,1117,564,553
2021,Ceredigion 008E,W01000541,1696,803,893
2021,Ceredigion 011F,W01000542,2152,1071,1081
2021,Ceredigion 011C,W01000543,1959,995,964
2021,Ceredigion 007D,W01000545,1944,1062,882
2021,Ceredigion 009F,W01000546,1115,608,507
2021,Ceredigion 009G,W01000547,1120,499,621
2021,Ceredigion 001D,W01000548,1727,828,899
2021,Ceredigion 001E,W01000549,1716,810,906
2021,Ceredigion 011G,W01000550,1130,467,663
2021,Ceredigion 010E,W01000551,1346,675,671
2021,Ceredigion 011D,W01000552,1954,836,1118
2021,Pembrokeshire 011A,W01000553,1209,1087,122
2021,Pembrokeshire 009A,W01000554,1812,1623,189
2021,Pembrokeshire 008A,W01000555,1490,1273,217
2021,Pembrokeshire 008B,W01000556,1153,995,158
2021,Pembrokeshire 014A,W01000557,1488,1325,163
2021,Pembrokeshire 001A,W01000558,2066,1103,963
2021,Pembrokeshire 001B,W01000559,1427,708,719
2021,Pembrokeshire 001C,W01000560,1268,525,743
2021,Pembrokeshire 001D,W01000561,1271,555,716
2021,Pembrokeshire 002A,W01000562,1574,836,738
2021,Pembrokeshire 011B,W01000563,1100,956,144
2021,Pembrokeshire 011C,W01000564,1267,1120,147
2021,Pembrokeshire 002B,W01000565,1796,1290,506
2021,Pembrokeshire 002C,W01000566,1549,1066,483
2021,Pembrokeshire 002D,W01000567,1968,1421,547
2021,Pembrokeshire 005B,W01000569,1065,946,119
2021,Pembrokeshire 005C,W01000570,1366,1222,144
2021,Pembrokeshire 006A,W01000571,2354,2073,281
2021,Pembrokeshire 005D,W01000572,1784,1566,218
2021,Pembrokeshire 006B,W01000573,2494,2149,345
2021,Pembrokeshire 015A,W01000574,1684,1531,153
2021,Pembrokeshire 008C,W01000575,2716,2413,303
2021,Pembrokeshire 011D,W01000576,2243,2006,237
2021,Pembrokeshire 007A,W01000577,1521,1232,289
2021,Pembrokeshire 014B,W01000578,1679,1519,160
2021,Pembrokeshire 003A,W01000579,2308,1576,732
2021,Pembrokeshire 009B,W01000580,2262,2012,250
2021,Pembrokeshire 003B,W01000581,1376,862,514
2021,Pembrokeshire 004A,W01000582,1636,965,671
2021,Pembrokeshire 004B,W01000583,1391,754,637
2021,Pembrokeshire 014C,W01000584,2022,1814,208
2021,Pembrokeshire 007B,W01000585,1332,1099,233
2021,Pembrokeshire 006C,W01000586,2143,1887,256
2021,Pembrokeshire 010A,W01000587,1935,1773,162
2021,Pembrokeshire 010B,W01000588,2259,2052,207
2021,Pembrokeshire 012A,W01000589,1106,1034,72
2021,Pembrokeshire 012B,W01000590,1110,1045,65
2021,Pembrokeshire 012C,W01000591,1587,1470,117
2021,Pembrokeshire 012D,W01000592,1279,1182,97
2021,Pembrokeshire 012E,W01000594,2103,1937,166
2021,Pembrokeshire 007C,W01000595,2300,1807,493
2021,Pembrokeshire 007D,W01000596,1676,1390,286
2021,Pembrokeshire 002E,W01000597,1038,612,426
2021,Pembrokeshire 009C,W01000598,2108,1960,148
2021,Pembrokeshire 009D,W01000599,1948,1798,150
2021,Pembrokeshire 013A,W01000600,1559,1429,130
2021,Pembrokeshire 013B,W01000601,1462,1369,93
2021,Pembrokeshire 013C,W01000602,1184,1079,105
2021,Pembrokeshire 013D,W01000603,1754,1620,134
2021,Pembrokeshire 013E,W01000604,1654,1525,129
2021,Pembrokeshire 013F,W01000605,1743,1628,115
2021,Pembrokeshire 015B,W01000606,1603,1516,87
2021,Pembrokeshire 015C,W01000607,2375,2165,210
2021,Pembrokeshire 015D,W01000608,1392,1265,127
2021,Pembrokeshire 014D,W01000609,2375,2166,209
2021,Pembrokeshire 016A,W01000610,1676,1448,228
2021,Pembrokeshire 004C,W01000611,2042,1695,347
2021,Pembrokeshire 003C,W01000612,1733,1308,425
2021,Pembrokeshire 001E,W01000613,2011,1174,837
2021,Pembrokeshire 008D,W01000614,1352,1191,161
2021,Pembrokeshire 002F,W01000617,1485,1040,445
2021,Pembrokeshire 003D,W01000618,1685,1334,351
2021,Pembrokeshire 016B,W01000619,1959,1740,219
2021,Pembrokeshire 008E,W01000622,1392,1229,163
2021,Pembrokeshire 004D,W01000623,1961,1540,421
2021,Carmarthenshire 005A,W01000624,2280,1023,1257
2021,Carmarthenshire 013A,W01000625,1087,607,480
2021,Carmarthenshire 013B,W01000626,1572,826,746
2021,Carmarthenshire 013C,W01000627,2324,1160,1164
2021,Carmarthenshire 024A,W01000628,1492,1117,375
2021,Carmarthenshire 024B,W01000629,1595,1251,344
2021,Carmarthenshire 024C,W01000630,1530,1198,332
2021,Carmarthenshire 024D,W01000631,1767,1502,265
2021,Carmarthenshire 021A,W01000632,1305,906,399
2021,Carmarthenshire 021B,W01000633,1383,1009,374
2021,Carmarthenshire 021C,W01000634,1276,862,414
2021,Carmarthenshire 025A,W01000635,2329,1709,620
2021,Carmarthenshire 025B,W01000636,2268,1708,560
2021,Carmarthenshire 007A,W01000637,1336,905,431
2021,Carmarthenshire 007B,W01000638,1101,820,281
2021,Carmarthenshire 007C,W01000639,1457,961,496
2021,Carmarthenshire 007D,W01000640,1187,654,533
2021,Carmarthenshire 008A,W01000641,1998,1382,616
2021,Carmarthenshire 008B,W01000642,1714,1065,649
2021,Carmarthenshire 006A,W01000643,1622,1199,423
2021,Carmarthenshire 006B,W01000644,1810,1107,703
2021,Carmarthenshire 006C,W01000645,1898,1193,705
2021,Carmarthenshire 003A,W01000646,2077,1130,947
2021,Carmarthenshire 002A,W01000647,1394,810,584
2021,Carmarthenshire 006D,W01000648,1393,722,671
2021,Carmarthenshire 006E,W01000649,1506,746,760
2021,Carmarthenshire 002B,W01000650,1520,861,659
2021,Carmarthenshire 020A,W01000651,1465,1064,401
2021,Carmarthenshire 020B,W01000652,1733,1366,367
2021,Carmarthenshire 023A,W01000653,1427,948,479
2021,Carmarthenshire 023B,W01000654,1618,1236,382
2021,Carmarthenshire 020C,W01000655,1849,1377,472
2021,Carmarthenshire 010A,W01000656,1987,979,1008
2021,Carmarthenshire 010B,W01000657,1130,592,538
2021,Carmarthenshire 010C,W01000658,1287,661,626
2021,Carmarthenshire 026A,W01000659,1712,1408,304
2021,Carmarthenshire 026B,W01000660,1444,1184,260
2021,Carmarthenshire 016A,W01000662,2107,967,1140
2021,Carmarthenshire 016B,W01000663,2402,935,1467
2021,Carmarthenshire 016C,W01000664,2506,1107,1399
2021,Carmarthenshire 017A,W01000665,1768,1094,674
2021,Carmarthenshire 017B,W01000666,1596,999,597
2021,Carmarthenshire 023C,W01000667,2039,1372,667
2021,Carmarthenshire 018A,W01000670,1532,953,579
2021,Carmarthenshire 018B,W01000671,2088,1301,787
2021,Carmarthenshire 027E,W01000672,1462,1181,281
2021,Carmarthenshire 027F,W01000673,1082,852,230
2021,Carmarthenshire 027A,W01000674,2044,1076,968
2021,Carmarthenshire 012A,W01000675,2021,896,1125
2021,Carmarthenshire 004A,W01000676,1488,782,706
2021,Carmarthenshire 004B,W01000677,1411,809,602
2021,Carmarthenshire 002C,W01000678,1344,858,486
2021,Carmarthenshire 002D,W01000679,1206,740,466
2021,Carmarthenshire 011A,W01000680,2248,1108,1140
2021,Carmarthenshire 011B,W01000681,2020,966,1054
2021,Carmarthenshire 005B,W01000682,1363,577,786
2021,Carmarthenshire 005C,W01000683,1039,665,374
2021,Carmarthenshire 005D,W01000684,1720,929,791
2021,Carmarthenshire 001A,W01000685,1502,732,770
2021,Carmarthenshire 001B,W01000686,1187,521,666
2021,Carmarthenshire 004C,W01000687,1906,1007,899
2021,Carmarthenshire 003B,W01000688,1657,871,786
2021,Carmarthenshire 003C,W01000689,1696,882,814
2021,Carmarthenshire 019A,W01000690,1729,1009,720
2021,Carmarthenshire 019B,W01000691,1800,1232,568
2021,Carmarthenshire 019C,W01000692,1500,942,558
2021,Carmarthenshire 008C,W01000693,1099,576,523
2021,Carmarthenshire 008D,W01000694,1464,756,708
2021,Carmarthenshire 012B,W01000695,2162,1177,985
2021,Carmarthenshire 012C,W01000696,1609,735,874
2021,Carmarthenshire 015A,W01000697,1876,769,1107
2021,Carmarthenshire 015B,W01000698,1908,753,1155
2021,Carmarthenshire 015C,W01000699,1434,721,713
2021,Carmarthenshire 027G,W01000700,1938,1161,777
2021,Carmarthenshire 001C,W01000701,1564,745,819
2021,Carmarthenshire 001D,W01000702,1147,565,582
2021,Carmarthenshire 022A,W01000703,1719,1338,381
2021,Carmarthenshire 022B,W01000704,1609,1078,531
2021,Carmarthenshire 022C,W01000705,1852,1415,437
2021,Carmarthenshire 025C,W01000706,1505,1166,339
2021,Carmarthenshire 025D,W01000707,1392,1075,317
2021,Carmarthenshire 025E,W01000708,1329,1062,267
2021,Carmarthenshire 004D,W01000709,2145,1176,969
2021,Carmarthenshire 021D,W01000710,2124,1395,729
2021,Carmarthenshire 021E,W01000711,1975,1522,453
2021,Carmarthenshire 015D,W01000712,1643,735,908
2021,Carmarthenshire 015E,W01000713,1328,564,764
2021,Carmarthenshire 013D,W01000714,1377,747,630
2021,Carmarthenshire 013E,W01000715,1252,607,645
2021,Carmarthenshire 016D,W01000716,1371,529,842
2021,Carmarthenshire 016E,W01000717,1406,563,843
2021,Carmarthenshire 010D,W01000718,1361,514,847
2021,Carmarthenshire 010E,W01000719,1404,607,797
2021,Carmarthenshire 027B,W01000720,1770,939,831
2021,Carmarthenshire 027C,W01000721,1355,709,646
2021,Carmarthenshire 012D,W01000722,1321,623,698
2021,Carmarthenshire 012E,W01000723,1344,842,502
2021,Carmarthenshire 011C,W01000724,1889,1018,871
2021,Carmarthenshire 011D,W01000725,2262,1162,1100
2021,Carmarthenshire 003D,W01000728,2022,1112,910
2021,Carmarthenshire 018C,W01000729,1197,599,598
2021,Carmarthenshire 018D,W01000730,1234,740,494
2021,Carmarthenshire 017C,W01000731,2337,1352,985
2021,Carmarthenshire 026D,W01000732,1263,1020,243
2021,Carmarthenshire 026E,W01000733,1156,956,200
2021,Carmarthenshire 026F,W01000734,1344,1106,238
2021,Carmarthenshire 027D,W01000735,2318,1460,858
2021,Swansea 028A,W01000736,1721,1532,189
2021,Swansea 028B,W01000737,1452,1302,150
2021,Swansea 014A,W01000738,1659,1549,110
2021,Swansea 014B,W01000739,2151,1991,160
2021,Swansea 014C,W01000740,1525,1396,129
2021,Swansea 014D,W01000741,1798,1632,166
2021,Swansea 016A,W01000742,1604,1506,98
2021,Swansea 016B,W01000744,1472,1376,96
2021,Swansea 025B,W01000745,2404,2236,168
2021,Swansea 025C,W01000746,1377,1270,107
2021,Swansea 024A,W01000747,1552,1416,136
2021,Swansea 026A,W01000749,1951,1799,152
2021,Swansea 002A,W01000750,1414,1120,294
2021,Swansea 002B,W01000751,1366,1032,334
2021,Swansea 002C,W01000752,1427,1239,188
2021,Swansea 002D,W01000753,1382,1124,258
2021,Swansea 002E,W01000754,1512,1233,279
2021,Swansea 017A,W01000755,1919,1749,170
2021,Swansea 017B,W01000756,1428,1296,132
2021,Swansea 017C,W01000757,1394,1278,116
2021,Swansea 017D,W01000758,1842,1626,216
2021,Swansea 012A,W01000759,1506,1327,179
2021,Swansea 013A,W01000760,1527,1347,180
2021,Swansea 013B,W01000761,1518,1386,132
2021,Swansea 013C,W01000762,1611,1512,99
2021,Swansea 015A,W01000763,1363,1272,91
2021,Swansea 015B,W01000764,1517,1410,107
2021,Swansea 015C,W01000765,1581,1471,110
2021,Swansea 015D,W01000766,1448,1350,98
2021,Swansea 015E,W01000767,1388,1309,79
2021,Swansea 032A,W01000768,1315,1206,109
2021,Swansea 032B,W01000769,1356,1253,103
2021,Swansea 032D,W01000770,1484,1384,100
2021,Swansea 032G,W01000771,1273,1162,111
2021,Swansea 018A,W01000772,1451,1289,162
2021,Swansea 005B,W01000774,1563,1320,243
2021,Swansea 030A,W01000775,1602,1480,122
2021,Swansea 030B,W01000776,1749,1551,198
2021,Swansea 012B,W01000777,1672,1482,190
2021,Swansea 012C,W01000778,1733,1532,201
2021,Swansea 012D,W01000779,1417,1239,178
2021,Swansea 032E,W01000781,1584,1414,170
2021,Swansea 032F,W01000782,1049,965,84
2021,Swansea 007A,W01000784,1261,1069,192
2021,Swansea 007B,W01000785,1719,1426,293
2021,Swansea 007C,W01000786,1229,1018,211
2021,Swansea 016C,W01000787,1395,1258,137
2021,Swansea 016D,W01000788,1438,1336,102
2021,Swansea 016E,W01000789,1368,1293,75
2021,Swansea 016F,W01000790,2618,2448,170
2021,Swansea 004A,W01000791,1377,1222,155
2021,Swansea 004B,W01000792,1536,1223,313
2021,Swansea 004C,W01000793,1813,1505,308
2021,Swansea 010A,W01000794,2133,1765,368
2021,Swansea 006A,W01000795,1522,1305,217
2021,Swansea 010B,W01000797,1476,1280,196
2021,Swansea 010C,W01000798,1383,1226,157
2021,Swansea 010D,W01000799,1783,1617,166
2021,Swansea 006C,W01000800,1425,1186,239
2021,Swansea 006D,W01000801,1666,1546,120
2021,Swansea 007D,W01000802,2284,1954,330
2021,Swansea 002F,W01000803,1778,1227,551
2021,Swansea 028C,W01000804,1404,1222,182
2021,Swansea 028D,W01000805,1119,989,130
2021,Swansea 003A,W01000806,1367,1217,150
2021,Swansea 003B,W01000807,1267,1143,124
2021,Swansea 003C,W01000808,1361,1205,156
2021,Swansea 008A,W01000809,1463,1326,137
2021,Swansea 003D,W01000810,1303,1204,99
2021,Swansea 008B,W01000811,1347,1214,133
2021,Swansea 008C,W01000812,1409,1317,92
2021,Swansea 008D,W01000813,1531,1307,224
2021,Swansea 008E,W01000814,1382,1264,118
2021,Swansea 003E,W01000815,1459,1186,273
2021,Swansea 003F,W01000816,1725,1523,202
2021,Swansea 009A,W01000817,1880,1723,157
2021,Swansea 009B,W01000818,1447,1290,157
2021,Swansea 009C,W01000819,1412,1258,154
2021,Swansea 009D,W01000820,1353,1214,139
2021,Swansea 009E,W01000821,1432,1344,88
2021,Swansea 009F,W01000822,1170,1056,114
2021,Swansea 031A,W01000823,1789,1604,185
2021,Swansea 031B,W01000824,1624,1413,211
2021,Swansea 031C,W01000825,1247,1082,165
2021,Swansea 031D,W01000826,1236,1073,163
2021,Swansea 031E,W01000827,1227,1093,134
2021,Swansea 018B,W01000828,1606,1417,189
2021,Swansea 018C,W01000829,1872,1641,231
2021,Swansea 011A,W01000830,1696,1607,89
2021,Swansea 013D,W01000831,1668,1511,157
2021,Swansea 011B,W01000832,1522,1423,99
2021,Swansea 011C,W01000833,1567,1472,95
2021,Swansea 011D,W01000834,1393,1259,134
2021,Swansea 013E,W01000835,1405,1301,104
2021,Swansea 011E,W01000836,2281,2072,209
2021,Swansea 004D,W01000837,2238,1861,377
2021,Swansea 004E,W01000838,1226,1103,123
2021,Swansea 030C,W01000839,1024,916,108
2021,Swansea 030D,W01000840,1588,1420,168
2021,Swansea 005C,W01000841,1428,1245,183
2021,Swansea 005D,W01000842,1385,1200,185
2021,Swansea 005E,W01000843,1349,1144,205
2021,Swansea 005F,W01000844,1459,1276,183
2021,Swansea 001A,W01000845,1963,1409,554
2021,Swansea 001B,W01000846,1985,1460,525
2021,Swansea 001C,W01000847,1230,901,329
2021,Swansea 001D,W01000848,1168,968,200
2021,Swansea 021A,W01000849,2118,1951,167
2021,Swansea 021C,W01000851,1564,1449,115
2021,Swansea 021D,W01000852,1433,1336,97
2021,Swansea 022A,W01000853,1634,1429,205
2021,Swansea 022B,W01000854,1462,1278,184
2021,Swansea 022C,W01000855,1390,1234,156
2021,Swansea 022D,W01000856,1695,1589,106
2021,Swansea 022E,W01000857,1872,1684,188
2021,Swansea 027A,W01000858,1603,1367,236
2021,Swansea 027B,W01000859,1376,1219,157
2021,Swansea 027C,W01000860,1503,1266,237
2021,Swansea 027D,W01000861,1930,1695,235
2021,Swansea 019A,W01000862,1492,1402,90
2021,Swansea 019B,W01000863,1561,1488,73
2021,Swansea 019C,W01000864,1568,1488,80
2021,Swansea 019D,W01000865,1367,1296,71
2021,Swansea 019E,W01000866,1134,1066,68
2021,Swansea 019F,W01000867,1238,1154,84
2021,Swansea 024B,W01000868,1066,913,153
2021,Swansea 024C,W01000869,1499,1331,168
2021,Swansea 024D,W01000870,1349,1189,160
2021,Swansea 026B,W01000871,1739,1583,156
2021,Swansea 024E,W01000872,1365,1137,228
2021,Swansea 026C,W01000873,1513,1344,169
2021,Swansea 024F,W01000874,1774,1552,222
2021,Swansea 026D,W01000875,1878,1687,191
2021,Swansea 026E,W01000876,1616,1422,194
2021,Swansea 007E,W01000877,1629,1349,280
2021,Swansea 007F,W01000878,1237,1035,202
2021,Swansea 029A,W01000879,1647,1451,196
2021,Swansea 029B,W01000880,1517,1328,189
2021,Swansea 029C,W01000881,1291,1156,135
2021,Swansea 029D,W01000882,1689,1531,158
2021,Neath Port Talbot 016A,W01000883,1301,1219,82
2021,Neath Port Talbot 017A,W01000884,1230,1149,81
2021,Neath Port Talbot 017B,W01000885,1402,1308,94
2021,Neath Port Talbot 017C,W01000886,1564,1476,88
2021,Neath Port Talbot 021C,W01000887,2315,2028,287
2021,Neath Port Talbot 004A,W01000888,2630,1996,634
2021,Neath Port Talbot 015A,W01000889,1762,1606,156
2021,Neath Port Talbot 015B,W01000890,1502,1394,108
2021,Neath Port Talbot 015C,W01000891,1403,1286,117
2021,Neath Port Talbot 015D,W01000892,1906,1725,181
2021,Neath Port Talbot 003A,W01000893,1868,1656,212
2021,Neath Port Talbot 013A,W01000894,1426,1304,122
2021,Neath Port Talbot 013B,W01000895,1421,1307,114
2021,Neath Port Talbot 013C,W01000896,1524,1369,155
2021,Neath Port Talbot 013D,W01000897,1279,1175,104
2021,Neath Port Talbot 014A,W01000898,1421,1240,181
2021,Neath Port Talbot 014B,W01000899,1817,1570,247
2021,Neath Port Talbot 014C,W01000900,1527,1363,164
2021,Neath Port Talbot 014D,W01000901,1616,1395,221
2021,Neath Port Talbot 006C,W01000904,1439,1265,174
2021,Neath Port Talbot 006D,W01000905,1451,1300,151
2021,Neath Port Talbot 007B,W01000907,1681,1518,163
2021,Neath Port Talbot 006E,W01000908,1555,1369,186
2021,Neath Port Talbot 009A,W01000909,1151,1063,88
2021,Neath Port Talbot 009B,W01000910,1339,1210,129
2021,Neath Port Talbot 009C,W01000911,1124,994,130
2021,Neath Port Talbot 010A,W01000912,1169,1077,92
2021,Neath Port Talbot 010B,W01000913,1120,1009,111
2021,Neath Port Talbot 010C,W01000914,1598,1482,116
2021,Neath Port Talbot 010D,W01000915,1090,981,109
2021,Neath Port Talbot 010E,W01000916,1154,1041,113
2021,Neath Port Talbot 002A,W01000918,1883,1529,354
2021,Neath Port Talbot 020A,W01000919,1120,520,600
2021,Neath Port Talbot 021G,W01000921,1405,1332,73
2021,Neath Port Talbot 007C,W01000922,1541,1396,145
2021,Neath Port Talbot 003B,W01000925,1488,1261,227
2021,Neath Port Talbot 003C,W01000926,1798,1398,400
2021,Neath Port Talbot 020B,W01000927,1993,1455,538
2021,Neath Port Talbot 020C,W01000928,1544,743,801
2021,Neath Port Talbot 020D,W01000929,1224,711,513
2021,Neath Port Talbot 021F,W01000930,1111,1051,60
2021,Neath Port Talbot 020E,W01000931,1316,644,672
2021,Neath Port Talbot 019A,W01000932,1002,930,72
2021,Neath Port Talbot 019B,W01000933,1943,1726,217
2021,Neath Port Talbot 008A,W01000934,1205,1112,93
2021,Neath Port Talbot 008B,W01000935,1508,1391,117
2021,Neath Port Talbot 012A,W01000936,1327,1240,87
2021,Neath Port Talbot 013E,W01000937,1873,1681,192
2021,Neath Port Talbot 008C,W01000938,1360,1194,166
2021,Neath Port Talbot 008D,W01000939,1122,1041,81
2021,Neath Port Talbot 008E,W01000940,1230,1118,112
2021,Neath Port Talbot 012B,W01000941,1487,1360,127
2021,Neath Port Talbot 012C,W01000942,1735,1599,136
2021,Neath Port Talbot 012D,W01000943,1442,1256,186
2021,Neath Port Talbot 002B,W01000944,1145,973,172
2021,Neath Port Talbot 014E,W01000945,1131,994,137
2021,Neath Port Talbot 004B,W01000946,1749,1271,478
2021,Neath Port Talbot 004C,W01000947,2109,1610,499
2021,Neath Port Talbot 004D,W01000948,1777,1285,492
2021,Neath Port Talbot 018A,W01000949,1291,1164,127
2021,Neath Port Talbot 018B,W01000950,1417,1298,119
2021,Neath Port Talbot 018C,W01000951,1736,1590,146
2021,Neath Port Talbot 018D,W01000952,1135,1042,93
2021,Neath Port Talbot 021B,W01000953,1559,1379,180
2021,Neath Port Talbot 021A,W01000954,1312,1187,125
2021,Neath Port Talbot 004E,W01000955,1340,1029,311
2021,Neath Port Talbot 004F,W01000956,1172,941,231
2021,Neath Port Talbot 017D,W01000957,1570,1463,107
2021,Neath Port Talbot 016B,W01000958,1512,1429,83
2021,Neath Port Talbot 017E,W01000959,1687,1561,126
2021,Neath Port Talbot 017F,W01000960,1718,1609,109
2021,Neath Port Talbot 016C,W01000961,1542,1416,126
2021,Neath Port Talbot 016D,W01000962,1487,1364,123
2021,Neath Port Talbot 016E,W01000963,1798,1673,125
2021,Neath Port Talbot 016F,W01000964,1755,1623,132
2021,Neath Port Talbot 002C,W01000965,1968,1555,413
2021,Neath Port Talbot 018E,W01000966,1402,1284,118
2021,Neath Port Talbot 019C,W01000967,1372,1304,68
2021,Neath Port Talbot 019D,W01000968,1905,1736,169
2021,Neath Port Talbot 009D,W01000969,1498,1307,191
2021,Neath Port Talbot 021D,W01000970,1081,994,87
2021,Neath Port Talbot 004G,W01000971,1359,941,418
2021,Neath Port Talbot 020F,W01000973,1294,799,495
2021,Bridgend 006A,W01000974,2301,2085,216
2021,Bridgend 004A,W01000975,2165,2012,153
2021,Bridgend 003A,W01000976,1060,990,70
2021,Bridgend 003B,W01000977,1379,1271,108
2021,Bridgend 004B,W01000978,1725,1565,160
2021,Bridgend 015A,W01000979,1558,1416,142
2021,Bridgend 016A,W01000980,1303,1196,107
2021,Bridgend 016B,W01000981,1202,1079,123
2021,Bridgend 016C,W01000982,1393,1287,106
2021,Bridgend 015B,W01000983,1466,1317,149
2021,Bridgend 016D,W01000984,2103,1885,218
2021,Bridgend 015C,W01000985,1236,1134,102
2021,Bridgend 007A,W01000986,1618,1415,203
2021,Bridgend 007B,W01000987,2334,2153,181
2021,Bridgend 013A,W01000989,1530,1355,175
2021,Bridgend 017B,W01000990,1508,1408,100
2021,Bridgend 001A,W01000991,1104,1016,88
2021,Bridgend 001B,W01000992,1348,1262,86
2021,Bridgend 001C,W01000993,1315,1219,96
2021,Bridgend 001D,W01000994,1351,1245,106
2021,Bridgend 001E,W01000995,1325,1182,143
2021,Bridgend 008A,W01000996,1496,1379,117
2021,Bridgend 012A,W01000997,1651,1542,109
2021,Bridgend 010A,W01000999,1355,1236,119
2021,Bridgend 010B,W01001000,1685,1516,169
2021,Bridgend 010C,W01001001,1758,1583,175
2021,Bridgend 010D,W01001002,2339,2141,198
2021,Bridgend 015D,W01001003,1310,1205,105
2021,Bridgend 009A,W01001004,1014,920,94
2021,Bridgend 009B,W01001005,1556,1401,155
2021,Bridgend 009C,W01001006,2186,1958,228
2021,Bridgend 009D,W01001007,1832,1652,180
2021,Bridgend 011B,W01001008,2472,2224,248
2021,Bridgend 004C,W01001009,1208,1088,120
2021,Bridgend 012B,W01001010,1126,1053,73
2021,Bridgend 012C,W01001011,1246,1169,77
2021,Bridgend 005A,W01001012,1469,1251,218
2021,Bridgend 005B,W01001013,1437,1258,179
2021,Bridgend 002A,W01001014,1575,1418,157
2021,Bridgend 002B,W01001015,1423,1253,170
2021,Bridgend 005C,W01001016,1596,1452,144
2021,Bridgend 002C,W01001017,1425,1225,200
2021,Bridgend 002D,W01001018,1253,1079,174
2021,Bridgend 005D,W01001019,1539,1366,173
2021,Bridgend 002E,W01001020,1316,1183,133
2021,Bridgend 014A,W01001021,1558,1426,132
2021,Bridgend 014B,W01001022,1381,1286,95
2021,Bridgend 014C,W01001023,1607,1495,112
2021,Bridgend 003C,W01001024,1103,1029,74
2021,Bridgend 003D,W01001025,1195,1109,86
2021,Bridgend 012D,W01001026,1942,1800,142
2021,Bridgend 017C,W01001027,1459,1353,106
2021,Bridgend 014D,W01001028,1846,1670,176
2021,Bridgend 019A,W01001029,1684,1550,134
2021,Bridgend 019B,W01001030,1918,1737,181
2021,Bridgend 018A,W01001031,1443,1333,110
2021,Bridgend 018B,W01001032,1726,1573,153
2021,Bridgend 003E,W01001033,1701,1580,121
2021,Bridgend 003F,W01001034,1299,1192,107
2021,Bridgend 014E,W01001035,1689,1549,140
2021,Bridgend 017D,W01001036,1580,1376,204
2021,Bridgend 013B,W01001037,1763,1574,189
2021,Bridgend 011C,W01001038,2494,2266,228
2021,Bridgend 009E,W01001039,1662,1507,155
2021,Bridgend 009F,W01001040,1521,1386,135
2021,Bridgend 013C,W01001041,2240,2014,226
2021,Bridgend 004D,W01001042,1222,1057,165
2021,Bridgend 004E,W01001043,1132,997,135
2021,Bridgend 019C,W01001044,1558,1477,81
2021,Bridgend 019D,W01001045,1668,1563,105
2021,Bridgend 018C,W01001046,1886,1759,127
2021,Bridgend 018D,W01001047,1634,1474,160
2021,Bridgend 008B,W01001048,1382,1292,90
2021,Bridgend 008C,W01001049,1259,1149,110
2021,Bridgend 008D,W01001050,1501,1355,146
2021,Bridgend 008E,W01001051,1764,1611,153
2021,Bridgend 008F,W01001052,1240,1150,90
2021,Bridgend 018E,W01001053,992,886,106
2021,Bridgend 018F,W01001054,1332,1221,111
2021,Bridgend 007C,W01001055,1164,1079,85
2021,Bridgend 007D,W01001056,1152,1063,89
2021,Bridgend 006B,W01001057,1678,1533,145
2021,Bridgend 006C,W01001058,1840,1640,200
2021,Vale of Glamorgan 015A,W01001059,1702,1449,253
2021,Vale of Glamorgan 015B,W01001060,1383,1189,194
2021,Vale of Glamorgan 013A,W01001062,1304,1100,204
2021,Vale of Glamorgan 012A,W01001063,1543,1387,156
2021,Vale of Glamorgan 013B,W01001064,1371,1243,128
2021,Vale of Glamorgan 012B,W01001065,1518,1316,202
2021,Vale of Glamorgan 015D,W01001066,1575,1363,212
2021,Vale of Glamorgan 009A,W01001067,1344,1230,114
2021,Vale of Glamorgan 009B,W01001068,1604,1473,131
2021,Vale of Glamorgan 012C,W01001069,1474,1348,126
2021,Vale of Glamorgan 009C,W01001070,993,910,83
2021,Vale of Glamorgan 009D,W01001071,1436,1303,133
2021,Vale of Glamorgan 009E,W01001072,2630,2306,324
2021,Vale of Glamorgan 015E,W01001073,2017,1822,195
2021,Vale of Glamorgan 004A,W01001075,1143,985,158
2021,Vale of Glamorgan 004B,W01001076,1344,1214,130
2021,Vale of Glamorgan 004C,W01001077,1384,1246,138
2021,Vale of Glamorgan 004D,W01001078,1255,1084,171
2021,Vale of Glamorgan 012E,W01001079,1438,1265,173
2021,Vale of Glamorgan 012F,W01001080,1528,1382,146
2021,Vale of Glamorgan 007A,W01001081,1677,1484,193
2021,Vale of Glamorgan 002A,W01001082,1526,1302,224
2021,Vale of Glamorgan 002B,W01001083,1668,1407,261
2021,Vale of Glamorgan 002C,W01001084,1626,1414,212
2021,Vale of Glamorgan 002D,W01001085,1610,1376,234
2021,Vale of Glamorgan 006A,W01001086,1468,1261,207
2021,Vale of Glamorgan 006B,W01001087,1474,1286,188
2021,Vale of Glamorgan 006C,W01001088,2073,1875,198
2021,Vale of Glamorgan 006D,W01001089,1552,1404,148
2021,Vale of Glamorgan 006E,W01001090,1410,1234,176
2021,Vale of Glamorgan 010A,W01001091,1589,1420,169
2021,Vale of Glamorgan 007B,W01001092,2047,1787,260
2021,Vale of Glamorgan 013C,W01001093,1719,1533,186
2021,Vale of Glamorgan 007C,W01001094,1195,1065,130
2021,Vale of Glamorgan 007D,W01001095,1321,1175,146
2021,Vale of Glamorgan 007E,W01001096,1274,1147,127
2021,Vale of Glamorgan 007F,W01001097,1469,1346,123
2021,Vale of Glamorgan 010B,W01001098,1012,894,118
2021,Vale of Glamorgan 013D,W01001099,1166,1038,128
2021,Vale of Glamorgan 010C,W01001100,1452,1280,172
2021,Vale of Glamorgan 013E,W01001101,1472,1306,166
2021,Vale of Glamorgan 013F,W01001102,1467,1266,201
2021,Vale of Glamorgan 010D,W01001103,1149,1046,103
2021,Vale of Glamorgan 004E,W01001104,2041,1835,206
2021,Vale of Glamorgan 001A,W01001105,2757,2362,395
2021,Vale of Glamorgan 011A,W01001106,1415,1280,135
2021,Vale of Glamorgan 011B,W01001107,1475,1351,124
2021,Vale of Glamorgan 014A,W01001108,1756,1574,182
2021,Vale of Glamorgan 011C,W01001109,1345,1200,145
2021,Vale of Glamorgan 011D,W01001110,1659,1481,178
2021,Vale of Glamorgan 011E,W01001111,1314,1206,108
2021,Vale of Glamorgan 011F,W01001112,1279,1119,160
2021,Vale of Glamorgan 003A,W01001113,2263,1947,316
2021,Vale of Glamorgan 008A,W01001114,1545,1322,223
2021,Vale of Glamorgan 008B,W01001115,2099,1865,234
2021,Vale of Glamorgan 005A,W01001116,1908,1630,278
2021,Vale of Glamorgan 014B,W01001117,1263,1144,119
2021,Vale of Glamorgan 003B,W01001119,1819,1600,219
2021,Vale of Glamorgan 014D,W01001120,1320,1199,121
2021,Vale of Glamorgan 014E,W01001121,1659,1516,143
2021,Vale of Glamorgan 014F,W01001122,2369,2141,228
2021,Vale of Glamorgan 005B,W01001123,1447,1255,192
2021,Vale of Glamorgan 005C,W01001124,1421,1244,177
2021,Vale of Glamorgan 005D,W01001125,1386,1222,164
2021,Vale of Glamorgan 001B,W01001127,1588,1390,198
2021,Vale of Glamorgan 001C,W01001128,1638,1430,208
2021,Vale of Glamorgan 004F,W01001129,1598,1421,177
2021,Vale of Glamorgan 005F,W01001130,1240,1077,163
2021,Vale of Glamorgan 008C,W01001131,1650,1473,177
2021,Vale of Glamorgan 008D,W01001132,1307,1174,133
2021,Vale of Glamorgan 008E,W01001133,2187,1978,209
2021,Vale of Glamorgan 008F,W01001134,1084,970,114
2021,Vale of Glamorgan 003C,W01001135,2240,1943,297
2021,Vale of Glamorgan 003D,W01001136,1465,1316,149
2021,Rhondda Cynon Taf 005A,W01001137,2290,2078,212
2021,Rhondda Cynon Taf 005B,W01001138,1289,1159,130
2021,Rhondda Cynon Taf 005C,W01001139,1355,1242,113
2021,Rhondda Cynon Taf 005D,W01001140,1364,1244,120
2021,Rhondda Cynon Taf 005E,W01001141,1463,1356,107
2021,Rhondda Cynon Taf 005F,W01001142,1840,1667,173
2021,Rhondda Cynon Taf 012A,W01001143,1433,1258,175
2021,Rhondda Cynon Taf 012B,W01001144,1672,1523,149
2021,Rhondda Cynon Taf 012C,W01001145,1686,1508,178
2021,Rhondda Cynon Taf 012D,W01001146,1366,1188,178
2021,Rhondda Cynon Taf 004A,W01001147,1760,1548,212
2021,Rhondda Cynon Taf 002A,W01001148,1683,1504,179
2021,Rhondda Cynon Taf 003A,W01001149,1357,1208,149
2021,Rhondda Cynon Taf 003B,W01001150,1821,1627,194
2021,Rhondda Cynon Taf 003C,W01001151,1770,1562,208
2021,Rhondda Cynon Taf 002B,W01001152,1882,1630,252
2021,Rhondda Cynon Taf 002C,W01001153,1512,1350,162
2021,Rhondda Cynon Taf 003D,W01001154,1370,1255,115
2021,Rhondda Cynon Taf 002D,W01001155,1482,1323,159
2021,Rhondda Cynon Taf 003E,W01001156,1376,1152,224
2021,Rhondda Cynon Taf 028A,W01001157,1266,1117,149
2021,Rhondda Cynon Taf 028B,W01001158,1437,1283,154
2021,Rhondda Cynon Taf 028C,W01001159,1513,1273,240
2021,Rhondda Cynon Taf 029A,W01001160,1586,1415,171
2021,Rhondda Cynon Taf 025A,W01001162,2434,1990,444
2021,Rhondda Cynon Taf 019A,W01001164,1518,1321,197
2021,Rhondda Cynon Taf 019B,W01001165,1307,1125,182
2021,Rhondda Cynon Taf 016A,W01001166,1325,1251,74
2021,Rhondda Cynon Taf 016B,W01001167,1362,1219,143
2021,Rhondda Cynon Taf 004B,W01001168,1357,1247,110
2021,Rhondda Cynon Taf 004C,W01001169,2444,2221,223
2021,Rhondda Cynon Taf 004D,W01001170,1162,1036,126
2021,Rhondda Cynon Taf 017A,W01001171,1256,1126,130
2021,Rhondda Cynon Taf 020A,W01001172,1352,1163,189
2021,Rhondda Cynon Taf 020B,W01001173,1315,1212,103
2021,Rhondda Cynon Taf 020C,W01001174,1364,1274,90
2021,Rhondda Cynon Taf 009A,W01001175,1260,1129,131
2021,Rhondda Cynon Taf 013A,W01001176,1400,1235,165
2021,Rhondda Cynon Taf 009B,W01001177,1258,1138,120
2021,Rhondda Cynon Taf 023A,W01001178,1570,1412,158
2021,Rhondda Cynon Taf 023B,W01001179,1660,1549,111
2021,Rhondda Cynon Taf 015A,W01001180,1479,1301,178
2021,Rhondda Cynon Taf 015B,W01001181,1351,1179,172
2021,Rhondda Cynon Taf 026A,W01001184,2023,1789,234
2021,Rhondda Cynon Taf 022A,W01001185,2003,1761,242
2021,Rhondda Cynon Taf 001A,W01001186,1689,1404,285
2021,Rhondda Cynon Taf 001B,W01001187,1323,1088,235
2021,Rhondda Cynon Taf 001C,W01001188,1266,1126,140
2021,Rhondda Cynon Taf 029C,W01001189,1462,1304,158
2021,Rhondda Cynon Taf 029D,W01001190,2879,2422,457
2021,Rhondda Cynon Taf 031B,W01001192,1380,1228,152
2021,Rhondda Cynon Taf 030A,W01001193,1112,924,188
2021,Rhondda Cynon Taf 030B,W01001194,2058,1725,333
2021,Rhondda Cynon Taf 030C,W01001195,1424,1183,241
2021,Rhondda Cynon Taf 027B,W01001196,1401,1153,248
2021,Rhondda Cynon Taf 027C,W01001197,1184,886,298
2021,Rhondda Cynon Taf 027D,W01001198,1457,1275,182
2021,Rhondda Cynon Taf 027E,W01001199,1613,1360,253
2021,Rhondda Cynon Taf 009C,W01001202,1712,1564,148
2021,Rhondda Cynon Taf 009D,W01001203,1316,1210,106
2021,Rhondda Cynon Taf 006A,W01001204,1471,1285,186
2021,Rhondda Cynon Taf 006B,W01001205,1426,1250,176
2021,Rhondda Cynon Taf 006C,W01001206,1425,1289,136
2021,Rhondda Cynon Taf 006D,W01001207,1231,1114,117
2021,Rhondda Cynon Taf 006E,W01001208,1473,1308,165
2021,Rhondda Cynon Taf 008A,W01001209,1403,1267,136
2021,Rhondda Cynon Taf 008B,W01001210,1417,1287,130
2021,Rhondda Cynon Taf 008C,W01001211,1474,1348,126
2021,Rhondda Cynon Taf 008D,W01001212,1263,1153,110
2021,Rhondda Cynon Taf 011B,W01001214,1272,1095,177
2021,Rhondda Cynon Taf 011D,W01001216,1462,1320,142
2021,Rhondda Cynon Taf 018A,W01001217,1080,982,98
2021,Rhondda Cynon Taf 018B,W01001218,1478,1357,121
2021,Rhondda Cynon Taf 018C,W01001219,1178,1109,69
2021,Rhondda Cynon Taf 018D,W01001220,1449,1332,117
2021,Rhondda Cynon Taf 001D,W01001221,1387,1244,143
2021,Rhondda Cynon Taf 001E,W01001222,1499,1366,133
2021,Rhondda Cynon Taf 031C,W01001223,1691,1495,196
2021,Rhondda Cynon Taf 031D,W01001224,1982,1449,533
2021,Rhondda Cynon Taf 031E,W01001225,1536,1253,283
2021,Rhondda Cynon Taf 031F,W01001226,1641,1385,256
2021,Rhondda Cynon Taf 021C,W01001227,1233,988,245
2021,Rhondda Cynon Taf 021D,W01001228,1574,1317,257
2021,Rhondda Cynon Taf 017B,W01001229,1365,1189,176
2021,Rhondda Cynon Taf 017C,W01001230,1505,1288,217
2021,Rhondda Cynon Taf 017D,W01001231,1387,1195,192
2021,Rhondda Cynon Taf 020D,W01001232,1237,1085,152
2021,Rhondda Cynon Taf 001F,W01001233,1779,1515,264
2021,Rhondda Cynon Taf 021E,W01001234,1453,1267,186
2021,Rhondda Cynon Taf 021F,W01001235,1601,1431,170
2021,Rhondda Cynon Taf 021G,W01001236,1563,1343,220
2021,Rhondda Cynon Taf 022B,W01001237,1409,1269,140
2021,Rhondda Cynon Taf 022C,W01001238,1652,1477,175
2021,Rhondda Cynon Taf 026B,W01001239,1266,1115,151
2021,Rhondda Cynon Taf 026C,W01001240,1856,1615,241
2021,Rhondda Cynon Taf 026D,W01001241,1612,1355,257
2021,Rhondda Cynon Taf 030D,W01001242,1324,1134,190
2021,Rhondda Cynon Taf 030E,W01001243,1368,1220,148
2021,Rhondda Cynon Taf 025B,W01001244,1351,1162,189
2021,Rhondda Cynon Taf 025C,W01001245,1201,1039,162
2021,Rhondda Cynon Taf 025D,W01001246,1309,1132,177
2021,Rhondda Cynon Taf 016C,W01001247,1541,1402,139
2021,Rhondda Cynon Taf 016D,W01001248,1930,1716,214
2021,Rhondda Cynon Taf 024A,W01001249,1418,1268,150
2021,Rhondda Cynon Taf 024B,W01001250,1491,1306,185
2021,Rhondda Cynon Taf 024C,W01001251,1451,1308,143
2021,Rhondda Cynon Taf 024D,W01001252,1521,1374,147
2021,Rhondda Cynon Taf 023C,W01001253,1406,1282,124
2021,Rhondda Cynon Taf 023E,W01001255,1939,1736,203
2021,Rhondda Cynon Taf 019C,W01001256,1155,1007,148
2021,Rhondda Cynon Taf 019D,W01001257,1203,1019,184
2021,Rhondda Cynon Taf 019E,W01001258,1211,1070,141
2021,Rhondda Cynon Taf 018E,W01001259,1558,1433,125
2021,Rhondda Cynon Taf 014C,W01001260,1138,968,170
2021,Rhondda Cynon Taf 018F,W01001261,1208,1081,127
2021,Rhondda Cynon Taf 022D,W01001262,1534,1391,143
2021,Rhondda Cynon Taf 022E,W01001263,1642,1499,143
2021,Rhondda Cynon Taf 022F,W01001264,1883,1685,198
2021,Rhondda Cynon Taf 007A,W01001265,1493,1264,229
2021,Rhondda Cynon Taf 007B,W01001266,1332,1183,149
2021,Rhondda Cynon Taf 007C,W01001267,1439,1283,156
2021,Rhondda Cynon Taf 007D,W01001268,1277,1087,190
2021,Rhondda Cynon Taf 010A,W01001269,1411,1204,207
2021,Rhondda Cynon Taf 010B,W01001270,1406,1209,197
2021,Rhondda Cynon Taf 010C,W01001271,1479,1263,216
2021,Rhondda Cynon Taf 010D,W01001272,1426,1240,186
2021,Rhondda Cynon Taf 010E,W01001273,1710,1399,311
2021,Rhondda Cynon Taf 013B,W01001274,1143,1036,107
2021,Rhondda Cynon Taf 013C,W01001275,1729,1506,223
2021,Rhondda Cynon Taf 013D,W01001276,1226,1136,90
2021,Rhondda Cynon Taf 028D,W01001277,1087,974,113
2021,Rhondda Cynon Taf 028E,W01001278,1107,964,143
2021,Rhondda Cynon Taf 028F,W01001279,1069,976,93
2021,Rhondda Cynon Taf 017E,W01001280,1518,1364,154
2021,Rhondda Cynon Taf 017F,W01001281,1629,1390,239
2021,Rhondda Cynon Taf 015C,W01001282,1961,1723,238
2021,Rhondda Cynon Taf 015D,W01001283,1405,1182,223
2021,Rhondda Cynon Taf 015E,W01001284,1046,823,223
2021,Rhondda Cynon Taf 014D,W01001285,1332,1151,181
2021,Rhondda Cynon Taf 014E,W01001286,1419,1220,199
2021,Rhondda Cynon Taf 014F,W01001287,1417,1271,146
2021,Rhondda Cynon Taf 014G,W01001288,1384,1195,189
2021,Merthyr Tydfil 006A,W01001289,1314,1202,112
2021,Merthyr Tydfil 007A,W01001290,2304,2074,230
2021,Merthyr Tydfil 003A,W01001291,2002,1769,233
2021,Merthyr Tydfil 004A,W01001292,1759,1620,139
2021,Merthyr Tydfil 004B,W01001293,1637,1499,138
2021,Merthyr Tydfil 003B,W01001294,1628,1466,162
2021,Merthyr Tydfil 002A,W01001295,1454,1355,99
2021,Merthyr Tydfil 002B,W01001296,1521,1388,133
2021,Merthyr Tydfil 002C,W01001297,1762,1611,151
2021,Merthyr Tydfil 002D,W01001298,1678,1562,116
2021,Merthyr Tydfil 008A,W01001299,1617,1525,92
2021,Merthyr Tydfil 008B,W01001300,1678,1583,95
2021,Merthyr Tydfil 008C,W01001301,1834,1749,85
2021,Merthyr Tydfil 006B,W01001302,1370,1205,165
2021,Merthyr Tydfil 003C,W01001305,1192,1103,89
2021,Merthyr Tydfil 003D,W01001306,1388,1279,109
2021,Merthyr Tydfil 004C,W01001307,1490,1387,103
2021,Merthyr Tydfil 008D,W01001308,1194,1137,57
2021,Merthyr Tydfil 008E,W01001309,1259,1189,70
2021,Merthyr Tydfil 002E,W01001310,1494,1393,101
2021,Merthyr Tydfil 002F,W01001311,1103,1015,88
2021,Merthyr Tydfil 006E,W01001312,1431,1318,113
2021,Merthyr Tydfil 006F,W01001313,1434,1324,110
2021,Merthyr Tydfil 005A,W01001314,2050,1857,193
2021,Merthyr Tydfil 004D,W01001315,1658,1512,146
2021,Merthyr Tydfil 005C,W01001317,1692,1497,195
2021,Merthyr Tydfil 005D,W01001318,1438,1315,123
2021,Merthyr Tydfil 007B,W01001319,1566,1347,219
2021,Merthyr Tydfil 007C,W01001320,1386,1238,148
2021,Merthyr Tydfil 007D,W01001321,1566,1390,176
2021,Merthyr Tydfil 007E,W01001322,1578,1406,172
2021,Merthyr Tydfil 003E,W01001324,1877,1696,181
2021,Caerphilly 003A,W01001325,1603,1402,201
2021,Caerphilly 003B,W01001326,2079,1833,246
2021,Caerphilly 014A,W01001327,2361,2080,281
2021,Caerphilly 014B,W01001328,1464,1295,169
2021,Caerphilly 014C,W01001329,1447,1308,139
2021,Caerphilly 018A,W01001330,1401,1147,254
2021,Caerphilly 018B,W01001331,1679,1433,246
2021,Caerphilly 018C,W01001332,1781,1545,236
2021,Caerphilly 018D,W01001333,1421,1228,193
2021,Caerphilly 005A,W01001334,1397,1284,113
2021,Caerphilly 005B,W01001335,1237,1085,152
2021,Caerphilly 004A,W01001336,1369,1205,164
2021,Caerphilly 004B,W01001337,1407,1293,114
2021,Caerphilly 004C,W01001338,1662,1512,150
2021,Caerphilly 004D,W01001339,1367,1233,134
2021,Caerphilly 020A,W01001340,1826,1594,232
2021,Caerphilly 020B,W01001341,1651,1506,145
2021,Caerphilly 021A,W01001342,1158,1052,106
2021,Caerphilly 021B,W01001343,1071,932,139
2021,Caerphilly 020C,W01001344,1631,1479,152
2021,Caerphilly 021C,W01001345,1337,1231,106
2021,Caerphilly 020D,W01001346,1477,1324,153
2021,Caerphilly 005C,W01001347,1452,1332,120
2021,Caerphilly 009A,W01001348,1700,1584,116
2021,Caerphilly 009B,W01001349,1680,1481,199
2021,Caerphilly 009C,W01001350,1681,1539,142
2021,Caerphilly 005D,W01001351,1373,1278,95
2021,Caerphilly 007A,W01001352,1699,1593,106
2021,Caerphilly 007B,W01001353,1493,1403,90
2021,Caerphilly 014D,W01001354,1633,1487,146
2021,Caerphilly 015A,W01001355,1494,1379,115
2021,Caerphilly 006A,W01001356,1166,1086,80
2021,Caerphilly 006B,W01001357,1656,1511,145
2021,Caerphilly 006C,W01001358,1442,1320,122
2021,Caerphilly 006D,W01001359,1365,1257,108
2021,Caerphilly 002A,W01001360,1267,1155,112
2021,Caerphilly 002B,W01001361,1122,1038,84
2021,Caerphilly 003C,W01001362,1941,1737,204
2021,Caerphilly 012A,W01001363,1746,1521,225
2021,Caerphilly 012B,W01001364,1724,1577,147
2021,Caerphilly 012C,W01001365,1888,1675,213
2021,Caerphilly 019A,W01001366,1528,1374,154
2021,Caerphilly 019B,W01001367,1411,1276,135
2021,Caerphilly 019C,W01001368,1391,1237,154
2021,Caerphilly 012D,W01001369,2350,2105,245
2021,Caerphilly 023A,W01001370,1791,1553,238
2021,Caerphilly 022A,W01001371,1834,1586,248
2021,Caerphilly 022B,W01001372,1760,1481,279
2021,Caerphilly 022C,W01001373,1876,1555,321
2021,Caerphilly 001A,W01001374,1375,1276,99
2021,Caerphilly 001B,W01001375,1435,1246,189
2021,Caerphilly 001C,W01001376,1378,1262,116
2021,Caerphilly 013A,W01001377,1418,1269,149
2021,Caerphilly 013B,W01001378,1459,1323,136
2021,Caerphilly 013C,W01001379,1485,1278,207
2021,Caerphilly 010A,W01001380,1733,1595,138
2021,Caerphilly 010B,W01001381,1429,1324,105
2021,Caerphilly 010C,W01001382,1508,1384,124
2021,Caerphilly 010D,W01001383,1410,1268,142
2021,Caerphilly 002C,W01001384,1448,1336,112
2021,Caerphilly 002D,W01001385,1474,1391,83
2021,Caerphilly 002E,W01001386,1527,1431,96
2021,Caerphilly 007C,W01001387,1162,1018,144
2021,Caerphilly 007D,W01001388,1741,1541,200
2021,Caerphilly 007E,W01001389,1072,935,137
2021,Caerphilly 006E,W01001390,2046,1832,214
2021,Caerphilly 006F,W01001391,1584,1448,136
2021,Caerphilly 009D,W01001392,1890,1734,156
2021,Caerphilly 019D,W01001393,1302,1127,175
2021,Caerphilly 023B,W01001394,1257,1115,142
2021,Caerphilly 023C,W01001395,1282,1157,125
2021,Caerphilly 023D,W01001396,1498,1345,153
2021,Caerphilly 019E,W01001397,1533,1308,225
2021,Caerphilly 024A,W01001398,2683,2291,392
2021,Caerphilly 023E,W01001399,1221,1108,113
2021,Caerphilly 019F,W01001400,1358,1195,163
2021,Caerphilly 011A,W01001401,2002,1857,145
2021,Caerphilly 011B,W01001402,1548,1423,125
2021,Caerphilly 011C,W01001403,1543,1393,150
2021,Caerphilly 011D,W01001404,1321,1210,111
2021,Caerphilly 011E,W01001405,1734,1564,170
2021,Caerphilly 001D,W01001406,1776,1626,150
2021,Caerphilly 016A,W01001407,1276,1186,90
2021,Caerphilly 016B,W01001408,1390,1311,79
2021,Caerphilly 016C,W01001409,1532,1422,110
2021,Caerphilly 016D,W01001410,1746,1601,145
2021,Caerphilly 017A,W01001411,1569,1447,122
2021,Caerphilly 017B,W01001412,1606,1490,116
2021,Caerphilly 017C,W01001413,1767,1632,135
2021,Caerphilly 008A,W01001414,1525,1358,167
2021,Caerphilly 008B,W01001415,1673,1485,188
2021,Caerphilly 008C,W01001416,1342,1210,132
2021,Caerphilly 008D,W01001417,1340,1160,180
2021,Caerphilly 008E,W01001418,1354,1192,162
2021,Caerphilly 021D,W01001419,1568,1382,186
2021,Caerphilly 022D,W01001420,1184,1033,151
2021,Caerphilly 022E,W01001421,1390,1278,112
2021,Caerphilly 022F,W01001422,1423,1279,144
2021,Caerphilly 024B,W01001423,1341,1203,138
2021,Caerphilly 024C,W01001424,1369,1202,167
2021,Caerphilly 024D,W01001425,1685,1443,242
2021,Caerphilly 024E,W01001426,1411,1204,207
2021,Caerphilly 024F,W01001427,1798,1533,265
2021,Caerphilly 001E,W01001428,1188,1111,77
2021,Caerphilly 001F,W01001429,1129,983,146
2021,Caerphilly 015B,W01001430,2307,2102,205
2021,Caerphilly 015C,W01001431,1533,1401,132
2021,Caerphilly 013D,W01001432,2657,2229,428
2021,Caerphilly 013E,W01001433,1324,1129,195
2021,Caerphilly 013F,W01001434,1340,1116,224
2021,Blaenau Gwent 008A,W01001435,1316,1236,80
2021,Blaenau Gwent 008B,W01001436,1329,1267,62
2021,Blaenau Gwent 008C,W01001437,1401,1316,85
2021,Blaenau Gwent 004A,W01001438,1437,1358,79
2021,Blaenau Gwent 004B,W01001439,1560,1462,98
2021,Blaenau Gwent 001A,W01001440,1303,1216,87
2021,Blaenau Gwent 001B,W01001441,1115,1067,48
2021,Blaenau Gwent 001C,W01001442,1069,988,81
2021,Blaenau Gwent 005A,W01001443,1200,1134,66
2021,Blaenau Gwent 005B,W01001444,1901,1764,137
2021,Blaenau Gwent 005C,W01001445,1306,1189,117
2021,Blaenau Gwent 002A,W01001446,1199,1104,95
2021,Blaenau Gwent 002B,W01001447,1424,1331,93
2021,Blaenau Gwent 002C,W01001448,1129,1063,66
2021,Blaenau Gwent 002D,W01001449,1331,1245,86
2021,Blaenau Gwent 007A,W01001450,1180,1122,58
2021,Blaenau Gwent 007B,W01001451,1258,1178,80
2021,Blaenau Gwent 007C,W01001452,1398,1302,96
2021,Blaenau Gwent 008D,W01001453,1443,1346,97
2021,Blaenau Gwent 008E,W01001454,1239,1174,65
2021,Blaenau Gwent 008F,W01001455,1615,1511,104
2021,Blaenau Gwent 004C,W01001456,1217,1152,65
2021,Blaenau Gwent 004D,W01001457,1719,1654,65
2021,Blaenau Gwent 004E,W01001458,1575,1486,89
2021,Blaenau Gwent 007D,W01001459,1152,1098,54
2021,Blaenau Gwent 007E,W01001460,1683,1559,124
2021,Blaenau Gwent 007F,W01001461,1232,1157,75
2021,Blaenau Gwent 006A,W01001462,1748,1623,125
2021,Blaenau Gwent 006B,W01001463,1740,1632,108
2021,Blaenau Gwent 009A,W01001464,1397,1312,85
2021,Blaenau Gwent 009B,W01001465,1484,1395,89
2021,Blaenau Gwent 009C,W01001466,1408,1350,58
2021,Blaenau Gwent 005D,W01001467,1823,1688,135
2021,Blaenau Gwent 005E,W01001468,1286,1193,93
2021,Blaenau Gwent 005F,W01001469,1267,1181,86
2021,Blaenau Gwent 001D,W01001470,1368,1298,70
2021,Blaenau Gwent 001E,W01001471,1563,1500,63
2021,Blaenau Gwent 003A,W01001472,1342,1227,115
2021,Blaenau Gwent 003B,W01001473,1225,1171,54
2021,Blaenau Gwent 003C,W01001474,1382,1288,94
2021,Blaenau Gwent 003D,W01001475,1089,999,90
2021,Blaenau Gwent 006C,W01001478,1328,1228,100
2021,Blaenau Gwent 006D,W01001479,1408,1332,76
2021,Blaenau Gwent 003E,W01001480,1421,1320,101
2021,Blaenau Gwent 006E,W01001481,1596,1500,96
2021,Torfaen 002A,W01001482,1195,1022,173
2021,Torfaen 002B,W01001483,1376,1230,146
2021,Torfaen 002C,W01001484,1594,1425,169
2021,Torfaen 002D,W01001485,1213,1095,118
2021,Torfaen 002E,W01001486,1428,1291,137
2021,Torfaen 001A,W01001487,1612,1433,179
2021,Torfaen 001B,W01001488,1443,1329,114
2021,Torfaen 001C,W01001489,1396,1267,129
2021,Torfaen 001D,W01001490,1367,1250,117
2021,Torfaen 004A,W01001491,1633,1527,106
2021,Torfaen 012A,W01001492,2359,2168,191
2021,Torfaen 008A,W01001493,1753,1655,98
2021,Torfaen 008B,W01001494,1500,1369,131
2021,Torfaen 008C,W01001495,1745,1601,144
2021,Torfaen 004B,W01001496,1404,1303,101
2021,Torfaen 011A,W01001497,1346,1233,113
2021,Torfaen 011B,W01001498,1209,1092,117
2021,Torfaen 011C,W01001499,1117,1006,111
2021,Torfaen 011D,W01001500,1213,1130,83
2021,Torfaen 009A,W01001501,1278,1162,116
2021,Torfaen 011E,W01001502,1175,1106,69
2021,Torfaen 009B,W01001503,1192,1101,91
2021,Torfaen 013A,W01001504,2251,2066,185
2021,Torfaen 013B,W01001505,2547,2330,217
2021,Torfaen 010A,W01001506,1478,1393,85
2021,Torfaen 008D,W01001507,1894,1763,131
2021,Torfaen 013C,W01001508,1157,1074,83
2021,Torfaen 013D,W01001509,1367,1253,114
2021,Torfaen 005A,W01001510,1556,1460,96
2021,Torfaen 005B,W01001511,1491,1386,105
2021,Torfaen 005C,W01001512,1270,1217,53
2021,Torfaen 005D,W01001513,1430,1319,111
2021,Torfaen 006A,W01001514,1054,960,94
2021,Torfaen 006B,W01001515,1367,1238,129
2021,Torfaen 006C,W01001516,1382,1269,113
2021,Torfaen 006D,W01001517,2373,2125,248
2021,Torfaen 006E,W01001518,1110,1031,79
2021,Torfaen 007A,W01001519,1236,1150,86
2021,Torfaen 007B,W01001520,2493,2241,252
2021,Torfaen 007C,W01001521,1370,1248,122
2021,Torfaen 007D,W01001522,1561,1419,142
2021,Torfaen 004C,W01001523,1378,1255,123
2021,Torfaen 004D,W01001524,1809,1667,142
2021,Torfaen 003A,W01001525,1792,1657,135
2021,Torfaen 010B,W01001526,1332,1211,121
2021,Torfaen 010C,W01001527,1151,1072,79
2021,Torfaen 010D,W01001528,1697,1524,173
2021,Torfaen 003B,W01001529,1934,1797,137
2021,Torfaen 003C,W01001530,1704,1578,126
2021,Torfaen 003D,W01001531,1621,1497,124
2021,Torfaen 010E,W01001532,1706,1569,137
2021,Torfaen 012B,W01001533,1469,1347,122
2021,Torfaen 012C,W01001534,1365,1258,107
2021,Torfaen 012D,W01001535,1221,1153,68
2021,Torfaen 009C,W01001536,1091,1013,78
2021,Torfaen 007E,W01001537,1141,1044,97
2021,Torfaen 009D,W01001538,1288,1200,88
2021,Torfaen 009E,W01001539,1386,1280,106
2021,Torfaen 004E,W01001540,1229,1133,96
2021,Torfaen 004F,W01001541,1131,1024,107
2021,Monmouthshire 009A,W01001542,2067,1884,183
2021,Monmouthshire 009B,W01001543,1739,1546,193
2021,Monmouthshire 001A,W01001545,1497,1348,149
2021,Monmouthshire 002A,W01001546,1508,1375,133
2021,Monmouthshire 001B,W01001548,2049,1846,203
2021,Monmouthshire 007A,W01001549,1371,1265,106
2021,Monmouthshire 010C,W01001551,1137,1045,92
2021,Monmouthshire 004A,W01001552,1485,1368,117
2021,Monmouthshire 004C,W01001554,1508,1407,101
2021,Monmouthshire 006A,W01001555,1120,1003,117
2021,Monmouthshire 006B,W01001556,1331,1208,123
2021,Monmouthshire 001C,W01001557,1768,1601,167
2021,Monmouthshire 002C,W01001558,1544,1403,141
2021,Monmouthshire 008A,W01001559,1249,1170,79
2021,Monmouthshire 006C,W01001560,1349,1257,92
2021,Monmouthshire 003A,W01001561,1560,1421,139
2021,Monmouthshire 003B,W01001562,1329,1198,131
2021,Monmouthshire 003C,W01001563,1107,1017,90
2021,Monmouthshire 006D,W01001565,1781,1650,131
2021,Monmouthshire 005C,W01001568,1742,1575,167
2021,Monmouthshire 003E,W01001569,1315,1177,138
2021,Monmouthshire 001D,W01001571,1460,1309,151
2021,Monmouthshire 011A,W01001572,1576,1448,128
2021,Monmouthshire 011B,W01001573,1390,1245,145
2021,Monmouthshire 011C,W01001574,1277,1163,114
2021,Monmouthshire 005D,W01001575,1218,1109,109
2021,Monmouthshire 004D,W01001576,1042,964,78
2021,Monmouthshire 004E,W01001577,1255,1149,106
2021,Monmouthshire 009C,W01001578,2425,2221,204
2021,Monmouthshire 001E,W01001579,1539,1411,128
2021,Monmouthshire 002E,W01001580,1712,1564,148
2021,Monmouthshire 005E,W01001581,1901,1720,181
2021,Monmouthshire 011D,W01001582,1729,1564,165
2021,Monmouthshire 007B,W01001583,1491,1357,134
2021,Monmouthshire 008B,W01001584,1716,1582,134
2021,Monmouthshire 007C,W01001585,1252,1141,111
2021,Monmouthshire 007D,W01001586,2424,2183,241
2021,Monmouthshire 008C,W01001587,1818,1702,116
2021,Monmouthshire 010D,W01001588,1580,1455,125
2021,Monmouthshire 010E,W01001589,1379,1260,119
2021,Monmouthshire 009D,W01001590,2078,1898,180
2021,Monmouthshire 011E,W01001591,1534,1359,175
2021,Monmouthshire 008D,W01001592,1582,1453,129
2021,Monmouthshire 008E,W01001593,1573,1468,105
2021,Monmouthshire 007E,W01001594,1373,1253,120
2021,Monmouthshire 007F,W01001595,1262,1176,86
2021,Monmouthshire 006E,W01001596,1202,1126,76
2021,Monmouthshire 006F,W01001597,1390,1290,100
2021,Monmouthshire 010F,W01001598,1606,1467,139
2021,Monmouthshire 004F,W01001599,2084,1911,173
2021,Newport 012A,W01001600,1783,1619,164
2021,Newport 006A,W01001601,1491,1364,127
2021,Newport 012B,W01001602,1573,1418,155
2021,Newport 012C,W01001603,1479,1327,152
2021,Newport 012D,W01001604,1454,1328,126
2021,Newport 014A,W01001605,1424,1298,126
2021,Newport 008A,W01001606,1234,1111,123
2021,Newport 015A,W01001607,1304,1211,93
2021,Newport 008B,W01001608,1450,1335,115
2021,Newport 015B,W01001609,1826,1698,128
2021,Newport 015C,W01001610,1282,1181,101
2021,Newport 011A,W01001611,1162,1094,68
2021,Newport 011B,W01001612,1481,1393,88
2021,Newport 011C,W01001613,1459,1332,127
2021,Newport 005A,W01001614,1529,1425,104
2021,Newport 005B,W01001615,1528,1422,106
2021,Newport 005C,W01001616,1368,1252,116
2021,Newport 003A,W01001617,1392,1302,90
2021,Newport 003B,W01001618,1089,1024,65
2021,Newport 003C,W01001619,1308,1229,79
2021,Newport 003D,W01001620,1619,1489,130
2021,Newport 003E,W01001621,1379,1289,90
2021,Newport 003F,W01001622,1172,1099,73
2021,Newport 001A,W01001623,1382,1269,113
2021,Newport 001B,W01001624,1184,1093,91
2021,Newport 001C,W01001625,1162,1073,89
2021,Newport 001D,W01001626,1468,1330,138
2021,Newport 001E,W01001627,1574,1430,144
2021,Newport 001F,W01001628,1026,965,61
2021,Newport 017A,W01001629,1347,1268,79
2021,Newport 017B,W01001630,1585,1501,84
2021,Newport 017C,W01001631,1295,1221,74
2021,Newport 017D,W01001632,1365,1287,78
2021,Newport 019A,W01001633,1621,1515,106
2021,Newport 019B,W01001634,1442,1322,120
2021,Newport 016A,W01001635,1295,1201,94
2021,Newport 020A,W01001636,1874,1691,183
2021,Newport 016B,W01001637,2064,1896,168
2021,Newport 016C,W01001638,1182,1069,113
2021,Newport 004A,W01001639,2091,1900,191
2021,Newport 004B,W01001640,1088,1016,72
2021,Newport 004C,W01001641,1334,1217,117
2021,Newport 013A,W01001642,1587,1484,103
2021,Newport 013B,W01001643,1822,1694,128
2021,Newport 015D,W01001645,1248,1168,80
2021,Newport 015E,W01001646,1568,1410,158
2021,Newport 015G,W01001648,1509,1420,89
2021,Newport 004E,W01001650,1612,1501,111
2021,Newport 002A,W01001651,1402,1307,95
2021,Newport 002B,W01001652,1593,1524,69
2021,Newport 002C,W01001653,1327,1239,88
2021,Newport 002D,W01001654,1536,1431,105
2021,Newport 002E,W01001655,1528,1422,106
2021,Newport 020C,W01001657,1413,1291,122
2021,Newport 020D,W01001658,2018,1829,189
2021,Newport 018A,W01001659,1828,1743,85
2021,Newport 018B,W01001660,2588,2380,208
2021,Newport 018C,W01001661,2847,2670,177
2021,Newport 018D,W01001662,1628,1487,141
2021,Newport 008C,W01001663,1351,1275,76
2021,Newport 010A,W01001664,1171,1103,68
2021,Newport 008D,W01001665,1597,1485,112
2021,Newport 010B,W01001666,1452,1345,107
2021,Newport 010C,W01001667,1259,1192,67
2021,Newport 010D,W01001668,1183,1096,87
2021,Newport 009A,W01001669,1232,1136,96
2021,Newport 009B,W01001670,2227,2002,225
2021,Newport 016D,W01001671,2208,2044,164
2021,Newport 009D,W01001673,1389,1292,97
2021,Newport 009E,W01001674,1515,1401,114
2021,Newport 007A,W01001675,1524,1417,107
2021,Newport 007B,W01001676,1779,1627,152
2021,Newport 007C,W01001677,1350,1267,83
2021,Newport 005D,W01001678,1578,1458,120
2021,Newport 007D,W01001679,1079,957,122
2021,Newport 007E,W01001680,1241,1113,128
2021,Newport 006B,W01001681,1283,1179,104
2021,Newport 006C,W01001682,1353,1274,79
2021,Newport 006D,W01001683,1058,970,88
2021,Newport 006E,W01001684,1363,1231,132
2021,Newport 014B,W01001685,1642,1525,117
2021,Newport 014C,W01001686,1266,1153,113
2021,Newport 014D,W01001687,2263,2159,104
2021,Newport 019D,W01001689,2019,1802,217
2021,Newport 013D,W01001690,2106,1951,155
2021,Newport 011D,W01001691,1640,1565,75
2021,Newport 011E,W01001692,2192,2053,139
2021,Newport 013E,W01001693,2743,2616,127
2021,Cardiff 036A,W01001694,1931,1811,120
2021,Cardiff 036B,W01001695,3932,3682,250
2021,Cardiff 036C,W01001696,1478,1372,106
2021,Cardiff 036D,W01001697,1867,1677,190
2021,Cardiff 036E,W01001698,2012,1840,172
2021,Cardiff 049A,W01001699,2422,2292,130
2021,Cardiff 045A,W01001702,1721,1543,178
2021,Cardiff 045B,W01001703,1162,1059,103
2021,Cardiff 041A,W01001704,1612,1503,109
2021,Cardiff 045C,W01001705,1899,1703,196
2021,Cardiff 041B,W01001706,1338,1206,132
2021,Cardiff 041C,W01001707,1957,1767,190
2021,Cardiff 045D,W01001708,1597,1439,158
2021,Cardiff 040B,W01001710,1775,1364,411
2021,Cardiff 040C,W01001711,2026,1795,231
2021,Cardiff 040D,W01001712,1412,1078,334
2021,Cardiff 040E,W01001713,1672,1216,456
2021,Cardiff 035A,W01001714,1526,997,529
2021,Cardiff 035B,W01001715,1520,1093,427
2021,Cardiff 035C,W01001716,1242,905,337
2021,Cardiff 035D,W01001717,1470,1111,359
2021,Cardiff 028A,W01001718,1728,1533,195
2021,Cardiff 028B,W01001719,1985,1743,242
2021,Cardiff 028C,W01001720,2223,1987,236
2021,Cardiff 032A,W01001721,2875,2645,230
2021,Cardiff 028D,W01001722,1748,1575,173
2021,Cardiff 032C,W01001724,2392,2148,244
2021,Cardiff 032D,W01001725,2298,2082,216
2021,Cardiff 028E,W01001726,1758,1560,198
2021,Cardiff 014A,W01001727,1172,947,225
2021,Cardiff 014B,W01001728,1386,1017,369
2021,Cardiff 014C,W01001729,2786,2377,409
2021,Cardiff 008A,W01001730,1515,1321,194
2021,Cardiff 008B,W01001731,1419,1229,190
2021,Cardiff 019A,W01001732,1697,1509,188
2021,Cardiff 019B,W01001733,1465,1293,172
2021,Cardiff 019C,W01001734,1564,1352,212
2021,Cardiff 019D,W01001735,1998,1756,242
2021,Cardiff 008C,W01001736,1457,1274,183
2021,Cardiff 039A,W01001737,1576,1436,140
2021,Cardiff 039B,W01001738,1365,1286,79
2021,Cardiff 039C,W01001739,1408,1278,130
2021,Cardiff 039D,W01001740,1449,1329,120
2021,Cardiff 039E,W01001741,1572,1458,114
2021,Cardiff 043A,W01001742,1533,1406,127
2021,Cardiff 043B,W01001743,1412,1265,147
2021,Cardiff 043C,W01001744,1645,1524,121
2021,Cardiff 043D,W01001745,1236,1126,110
2021,Cardiff 041D,W01001746,1475,1357,118
2021,Cardiff 027A,W01001747,1626,1433,193
2021,Cardiff 027B,W01001748,1509,1362,147
2021,Cardiff 027C,W01001749,1491,1331,160
2021,Cardiff 031A,W01001750,1562,1407,155
2021,Cardiff 027D,W01001751,1729,1576,153
2021,Cardiff 031B,W01001752,1541,1335,206
2021,Cardiff 031C,W01001753,1589,1425,164
2021,Cardiff 031D,W01001754,1565,1366,199
2021,Cardiff 025A,W01001755,1449,1228,221
2021,Cardiff 025B,W01001756,4209,3812,397
2021,Cardiff 025C,W01001757,1420,1195,225
2021,Cardiff 025D,W01001758,2145,1825,320
2021,Cardiff 046A,W01001759,1532,1379,153
2021,Cardiff 046B,W01001760,1596,1409,187
2021,Cardiff 046C,W01001761,1710,1452,258
2021,Cardiff 046D,W01001762,1757,1579,178
2021,Cardiff 044A,W01001764,1961,1755,206
2021,Cardiff 044B,W01001765,1389,1222,167
2021,Cardiff 044C,W01001766,1627,1415,212
2021,Cardiff 044D,W01001767,1756,1553,203
2021,Cardiff 044E,W01001768,1603,1437,166
2021,Cardiff 018A,W01001769,1539,1265,274
2021,Cardiff 018B,W01001770,1013,851,162
2021,Cardiff 018C,W01001771,1612,1362,250
2021,Cardiff 021A,W01001772,1361,1180,181
2021,Cardiff 012A,W01001773,2464,2201,263
2021,Cardiff 018D,W01001774,1360,1120,240
2021,Cardiff 021B,W01001775,1550,1362,188
2021,Cardiff 021C,W01001776,1257,1113,144
2021,Cardiff 001A,W01001777,1714,1497,217
2021,Cardiff 001B,W01001778,1714,1492,222
2021,Cardiff 026A,W01001779,1473,1237,236
2021,Cardiff 026B,W01001780,1606,1289,317
2021,Cardiff 026C,W01001781,1635,1245,390
2021,Cardiff 026D,W01001782,1416,1095,321
2021,Cardiff 026E,W01001783,1185,1049,136
2021,Cardiff 026F,W01001784,1279,1127,152
2021,Cardiff 023A,W01001785,1167,1040,127
2021,Cardiff 023B,W01001786,1440,1204,236
2021,Cardiff 023C,W01001787,1340,1202,138
2021,Cardiff 023D,W01001788,1538,1381,157
2021,Cardiff 023E,W01001789,1497,1187,310
2021,Cardiff 023F,W01001790,1178,1062,116
2021,Cardiff 005A,W01001791,1772,1498,274
2021,Cardiff 005B,W01001792,1566,1428,138
2021,Cardiff 002A,W01001793,1315,1150,165
2021,Cardiff 001C,W01001794,1296,1131,165
2021,Cardiff 002B,W01001795,1456,1267,189
2021,Cardiff 002C,W01001796,1392,1213,179
2021,Cardiff 005C,W01001797,1390,1219,171
2021,Cardiff 002D,W01001798,1359,1205,154
2021,Cardiff 001D,W01001799,1241,1051,190
2021,Cardiff 005D,W01001800,1371,1229,142
2021,Cardiff 007A,W01001802,1655,1553,102
2021,Cardiff 015A,W01001803,1617,1506,111
2021,Cardiff 015B,W01001804,1538,1430,108
2021,Cardiff 015C,W01001805,1496,1343,153
2021,Cardiff 015D,W01001806,1667,1478,189
2021,Cardiff 007B,W01001807,1592,1455,137
2021,Cardiff 007C,W01001808,1659,1552,107
2021,Cardiff 017A,W01001809,1186,1066,120
2021,Cardiff 017B,W01001810,1683,1557,126
2021,Cardiff 009A,W01001811,1521,1409,112
2021,Cardiff 017C,W01001812,1236,1152,84
2021,Cardiff 017D,W01001813,1771,1625,146
2021,Cardiff 017E,W01001814,1402,1291,111
2021,Cardiff 008D,W01001815,1350,1261,89
2021,Cardiff 009B,W01001816,2671,2426,245
2021,Cardiff 009C,W01001817,1346,1251,95
2021,Cardiff 009D,W01001818,1503,1371,132
2021,Cardiff 014D,W01001819,2325,1869,456
2021,Cardiff 006A,W01001820,1169,893,276
2021,Cardiff 024A,W01001821,1693,1502,191
2021,Cardiff 029A,W01001822,1797,1573,224
2021,Cardiff 029B,W01001823,1233,1007,226
2021,Cardiff 029C,W01001824,1510,1311,199
2021,Cardiff 029D,W01001825,1909,1624,285
2021,Cardiff 024B,W01001826,1342,1132,210
2021,Cardiff 024C,W01001827,1608,1402,206
2021,Cardiff 024D,W01001828,1472,1261,211
2021,Cardiff 033A,W01001829,1963,1797,166
2021,Cardiff 033B,W01001830,1595,1436,159
2021,Cardiff 030A,W01001831,1459,1274,185
2021,Cardiff 033C,W01001832,1743,1598,145
2021,Cardiff 033D,W01001833,1500,1295,205
2021,Cardiff 033E,W01001834,1609,1447,162
2021,Cardiff 033F,W01001835,2161,1988,173
2021,Cardiff 030B,W01001836,1300,1110,190
2021,Cardiff 030C,W01001837,1439,1314,125
2021,Cardiff 030D,W01001838,1598,1371,227
2021,Cardiff 030E,W01001839,1553,1372,181
2021,Cardiff 007D,W01001840,1885,1759,126
2021,Cardiff 003A,W01001841,1859,1669,190
2021,Cardiff 003B,W01001842,1696,1508,188
2021,Cardiff 003D,W01001844,1832,1638,194
2021,Cardiff 006C,W01001846,1699,1422,277
2021,Cardiff 006D,W01001847,1508,1317,191
2021,Cardiff 012B,W01001848,1416,1170,246
2021,Cardiff 004A,W01001849,1518,1300,218
2021,Cardiff 012C,W01001850,1868,1528,340
2021,Cardiff 012D,W01001851,1519,1328,191
2021,Cardiff 004B,W01001852,1826,1538,288
2021,Cardiff 004C,W01001853,1569,1395,174
2021,Cardiff 004D,W01001854,1499,1330,169
2021,Cardiff 042A,W01001855,1726,1517,209
2021,Cardiff 042B,W01001856,1661,1550,111
2021,Cardiff 042C,W01001857,2015,1825,190
2021,Cardiff 034A,W01001858,1556,1237,319
2021,Cardiff 034B,W01001859,1462,1108,354
2021,Cardiff 034C,W01001860,1617,1249,368
2021,Cardiff 034D,W01001861,1501,1130,371
2021,Cardiff 042D,W01001862,1805,1645,160
2021,Cardiff 022A,W01001863,1457,1322,135
2021,Cardiff 022B,W01001864,1432,1331,101
2021,Cardiff 022C,W01001865,1255,1120,135
2021,Cardiff 016A,W01001866,1520,1405,115
2021,Cardiff 016B,W01001867,1366,1244,122
2021,Cardiff 022D,W01001868,1470,1341,129
2021,Cardiff 038A,W01001869,1344,1207,137
2021,Cardiff 037A,W01001870,1404,1239,165
2021,Cardiff 037B,W01001871,1586,1445,141
2021,Cardiff 038B,W01001872,1555,1402,153
2021,Cardiff 038C,W01001873,1759,1566,193
2021,Cardiff 038D,W01001874,1467,1322,145
2021,Cardiff 037D,W01001876,1570,1445,125
2021,Cardiff 011A,W01001877,1770,1587,183
2021,Cardiff 011B,W01001878,1521,1394,127
2021,Cardiff 013A,W01001879,1831,1695,136
2021,Cardiff 013B,W01001880,1585,1450,135
2021,Cardiff 013C,W01001881,1423,1338,85
2021,Cardiff 011C,W01001882,1680,1521,159
2021,Cardiff 016C,W01001883,1608,1465,143
2021,Cardiff 013D,W01001884,1375,1250,125
2021,Cardiff 011D,W01001885,2495,2261,234
2021,Cardiff 016D,W01001886,1274,1163,111
2021,Cardiff 020A,W01001887,1580,1098,482
2021,Cardiff 010A,W01001888,1604,1299,305
2021,Cardiff 020B,W01001889,1433,1224,209
2021,Cardiff 021D,W01001890,1522,1358,164
2021,Cardiff 020C,W01001891,1587,1312,275
2021,Cardiff 020D,W01001892,1386,1182,204
2021,Cardiff 010B,W01001893,1781,1556,225
2021,Cardiff 010C,W01001894,1483,1233,250
2021,Cardiff 010D,W01001895,1591,1319,272
2021,Cardiff 020E,W01001896,1415,1060,355
2021,Powys 020D,W01001897,1831,1593,238
2021,Merthyr Tydfil 008F,W01001898,1426,1305,121
2021,Powys 021F,W01001899,2137,1343,794
2021,Neath Port Talbot 020G,W01001900,1373,916,457
2021,Powys 017F,W01001901,1773,1572,201
2021,Powys 017G,W01001902,1344,1217,127
2021,Powys 018F,W01001903,2065,1857,208
2021,Powys 018G,W01001904,1614,1463,151
2021,Powys 018H,W01001905,2107,1872,235
2021,Powys 001F,W01001906,1907,1136,771
2021,Powys 001G,W01001907,1344,972,372
2021,Monmouthshire 010G,W01001908,2074,1892,182
2021,Vale of Glamorgan 012G,W01001910,1603,1417,186
2021,Vale of Glamorgan 012H,W01001911,1102,987,115
2021,Newport 020E,W01001912,1485,1385,100
2021,Newport 020F,W01001913,1407,1263,144
2021,Rhondda Cynon Taf 023F,W01001914,1870,1580,290
2021,Rhondda Cynon Taf 027F,W01001915,1599,1257,342
2021,Rhondda Cynon Taf 027G,W01001916,1448,1071,377
2021,Rhondda Cynon Taf 023G,W01001917,1427,1302,125
2021,Bridgend 017E,W01001918,1818,1615,203
2021,Bridgend 017F,W01001919,1330,1189,141
2021,Bridgend 017G,W01001920,1167,1036,131
2021,Bridgend 017H,W01001921,1477,1337,140
2021,Cardiff 032E,W01001922,2009,1808,201
2021,Carmarthenshire 026G,W01001923,1690,1295,395
2021,Carmarthenshire 026H,W01001924,1324,1100,224
2021,Carmarthenshire 023F,W01001925,2139,1478,661
2021,Conwy 011F,W01001926,2064,1399,665
2021,Conwy 010G,W01001927,1312,1145,167
2021,Conwy 010H,W01001928,1059,948,111
2021,Wrexham 012F,W01001929,1132,1043,89
2021,Wrexham 019F,W01001930,2024,1419,605
2021,Wrexham 012G,W01001931,1367,1246,121
2021,Gwynedd 014E,W01001932,2694,651,2043
2021,Gwynedd 017F,W01001933,1878,1065,813
2021,Ceredigion 003E,W01001935,1005,582,423
2021,Ceredigion 003F,W01001936,1434,1033,401
2021,Ceredigion 001F,W01001937,1916,1112,804
2021,Cardiff 048A,W01001940,1028,921,107
2021,Cardiff 049B,W01001942,1536,1399,137
2021,Cardiff 048B,W01001943,1162,1031,131
2021,Cardiff 048C,W01001944,1152,1022,130
2021,Cardiff 049C,W01001946,1285,1173,112
2021,Cardiff 048E,W01001947,1657,1487,170
2021,Cardiff 006E,W01001948,2184,1839,345
2021,Cardiff 005F,W01001949,1266,1140,126
2021,Cardiff 049D,W01001950,1131,1026,105
2021,Cardiff 049E,W01001951,1498,1335,163
2021,Cardiff 049F,W01001952,1848,1721,127
2021,Cardiff 005G,W01001953,1457,1249,208
2021,Cardiff 006F,W01001954,1497,1260,237
2021,Swansea 025F,W01001955,1904,1826,78
2021,Swansea 032C,W01001956,2196,1991,205
2021,Swansea 025H,W01001958,1285,1172,113
2021,Merthyr Tydfil 005E,W01001959,1498,1346,152
2021,Merthyr Tydfil 005F,W01001960,1395,1213,182
2021,Merthyr Tydfil 006G,W01001961,2281,2003,278
2021,Rhondda Cynon Taf 011E,W01001962,2391,2120,271
2021,Rhondda Cynon Taf 014H,W01001963,2189,1987,202
2021,Rhondda Cynon Taf 021H,W01001964,2198,1943,255
2021,Rhondda Cynon Taf 029E,W01001965,1653,1415,238
2021,Rhondda Cynon Taf 029F,W01001966,1650,1320,330
2021,Rhondda Cynon Taf 031G,W01001967,1453,1182,271
2021,Rhondda Cynon Taf 031H,W01001968,1438,1168,270
2021,Wrexham 010F,W01001969,2210,2007,203
2021,Wrexham 021C,W01001970,2111,1911,200
2021,Wrexham 022D,W01001971,2637,2465,172
2021,Wrexham 022E,W01001972,1271,1137,134
2021,Blaenau Gwent 009F,W01001973,2190,2041,149
2021,Monmouthshire 002G,W01001974,1369,1256,113
2021,Monmouthshire 002H,W01001975,1271,1157,114
2021,Monmouthshire 003F,W01001976,1570,1421,149
2021,Monmouthshire 003G,W01001977,1406,1279,127
2021,Monmouthshire 004G,W01001978,1455,1345,110
2021,Monmouthshire 004H,W01001979,1965,1786,179
2021,Monmouthshire 005F,W01001980,2155,1986,169
2021,Bridgend 011D,W01001981,2890,2614,276
2021,Bridgend 011E,W01001982,1269,1114,155
2021,Bridgend 011F,W01001983,1404,1198,206
2021,Bridgend 011G,W01001984,1134,997,137
2021,Neath Port Talbot 006F,W01001985,2005,1745,260
2021,Neath Port Talbot 007E,W01001986,2383,2107,276
2021,Neath Port Talbot 010G,W01001987,1439,1277,162
2021,Neath Port Talbot 010H,W01001988,1408,1182,226
2021,Neath Port Talbot 010I,W01001989,3366,3085,281
2021,Neath Port Talbot 021E,W01001990,2085,1961,124
2021,Swansea 005G,W01001991,1359,1186,173
2021,Swansea 005H,W01001992,1381,1224,157
2021,Swansea 006E,W01001993,1642,1365,277
2021,Swansea 006F,W01001994,1427,1255,172
2021,Swansea 021E,W01001995,1329,1237,92
2021,Swansea 021F,W01001996,1385,1285,100
2021,Swansea 025I,W01001997,1958,1824,134
2021,Vale of Glamorgan 015G,W01001998,2157,1946,211
2021,Carmarthenshire 019F,W01001999,2427,1704,723
2021,Ceredigion 002G,W01002000,2896,2266,630
2021,Ceredigion 002H,W01002001,1403,1126,277
2021,Ceredigion 007E,W01002002,4232,2304,1928
2021,Gwynedd 013E,W01002003,2337,1246,1091
2021,Gwynedd 016F,W01002004,2098,1219,879
2021,Isle of Anglesey 002E,W01002005,2190,923,1267
2021,Isle of Anglesey 004G,W01002007,2163,1094,1069
2021,Isle of Anglesey 007F,W01002008,2046,1001,1045
2021,Pembrokeshire 005E,W01002009,1174,1003,171
2021,Pembrokeshire 005F,W01002010,1077,968,109
2021,Pembrokeshire 010D,W01002011,1529,1396,133
2021,Pembrokeshire 010E,W01002012,1393,1280,113
2021,Pembrokeshire 011G,W01002013,2322,2083,239
2021,Pembrokeshire 016E,W01002014,2050,1819,231
2021,Cardiff 003E,W01002016,1155,1034,121
2021,Cardiff 003F,W01002017,1297,1135,162
2021,Cardiff 003G,W01002018,1480,1287,193
2021,Cardiff 032H,W01002019,2584,2413,171
2021,Cardiff 037E,W01002020,1503,1380,123
2021,Cardiff 037F,W01002021,1441,1278,163
2021,Cardiff 040F,W01002022,1151,885,266
2021,Cardiff 040G,W01002023,1750,1369,381
2021,Cardiff 048F,W01002024,1090,988,102
2021,Cardiff 048G,W01002025,1074,967,107
2021,Newport 004F,W01002026,1746,1601,145
2021,Newport 004G,W01002027,1734,1619,115
2021,Newport 009F,W01002028,1891,1745,146
2021,Newport 009G,W01002029,1635,1474,161
2021,Newport 013F,W01002030,1358,1273,85
2021,Newport 013G,W01002031,1605,1470,135
2021,Newport 015H,W01002032,1247,1167,80
2021,Newport 015I,W01002033,1332,1229,103
2021,Newport 019E,W01002034,1631,1488,143
2021,Newport 019F,W01002035,1526,1373,153
2021,Vale of Glamorgan 005G,W01002036,1505,1348,157
2021,Vale of Glamorgan 005H,W01002037,1042,897,145
2021,Vale of Glamorgan 014G,W01002038,1239,1120,119
2021,Vale of Glamorgan 014H,W01002039,1681,1431,250
2021,Vale of Glamorgan 015F,W01002040,1819,1578,241
