date,geography,geography code,Welsh understanding ability: Total: All usual residents aged 3 years and over,Welsh understanding ability: Cannot understand spoken Welsh,Welsh understanding ability: Can understand spoken Welsh
2021,Isle of Anglesey 001A,W01000003,2370,761,1609
2021,Isle of Anglesey 001B,W01000004,1229,535,694
2021,Isle of Anglesey 005A,W01000005,1585,771,814
2021,Isle of Anglesey 006A,W01000006,1494,395,1099
2021,Isle of Anglesey 009A,W01000007,1738,567,1171
2021,Isle of Anglesey 008A,W01000008,1418,340,1078
2021,Isle of Anglesey 007C,W01000009,1818,531,1287
2021,Isle of Anglesey 002A,W01000010,1775,795,980
2021,Isle of Anglesey 008B,W01000011,999,458,541
2021,Isle of Anglesey 006B,W01000012,1656,403,1253
2021,Isle of Anglesey 005B,W01000013,2130,767,1363
2021,Isle of Anglesey 006C,W01000014,2128,448,1680
2021,Isle of Anglesey 008C,W01000015,1431,395,1036
2021,Isle of Anglesey 003A,W01000016,1157,546,611
2021,Isle of Anglesey 003B,W01000017,1636,626,1010
2021,Isle of Anglesey 001C,W01000018,1148,524,624
2021,Isle of Anglesey 005C,W01000019,1322,723,599
2021,Isle of Anglesey 002C,W01000021,2266,931,1335
2021,Isle of Anglesey 004A,W01000022,1576,573,1003
2021,Isle of Anglesey 007D,W01000023,1526,444,1082
2021,Isle of Anglesey 007E,W01000024,1293,704,589
2021,Isle of Anglesey 009B,W01000025,2097,496,1601
2021,Isle of Anglesey 005D,W01000026,1229,568,661
2021,Isle of Anglesey 009C,W01000027,1812,570,1242
2021,Isle of Anglesey 001D,W01000028,1921,587,1334
2021,Isle of Anglesey 003C,W01000029,1541,587,954
2021,Isle of Anglesey 003D,W01000030,2236,920,1316
2021,Isle of Anglesey 001E,W01000031,1512,612,900
2021,Isle of Anglesey 003E,W01000033,1504,654,850
2021,Isle of Anglesey 004B,W01000034,1399,459,940
2021,Isle of Anglesey 005E,W01000035,1743,693,1050
2021,Isle of Anglesey 003F,W01000036,1068,475,593
2021,Isle of Anglesey 003G,W01000037,1124,442,682
2021,Isle of Anglesey 009D,W01000038,2178,760,1418
2021,Isle of Anglesey 004D,W01000040,1041,556,485
2021,Isle of Anglesey 006D,W01000041,1529,323,1206
2021,Isle of Anglesey 008D,W01000042,1982,605,1377
2021,Isle of Anglesey 004F,W01000044,1070,475,595
2021,Gwynedd 011A,W01000047,1233,295,938
2021,Gwynedd 003A,W01000050,1397,519,878
2021,Gwynedd 015A,W01000051,1945,521,1424
2021,Gwynedd 004A,W01000052,1061,187,874
2021,Gwynedd 004B,W01000053,1146,311,835
2021,Gwynedd 007A,W01000054,989,182,807
2021,Gwynedd 009A,W01000056,1715,404,1311
2021,Gwynedd 016C,W01000057,1358,484,874
2021,Gwynedd 006A,W01000059,2028,374,1654
2021,Gwynedd 015B,W01000060,1227,563,664
2021,Gwynedd 011B,W01000061,1697,611,1086
2021,Gwynedd 001A,W01000062,1964,1477,487
2021,Gwynedd 005A,W01000063,1847,484,1363
2021,Gwynedd 002A,W01000064,1943,681,1262
2021,Gwynedd 009B,W01000065,995,278,717
2021,Gwynedd 010A,W01000066,1143,377,766
2021,Gwynedd 016D,W01000067,1165,403,762
2021,Gwynedd 016E,W01000068,1375,476,899
2021,Gwynedd 012A,W01000070,1263,336,927
2021,Gwynedd 003B,W01000071,2174,530,1644
2021,Gwynedd 002B,W01000072,1633,606,1027
2021,Gwynedd 008A,W01000073,1620,341,1279
2021,Gwynedd 013B,W01000074,1770,746,1024
2021,Gwynedd 002C,W01000075,1367,676,691
2021,Gwynedd 001B,W01000076,1273,746,527
2021,Gwynedd 001C,W01000077,1146,627,519
2021,Gwynedd 011C,W01000078,1517,452,1065
2021,Gwynedd 014C,W01000080,1424,603,821
2021,Gwynedd 005B,W01000081,1958,543,1415
2021,Gwynedd 015C,W01000082,1067,359,708
2021,Gwynedd 015D,W01000083,1318,302,1016
2021,Gwynedd 014D,W01000084,1047,359,688
2021,Gwynedd 017C,W01000085,1888,1047,841
2021,Gwynedd 008B,W01000086,2113,591,1522
2021,Gwynedd 004C,W01000087,1778,306,1472
2021,Gwynedd 007B,W01000088,2009,387,1622
2021,Gwynedd 011D,W01000089,1869,430,1439
2021,Gwynedd 002D,W01000090,1315,376,939
2021,Gwynedd 001D,W01000091,1048,371,677
2021,Gwynedd 001E,W01000092,3035,2264,771
2021,Gwynedd 006B,W01000093,2184,440,1744
2021,Gwynedd 012B,W01000094,1188,305,883
2021,Gwynedd 012C,W01000095,1261,316,945
2021,Gwynedd 003C,W01000096,1220,231,989
2021,Gwynedd 003D,W01000097,1104,289,815
2021,Gwynedd 006C,W01000098,2422,450,1972
2021,Gwynedd 005C,W01000099,1617,452,1165
2021,Gwynedd 010B,W01000100,1032,296,736
2021,Gwynedd 013D,W01000101,1330,359,971
2021,Gwynedd 002E,W01000102,1831,574,1257
2021,Gwynedd 005D,W01000103,1141,386,755
2021,Gwynedd 008C,W01000104,1745,337,1408
2021,Gwynedd 010C,W01000105,1689,377,1312
2021,Gwynedd 010D,W01000106,1475,631,844
2021,Gwynedd 010E,W01000107,1167,367,800
2021,Gwynedd 012D,W01000108,2032,488,1544
2021,Gwynedd 012E,W01000109,1815,425,1390
2021,Gwynedd 006D,W01000110,1544,227,1317
2021,Gwynedd 007C,W01000111,1530,347,1183
2021,Gwynedd 008D,W01000112,1877,527,1350
2021,Gwynedd 009C,W01000113,1793,456,1337
2021,Gwynedd 009D,W01000114,1378,356,1022
2021,Gwynedd 003E,W01000115,2066,565,1501
2021,Gwynedd 017D,W01000116,1650,942,708
2021,Gwynedd 017E,W01000117,1437,731,706
2021,Gwynedd 007D,W01000118,1655,449,1206
2021,Gwynedd 004D,W01000119,2257,621,1636
2021,Conwy 015A,W01000121,1124,530,594
2021,Conwy 014A,W01000122,1916,989,927
2021,Conwy 013A,W01000123,1700,808,892
2021,Conwy 012A,W01000124,1906,1018,888
2021,Conwy 013B,W01000125,1494,837,657
2021,Conwy 009A,W01000126,1641,1136,505
2021,Conwy 009B,W01000127,1334,1063,271
2021,Conwy 009C,W01000128,1452,992,460
2021,Conwy 012B,W01000129,1151,705,446
2021,Conwy 012C,W01000130,1389,905,484
2021,Conwy 012D,W01000131,1624,879,745
2021,Conwy 001A,W01000132,1500,1077,423
2021,Conwy 002A,W01000133,1754,1311,443
2021,Conwy 015B,W01000134,1990,667,1323
2021,Conwy 006A,W01000135,1965,1399,566
2021,Conwy 006B,W01000136,1723,1145,578
2021,Conwy 015C,W01000137,1509,613,896
2021,Conwy 008A,W01000138,1891,1268,623
2021,Conwy 007A,W01000139,1575,1020,555
2021,Conwy 010B,W01000140,1721,1215,506
2021,Conwy 010C,W01000141,1501,1110,391
2021,Conwy 010D,W01000142,1493,1035,458
2021,Conwy 007B,W01000143,1524,1099,425
2021,Conwy 007C,W01000144,1594,1231,363
2021,Conwy 008B,W01000145,1259,867,392
2021,Conwy 001B,W01000146,2002,1558,444
2021,Conwy 001C,W01000147,1473,1134,339
2021,Conwy 015D,W01000148,1046,323,723
2021,Conwy 005A,W01000149,1455,1279,176
2021,Conwy 005B,W01000150,1451,1201,250
2021,Conwy 005C,W01000151,1474,1223,251
2021,Conwy 005D,W01000152,1383,1165,218
2021,Conwy 009D,W01000153,1572,1106,466
2021,Conwy 003A,W01000154,1375,1014,361
2021,Conwy 004A,W01000155,1382,1028,354
2021,Conwy 004B,W01000156,1470,1143,327
2021,Conwy 004C,W01000157,1378,1024,354
2021,Conwy 004D,W01000158,1530,1095,435
2021,Conwy 014B,W01000159,1388,481,907
2021,Conwy 014C,W01000162,1772,712,1060
2021,Conwy 009E,W01000163,1325,967,358
2021,Conwy 009F,W01000164,1315,900,415
2021,Conwy 006C,W01000165,1829,1133,696
2021,Conwy 006D,W01000166,2664,1611,1053
2021,Conwy 011C,W01000167,1933,1343,590
2021,Conwy 002B,W01000168,1775,1255,520
2021,Conwy 001D,W01000169,1737,1298,439
2021,Conwy 013C,W01000170,1753,762,991
2021,Conwy 013D,W01000171,1452,836,616
2021,Conwy 013E,W01000172,1220,638,582
2021,Conwy 003B,W01000173,1419,938,481
2021,Conwy 003C,W01000174,1557,1034,523
2021,Conwy 003D,W01000175,1502,1089,413
2021,Conwy 011D,W01000176,1556,951,605
2021,Conwy 011E,W01000177,1392,822,570
2021,Conwy 010E,W01000178,1945,1424,521
2021,Conwy 010F,W01000179,1949,1436,513
2021,Conwy 008C,W01000180,1477,1056,421
2021,Conwy 008D,W01000181,1424,982,442
2021,Conwy 007D,W01000182,2036,1610,426
2021,Conwy 008E,W01000183,1444,1075,369
2021,Conwy 005E,W01000184,2222,1867,355
2021,Conwy 015E,W01000185,1205,589,616
2021,Conwy 001E,W01000186,1552,1136,416
2021,Conwy 002C,W01000187,1463,1068,395
2021,Conwy 002D,W01000188,1549,1075,474
2021,Conwy 015F,W01000189,1428,495,933
2021,Conwy 014D,W01000190,1359,476,883
2021,Denbighshire 009A,W01000191,2027,1551,476
2021,Denbighshire 016A,W01000192,973,489,484
2021,Denbighshire 015A,W01000193,1220,612,608
2021,Denbighshire 011A,W01000194,1850,1133,717
2021,Denbighshire 012A,W01000195,1413,614,799
2021,Denbighshire 012B,W01000196,1360,688,672
2021,Denbighshire 012C,W01000197,1649,878,771
2021,Denbighshire 011B,W01000198,1324,854,470
2021,Denbighshire 011C,W01000199,1661,961,700
2021,Denbighshire 008A,W01000200,1256,916,340
2021,Denbighshire 008B,W01000201,1667,1315,352
2021,Denbighshire 015B,W01000202,1597,773,824
2021,Denbighshire 013A,W01000203,2388,1689,699
2021,Denbighshire 013B,W01000204,1424,850,574
2021,Denbighshire 016B,W01000205,1172,479,693
2021,Denbighshire 013C,W01000206,2171,1212,959
2021,Denbighshire 015C,W01000207,2243,1112,1131
2021,Denbighshire 016C,W01000208,1257,944,313
2021,Denbighshire 016D,W01000209,1373,978,395
2021,Denbighshire 016E,W01000210,1306,924,382
2021,Denbighshire 012D,W01000211,1762,864,898
2021,Denbighshire 003A,W01000212,2132,1596,536
2021,Denbighshire 002A,W01000213,1278,1021,257
2021,Denbighshire 002B,W01000214,1124,927,197
2021,Denbighshire 002C,W01000215,1438,1098,340
2021,Denbighshire 002D,W01000216,1258,997,261
2021,Denbighshire 008C,W01000217,1948,1524,424
2021,Denbighshire 001A,W01000218,1547,1298,249
2021,Denbighshire 001B,W01000219,2546,2039,507
2021,Denbighshire 001C,W01000220,1610,1375,235
2021,Denbighshire 003B,W01000221,1305,1064,241
2021,Denbighshire 003C,W01000222,1749,1417,332
2021,Denbighshire 009B,W01000223,1272,990,282
2021,Denbighshire 009C,W01000224,1521,1144,377
2021,Denbighshire 009D,W01000225,1404,1022,382
2021,Denbighshire 004A,W01000226,1485,1255,230
2021,Denbighshire 004B,W01000227,1454,1184,270
2021,Denbighshire 004C,W01000228,1596,1340,256
2021,Denbighshire 017E,W01000229,1496,1196,300
2021,Denbighshire 017F,W01000230,1866,1430,436
2021,Denbighshire 017A,W01000231,1297,1046,251
2021,Denbighshire 017B,W01000232,1584,1239,345
2021,Denbighshire 017C,W01000233,1261,1022,239
2021,Denbighshire 017G,W01000234,2182,1782,400
2021,Denbighshire 017D,W01000235,1290,998,292
2021,Denbighshire 006A,W01000236,1902,1583,319
2021,Denbighshire 006B,W01000237,1704,1504,200
2021,Denbighshire 006C,W01000238,1734,1408,326
2021,Denbighshire 004D,W01000239,1650,1432,218
2021,Denbighshire 004E,W01000240,1589,1388,201
2021,Denbighshire 004F,W01000241,1449,1237,212
2021,Denbighshire 014A,W01000242,1909,1065,844
2021,Denbighshire 014B,W01000243,2047,1197,850
2021,Denbighshire 014C,W01000244,1567,684,883
2021,Denbighshire 010A,W01000245,1795,1246,549
2021,Denbighshire 010B,W01000246,1600,1201,399
2021,Denbighshire 010C,W01000247,1781,1119,662
2021,Denbighshire 008D,W01000248,1600,1044,556
2021,Flintshire 014A,W01000249,1167,958,209
2021,Flintshire 014B,W01000250,1395,1104,291
2021,Flintshire 013A,W01000251,1503,1315,188
2021,Flintshire 010A,W01000252,1602,1435,167
2021,Flintshire 003A,W01000253,1787,1505,282
2021,Flintshire 003B,W01000254,2052,1752,300
2021,Flintshire 015A,W01000255,2207,1967,240
2021,Flintshire 015B,W01000256,1499,1333,166
2021,Flintshire 015C,W01000257,2612,2370,242
2021,Flintshire 006A,W01000258,2062,1625,437
2021,Flintshire 017A,W01000259,1628,1407,221
2021,Flintshire 017B,W01000260,1673,1438,235
2021,Flintshire 014C,W01000261,1378,1175,203
2021,Flintshire 017C,W01000262,1376,1189,187
2021,Flintshire 017D,W01000263,1298,1141,157
2021,Flintshire 012A,W01000264,1663,1403,260
2021,Flintshire 012B,W01000265,1447,1233,214
2021,Flintshire 017E,W01000266,1600,1346,254
2021,Flintshire 017F,W01000267,1978,1670,308
2021,Flintshire 013B,W01000268,1618,1368,250
2021,Flintshire 020A,W01000269,1523,1264,259
2021,Flintshire 006B,W01000270,1217,893,324
2021,Flintshire 006C,W01000271,1217,906,311
2021,Flintshire 006D,W01000272,1758,1332,426
2021,Flintshire 007A,W01000273,1499,1340,159
2021,Flintshire 007B,W01000274,1836,1649,187
2021,Flintshire 007C,W01000275,1159,1032,127
2021,Flintshire 008A,W01000276,1165,1029,136
2021,Flintshire 008B,W01000277,1328,1156,172
2021,Flintshire 007D,W01000278,1418,1290,128
2021,Flintshire 008C,W01000279,1151,1031,120
2021,Flintshire 010B,W01000280,1686,1484,202
2021,Flintshire 008D,W01000281,1140,1020,120
2021,Flintshire 010C,W01000282,1589,1382,207
2021,Flintshire 008E,W01000283,2249,2034,215
2021,Flintshire 013C,W01000284,1684,1458,226
2021,Flintshire 013D,W01000285,1566,1383,183
2021,Flintshire 013E,W01000286,2132,1826,306
2021,Flintshire 001A,W01000287,1820,1436,384
2021,Flintshire 004A,W01000288,2113,1856,257
2021,Flintshire 005A,W01000289,1300,1075,225
2021,Flintshire 004B,W01000290,1240,1074,166
2021,Flintshire 005B,W01000291,1266,1086,180
2021,Flintshire 004C,W01000292,1419,1227,192
2021,Flintshire 004D,W01000293,2558,2142,416
2021,Flintshire 005C,W01000294,1843,1550,293
2021,Flintshire 005D,W01000295,1537,1299,238
2021,Flintshire 003C,W01000296,1492,1268,224
2021,Flintshire 003D,W01000297,1195,986,209
2021,Flintshire 001B,W01000298,1439,1147,292
2021,Flintshire 019A,W01000299,1859,1483,376
2021,Flintshire 019B,W01000300,1591,1177,414
2021,Flintshire 006E,W01000301,1688,1248,440
2021,Flintshire 013F,W01000302,1897,1654,243
2021,Flintshire 018A,W01000303,1682,1460,222
2021,Flintshire 003E,W01000304,2006,1692,314
2021,Flintshire 003F,W01000305,1854,1505,349
2021,Flintshire 002A,W01000306,2360,1867,493
2021,Flintshire 020B,W01000307,1392,1175,217
2021,Flintshire 020C,W01000308,1158,955,203
2021,Flintshire 019C,W01000309,2058,1696,362
2021,Flintshire 020D,W01000310,1853,1461,392
2021,Flintshire 011A,W01000311,1634,1466,168
2021,Flintshire 011B,W01000312,1568,1416,152
2021,Flintshire 016A,W01000313,1554,1205,349
2021,Flintshire 016B,W01000314,1100,860,240
2021,Flintshire 016C,W01000315,1903,1521,382
2021,Flintshire 016D,W01000316,1199,837,362
2021,Flintshire 016E,W01000317,1563,1023,540
2021,Flintshire 016F,W01000318,1162,983,179
2021,Flintshire 016G,W01000319,1396,1132,264
2021,Flintshire 002B,W01000320,1831,1491,340
2021,Flintshire 014D,W01000321,1598,1310,288
2021,Flintshire 014E,W01000322,1343,1124,219
2021,Flintshire 012C,W01000323,1536,1240,296
2021,Flintshire 012D,W01000324,1471,1162,309
2021,Flintshire 010D,W01000325,1761,1523,238
2021,Flintshire 018B,W01000326,2151,1766,385
2021,Flintshire 018C,W01000327,2385,2019,366
2021,Flintshire 011C,W01000328,1868,1702,166
2021,Flintshire 015D,W01000329,1556,1432,124
2021,Flintshire 015E,W01000330,2016,1873,143
2021,Flintshire 015F,W01000331,1421,1333,88
2021,Flintshire 009A,W01000332,1765,1608,157
2021,Flintshire 009B,W01000333,1425,1305,120
2021,Flintshire 009C,W01000334,1701,1532,169
2021,Flintshire 009D,W01000335,1144,1023,121
2021,Flintshire 009E,W01000336,1390,1244,146
2021,Flintshire 009F,W01000337,2095,1858,237
2021,Flintshire 001C,W01000338,1725,1282,443
2021,Flintshire 019D,W01000339,1636,1182,454
2021,Flintshire 002C,W01000340,2191,1642,549
2021,Wrexham 023C,W01000341,1508,1282,226
2021,Wrexham 023E,W01000342,1487,1275,212
2021,Wrexham 023B,W01000343,1010,857,153
2021,Wrexham 023A,W01000344,1221,1030,191
2021,Wrexham 018A,W01000345,1559,1372,187
2021,Wrexham 018B,W01000346,1460,1336,124
2021,Wrexham 006A,W01000347,2701,2174,527
2021,Wrexham 006B,W01000348,1376,1180,196
2021,Wrexham 011A,W01000349,2203,1820,383
2021,Wrexham 011B,W01000350,1759,1549,210
2021,Wrexham 005A,W01000351,1998,1680,318
2021,Wrexham 017A,W01000354,1604,1301,303
2021,Wrexham 017B,W01000355,1687,1403,284
2021,Wrexham 017C,W01000356,1574,1327,247
2021,Wrexham 019C,W01000359,1159,958,201
2021,Wrexham 019D,W01000360,1193,1050,143
2021,Wrexham 019E,W01000361,1926,1645,281
2021,Wrexham 006C,W01000362,1443,1136,307
2021,Wrexham 006D,W01000363,1429,1075,354
2021,Wrexham 006E,W01000364,1429,1084,345
2021,Wrexham 011C,W01000365,1985,1578,407
2021,Wrexham 014A,W01000366,1420,1227,193
2021,Wrexham 014B,W01000367,1248,1058,190
2021,Wrexham 008A,W01000368,1935,1597,338
2021,Wrexham 021B,W01000369,1237,1087,150
2021,Wrexham 021D,W01000370,1507,1298,209
2021,Wrexham 008B,W01000371,1029,865,164
2021,Wrexham 008C,W01000372,1484,1273,211
2021,Wrexham 005B,W01000373,1698,1446,252
2021,Wrexham 003A,W01000374,1327,1112,215
2021,Wrexham 003B,W01000375,2036,1667,369
2021,Wrexham 003C,W01000376,1305,1052,253
2021,Wrexham 004A,W01000377,1497,1222,275
2021,Wrexham 004B,W01000378,1249,1094,155
2021,Wrexham 004C,W01000379,1559,1313,246
2021,Wrexham 004D,W01000380,1419,1130,289
2021,Wrexham 012A,W01000381,1084,913,171
2021,Wrexham 012B,W01000382,1337,1097,240
2021,Wrexham 022C,W01000384,1067,933,134
2021,Wrexham 014C,W01000385,1692,1306,386
2021,Wrexham 015A,W01000386,1389,1112,277
2021,Wrexham 008D,W01000387,1105,937,168
2021,Wrexham 008E,W01000388,1073,907,166
2021,Wrexham 017D,W01000389,1943,1532,411
2021,Wrexham 021A,W01000390,1695,1449,246
2021,Wrexham 003D,W01000391,1403,1175,228
2021,Wrexham 003E,W01000392,1562,1355,207
2021,Wrexham 023G,W01000393,1890,1577,313
2021,Wrexham 016A,W01000394,1136,983,153
2021,Wrexham 016B,W01000395,1015,863,152
2021,Wrexham 013A,W01000398,1189,886,303
2021,Wrexham 013B,W01000399,1064,809,255
2021,Wrexham 005C,W01000400,1775,1496,279
2021,Wrexham 005D,W01000401,1944,1641,303
2021,Wrexham 011D,W01000402,2467,2097,370
2021,Wrexham 018C,W01000403,1284,1141,143
2021,Wrexham 018D,W01000404,1956,1726,230
2021,Wrexham 015B,W01000405,2204,1550,654
2021,Wrexham 013C,W01000406,2095,1595,500
2021,Wrexham 016C,W01000407,1360,1116,244
2021,Wrexham 013D,W01000408,1194,901,293
2021,Wrexham 017E,W01000409,1782,1560,222
2021,Wrexham 014D,W01000410,1644,1159,485
2021,Wrexham 015C,W01000411,1470,1081,389
2021,Wrexham 015D,W01000412,1446,956,490
2021,Wrexham 010C,W01000413,1251,1102,149
2021,Wrexham 010D,W01000414,1150,1030,120
2021,Wrexham 023F,W01000415,1392,1188,204
2021,Wrexham 023D,W01000416,1142,994,148
2021,Wrexham 022B,W01000417,1499,1340,159
2021,Wrexham 022A,W01000418,1705,1489,216
2021,Wrexham 016D,W01000419,1389,1117,272
2021,Wrexham 016E,W01000420,1483,1225,258
2021,Wrexham 008F,W01000422,2096,1757,339
2021,Wrexham 012D,W01000423,2104,1760,344
2021,Wrexham 012E,W01000424,1239,1063,176
2021,Wrexham 010E,W01000425,1970,1768,202
2021,Powys 021A,W01000426,1385,735,650
2021,Powys 011A,W01000427,1310,1144,166
2021,Powys 005A,W01000428,1299,1070,229
2021,Powys 010A,W01000429,2272,1606,666
2021,Powys 015A,W01000430,1290,1092,198
2021,Powys 014A,W01000431,1226,998,228
2021,Powys 014B,W01000432,1178,948,230
2021,Powys 006A,W01000433,2219,1481,738
2021,Powys 007A,W01000434,1704,1581,123
2021,Powys 012A,W01000438,1203,1055,148
2021,Powys 007B,W01000439,1984,1617,367
2021,Powys 020A,W01000440,1286,1039,247
2021,Powys 005B,W01000441,1493,1270,223
2021,Powys 004A,W01000442,2002,842,1160
2021,Powys 015B,W01000443,2236,1954,282
2021,Powys 002A,W01000444,2199,1759,440
2021,Powys 015C,W01000445,1458,1337,121
2021,Powys 015D,W01000446,1642,1485,157
2021,Powys 007C,W01000447,1954,1648,306
2021,Powys 011B,W01000448,1350,1243,107
2021,Powys 011C,W01000449,1494,1354,140
2021,Powys 014C,W01000450,1364,1096,268
2021,Powys 012B,W01000451,1160,1006,154
2021,Powys 004B,W01000452,1964,1060,904
2021,Powys 010B,W01000453,1353,1048,305
2021,Powys 013A,W01000454,1242,1073,169
2021,Powys 013B,W01000455,2125,1810,315
2021,Powys 013C,W01000456,2119,1819,300
2021,Powys 002B,W01000457,2099,1790,309
2021,Powys 002C,W01000458,1814,1528,286
2021,Powys 014D,W01000459,1184,1010,174
2021,Powys 006B,W01000460,1668,993,675
2021,Powys 001A,W01000461,1548,957,591
2021,Powys 011D,W01000464,1155,1041,114
2021,Powys 018E,W01000465,1018,869,149
2021,Powys 010C,W01000466,1289,983,306
2021,Powys 010D,W01000467,1422,1107,315
2021,Powys 001D,W01000470,1948,1469,479
2021,Powys 014E,W01000471,1723,1319,404
2021,Powys 012C,W01000472,1160,962,198
2021,Powys 004C,W01000473,2092,907,1185
2021,Powys 020B,W01000474,1708,1149,559
2021,Powys 001E,W01000475,2349,1533,816
2021,Powys 005C,W01000476,1250,1063,187
2021,Powys 012D,W01000477,1488,1284,204
2021,Powys 009A,W01000478,1797,1534,263
2021,Powys 009B,W01000479,1401,1163,238
2021,Powys 008A,W01000480,2036,1711,325
2021,Powys 008B,W01000481,2139,1768,371
2021,Powys 008C,W01000482,1853,1502,351
2021,Powys 009C,W01000483,1772,1494,278
2021,Powys 011E,W01000484,1650,1514,136
2021,Powys 011F,W01000485,1553,1437,116
2021,Powys 011G,W01000486,1039,958,81
2021,Powys 012E,W01000487,2029,1666,363
2021,Powys 006C,W01000488,2124,1553,571
2021,Powys 017A,W01000489,1741,1449,292
2021,Powys 017D,W01000492,1492,1243,249
2021,Powys 017E,W01000493,1693,1464,229
2021,Powys 015E,W01000494,1661,1409,252
2021,Powys 021B,W01000496,2036,1353,683
2021,Powys 005D,W01000497,1338,1172,166
2021,Powys 003A,W01000498,1439,1233,206
2021,Powys 003B,W01000499,1208,1039,169
2021,Powys 003C,W01000500,1644,1344,300
2021,Powys 003D,W01000501,2157,1780,377
2021,Powys 021C,W01000502,2023,1040,983
2021,Powys 020C,W01000503,1034,835,199
2021,Powys 021D,W01000504,1098,674,424
2021,Powys 021E,W01000505,1399,722,677
2021,Ceredigion 005A,W01000506,1251,470,781
2021,Ceredigion 009A,W01000507,1112,532,580
2021,Ceredigion 009B,W01000508,1010,487,523
2021,Ceredigion 009C,W01000509,1819,682,1137
2021,Ceredigion 009D,W01000510,1149,487,662
2021,Ceredigion 009E,W01000511,1135,544,591
2021,Ceredigion 002A,W01000512,1341,681,660
2021,Ceredigion 002B,W01000513,2085,1474,611
2021,Ceredigion 003A,W01000515,1276,694,582
2021,Ceredigion 003B,W01000516,1580,840,740
2021,Ceredigion 002D,W01000517,1157,807,350
2021,Ceredigion 003C,W01000518,991,561,430
2021,Ceredigion 010A,W01000519,1721,778,943
2021,Ceredigion 010B,W01000522,1181,589,592
2021,Ceredigion 001C,W01000523,1836,744,1092
2021,Ceredigion 005B,W01000524,1877,774,1103
2021,Ceredigion 011A,W01000525,1209,567,642
2021,Ceredigion 008A,W01000527,1129,583,546
2021,Ceredigion 008B,W01000528,1314,565,749
2021,Ceredigion 010C,W01000531,1721,771,950
2021,Ceredigion 010D,W01000533,1313,497,816
2021,Ceredigion 011B,W01000534,1485,555,930
2021,Ceredigion 008C,W01000535,1996,892,1104
2021,Ceredigion 011E,W01000536,1336,663,673
2021,Ceredigion 008D,W01000537,1366,727,639
2021,Ceredigion 005C,W01000538,1507,655,852
2021,Ceredigion 005D,W01000539,1153,562,591
2021,Ceredigion 005E,W01000540,1117,477,640
2021,Ceredigion 008E,W01000541,1699,752,947
2021,Ceredigion 011F,W01000542,2151,1000,1151
2021,Ceredigion 011C,W01000543,1959,871,1088
2021,Ceredigion 007D,W01000545,1944,925,1019
2021,Ceredigion 009F,W01000546,1115,541,574
2021,Ceredigion 009G,W01000547,1121,445,676
2021,Ceredigion 001D,W01000548,1729,718,1011
2021,Ceredigion 001E,W01000549,1715,639,1076
2021,Ceredigion 011G,W01000550,1130,434,696
2021,Ceredigion 010E,W01000551,1346,641,705
2021,Ceredigion 011D,W01000552,1954,730,1224
2021,Pembrokeshire 011A,W01000553,1209,1006,203
2021,Pembrokeshire 009A,W01000554,1812,1525,287
2021,Pembrokeshire 008A,W01000555,1490,1178,312
2021,Pembrokeshire 008B,W01000556,1154,935,219
2021,Pembrokeshire 014A,W01000557,1488,1237,251
2021,Pembrokeshire 001A,W01000558,2066,945,1121
2021,Pembrokeshire 001B,W01000559,1427,664,763
2021,Pembrokeshire 001C,W01000560,1269,515,754
2021,Pembrokeshire 001D,W01000561,1266,495,771
2021,Pembrokeshire 002A,W01000562,1576,784,792
2021,Pembrokeshire 011B,W01000563,1100,883,217
2021,Pembrokeshire 011C,W01000564,1267,1090,177
2021,Pembrokeshire 002B,W01000565,1796,1127,669
2021,Pembrokeshire 002C,W01000566,1549,911,638
2021,Pembrokeshire 002D,W01000567,1968,1228,740
2021,Pembrokeshire 005B,W01000569,1064,883,181
2021,Pembrokeshire 005C,W01000570,1366,1159,207
2021,Pembrokeshire 006A,W01000571,2355,1933,422
2021,Pembrokeshire 005D,W01000572,1783,1487,296
2021,Pembrokeshire 006B,W01000573,2494,2008,486
2021,Pembrokeshire 015A,W01000574,1684,1466,218
2021,Pembrokeshire 008C,W01000575,2718,2296,422
2021,Pembrokeshire 011D,W01000576,2243,1890,353
2021,Pembrokeshire 007A,W01000577,1521,1133,388
2021,Pembrokeshire 014B,W01000578,1679,1457,222
2021,Pembrokeshire 003A,W01000579,2308,1349,959
2021,Pembrokeshire 009B,W01000580,2264,1907,357
2021,Pembrokeshire 003B,W01000581,1376,743,633
2021,Pembrokeshire 004A,W01000582,1637,888,749
2021,Pembrokeshire 004B,W01000583,1390,677,713
2021,Pembrokeshire 014C,W01000584,2023,1741,282
2021,Pembrokeshire 007B,W01000585,1332,1021,311
2021,Pembrokeshire 006C,W01000586,2142,1756,386
2021,Pembrokeshire 010A,W01000587,1935,1693,242
2021,Pembrokeshire 010B,W01000588,2259,1988,271
2021,Pembrokeshire 012A,W01000589,1106,977,129
2021,Pembrokeshire 012B,W01000590,1110,1020,90
2021,Pembrokeshire 012C,W01000591,1588,1435,153
2021,Pembrokeshire 012D,W01000592,1279,1146,133
2021,Pembrokeshire 012E,W01000594,2103,1887,216
2021,Pembrokeshire 007C,W01000595,2300,1666,634
2021,Pembrokeshire 007D,W01000596,1676,1267,409
2021,Pembrokeshire 002E,W01000597,1038,532,506
2021,Pembrokeshire 009C,W01000598,2108,1876,232
2021,Pembrokeshire 009D,W01000599,1949,1722,227
2021,Pembrokeshire 013A,W01000600,1559,1377,182
2021,Pembrokeshire 013B,W01000601,1462,1341,121
2021,Pembrokeshire 013C,W01000602,1184,1034,150
2021,Pembrokeshire 013D,W01000603,1754,1547,207
2021,Pembrokeshire 013E,W01000604,1654,1496,158
2021,Pembrokeshire 013F,W01000605,1744,1565,179
2021,Pembrokeshire 015B,W01000606,1603,1477,126
2021,Pembrokeshire 015C,W01000607,2375,2076,299
2021,Pembrokeshire 015D,W01000608,1392,1214,178
2021,Pembrokeshire 014D,W01000609,2375,2079,296
2021,Pembrokeshire 016A,W01000610,1676,1394,282
2021,Pembrokeshire 004C,W01000611,2043,1562,481
2021,Pembrokeshire 003C,W01000612,1732,1182,550
2021,Pembrokeshire 001E,W01000613,2011,1016,995
2021,Pembrokeshire 008D,W01000614,1353,1159,194
2021,Pembrokeshire 002F,W01000617,1485,883,602
2021,Pembrokeshire 003D,W01000618,1686,1173,513
2021,Pembrokeshire 016B,W01000619,1959,1648,311
2021,Pembrokeshire 008E,W01000622,1392,1154,238
2021,Pembrokeshire 004D,W01000623,1961,1383,578
2021,Carmarthenshire 005A,W01000624,2280,896,1384
2021,Carmarthenshire 013A,W01000625,1087,514,573
2021,Carmarthenshire 013B,W01000626,1571,646,925
2021,Carmarthenshire 013C,W01000627,2324,976,1348
2021,Carmarthenshire 024A,W01000628,1492,944,548
2021,Carmarthenshire 024B,W01000629,1595,1089,506
2021,Carmarthenshire 024C,W01000630,1530,1031,499
2021,Carmarthenshire 024D,W01000631,1765,1357,408
2021,Carmarthenshire 021A,W01000632,1303,750,553
2021,Carmarthenshire 021B,W01000633,1383,887,496
2021,Carmarthenshire 021C,W01000634,1273,744,529
2021,Carmarthenshire 025A,W01000635,2329,1465,864
2021,Carmarthenshire 025B,W01000636,2268,1451,817
2021,Carmarthenshire 007A,W01000637,1336,769,567
2021,Carmarthenshire 007B,W01000638,1101,687,414
2021,Carmarthenshire 007C,W01000639,1457,811,646
2021,Carmarthenshire 007D,W01000640,1187,566,621
2021,Carmarthenshire 008A,W01000641,1998,1221,777
2021,Carmarthenshire 008B,W01000642,1714,883,831
2021,Carmarthenshire 006A,W01000643,1621,980,641
2021,Carmarthenshire 006B,W01000644,1812,906,906
2021,Carmarthenshire 006C,W01000645,1898,999,899
2021,Carmarthenshire 003A,W01000646,2077,1069,1008
2021,Carmarthenshire 002A,W01000647,1394,720,674
2021,Carmarthenshire 006D,W01000648,1393,670,723
2021,Carmarthenshire 006E,W01000649,1506,699,807
2021,Carmarthenshire 002B,W01000650,1521,785,736
2021,Carmarthenshire 020A,W01000651,1465,878,587
2021,Carmarthenshire 020B,W01000652,1732,1160,572
2021,Carmarthenshire 023A,W01000653,1427,768,659
2021,Carmarthenshire 023B,W01000654,1618,1065,553
2021,Carmarthenshire 020C,W01000655,1849,1186,663
2021,Carmarthenshire 010A,W01000656,1987,865,1122
2021,Carmarthenshire 010B,W01000657,1131,532,599
2021,Carmarthenshire 010C,W01000658,1287,604,683
2021,Carmarthenshire 026A,W01000659,1713,1246,467
2021,Carmarthenshire 026B,W01000660,1444,1042,402
2021,Carmarthenshire 016A,W01000662,2107,854,1253
2021,Carmarthenshire 016B,W01000663,2402,853,1549
2021,Carmarthenshire 016C,W01000664,2508,981,1527
2021,Carmarthenshire 017A,W01000665,1767,945,822
2021,Carmarthenshire 017B,W01000666,1596,866,730
2021,Carmarthenshire 023C,W01000667,2039,1122,917
2021,Carmarthenshire 018A,W01000670,1532,781,751
2021,Carmarthenshire 018B,W01000671,2089,1122,967
2021,Carmarthenshire 027E,W01000672,1464,1054,410
2021,Carmarthenshire 027F,W01000673,1082,717,365
2021,Carmarthenshire 027A,W01000674,2044,1010,1034
2021,Carmarthenshire 012A,W01000675,2021,823,1198
2021,Carmarthenshire 004A,W01000676,1487,681,806
2021,Carmarthenshire 004B,W01000677,1411,661,750
2021,Carmarthenshire 002C,W01000678,1344,772,572
2021,Carmarthenshire 002D,W01000679,1206,634,572
2021,Carmarthenshire 011A,W01000680,2248,860,1388
2021,Carmarthenshire 011B,W01000681,2020,779,1241
2021,Carmarthenshire 005B,W01000682,1363,512,851
2021,Carmarthenshire 005C,W01000683,1039,615,424
2021,Carmarthenshire 005D,W01000684,1718,834,884
2021,Carmarthenshire 001A,W01000685,1502,683,819
2021,Carmarthenshire 001B,W01000686,1187,520,667
2021,Carmarthenshire 004C,W01000687,1906,907,999
2021,Carmarthenshire 003B,W01000688,1657,771,886
2021,Carmarthenshire 003C,W01000689,1697,856,841
2021,Carmarthenshire 019A,W01000690,1729,845,884
2021,Carmarthenshire 019B,W01000691,1800,1041,759
2021,Carmarthenshire 019C,W01000692,1500,802,698
2021,Carmarthenshire 008C,W01000693,1099,505,594
2021,Carmarthenshire 008D,W01000694,1464,641,823
2021,Carmarthenshire 012B,W01000695,2162,1081,1081
2021,Carmarthenshire 012C,W01000696,1609,670,939
2021,Carmarthenshire 015A,W01000697,1876,705,1171
2021,Carmarthenshire 015B,W01000698,1908,678,1230
2021,Carmarthenshire 015C,W01000699,1434,619,815
2021,Carmarthenshire 027G,W01000700,1938,1005,933
2021,Carmarthenshire 001C,W01000701,1564,712,852
2021,Carmarthenshire 001D,W01000702,1148,513,635
2021,Carmarthenshire 022A,W01000703,1719,1129,590
2021,Carmarthenshire 022B,W01000704,1608,901,707
2021,Carmarthenshire 022C,W01000705,1852,1233,619
2021,Carmarthenshire 025C,W01000706,1505,993,512
2021,Carmarthenshire 025D,W01000707,1392,899,493
2021,Carmarthenshire 025E,W01000708,1329,923,406
2021,Carmarthenshire 004D,W01000709,2145,1062,1083
2021,Carmarthenshire 021D,W01000710,2123,1172,951
2021,Carmarthenshire 021E,W01000711,1977,1306,671
2021,Carmarthenshire 015D,W01000712,1643,678,965
2021,Carmarthenshire 015E,W01000713,1329,474,855
2021,Carmarthenshire 013D,W01000714,1378,593,785
2021,Carmarthenshire 013E,W01000715,1252,529,723
2021,Carmarthenshire 016D,W01000716,1371,515,856
2021,Carmarthenshire 016E,W01000717,1407,502,905
2021,Carmarthenshire 010D,W01000718,1360,479,881
2021,Carmarthenshire 010E,W01000719,1404,550,854
2021,Carmarthenshire 027B,W01000720,1771,846,925
2021,Carmarthenshire 027C,W01000721,1355,625,730
2021,Carmarthenshire 012D,W01000722,1321,575,746
2021,Carmarthenshire 012E,W01000723,1344,710,634
2021,Carmarthenshire 011C,W01000724,1889,899,990
2021,Carmarthenshire 011D,W01000725,2262,973,1289
2021,Carmarthenshire 003D,W01000728,2022,1024,998
2021,Carmarthenshire 018C,W01000729,1197,503,694
2021,Carmarthenshire 018D,W01000730,1234,620,614
2021,Carmarthenshire 017C,W01000731,2337,1138,1199
2021,Carmarthenshire 026D,W01000732,1263,915,348
2021,Carmarthenshire 026E,W01000733,1156,864,292
2021,Carmarthenshire 026F,W01000734,1344,978,366
2021,Carmarthenshire 027D,W01000735,2318,1239,1079
2021,Swansea 028A,W01000736,1721,1454,267
2021,Swansea 028B,W01000737,1452,1230,222
2021,Swansea 014A,W01000738,1660,1496,164
2021,Swansea 014B,W01000739,2152,1901,251
2021,Swansea 014C,W01000740,1525,1337,188
2021,Swansea 014D,W01000741,1798,1580,218
2021,Swansea 016A,W01000742,1604,1461,143
2021,Swansea 016B,W01000744,1472,1354,118
2021,Swansea 025B,W01000745,2404,2163,241
2021,Swansea 025C,W01000746,1377,1225,152
2021,Swansea 024A,W01000747,1552,1377,175
2021,Swansea 026A,W01000749,1951,1767,184
2021,Swansea 002A,W01000750,1414,1028,386
2021,Swansea 002B,W01000751,1366,930,436
2021,Swansea 002C,W01000752,1427,1160,267
2021,Swansea 002D,W01000753,1382,1030,352
2021,Swansea 002E,W01000754,1512,1126,386
2021,Swansea 017A,W01000755,1919,1688,231
2021,Swansea 017B,W01000756,1428,1234,194
2021,Swansea 017C,W01000757,1393,1212,181
2021,Swansea 017D,W01000758,1841,1555,286
2021,Swansea 012A,W01000759,1506,1236,270
2021,Swansea 013A,W01000760,1527,1298,229
2021,Swansea 013B,W01000761,1518,1326,192
2021,Swansea 013C,W01000762,1611,1491,120
2021,Swansea 015A,W01000763,1363,1218,145
2021,Swansea 015B,W01000764,1520,1356,164
2021,Swansea 015C,W01000765,1581,1415,166
2021,Swansea 015D,W01000766,1448,1286,162
2021,Swansea 015E,W01000767,1388,1278,110
2021,Swansea 032A,W01000768,1315,1147,168
2021,Swansea 032B,W01000769,1356,1186,170
2021,Swansea 032D,W01000770,1484,1320,164
2021,Swansea 032G,W01000771,1273,1120,153
2021,Swansea 018A,W01000772,1451,1216,235
2021,Swansea 005B,W01000774,1563,1217,346
2021,Swansea 030A,W01000775,1604,1383,221
2021,Swansea 030B,W01000776,1749,1454,295
2021,Swansea 012B,W01000777,1672,1395,277
2021,Swansea 012C,W01000778,1733,1460,273
2021,Swansea 012D,W01000779,1417,1147,270
2021,Swansea 032E,W01000781,1587,1328,259
2021,Swansea 032F,W01000782,1049,925,124
2021,Swansea 007A,W01000784,1263,993,270
2021,Swansea 007B,W01000785,1718,1297,421
2021,Swansea 007C,W01000786,1231,916,315
2021,Swansea 016C,W01000787,1395,1211,184
2021,Swansea 016D,W01000788,1438,1294,144
2021,Swansea 016E,W01000789,1368,1246,122
2021,Swansea 016F,W01000790,2618,2397,221
2021,Swansea 004A,W01000791,1377,1171,206
2021,Swansea 004B,W01000792,1536,1129,407
2021,Swansea 004C,W01000793,1813,1399,414
2021,Swansea 010A,W01000794,2133,1671,462
2021,Swansea 006A,W01000795,1524,1224,300
2021,Swansea 010B,W01000797,1475,1211,264
2021,Swansea 010C,W01000798,1383,1156,227
2021,Swansea 010D,W01000799,1783,1583,200
2021,Swansea 006C,W01000800,1425,1066,359
2021,Swansea 006D,W01000801,1667,1491,176
2021,Swansea 007D,W01000802,2284,1796,488
2021,Swansea 002F,W01000803,1778,1075,703
2021,Swansea 028C,W01000804,1404,1159,245
2021,Swansea 028D,W01000805,1119,928,191
2021,Swansea 003A,W01000806,1367,1165,202
2021,Swansea 003B,W01000807,1266,1086,180
2021,Swansea 003C,W01000808,1362,1153,209
2021,Swansea 008A,W01000809,1464,1251,213
2021,Swansea 003D,W01000810,1303,1150,153
2021,Swansea 008B,W01000811,1347,1186,161
2021,Swansea 008C,W01000812,1409,1273,136
2021,Swansea 008D,W01000813,1531,1235,296
2021,Swansea 008E,W01000814,1382,1204,178
2021,Swansea 003E,W01000815,1459,1114,345
2021,Swansea 003F,W01000816,1725,1445,280
2021,Swansea 009A,W01000817,1880,1626,254
2021,Swansea 009B,W01000818,1447,1245,202
2021,Swansea 009C,W01000819,1410,1200,210
2021,Swansea 009D,W01000820,1353,1167,186
2021,Swansea 009E,W01000821,1431,1293,138
2021,Swansea 009F,W01000822,1171,1010,161
2021,Swansea 031A,W01000823,1789,1530,259
2021,Swansea 031B,W01000824,1622,1327,295
2021,Swansea 031C,W01000825,1247,1029,218
2021,Swansea 031D,W01000826,1236,1001,235
2021,Swansea 031E,W01000827,1227,1046,181
2021,Swansea 018B,W01000828,1607,1296,311
2021,Swansea 018C,W01000829,1873,1519,354
2021,Swansea 011A,W01000830,1696,1574,122
2021,Swansea 013D,W01000831,1668,1464,204
2021,Swansea 011B,W01000832,1522,1390,132
2021,Swansea 011C,W01000833,1567,1417,150
2021,Swansea 011D,W01000834,1393,1202,191
2021,Swansea 013E,W01000835,1405,1282,123
2021,Swansea 011E,W01000836,2282,2005,277
2021,Swansea 004D,W01000837,2238,1712,526
2021,Swansea 004E,W01000838,1225,1030,195
2021,Swansea 030C,W01000839,1024,881,143
2021,Swansea 030D,W01000840,1588,1350,238
2021,Swansea 005C,W01000841,1427,1156,271
2021,Swansea 005D,W01000842,1384,1106,278
2021,Swansea 005E,W01000843,1348,1075,273
2021,Swansea 005F,W01000844,1459,1223,236
2021,Swansea 001A,W01000845,1960,1249,711
2021,Swansea 001B,W01000846,1985,1308,677
2021,Swansea 001C,W01000847,1230,786,444
2021,Swansea 001D,W01000848,1168,883,285
2021,Swansea 021A,W01000849,2118,1905,213
2021,Swansea 021C,W01000851,1562,1402,160
2021,Swansea 021D,W01000852,1432,1311,121
2021,Swansea 022A,W01000853,1634,1361,273
2021,Swansea 022B,W01000854,1462,1219,243
2021,Swansea 022C,W01000855,1390,1162,228
2021,Swansea 022D,W01000856,1695,1539,156
2021,Swansea 022E,W01000857,1873,1624,249
2021,Swansea 027A,W01000858,1603,1304,299
2021,Swansea 027B,W01000859,1376,1147,229
2021,Swansea 027C,W01000860,1502,1215,287
2021,Swansea 027D,W01000861,1930,1639,291
2021,Swansea 019A,W01000862,1492,1305,187
2021,Swansea 019B,W01000863,1561,1454,107
2021,Swansea 019C,W01000864,1568,1439,129
2021,Swansea 019D,W01000865,1367,1263,104
2021,Swansea 019E,W01000866,1134,1056,78
2021,Swansea 019F,W01000867,1238,1120,118
2021,Swansea 024B,W01000868,1067,851,216
2021,Swansea 024C,W01000869,1501,1274,227
2021,Swansea 024D,W01000870,1349,1141,208
2021,Swansea 026B,W01000871,1737,1522,215
2021,Swansea 024E,W01000872,1364,1083,281
2021,Swansea 026C,W01000873,1513,1289,224
2021,Swansea 024F,W01000874,1774,1494,280
2021,Swansea 026D,W01000875,1880,1641,239
2021,Swansea 026E,W01000876,1616,1357,259
2021,Swansea 007E,W01000877,1629,1239,390
2021,Swansea 007F,W01000878,1237,950,287
2021,Swansea 029A,W01000879,1647,1374,273
2021,Swansea 029B,W01000880,1518,1251,267
2021,Swansea 029C,W01000881,1291,1118,173
2021,Swansea 029D,W01000882,1689,1462,227
2021,Neath Port Talbot 016A,W01000883,1300,1172,128
2021,Neath Port Talbot 017A,W01000884,1230,1099,131
2021,Neath Port Talbot 017B,W01000885,1405,1246,159
2021,Neath Port Talbot 017C,W01000886,1564,1422,142
2021,Neath Port Talbot 021C,W01000887,2316,1899,417
2021,Neath Port Talbot 004A,W01000888,2630,1737,893
2021,Neath Port Talbot 015A,W01000889,1762,1532,230
2021,Neath Port Talbot 015B,W01000890,1502,1331,171
2021,Neath Port Talbot 015C,W01000891,1403,1231,172
2021,Neath Port Talbot 015D,W01000892,1907,1668,239
2021,Neath Port Talbot 003A,W01000893,1869,1534,335
2021,Neath Port Talbot 013A,W01000894,1426,1245,181
2021,Neath Port Talbot 013B,W01000895,1421,1262,159
2021,Neath Port Talbot 013C,W01000896,1525,1323,202
2021,Neath Port Talbot 013D,W01000897,1279,1132,147
2021,Neath Port Talbot 014A,W01000898,1421,1142,279
2021,Neath Port Talbot 014B,W01000899,1817,1466,351
2021,Neath Port Talbot 014C,W01000900,1527,1290,237
2021,Neath Port Talbot 014D,W01000901,1616,1311,305
2021,Neath Port Talbot 006C,W01000904,1439,1188,251
2021,Neath Port Talbot 006D,W01000905,1451,1220,231
2021,Neath Port Talbot 007B,W01000907,1679,1429,250
2021,Neath Port Talbot 006E,W01000908,1555,1263,292
2021,Neath Port Talbot 009A,W01000909,1152,1008,144
2021,Neath Port Talbot 009B,W01000910,1340,1152,188
2021,Neath Port Talbot 009C,W01000911,1122,923,199
2021,Neath Port Talbot 010A,W01000912,1170,1024,146
2021,Neath Port Talbot 010B,W01000913,1120,936,184
2021,Neath Port Talbot 010C,W01000914,1598,1442,156
2021,Neath Port Talbot 010D,W01000915,1086,936,150
2021,Neath Port Talbot 010E,W01000916,1154,989,165
2021,Neath Port Talbot 002A,W01000918,1883,1348,535
2021,Neath Port Talbot 020A,W01000919,1120,501,619
2021,Neath Port Talbot 021G,W01000921,1405,1291,114
2021,Neath Port Talbot 007C,W01000922,1541,1301,240
2021,Neath Port Talbot 003B,W01000925,1484,1199,285
2021,Neath Port Talbot 003C,W01000926,1798,1300,498
2021,Neath Port Talbot 020B,W01000927,1993,1224,769
2021,Neath Port Talbot 020C,W01000928,1544,680,864
2021,Neath Port Talbot 020D,W01000929,1223,614,609
2021,Neath Port Talbot 021F,W01000930,1109,1032,77
2021,Neath Port Talbot 020E,W01000931,1316,573,743
2021,Neath Port Talbot 019A,W01000932,1001,886,115
2021,Neath Port Talbot 019B,W01000933,1943,1633,310
2021,Neath Port Talbot 008A,W01000934,1207,1067,140
2021,Neath Port Talbot 008B,W01000935,1508,1340,168
2021,Neath Port Talbot 012A,W01000936,1327,1204,123
2021,Neath Port Talbot 013E,W01000937,1873,1613,260
2021,Neath Port Talbot 008C,W01000938,1358,1114,244
2021,Neath Port Talbot 008D,W01000939,1121,976,145
2021,Neath Port Talbot 008E,W01000940,1228,1075,153
2021,Neath Port Talbot 012B,W01000941,1487,1305,182
2021,Neath Port Talbot 012C,W01000942,1735,1542,193
2021,Neath Port Talbot 012D,W01000943,1441,1193,248
2021,Neath Port Talbot 002B,W01000944,1145,897,248
2021,Neath Port Talbot 014E,W01000945,1131,947,184
2021,Neath Port Talbot 004B,W01000946,1750,1148,602
2021,Neath Port Talbot 004C,W01000947,2109,1428,681
2021,Neath Port Talbot 004D,W01000948,1777,1142,635
2021,Neath Port Talbot 018A,W01000949,1291,1108,183
2021,Neath Port Talbot 018B,W01000950,1417,1250,167
2021,Neath Port Talbot 018C,W01000951,1736,1533,203
2021,Neath Port Talbot 018D,W01000952,1135,983,152
2021,Neath Port Talbot 021B,W01000953,1559,1320,239
2021,Neath Port Talbot 021A,W01000954,1315,1123,192
2021,Neath Port Talbot 004E,W01000955,1343,944,399
2021,Neath Port Talbot 004F,W01000956,1172,836,336
2021,Neath Port Talbot 017D,W01000957,1569,1397,172
2021,Neath Port Talbot 016B,W01000958,1513,1401,112
2021,Neath Port Talbot 017E,W01000959,1687,1501,186
2021,Neath Port Talbot 017F,W01000960,1717,1552,165
2021,Neath Port Talbot 016C,W01000961,1542,1357,185
2021,Neath Port Talbot 016D,W01000962,1486,1316,170
2021,Neath Port Talbot 016E,W01000963,1800,1608,192
2021,Neath Port Talbot 016F,W01000964,1755,1557,198
2021,Neath Port Talbot 002C,W01000965,1968,1400,568
2021,Neath Port Talbot 018E,W01000966,1401,1232,169
2021,Neath Port Talbot 019C,W01000967,1372,1255,117
2021,Neath Port Talbot 019D,W01000968,1906,1657,249
2021,Neath Port Talbot 009D,W01000969,1498,1222,276
2021,Neath Port Talbot 021D,W01000970,1081,936,145
2021,Neath Port Talbot 004G,W01000971,1359,833,526
2021,Neath Port Talbot 020F,W01000973,1295,669,626
2021,Bridgend 006A,W01000974,2301,2010,291
2021,Bridgend 004A,W01000975,2163,1978,185
2021,Bridgend 003A,W01000976,1060,941,119
2021,Bridgend 003B,W01000977,1380,1251,129
2021,Bridgend 004B,W01000978,1725,1513,212
2021,Bridgend 015A,W01000979,1558,1360,198
2021,Bridgend 016A,W01000980,1303,1161,142
2021,Bridgend 016B,W01000981,1202,1052,150
2021,Bridgend 016C,W01000982,1393,1238,155
2021,Bridgend 015B,W01000983,1466,1268,198
2021,Bridgend 016D,W01000984,2103,1829,274
2021,Bridgend 015C,W01000985,1236,1075,161
2021,Bridgend 007A,W01000986,1617,1361,256
2021,Bridgend 007B,W01000987,2334,2086,248
2021,Bridgend 013A,W01000989,1530,1275,255
2021,Bridgend 017B,W01000990,1508,1366,142
2021,Bridgend 001A,W01000991,1104,990,114
2021,Bridgend 001B,W01000992,1348,1230,118
2021,Bridgend 001C,W01000993,1316,1185,131
2021,Bridgend 001D,W01000994,1351,1205,146
2021,Bridgend 001E,W01000995,1325,1124,201
2021,Bridgend 008A,W01000996,1494,1315,179
2021,Bridgend 012A,W01000997,1651,1485,166
2021,Bridgend 010A,W01000999,1355,1202,153
2021,Bridgend 010B,W01001000,1686,1451,235
2021,Bridgend 010C,W01001001,1757,1526,231
2021,Bridgend 010D,W01001002,2337,2053,284
2021,Bridgend 015D,W01001003,1312,1147,165
2021,Bridgend 009A,W01001004,1014,882,132
2021,Bridgend 009B,W01001005,1556,1336,220
2021,Bridgend 009C,W01001006,2185,1856,329
2021,Bridgend 009D,W01001007,1830,1580,250
2021,Bridgend 011B,W01001008,2472,2140,332
2021,Bridgend 004C,W01001009,1208,1046,162
2021,Bridgend 012B,W01001010,1126,1030,96
2021,Bridgend 012C,W01001011,1246,1137,109
2021,Bridgend 005A,W01001012,1469,1178,291
2021,Bridgend 005B,W01001013,1437,1179,258
2021,Bridgend 002A,W01001014,1575,1351,224
2021,Bridgend 002B,W01001015,1423,1199,224
2021,Bridgend 005C,W01001016,1596,1378,218
2021,Bridgend 002C,W01001017,1426,1180,246
2021,Bridgend 002D,W01001018,1253,1043,210
2021,Bridgend 005D,W01001019,1539,1307,232
2021,Bridgend 002E,W01001020,1317,1149,168
2021,Bridgend 014A,W01001021,1558,1375,183
2021,Bridgend 014B,W01001022,1381,1252,129
2021,Bridgend 014C,W01001023,1607,1458,149
2021,Bridgend 003C,W01001024,1103,990,113
2021,Bridgend 003D,W01001025,1197,1067,130
2021,Bridgend 012D,W01001026,1942,1747,195
2021,Bridgend 017C,W01001027,1461,1293,168
2021,Bridgend 014D,W01001028,1846,1584,262
2021,Bridgend 019A,W01001029,1684,1497,187
2021,Bridgend 019B,W01001030,1918,1685,233
2021,Bridgend 018A,W01001031,1443,1268,175
2021,Bridgend 018B,W01001032,1726,1499,227
2021,Bridgend 003E,W01001033,1701,1528,173
2021,Bridgend 003F,W01001034,1298,1153,145
2021,Bridgend 014E,W01001035,1689,1499,190
2021,Bridgend 017D,W01001036,1582,1303,279
2021,Bridgend 013B,W01001037,1763,1513,250
2021,Bridgend 011C,W01001038,2494,2165,329
2021,Bridgend 009E,W01001039,1659,1437,222
2021,Bridgend 009F,W01001040,1520,1325,195
2021,Bridgend 013C,W01001041,2239,1930,309
2021,Bridgend 004D,W01001042,1221,1021,200
2021,Bridgend 004E,W01001043,1132,964,168
2021,Bridgend 019C,W01001044,1556,1427,129
2021,Bridgend 019D,W01001045,1668,1499,169
2021,Bridgend 018C,W01001046,1886,1687,199
2021,Bridgend 018D,W01001047,1633,1391,242
2021,Bridgend 008B,W01001048,1381,1246,135
2021,Bridgend 008C,W01001049,1257,1114,143
2021,Bridgend 008D,W01001050,1501,1303,198
2021,Bridgend 008E,W01001051,1764,1544,220
2021,Bridgend 008F,W01001052,1240,1099,141
2021,Bridgend 018E,W01001053,992,836,156
2021,Bridgend 018F,W01001054,1332,1171,161
2021,Bridgend 007C,W01001055,1164,1039,125
2021,Bridgend 007D,W01001056,1152,1018,134
2021,Bridgend 006B,W01001057,1678,1475,203
2021,Bridgend 006C,W01001058,1840,1563,277
2021,Vale of Glamorgan 015A,W01001059,1702,1386,316
2021,Vale of Glamorgan 015B,W01001060,1383,1157,226
2021,Vale of Glamorgan 013A,W01001062,1302,1064,238
2021,Vale of Glamorgan 012A,W01001063,1544,1344,200
2021,Vale of Glamorgan 013B,W01001064,1371,1222,149
2021,Vale of Glamorgan 012B,W01001065,1518,1284,234
2021,Vale of Glamorgan 015D,W01001066,1575,1314,261
2021,Vale of Glamorgan 009A,W01001067,1345,1202,143
2021,Vale of Glamorgan 009B,W01001068,1603,1432,171
2021,Vale of Glamorgan 012C,W01001069,1475,1312,163
2021,Vale of Glamorgan 009C,W01001070,993,896,97
2021,Vale of Glamorgan 009D,W01001071,1436,1285,151
2021,Vale of Glamorgan 009E,W01001072,2630,2226,404
2021,Vale of Glamorgan 015E,W01001073,2017,1782,235
2021,Vale of Glamorgan 004A,W01001075,1143,941,202
2021,Vale of Glamorgan 004B,W01001076,1344,1152,192
2021,Vale of Glamorgan 004C,W01001077,1384,1194,190
2021,Vale of Glamorgan 004D,W01001078,1257,1034,223
2021,Vale of Glamorgan 012E,W01001079,1436,1244,192
2021,Vale of Glamorgan 012F,W01001080,1529,1362,167
2021,Vale of Glamorgan 007A,W01001081,1675,1448,227
2021,Vale of Glamorgan 002A,W01001082,1525,1242,283
2021,Vale of Glamorgan 002B,W01001083,1668,1357,311
2021,Vale of Glamorgan 002C,W01001084,1626,1353,273
2021,Vale of Glamorgan 002D,W01001085,1610,1289,321
2021,Vale of Glamorgan 006A,W01001086,1466,1210,256
2021,Vale of Glamorgan 006B,W01001087,1472,1250,222
2021,Vale of Glamorgan 006C,W01001088,2074,1830,244
2021,Vale of Glamorgan 006D,W01001089,1553,1362,191
2021,Vale of Glamorgan 006E,W01001090,1414,1189,225
2021,Vale of Glamorgan 010A,W01001091,1589,1389,200
2021,Vale of Glamorgan 007B,W01001092,2046,1735,311
2021,Vale of Glamorgan 013C,W01001093,1719,1481,238
2021,Vale of Glamorgan 007C,W01001094,1195,1052,143
2021,Vale of Glamorgan 007D,W01001095,1321,1166,155
2021,Vale of Glamorgan 007E,W01001096,1274,1133,141
2021,Vale of Glamorgan 007F,W01001097,1469,1319,150
2021,Vale of Glamorgan 010B,W01001098,1011,874,137
2021,Vale of Glamorgan 013D,W01001099,1165,1010,155
2021,Vale of Glamorgan 010C,W01001100,1452,1215,237
2021,Vale of Glamorgan 013E,W01001101,1473,1275,198
2021,Vale of Glamorgan 013F,W01001102,1467,1228,239
2021,Vale of Glamorgan 010D,W01001103,1150,1009,141
2021,Vale of Glamorgan 004E,W01001104,2039,1790,249
2021,Vale of Glamorgan 001A,W01001105,2757,2226,531
2021,Vale of Glamorgan 011A,W01001106,1415,1231,184
2021,Vale of Glamorgan 011B,W01001107,1476,1307,169
2021,Vale of Glamorgan 014A,W01001108,1757,1544,213
2021,Vale of Glamorgan 011C,W01001109,1345,1135,210
2021,Vale of Glamorgan 011D,W01001110,1659,1428,231
2021,Vale of Glamorgan 011E,W01001111,1314,1173,141
2021,Vale of Glamorgan 011F,W01001112,1279,1064,215
2021,Vale of Glamorgan 003A,W01001113,2263,1847,416
2021,Vale of Glamorgan 008A,W01001114,1545,1259,286
2021,Vale of Glamorgan 008B,W01001115,2099,1791,308
2021,Vale of Glamorgan 005A,W01001116,1905,1577,328
2021,Vale of Glamorgan 014B,W01001117,1263,1115,148
2021,Vale of Glamorgan 003B,W01001119,1820,1530,290
2021,Vale of Glamorgan 014D,W01001120,1321,1177,144
2021,Vale of Glamorgan 014E,W01001121,1659,1473,186
2021,Vale of Glamorgan 014F,W01001122,2369,2089,280
2021,Vale of Glamorgan 005B,W01001123,1448,1231,217
2021,Vale of Glamorgan 005C,W01001124,1421,1191,230
2021,Vale of Glamorgan 005D,W01001125,1386,1186,200
2021,Vale of Glamorgan 001B,W01001127,1589,1315,274
2021,Vale of Glamorgan 001C,W01001128,1638,1368,270
2021,Vale of Glamorgan 004F,W01001129,1598,1384,214
2021,Vale of Glamorgan 005F,W01001130,1239,1020,219
2021,Vale of Glamorgan 008C,W01001131,1650,1418,232
2021,Vale of Glamorgan 008D,W01001132,1307,1130,177
2021,Vale of Glamorgan 008E,W01001133,2187,1886,301
2021,Vale of Glamorgan 008F,W01001134,1084,946,138
2021,Vale of Glamorgan 003C,W01001135,2240,1890,350
2021,Vale of Glamorgan 003D,W01001136,1465,1285,180
2021,Rhondda Cynon Taf 005A,W01001137,2290,2017,273
2021,Rhondda Cynon Taf 005B,W01001138,1289,1139,150
2021,Rhondda Cynon Taf 005C,W01001139,1355,1190,165
2021,Rhondda Cynon Taf 005D,W01001140,1363,1187,176
2021,Rhondda Cynon Taf 005E,W01001141,1463,1265,198
2021,Rhondda Cynon Taf 005F,W01001142,1840,1615,225
2021,Rhondda Cynon Taf 012A,W01001143,1433,1214,219
2021,Rhondda Cynon Taf 012B,W01001144,1672,1493,179
2021,Rhondda Cynon Taf 012C,W01001145,1686,1462,224
2021,Rhondda Cynon Taf 012D,W01001146,1366,1135,231
2021,Rhondda Cynon Taf 004A,W01001147,1760,1454,306
2021,Rhondda Cynon Taf 002A,W01001148,1683,1425,258
2021,Rhondda Cynon Taf 003A,W01001149,1357,1135,222
2021,Rhondda Cynon Taf 003B,W01001150,1820,1569,251
2021,Rhondda Cynon Taf 003C,W01001151,1770,1472,298
2021,Rhondda Cynon Taf 002B,W01001152,1881,1538,343
2021,Rhondda Cynon Taf 002C,W01001153,1515,1282,233
2021,Rhondda Cynon Taf 003D,W01001154,1370,1172,198
2021,Rhondda Cynon Taf 002D,W01001155,1482,1247,235
2021,Rhondda Cynon Taf 003E,W01001156,1375,1084,291
2021,Rhondda Cynon Taf 028A,W01001157,1266,1069,197
2021,Rhondda Cynon Taf 028B,W01001158,1437,1240,197
2021,Rhondda Cynon Taf 028C,W01001159,1512,1218,294
2021,Rhondda Cynon Taf 029A,W01001160,1586,1352,234
2021,Rhondda Cynon Taf 025A,W01001162,2434,1908,526
2021,Rhondda Cynon Taf 019A,W01001164,1520,1266,254
2021,Rhondda Cynon Taf 019B,W01001165,1307,1077,230
2021,Rhondda Cynon Taf 016A,W01001166,1325,1214,111
2021,Rhondda Cynon Taf 016B,W01001167,1362,1182,180
2021,Rhondda Cynon Taf 004B,W01001168,1357,1188,169
2021,Rhondda Cynon Taf 004C,W01001169,2444,2147,297
2021,Rhondda Cynon Taf 004D,W01001170,1163,989,174
2021,Rhondda Cynon Taf 017A,W01001171,1256,1067,189
2021,Rhondda Cynon Taf 020A,W01001172,1353,1129,224
2021,Rhondda Cynon Taf 020B,W01001173,1315,1187,128
2021,Rhondda Cynon Taf 020C,W01001174,1364,1238,126
2021,Rhondda Cynon Taf 009A,W01001175,1260,1080,180
2021,Rhondda Cynon Taf 013A,W01001176,1400,1188,212
2021,Rhondda Cynon Taf 009B,W01001177,1257,1090,167
2021,Rhondda Cynon Taf 023A,W01001178,1570,1365,205
2021,Rhondda Cynon Taf 023B,W01001179,1660,1508,152
2021,Rhondda Cynon Taf 015A,W01001180,1478,1282,196
2021,Rhondda Cynon Taf 015B,W01001181,1348,1137,211
2021,Rhondda Cynon Taf 026A,W01001184,2023,1742,281
2021,Rhondda Cynon Taf 022A,W01001185,2003,1715,288
2021,Rhondda Cynon Taf 001A,W01001186,1690,1323,367
2021,Rhondda Cynon Taf 001B,W01001187,1322,1015,307
2021,Rhondda Cynon Taf 001C,W01001188,1266,1086,180
2021,Rhondda Cynon Taf 029C,W01001189,1463,1256,207
2021,Rhondda Cynon Taf 029D,W01001190,2879,2330,549
2021,Rhondda Cynon Taf 031B,W01001192,1380,1192,188
2021,Rhondda Cynon Taf 030A,W01001193,1115,888,227
2021,Rhondda Cynon Taf 030B,W01001194,2058,1618,440
2021,Rhondda Cynon Taf 030C,W01001195,1422,1131,291
2021,Rhondda Cynon Taf 027B,W01001196,1401,1097,304
2021,Rhondda Cynon Taf 027C,W01001197,1183,830,353
2021,Rhondda Cynon Taf 027D,W01001198,1457,1220,237
2021,Rhondda Cynon Taf 027E,W01001199,1615,1308,307
2021,Rhondda Cynon Taf 009C,W01001202,1712,1511,201
2021,Rhondda Cynon Taf 009D,W01001203,1316,1165,151
2021,Rhondda Cynon Taf 006A,W01001204,1471,1239,232
2021,Rhondda Cynon Taf 006B,W01001205,1426,1193,233
2021,Rhondda Cynon Taf 006C,W01001206,1425,1257,168
2021,Rhondda Cynon Taf 006D,W01001207,1230,1070,160
2021,Rhondda Cynon Taf 006E,W01001208,1473,1264,209
2021,Rhondda Cynon Taf 008A,W01001209,1403,1255,148
2021,Rhondda Cynon Taf 008B,W01001210,1416,1257,159
2021,Rhondda Cynon Taf 008C,W01001211,1474,1321,153
2021,Rhondda Cynon Taf 008D,W01001212,1263,1132,131
2021,Rhondda Cynon Taf 011B,W01001214,1272,1051,221
2021,Rhondda Cynon Taf 011D,W01001216,1462,1260,202
2021,Rhondda Cynon Taf 018A,W01001217,1081,952,129
2021,Rhondda Cynon Taf 018B,W01001218,1476,1320,156
2021,Rhondda Cynon Taf 018C,W01001219,1178,1085,93
2021,Rhondda Cynon Taf 018D,W01001220,1447,1303,144
2021,Rhondda Cynon Taf 001D,W01001221,1387,1199,188
2021,Rhondda Cynon Taf 001E,W01001222,1500,1324,176
2021,Rhondda Cynon Taf 031C,W01001223,1691,1416,275
2021,Rhondda Cynon Taf 031D,W01001224,1981,1363,618
2021,Rhondda Cynon Taf 031E,W01001225,1538,1203,335
2021,Rhondda Cynon Taf 031F,W01001226,1642,1332,310
2021,Rhondda Cynon Taf 021C,W01001227,1232,928,304
2021,Rhondda Cynon Taf 021D,W01001228,1575,1237,338
2021,Rhondda Cynon Taf 017B,W01001229,1365,1125,240
2021,Rhondda Cynon Taf 017C,W01001230,1504,1232,272
2021,Rhondda Cynon Taf 017D,W01001231,1387,1159,228
2021,Rhondda Cynon Taf 020D,W01001232,1237,1048,189
2021,Rhondda Cynon Taf 001F,W01001233,1779,1395,384
2021,Rhondda Cynon Taf 021E,W01001234,1452,1230,222
2021,Rhondda Cynon Taf 021F,W01001235,1601,1383,218
2021,Rhondda Cynon Taf 021G,W01001236,1561,1282,279
2021,Rhondda Cynon Taf 022B,W01001237,1409,1235,174
2021,Rhondda Cynon Taf 022C,W01001238,1651,1445,206
2021,Rhondda Cynon Taf 026B,W01001239,1266,1089,177
2021,Rhondda Cynon Taf 026C,W01001240,1856,1560,296
2021,Rhondda Cynon Taf 026D,W01001241,1612,1294,318
2021,Rhondda Cynon Taf 030D,W01001242,1322,1082,240
2021,Rhondda Cynon Taf 030E,W01001243,1368,1174,194
2021,Rhondda Cynon Taf 025B,W01001244,1351,1113,238
2021,Rhondda Cynon Taf 025C,W01001245,1201,994,207
2021,Rhondda Cynon Taf 025D,W01001246,1308,1098,210
2021,Rhondda Cynon Taf 016C,W01001247,1541,1344,197
2021,Rhondda Cynon Taf 016D,W01001248,1930,1648,282
2021,Rhondda Cynon Taf 024A,W01001249,1418,1241,177
2021,Rhondda Cynon Taf 024B,W01001250,1491,1274,217
2021,Rhondda Cynon Taf 024C,W01001251,1451,1243,208
2021,Rhondda Cynon Taf 024D,W01001252,1521,1299,222
2021,Rhondda Cynon Taf 023C,W01001253,1406,1244,162
2021,Rhondda Cynon Taf 023E,W01001255,1939,1681,258
2021,Rhondda Cynon Taf 019C,W01001256,1155,972,183
2021,Rhondda Cynon Taf 019D,W01001257,1203,967,236
2021,Rhondda Cynon Taf 019E,W01001258,1211,1043,168
2021,Rhondda Cynon Taf 018E,W01001259,1558,1385,173
2021,Rhondda Cynon Taf 014C,W01001260,1138,951,187
2021,Rhondda Cynon Taf 018F,W01001261,1208,1060,148
2021,Rhondda Cynon Taf 022D,W01001262,1531,1341,190
2021,Rhondda Cynon Taf 022E,W01001263,1640,1459,181
2021,Rhondda Cynon Taf 022F,W01001264,1885,1654,231
2021,Rhondda Cynon Taf 007A,W01001265,1493,1221,272
2021,Rhondda Cynon Taf 007B,W01001266,1332,1141,191
2021,Rhondda Cynon Taf 007C,W01001267,1439,1254,185
2021,Rhondda Cynon Taf 007D,W01001268,1277,1026,251
2021,Rhondda Cynon Taf 010A,W01001269,1411,1125,286
2021,Rhondda Cynon Taf 010B,W01001270,1406,1151,255
2021,Rhondda Cynon Taf 010C,W01001271,1478,1211,267
2021,Rhondda Cynon Taf 010D,W01001272,1428,1176,252
2021,Rhondda Cynon Taf 010E,W01001273,1710,1304,406
2021,Rhondda Cynon Taf 013B,W01001274,1144,1005,139
2021,Rhondda Cynon Taf 013C,W01001275,1729,1441,288
2021,Rhondda Cynon Taf 013D,W01001276,1225,1084,141
2021,Rhondda Cynon Taf 028D,W01001277,1089,948,141
2021,Rhondda Cynon Taf 028E,W01001278,1107,916,191
2021,Rhondda Cynon Taf 028F,W01001279,1069,940,129
2021,Rhondda Cynon Taf 017E,W01001280,1518,1335,183
2021,Rhondda Cynon Taf 017F,W01001281,1629,1331,298
2021,Rhondda Cynon Taf 015C,W01001282,1961,1635,326
2021,Rhondda Cynon Taf 015D,W01001283,1405,1108,297
2021,Rhondda Cynon Taf 015E,W01001284,1046,791,255
2021,Rhondda Cynon Taf 014D,W01001285,1332,1102,230
2021,Rhondda Cynon Taf 014E,W01001286,1420,1185,235
2021,Rhondda Cynon Taf 014F,W01001287,1417,1210,207
2021,Rhondda Cynon Taf 014G,W01001288,1383,1153,230
2021,Merthyr Tydfil 006A,W01001289,1314,1152,162
2021,Merthyr Tydfil 007A,W01001290,2304,2004,300
2021,Merthyr Tydfil 003A,W01001291,2000,1673,327
2021,Merthyr Tydfil 004A,W01001292,1759,1588,171
2021,Merthyr Tydfil 004B,W01001293,1638,1418,220
2021,Merthyr Tydfil 003B,W01001294,1628,1381,247
2021,Merthyr Tydfil 002A,W01001295,1454,1301,153
2021,Merthyr Tydfil 002B,W01001296,1518,1326,192
2021,Merthyr Tydfil 002C,W01001297,1761,1544,217
2021,Merthyr Tydfil 002D,W01001298,1678,1510,168
2021,Merthyr Tydfil 008A,W01001299,1617,1509,108
2021,Merthyr Tydfil 008B,W01001300,1678,1543,135
2021,Merthyr Tydfil 008C,W01001301,1835,1708,127
2021,Merthyr Tydfil 006B,W01001302,1370,1162,208
2021,Merthyr Tydfil 003C,W01001305,1193,1048,145
2021,Merthyr Tydfil 003D,W01001306,1387,1226,161
2021,Merthyr Tydfil 004C,W01001307,1490,1357,133
2021,Merthyr Tydfil 008D,W01001308,1194,1100,94
2021,Merthyr Tydfil 008E,W01001309,1258,1152,106
2021,Merthyr Tydfil 002E,W01001310,1494,1345,149
2021,Merthyr Tydfil 002F,W01001311,1102,989,113
2021,Merthyr Tydfil 006E,W01001312,1431,1260,171
2021,Merthyr Tydfil 006F,W01001313,1435,1276,159
2021,Merthyr Tydfil 005A,W01001314,2053,1809,244
2021,Merthyr Tydfil 004D,W01001315,1659,1481,178
2021,Merthyr Tydfil 005C,W01001317,1693,1442,251
2021,Merthyr Tydfil 005D,W01001318,1438,1261,177
2021,Merthyr Tydfil 007B,W01001319,1566,1296,270
2021,Merthyr Tydfil 007C,W01001320,1386,1188,198
2021,Merthyr Tydfil 007D,W01001321,1566,1353,213
2021,Merthyr Tydfil 007E,W01001322,1578,1359,219
2021,Merthyr Tydfil 003E,W01001324,1879,1633,246
2021,Caerphilly 003A,W01001325,1602,1364,238
2021,Caerphilly 003B,W01001326,2079,1799,280
2021,Caerphilly 014A,W01001327,2361,2038,323
2021,Caerphilly 014B,W01001328,1464,1283,181
2021,Caerphilly 014C,W01001329,1446,1298,148
2021,Caerphilly 018A,W01001330,1401,1097,304
2021,Caerphilly 018B,W01001331,1679,1379,300
2021,Caerphilly 018C,W01001332,1781,1485,296
2021,Caerphilly 018D,W01001333,1421,1178,243
2021,Caerphilly 005A,W01001334,1396,1265,131
2021,Caerphilly 005B,W01001335,1237,1074,163
2021,Caerphilly 004A,W01001336,1369,1167,202
2021,Caerphilly 004B,W01001337,1408,1265,143
2021,Caerphilly 004C,W01001338,1663,1482,181
2021,Caerphilly 004D,W01001339,1367,1206,161
2021,Caerphilly 020A,W01001340,1825,1529,296
2021,Caerphilly 020B,W01001341,1651,1467,184
2021,Caerphilly 021A,W01001342,1158,1019,139
2021,Caerphilly 021B,W01001343,1071,907,164
2021,Caerphilly 020C,W01001344,1631,1431,200
2021,Caerphilly 021C,W01001345,1339,1204,135
2021,Caerphilly 020D,W01001346,1477,1275,202
2021,Caerphilly 005C,W01001347,1452,1302,150
2021,Caerphilly 009A,W01001348,1700,1551,149
2021,Caerphilly 009B,W01001349,1680,1443,237
2021,Caerphilly 009C,W01001350,1681,1514,167
2021,Caerphilly 005D,W01001351,1373,1243,130
2021,Caerphilly 007A,W01001352,1699,1558,141
2021,Caerphilly 007B,W01001353,1492,1364,128
2021,Caerphilly 014D,W01001354,1632,1457,175
2021,Caerphilly 015A,W01001355,1494,1355,139
2021,Caerphilly 006A,W01001356,1166,1057,109
2021,Caerphilly 006B,W01001357,1656,1482,174
2021,Caerphilly 006C,W01001358,1442,1310,132
2021,Caerphilly 006D,W01001359,1365,1233,132
2021,Caerphilly 002A,W01001360,1267,1124,143
2021,Caerphilly 002B,W01001361,1120,1017,103
2021,Caerphilly 003C,W01001362,1941,1709,232
2021,Caerphilly 012A,W01001363,1746,1475,271
2021,Caerphilly 012B,W01001364,1724,1544,180
2021,Caerphilly 012C,W01001365,1888,1604,284
2021,Caerphilly 019A,W01001366,1528,1346,182
2021,Caerphilly 019B,W01001367,1411,1241,170
2021,Caerphilly 019C,W01001368,1391,1191,200
2021,Caerphilly 012D,W01001369,2353,2039,314
2021,Caerphilly 023A,W01001370,1791,1504,287
2021,Caerphilly 022A,W01001371,1834,1554,280
2021,Caerphilly 022B,W01001372,1758,1428,330
2021,Caerphilly 022C,W01001373,1877,1508,369
2021,Caerphilly 001A,W01001374,1375,1230,145
2021,Caerphilly 001B,W01001375,1435,1190,245
2021,Caerphilly 001C,W01001376,1378,1227,151
2021,Caerphilly 013A,W01001377,1418,1212,206
2021,Caerphilly 013B,W01001378,1459,1286,173
2021,Caerphilly 013C,W01001379,1485,1225,260
2021,Caerphilly 010A,W01001380,1733,1600,133
2021,Caerphilly 010B,W01001381,1429,1322,107
2021,Caerphilly 010C,W01001382,1508,1352,156
2021,Caerphilly 010D,W01001383,1410,1246,164
2021,Caerphilly 002C,W01001384,1448,1318,130
2021,Caerphilly 002D,W01001385,1476,1354,122
2021,Caerphilly 002E,W01001386,1527,1410,117
2021,Caerphilly 007C,W01001387,1159,989,170
2021,Caerphilly 007D,W01001388,1741,1480,261
2021,Caerphilly 007E,W01001389,1072,907,165
2021,Caerphilly 006E,W01001390,2046,1779,267
2021,Caerphilly 006F,W01001391,1583,1417,166
2021,Caerphilly 009D,W01001392,1890,1678,212
2021,Caerphilly 019D,W01001393,1302,1093,209
2021,Caerphilly 023B,W01001394,1257,1074,183
2021,Caerphilly 023C,W01001395,1281,1123,158
2021,Caerphilly 023D,W01001396,1498,1304,194
2021,Caerphilly 019E,W01001397,1533,1268,265
2021,Caerphilly 024A,W01001398,2683,2225,458
2021,Caerphilly 023E,W01001399,1221,1073,148
2021,Caerphilly 019F,W01001400,1358,1173,185
2021,Caerphilly 011A,W01001401,2002,1832,170
2021,Caerphilly 011B,W01001402,1548,1392,156
2021,Caerphilly 011C,W01001403,1543,1365,178
2021,Caerphilly 011D,W01001404,1321,1178,143
2021,Caerphilly 011E,W01001405,1735,1523,212
2021,Caerphilly 001D,W01001406,1776,1588,188
2021,Caerphilly 016A,W01001407,1276,1159,117
2021,Caerphilly 016B,W01001408,1388,1279,109
2021,Caerphilly 016C,W01001409,1532,1393,139
2021,Caerphilly 016D,W01001410,1745,1585,160
2021,Caerphilly 017A,W01001411,1569,1416,153
2021,Caerphilly 017B,W01001412,1605,1474,131
2021,Caerphilly 017C,W01001413,1767,1605,162
2021,Caerphilly 008A,W01001414,1525,1332,193
2021,Caerphilly 008B,W01001415,1673,1434,239
2021,Caerphilly 008C,W01001416,1341,1177,164
2021,Caerphilly 008D,W01001417,1342,1132,210
2021,Caerphilly 008E,W01001418,1355,1159,196
2021,Caerphilly 021D,W01001419,1570,1339,231
2021,Caerphilly 022D,W01001420,1184,986,198
2021,Caerphilly 022E,W01001421,1390,1243,147
2021,Caerphilly 022F,W01001422,1422,1238,184
2021,Caerphilly 024B,W01001423,1341,1154,187
2021,Caerphilly 024C,W01001424,1369,1148,221
2021,Caerphilly 024D,W01001425,1685,1366,319
2021,Caerphilly 024E,W01001426,1411,1162,249
2021,Caerphilly 024F,W01001427,1798,1451,347
2021,Caerphilly 001E,W01001428,1188,1073,115
2021,Caerphilly 001F,W01001429,1129,950,179
2021,Caerphilly 015B,W01001430,2307,2063,244
2021,Caerphilly 015C,W01001431,1535,1381,154
2021,Caerphilly 013D,W01001432,2657,2179,478
2021,Caerphilly 013E,W01001433,1325,1100,225
2021,Caerphilly 013F,W01001434,1340,1070,270
2021,Blaenau Gwent 008A,W01001435,1315,1211,104
2021,Blaenau Gwent 008B,W01001436,1329,1258,71
2021,Blaenau Gwent 008C,W01001437,1401,1299,102
2021,Blaenau Gwent 004A,W01001438,1437,1334,103
2021,Blaenau Gwent 004B,W01001439,1560,1425,135
2021,Blaenau Gwent 001A,W01001440,1306,1196,110
2021,Blaenau Gwent 001B,W01001441,1117,1048,69
2021,Blaenau Gwent 001C,W01001442,1069,980,89
2021,Blaenau Gwent 005A,W01001443,1200,1131,69
2021,Blaenau Gwent 005B,W01001444,1901,1740,161
2021,Blaenau Gwent 005C,W01001445,1306,1179,127
2021,Blaenau Gwent 002A,W01001446,1197,1092,105
2021,Blaenau Gwent 002B,W01001447,1424,1297,127
2021,Blaenau Gwent 002C,W01001448,1126,1040,86
2021,Blaenau Gwent 002D,W01001449,1330,1216,114
2021,Blaenau Gwent 007A,W01001450,1182,1090,92
2021,Blaenau Gwent 007B,W01001451,1258,1158,100
2021,Blaenau Gwent 007C,W01001452,1398,1284,114
2021,Blaenau Gwent 008D,W01001453,1443,1343,100
2021,Blaenau Gwent 008E,W01001454,1239,1166,73
2021,Blaenau Gwent 008F,W01001455,1614,1495,119
2021,Blaenau Gwent 004C,W01001456,1220,1134,86
2021,Blaenau Gwent 004D,W01001457,1719,1638,81
2021,Blaenau Gwent 004E,W01001458,1575,1469,106
2021,Blaenau Gwent 007D,W01001459,1152,1084,68
2021,Blaenau Gwent 007E,W01001460,1683,1523,160
2021,Blaenau Gwent 007F,W01001461,1232,1155,77
2021,Blaenau Gwent 006A,W01001462,1748,1597,151
2021,Blaenau Gwent 006B,W01001463,1740,1591,149
2021,Blaenau Gwent 009A,W01001464,1397,1290,107
2021,Blaenau Gwent 009B,W01001465,1484,1373,111
2021,Blaenau Gwent 009C,W01001466,1408,1338,70
2021,Blaenau Gwent 005D,W01001467,1825,1655,170
2021,Blaenau Gwent 005E,W01001468,1285,1177,108
2021,Blaenau Gwent 005F,W01001469,1265,1157,108
2021,Blaenau Gwent 001D,W01001470,1368,1263,105
2021,Blaenau Gwent 001E,W01001471,1563,1479,84
2021,Blaenau Gwent 003A,W01001472,1343,1181,162
2021,Blaenau Gwent 003B,W01001473,1225,1154,71
2021,Blaenau Gwent 003C,W01001474,1382,1273,109
2021,Blaenau Gwent 003D,W01001475,1089,976,113
2021,Blaenau Gwent 006C,W01001478,1328,1192,136
2021,Blaenau Gwent 006D,W01001479,1408,1314,94
2021,Blaenau Gwent 003E,W01001480,1420,1306,114
2021,Blaenau Gwent 006E,W01001481,1598,1474,124
2021,Torfaen 002A,W01001482,1193,1015,178
2021,Torfaen 002B,W01001483,1376,1205,171
2021,Torfaen 002C,W01001484,1594,1413,181
2021,Torfaen 002D,W01001485,1213,1092,121
2021,Torfaen 002E,W01001486,1428,1276,152
2021,Torfaen 001A,W01001487,1608,1424,184
2021,Torfaen 001B,W01001488,1443,1320,123
2021,Torfaen 001C,W01001489,1396,1262,134
2021,Torfaen 001D,W01001490,1367,1230,137
2021,Torfaen 004A,W01001491,1633,1497,136
2021,Torfaen 012A,W01001492,2359,2135,224
2021,Torfaen 008A,W01001493,1753,1632,121
2021,Torfaen 008B,W01001494,1500,1346,154
2021,Torfaen 008C,W01001495,1746,1570,176
2021,Torfaen 004B,W01001496,1404,1288,116
2021,Torfaen 011A,W01001497,1346,1220,126
2021,Torfaen 011B,W01001498,1209,1074,135
2021,Torfaen 011C,W01001499,1117,982,135
2021,Torfaen 011D,W01001500,1213,1103,110
2021,Torfaen 009A,W01001501,1278,1146,132
2021,Torfaen 011E,W01001502,1175,1096,79
2021,Torfaen 009B,W01001503,1192,1083,109
2021,Torfaen 013A,W01001504,2251,2023,228
2021,Torfaen 013B,W01001505,2546,2297,249
2021,Torfaen 010A,W01001506,1479,1374,105
2021,Torfaen 008D,W01001507,1894,1729,165
2021,Torfaen 013C,W01001508,1160,1061,99
2021,Torfaen 013D,W01001509,1366,1230,136
2021,Torfaen 005A,W01001510,1556,1432,124
2021,Torfaen 005B,W01001511,1491,1372,119
2021,Torfaen 005C,W01001512,1270,1204,66
2021,Torfaen 005D,W01001513,1430,1293,137
2021,Torfaen 006A,W01001514,1054,966,88
2021,Torfaen 006B,W01001515,1366,1216,150
2021,Torfaen 006C,W01001516,1380,1265,115
2021,Torfaen 006D,W01001517,2373,2089,284
2021,Torfaen 006E,W01001518,1111,1010,101
2021,Torfaen 007A,W01001519,1236,1141,95
2021,Torfaen 007B,W01001520,2493,2208,285
2021,Torfaen 007C,W01001521,1370,1227,143
2021,Torfaen 007D,W01001522,1562,1396,166
2021,Torfaen 004C,W01001523,1376,1228,148
2021,Torfaen 004D,W01001524,1809,1657,152
2021,Torfaen 003A,W01001525,1792,1628,164
2021,Torfaen 010B,W01001526,1332,1199,133
2021,Torfaen 010C,W01001527,1151,1064,87
2021,Torfaen 010D,W01001528,1697,1515,182
2021,Torfaen 003B,W01001529,1937,1772,165
2021,Torfaen 003C,W01001530,1705,1534,171
2021,Torfaen 003D,W01001531,1621,1471,150
2021,Torfaen 010E,W01001532,1706,1541,165
2021,Torfaen 012B,W01001533,1469,1330,139
2021,Torfaen 012C,W01001534,1365,1240,125
2021,Torfaen 012D,W01001535,1221,1136,85
2021,Torfaen 009C,W01001536,1091,990,101
2021,Torfaen 007E,W01001537,1140,1026,114
2021,Torfaen 009D,W01001538,1289,1179,110
2021,Torfaen 009E,W01001539,1386,1263,123
2021,Torfaen 004E,W01001540,1229,1120,109
2021,Torfaen 004F,W01001541,1131,1001,130
2021,Monmouthshire 009A,W01001542,2067,1849,218
2021,Monmouthshire 009B,W01001543,1739,1508,231
2021,Monmouthshire 001A,W01001545,1497,1305,192
2021,Monmouthshire 002A,W01001546,1509,1347,162
2021,Monmouthshire 001B,W01001548,2049,1807,242
2021,Monmouthshire 007A,W01001549,1371,1232,139
2021,Monmouthshire 010C,W01001551,1137,1039,98
2021,Monmouthshire 004A,W01001552,1485,1354,131
2021,Monmouthshire 004C,W01001554,1510,1393,117
2021,Monmouthshire 006A,W01001555,1120,983,137
2021,Monmouthshire 006B,W01001556,1333,1173,160
2021,Monmouthshire 001C,W01001557,1771,1564,207
2021,Monmouthshire 002C,W01001558,1543,1372,171
2021,Monmouthshire 008A,W01001559,1245,1152,93
2021,Monmouthshire 006C,W01001560,1349,1231,118
2021,Monmouthshire 003A,W01001561,1560,1382,178
2021,Monmouthshire 003B,W01001562,1329,1158,171
2021,Monmouthshire 003C,W01001563,1107,993,114
2021,Monmouthshire 006D,W01001565,1780,1611,169
2021,Monmouthshire 005C,W01001568,1742,1535,207
2021,Monmouthshire 003E,W01001569,1315,1147,168
2021,Monmouthshire 001D,W01001571,1460,1268,192
2021,Monmouthshire 011A,W01001572,1576,1402,174
2021,Monmouthshire 011B,W01001573,1391,1217,174
2021,Monmouthshire 011C,W01001574,1276,1124,152
2021,Monmouthshire 005D,W01001575,1218,1100,118
2021,Monmouthshire 004D,W01001576,1042,958,84
2021,Monmouthshire 004E,W01001577,1255,1138,117
2021,Monmouthshire 009C,W01001578,2425,2223,202
2021,Monmouthshire 001E,W01001579,1540,1384,156
2021,Monmouthshire 002E,W01001580,1712,1524,188
2021,Monmouthshire 005E,W01001581,1901,1691,210
2021,Monmouthshire 011D,W01001582,1728,1543,185
2021,Monmouthshire 007B,W01001583,1491,1339,152
2021,Monmouthshire 008B,W01001584,1716,1564,152
2021,Monmouthshire 007C,W01001585,1252,1120,132
2021,Monmouthshire 007D,W01001586,2424,2164,260
2021,Monmouthshire 008C,W01001587,1818,1680,138
2021,Monmouthshire 010D,W01001588,1581,1431,150
2021,Monmouthshire 010E,W01001589,1382,1256,126
2021,Monmouthshire 009D,W01001590,2077,1878,199
2021,Monmouthshire 011E,W01001591,1534,1322,212
2021,Monmouthshire 008D,W01001592,1581,1446,135
2021,Monmouthshire 008E,W01001593,1573,1442,131
2021,Monmouthshire 007E,W01001594,1373,1230,143
2021,Monmouthshire 007F,W01001595,1262,1143,119
2021,Monmouthshire 006E,W01001596,1202,1097,105
2021,Monmouthshire 006F,W01001597,1390,1265,125
2021,Monmouthshire 010F,W01001598,1605,1444,161
2021,Monmouthshire 004F,W01001599,2084,1895,189
2021,Newport 012A,W01001600,1783,1583,200
2021,Newport 006A,W01001601,1491,1345,146
2021,Newport 012B,W01001602,1573,1385,188
2021,Newport 012C,W01001603,1481,1317,164
2021,Newport 012D,W01001604,1454,1302,152
2021,Newport 014A,W01001605,1424,1286,138
2021,Newport 008A,W01001606,1234,1103,131
2021,Newport 015A,W01001607,1304,1188,116
2021,Newport 008B,W01001608,1450,1300,150
2021,Newport 015B,W01001609,1829,1678,151
2021,Newport 015C,W01001610,1278,1169,109
2021,Newport 011A,W01001611,1163,1080,83
2021,Newport 011B,W01001612,1481,1373,108
2021,Newport 011C,W01001613,1458,1310,148
2021,Newport 005A,W01001614,1529,1405,124
2021,Newport 005B,W01001615,1528,1409,119
2021,Newport 005C,W01001616,1368,1236,132
2021,Newport 003A,W01001617,1392,1286,106
2021,Newport 003B,W01001618,1090,1007,83
2021,Newport 003C,W01001619,1308,1206,102
2021,Newport 003D,W01001620,1619,1462,157
2021,Newport 003E,W01001621,1379,1258,121
2021,Newport 003F,W01001622,1172,1089,83
2021,Newport 001A,W01001623,1382,1239,143
2021,Newport 001B,W01001624,1182,1071,111
2021,Newport 001C,W01001625,1162,1040,122
2021,Newport 001D,W01001626,1468,1293,175
2021,Newport 001E,W01001627,1574,1406,168
2021,Newport 001F,W01001628,1026,948,78
2021,Newport 017A,W01001629,1347,1261,86
2021,Newport 017B,W01001630,1585,1488,97
2021,Newport 017C,W01001631,1295,1202,93
2021,Newport 017D,W01001632,1367,1265,102
2021,Newport 019A,W01001633,1623,1499,124
2021,Newport 019B,W01001634,1440,1315,125
2021,Newport 016A,W01001635,1295,1149,146
2021,Newport 020A,W01001636,1874,1656,218
2021,Newport 016B,W01001637,2064,1849,215
2021,Newport 016C,W01001638,1182,1050,132
2021,Newport 004A,W01001639,2091,1862,229
2021,Newport 004B,W01001640,1088,1013,75
2021,Newport 004C,W01001641,1334,1194,140
2021,Newport 013A,W01001642,1588,1475,113
2021,Newport 013B,W01001643,1822,1676,146
2021,Newport 015D,W01001645,1248,1169,79
2021,Newport 015E,W01001646,1568,1422,146
2021,Newport 015G,W01001648,1509,1411,98
2021,Newport 004E,W01001650,1612,1480,132
2021,Newport 002A,W01001651,1402,1281,121
2021,Newport 002B,W01001652,1593,1497,96
2021,Newport 002C,W01001653,1327,1219,108
2021,Newport 002D,W01001654,1535,1402,133
2021,Newport 002E,W01001655,1529,1397,132
2021,Newport 020C,W01001657,1413,1253,160
2021,Newport 020D,W01001658,2018,1786,232
2021,Newport 018A,W01001659,1828,1724,104
2021,Newport 018B,W01001660,2588,2343,245
2021,Newport 018C,W01001661,2847,2627,220
2021,Newport 018D,W01001662,1628,1483,145
2021,Newport 008C,W01001663,1351,1267,84
2021,Newport 010A,W01001664,1171,1099,72
2021,Newport 008D,W01001665,1596,1463,133
2021,Newport 010B,W01001666,1453,1342,111
2021,Newport 010C,W01001667,1259,1183,76
2021,Newport 010D,W01001668,1183,1097,86
2021,Newport 009A,W01001669,1232,1113,119
2021,Newport 009B,W01001670,2227,1979,248
2021,Newport 016D,W01001671,2205,1973,232
2021,Newport 009D,W01001673,1391,1272,119
2021,Newport 009E,W01001674,1515,1382,133
2021,Newport 007A,W01001675,1524,1398,126
2021,Newport 007B,W01001676,1779,1618,161
2021,Newport 007C,W01001677,1350,1253,97
2021,Newport 005D,W01001678,1578,1442,136
2021,Newport 007D,W01001679,1080,959,121
2021,Newport 007E,W01001680,1240,1099,141
2021,Newport 006B,W01001681,1282,1169,113
2021,Newport 006C,W01001682,1352,1262,90
2021,Newport 006D,W01001683,1058,955,103
2021,Newport 006E,W01001684,1364,1225,139
2021,Newport 014B,W01001685,1641,1492,149
2021,Newport 014C,W01001686,1266,1133,133
2021,Newport 014D,W01001687,2263,2120,143
2021,Newport 019D,W01001689,2018,1796,222
2021,Newport 013D,W01001690,2106,1906,200
2021,Newport 011D,W01001691,1641,1527,114
2021,Newport 011E,W01001692,2192,2032,160
2021,Newport 013E,W01001693,2743,2586,157
2021,Cardiff 036A,W01001694,1931,1736,195
2021,Cardiff 036B,W01001695,3932,3588,344
2021,Cardiff 036C,W01001696,1478,1334,144
2021,Cardiff 036D,W01001697,1867,1639,228
2021,Cardiff 036E,W01001698,2013,1782,231
2021,Cardiff 049A,W01001699,2421,2233,188
2021,Cardiff 045A,W01001702,1721,1498,223
2021,Cardiff 045B,W01001703,1163,1062,101
2021,Cardiff 041A,W01001704,1611,1489,122
2021,Cardiff 045C,W01001705,1899,1677,222
2021,Cardiff 041B,W01001706,1338,1184,154
2021,Cardiff 041C,W01001707,1958,1723,235
2021,Cardiff 045D,W01001708,1597,1406,191
2021,Cardiff 040B,W01001710,1775,1293,482
2021,Cardiff 040C,W01001711,2025,1723,302
2021,Cardiff 040D,W01001712,1412,1040,372
2021,Cardiff 040E,W01001713,1672,1183,489
2021,Cardiff 035A,W01001714,1527,962,565
2021,Cardiff 035B,W01001715,1520,1042,478
2021,Cardiff 035C,W01001716,1242,868,374
2021,Cardiff 035D,W01001717,1470,1070,400
2021,Cardiff 028A,W01001718,1728,1484,244
2021,Cardiff 028B,W01001719,1984,1698,286
2021,Cardiff 028C,W01001720,2223,1951,272
2021,Cardiff 032A,W01001721,2875,2602,273
2021,Cardiff 028D,W01001722,1748,1549,199
2021,Cardiff 032C,W01001724,2392,2101,291
2021,Cardiff 032D,W01001725,2299,2062,237
2021,Cardiff 028E,W01001726,1761,1528,233
2021,Cardiff 014A,W01001727,1172,899,273
2021,Cardiff 014B,W01001728,1386,954,432
2021,Cardiff 014C,W01001729,2787,2295,492
2021,Cardiff 008A,W01001730,1516,1259,257
2021,Cardiff 008B,W01001731,1419,1169,250
2021,Cardiff 019A,W01001732,1697,1457,240
2021,Cardiff 019B,W01001733,1465,1259,206
2021,Cardiff 019C,W01001734,1566,1296,270
2021,Cardiff 019D,W01001735,1998,1713,285
2021,Cardiff 008C,W01001736,1457,1208,249
2021,Cardiff 039A,W01001737,1573,1424,149
2021,Cardiff 039B,W01001738,1367,1253,114
2021,Cardiff 039C,W01001739,1408,1270,138
2021,Cardiff 039D,W01001740,1449,1299,150
2021,Cardiff 039E,W01001741,1572,1459,113
2021,Cardiff 043A,W01001742,1533,1381,152
2021,Cardiff 043B,W01001743,1412,1230,182
2021,Cardiff 043C,W01001744,1646,1483,163
2021,Cardiff 043D,W01001745,1235,1094,141
2021,Cardiff 041D,W01001746,1475,1326,149
2021,Cardiff 027A,W01001747,1627,1363,264
2021,Cardiff 027B,W01001748,1507,1323,184
2021,Cardiff 027C,W01001749,1491,1292,199
2021,Cardiff 031A,W01001750,1562,1349,213
2021,Cardiff 027D,W01001751,1731,1520,211
2021,Cardiff 031B,W01001752,1541,1301,240
2021,Cardiff 031C,W01001753,1589,1400,189
2021,Cardiff 031D,W01001754,1563,1308,255
2021,Cardiff 025A,W01001755,1447,1177,270
2021,Cardiff 025B,W01001756,4208,3750,458
2021,Cardiff 025C,W01001757,1420,1164,256
2021,Cardiff 025D,W01001758,2141,1782,359
2021,Cardiff 046A,W01001759,1531,1326,205
2021,Cardiff 046B,W01001760,1596,1392,204
2021,Cardiff 046C,W01001761,1711,1427,284
2021,Cardiff 046D,W01001762,1757,1569,188
2021,Cardiff 044A,W01001764,1961,1723,238
2021,Cardiff 044B,W01001765,1389,1219,170
2021,Cardiff 044C,W01001766,1627,1387,240
2021,Cardiff 044D,W01001767,1756,1520,236
2021,Cardiff 044E,W01001768,1605,1403,202
2021,Cardiff 018A,W01001769,1539,1209,330
2021,Cardiff 018B,W01001770,1013,826,187
2021,Cardiff 018C,W01001771,1612,1293,319
2021,Cardiff 021A,W01001772,1361,1141,220
2021,Cardiff 012A,W01001773,2463,2121,342
2021,Cardiff 018D,W01001774,1359,1080,279
2021,Cardiff 021B,W01001775,1550,1329,221
2021,Cardiff 021C,W01001776,1258,1079,179
2021,Cardiff 001A,W01001777,1714,1432,282
2021,Cardiff 001B,W01001778,1714,1431,283
2021,Cardiff 026A,W01001779,1472,1171,301
2021,Cardiff 026B,W01001780,1607,1232,375
2021,Cardiff 026C,W01001781,1638,1185,453
2021,Cardiff 026D,W01001782,1416,1067,349
2021,Cardiff 026E,W01001783,1183,1027,156
2021,Cardiff 026F,W01001784,1280,1084,196
2021,Cardiff 023A,W01001785,1169,1013,156
2021,Cardiff 023B,W01001786,1437,1146,291
2021,Cardiff 023C,W01001787,1339,1167,172
2021,Cardiff 023D,W01001788,1538,1346,192
2021,Cardiff 023E,W01001789,1497,1137,360
2021,Cardiff 023F,W01001790,1179,1029,150
2021,Cardiff 005A,W01001791,1772,1439,333
2021,Cardiff 005B,W01001792,1566,1401,165
2021,Cardiff 002A,W01001793,1315,1099,216
2021,Cardiff 001C,W01001794,1297,1099,198
2021,Cardiff 002B,W01001795,1456,1210,246
2021,Cardiff 002C,W01001796,1392,1159,233
2021,Cardiff 005C,W01001797,1390,1182,208
2021,Cardiff 002D,W01001798,1359,1147,212
2021,Cardiff 001D,W01001799,1241,1003,238
2021,Cardiff 005D,W01001800,1371,1173,198
2021,Cardiff 007A,W01001802,1656,1540,116
2021,Cardiff 015A,W01001803,1617,1477,140
2021,Cardiff 015B,W01001804,1538,1374,164
2021,Cardiff 015C,W01001805,1495,1307,188
2021,Cardiff 015D,W01001806,1668,1428,240
2021,Cardiff 007B,W01001807,1592,1449,143
2021,Cardiff 007C,W01001808,1659,1528,131
2021,Cardiff 017A,W01001809,1185,1051,134
2021,Cardiff 017B,W01001810,1681,1534,147
2021,Cardiff 009A,W01001811,1521,1369,152
2021,Cardiff 017C,W01001812,1236,1135,101
2021,Cardiff 017D,W01001813,1771,1573,198
2021,Cardiff 017E,W01001814,1401,1271,130
2021,Cardiff 008D,W01001815,1351,1226,125
2021,Cardiff 009B,W01001816,2674,2368,306
2021,Cardiff 009C,W01001817,1346,1197,149
2021,Cardiff 009D,W01001818,1503,1331,172
2021,Cardiff 014D,W01001819,2327,1746,581
2021,Cardiff 006A,W01001820,1170,860,310
2021,Cardiff 024A,W01001821,1693,1483,210
2021,Cardiff 029A,W01001822,1797,1498,299
2021,Cardiff 029B,W01001823,1232,959,273
2021,Cardiff 029C,W01001824,1510,1277,233
2021,Cardiff 029D,W01001825,1909,1568,341
2021,Cardiff 024B,W01001826,1343,1076,267
2021,Cardiff 024C,W01001827,1608,1348,260
2021,Cardiff 024D,W01001828,1472,1196,276
2021,Cardiff 033A,W01001829,1963,1766,197
2021,Cardiff 033B,W01001830,1595,1408,187
2021,Cardiff 030A,W01001831,1457,1231,226
2021,Cardiff 033C,W01001832,1743,1568,175
2021,Cardiff 033D,W01001833,1500,1227,273
2021,Cardiff 033E,W01001834,1609,1405,204
2021,Cardiff 033F,W01001835,2161,1933,228
2021,Cardiff 030B,W01001836,1303,1079,224
2021,Cardiff 030C,W01001837,1439,1283,156
2021,Cardiff 030D,W01001838,1596,1352,244
2021,Cardiff 030E,W01001839,1554,1349,205
2021,Cardiff 007D,W01001840,1885,1712,173
2021,Cardiff 003A,W01001841,1859,1634,225
2021,Cardiff 003B,W01001842,1696,1440,256
2021,Cardiff 003D,W01001844,1832,1587,245
2021,Cardiff 006C,W01001846,1699,1349,350
2021,Cardiff 006D,W01001847,1508,1261,247
2021,Cardiff 012B,W01001848,1416,1131,285
2021,Cardiff 004A,W01001849,1518,1254,264
2021,Cardiff 012C,W01001850,1868,1460,408
2021,Cardiff 012D,W01001851,1519,1281,238
2021,Cardiff 004B,W01001852,1826,1465,361
2021,Cardiff 004C,W01001853,1569,1350,219
2021,Cardiff 004D,W01001854,1498,1266,232
2021,Cardiff 042A,W01001855,1728,1503,225
2021,Cardiff 042B,W01001856,1661,1537,124
2021,Cardiff 042C,W01001857,2014,1812,202
2021,Cardiff 034A,W01001858,1556,1184,372
2021,Cardiff 034B,W01001859,1462,1050,412
2021,Cardiff 034C,W01001860,1615,1206,409
2021,Cardiff 034D,W01001861,1501,1090,411
2021,Cardiff 042D,W01001862,1805,1613,192
2021,Cardiff 022A,W01001863,1457,1287,170
2021,Cardiff 022B,W01001864,1432,1312,120
2021,Cardiff 022C,W01001865,1256,1087,169
2021,Cardiff 016A,W01001866,1520,1389,131
2021,Cardiff 016B,W01001867,1366,1221,145
2021,Cardiff 022D,W01001868,1470,1350,120
2021,Cardiff 038A,W01001869,1347,1173,174
2021,Cardiff 037A,W01001870,1404,1192,212
2021,Cardiff 037B,W01001871,1586,1412,174
2021,Cardiff 038B,W01001872,1555,1361,194
2021,Cardiff 038C,W01001873,1759,1529,230
2021,Cardiff 038D,W01001874,1467,1281,186
2021,Cardiff 037D,W01001876,1570,1414,156
2021,Cardiff 011A,W01001877,1769,1552,217
2021,Cardiff 011B,W01001878,1520,1360,160
2021,Cardiff 013A,W01001879,1831,1672,159
2021,Cardiff 013B,W01001880,1585,1433,152
2021,Cardiff 013C,W01001881,1423,1297,126
2021,Cardiff 011C,W01001882,1679,1476,203
2021,Cardiff 016C,W01001883,1609,1450,159
2021,Cardiff 013D,W01001884,1377,1224,153
2021,Cardiff 011D,W01001885,2495,2203,292
2021,Cardiff 016D,W01001886,1274,1139,135
2021,Cardiff 020A,W01001887,1579,1021,558
2021,Cardiff 010A,W01001888,1604,1248,356
2021,Cardiff 020B,W01001889,1433,1182,251
2021,Cardiff 021D,W01001890,1522,1317,205
2021,Cardiff 020C,W01001891,1588,1265,323
2021,Cardiff 020D,W01001892,1386,1133,253
2021,Cardiff 010B,W01001893,1781,1501,280
2021,Cardiff 010C,W01001894,1483,1188,295
2021,Cardiff 010D,W01001895,1589,1265,324
2021,Cardiff 020E,W01001896,1415,1003,412
2021,Powys 020D,W01001897,1831,1479,352
2021,Merthyr Tydfil 008F,W01001898,1428,1240,188
2021,Powys 021F,W01001899,2136,1181,955
2021,Neath Port Talbot 020G,W01001900,1373,788,585
2021,Powys 017F,W01001901,1773,1482,291
2021,Powys 017G,W01001902,1344,1165,179
2021,Powys 018F,W01001903,2066,1792,274
2021,Powys 018G,W01001904,1614,1405,209
2021,Powys 018H,W01001905,2107,1755,352
2021,Powys 001F,W01001906,1907,1035,872
2021,Powys 001G,W01001907,1346,888,458
2021,Monmouthshire 010G,W01001908,2073,1878,195
2021,Vale of Glamorgan 012G,W01001910,1602,1380,222
2021,Vale of Glamorgan 012H,W01001911,1102,966,136
2021,Newport 020E,W01001912,1485,1360,125
2021,Newport 020F,W01001913,1407,1226,181
2021,Rhondda Cynon Taf 023F,W01001914,1870,1502,368
2021,Rhondda Cynon Taf 027F,W01001915,1599,1199,400
2021,Rhondda Cynon Taf 027G,W01001916,1448,1009,439
2021,Rhondda Cynon Taf 023G,W01001917,1427,1260,167
2021,Bridgend 017E,W01001918,1818,1541,277
2021,Bridgend 017F,W01001919,1329,1136,193
2021,Bridgend 017G,W01001920,1166,986,180
2021,Bridgend 017H,W01001921,1477,1285,192
2021,Cardiff 032E,W01001922,2009,1795,214
2021,Carmarthenshire 026G,W01001923,1690,1135,555
2021,Carmarthenshire 026H,W01001924,1324,990,334
2021,Carmarthenshire 023F,W01001925,2139,1225,914
2021,Conwy 011F,W01001926,2064,1160,904
2021,Conwy 010G,W01001927,1312,1084,228
2021,Conwy 010H,W01001928,1059,896,163
2021,Wrexham 012F,W01001929,1131,1028,103
2021,Wrexham 019F,W01001930,2026,1252,774
2021,Wrexham 012G,W01001931,1367,1219,148
2021,Gwynedd 014E,W01001932,2694,636,2058
2021,Gwynedd 017F,W01001933,1878,963,915
2021,Ceredigion 003E,W01001935,1004,504,500
2021,Ceredigion 003F,W01001936,1435,912,523
2021,Ceredigion 001F,W01001937,1916,962,954
2021,Cardiff 048A,W01001940,1028,893,135
2021,Cardiff 049B,W01001942,1536,1360,176
2021,Cardiff 048B,W01001943,1162,995,167
2021,Cardiff 048C,W01001944,1152,975,177
2021,Cardiff 049C,W01001946,1282,1143,139
2021,Cardiff 048E,W01001947,1656,1452,204
2021,Cardiff 006E,W01001948,2184,1757,427
2021,Cardiff 005F,W01001949,1269,1094,175
2021,Cardiff 049D,W01001950,1131,996,135
2021,Cardiff 049E,W01001951,1498,1298,200
2021,Cardiff 049F,W01001952,1847,1699,148
2021,Cardiff 005G,W01001953,1457,1188,269
2021,Cardiff 006F,W01001954,1501,1193,308
2021,Swansea 025F,W01001955,1905,1765,140
2021,Swansea 032C,W01001956,2196,1919,277
2021,Swansea 025H,W01001958,1285,1137,148
2021,Merthyr Tydfil 005E,W01001959,1499,1303,196
2021,Merthyr Tydfil 005F,W01001960,1395,1178,217
2021,Merthyr Tydfil 006G,W01001961,2281,1946,335
2021,Rhondda Cynon Taf 011E,W01001962,2391,2036,355
2021,Rhondda Cynon Taf 014H,W01001963,2189,1927,262
2021,Rhondda Cynon Taf 021H,W01001964,2197,1868,329
2021,Rhondda Cynon Taf 029E,W01001965,1653,1357,296
2021,Rhondda Cynon Taf 029F,W01001966,1650,1259,391
2021,Rhondda Cynon Taf 031G,W01001967,1453,1116,337
2021,Rhondda Cynon Taf 031H,W01001968,1438,1110,328
2021,Wrexham 010F,W01001969,2210,1924,286
2021,Wrexham 021C,W01001970,2109,1819,290
2021,Wrexham 022D,W01001971,2637,2393,244
2021,Wrexham 022E,W01001972,1271,1080,191
2021,Blaenau Gwent 009F,W01001973,2190,2031,159
2021,Monmouthshire 002G,W01001974,1369,1228,141
2021,Monmouthshire 002H,W01001975,1272,1130,142
2021,Monmouthshire 003F,W01001976,1569,1407,162
2021,Monmouthshire 003G,W01001977,1406,1254,152
2021,Monmouthshire 004G,W01001978,1455,1315,140
2021,Monmouthshire 004H,W01001979,1965,1749,216
2021,Monmouthshire 005F,W01001980,2154,1937,217
2021,Bridgend 011D,W01001981,2890,2517,373
2021,Bridgend 011E,W01001982,1269,1068,201
2021,Bridgend 011F,W01001983,1404,1146,258
2021,Bridgend 011G,W01001984,1134,959,175
2021,Neath Port Talbot 006F,W01001985,2005,1589,416
2021,Neath Port Talbot 007E,W01001986,2383,1993,390
2021,Neath Port Talbot 010G,W01001987,1439,1202,237
2021,Neath Port Talbot 010H,W01001988,1408,1127,281
2021,Neath Port Talbot 010I,W01001989,3364,2994,370
2021,Neath Port Talbot 021E,W01001990,2085,1866,219
2021,Swansea 005G,W01001991,1360,1098,262
2021,Swansea 005H,W01001992,1381,1134,247
2021,Swansea 006E,W01001993,1642,1271,371
2021,Swansea 006F,W01001994,1427,1178,249
2021,Swansea 021E,W01001995,1329,1198,131
2021,Swansea 021F,W01001996,1388,1234,154
2021,Swansea 025I,W01001997,1958,1734,224
2021,Vale of Glamorgan 015G,W01001998,2156,1901,255
2021,Carmarthenshire 019F,W01001999,2427,1413,1014
2021,Ceredigion 002G,W01002000,2896,2155,741
2021,Ceredigion 002H,W01002001,1406,1086,320
2021,Ceredigion 007E,W01002002,4232,2065,2167
2021,Gwynedd 013E,W01002003,2337,1107,1230
2021,Gwynedd 016F,W01002004,2099,1018,1081
2021,Isle of Anglesey 002E,W01002005,2190,832,1358
2021,Isle of Anglesey 004G,W01002007,2164,858,1306
2021,Isle of Anglesey 007F,W01002008,2047,890,1157
2021,Pembrokeshire 005E,W01002009,1174,963,211
2021,Pembrokeshire 005F,W01002010,1076,899,177
2021,Pembrokeshire 010D,W01002011,1528,1350,178
2021,Pembrokeshire 010E,W01002012,1393,1256,137
2021,Pembrokeshire 011G,W01002013,2322,1987,335
2021,Pembrokeshire 016E,W01002014,2049,1752,297
2021,Cardiff 003E,W01002016,1155,998,157
2021,Cardiff 003F,W01002017,1297,1096,201
2021,Cardiff 003G,W01002018,1480,1246,234
2021,Cardiff 032H,W01002019,2584,2365,219
2021,Cardiff 037E,W01002020,1503,1345,158
2021,Cardiff 037F,W01002021,1442,1268,174
2021,Cardiff 040F,W01002022,1150,829,321
2021,Cardiff 040G,W01002023,1750,1322,428
2021,Cardiff 048F,W01002024,1089,969,120
2021,Cardiff 048G,W01002025,1074,934,140
2021,Newport 004F,W01002026,1745,1570,175
2021,Newport 004G,W01002027,1734,1605,129
2021,Newport 009F,W01002028,1891,1702,189
2021,Newport 009G,W01002029,1635,1434,201
2021,Newport 013F,W01002030,1358,1241,117
2021,Newport 013G,W01002031,1605,1433,172
2021,Newport 015H,W01002032,1248,1165,83
2021,Newport 015I,W01002033,1333,1218,115
2021,Newport 019E,W01002034,1631,1453,178
2021,Newport 019F,W01002035,1528,1357,171
2021,Vale of Glamorgan 005G,W01002036,1505,1300,205
2021,Vale of Glamorgan 005H,W01002037,1042,860,182
2021,Vale of Glamorgan 014G,W01002038,1239,1078,161
2021,Vale of Glamorgan 014H,W01002039,1681,1365,316
2021,Vale of Glamorgan 015F,W01002040,1821,1540,281
