date,geography,geography code,Welsh writing ability: Total: All usual residents aged 3 years and over,Welsh writing ability: Cannot write Welsh,Welsh writing ability: Can write Welsh
2021,Isle of Anglesey 001A,W01000003,2370,1212,1158
2021,Isle of Anglesey 001B,W01000004,1229,705,524
2021,Isle of Anglesey 005A,W01000005,1585,1149,436
2021,Isle of Anglesey 006A,W01000006,1494,537,957
2021,Isle of Anglesey 009A,W01000007,1738,760,978
2021,Isle of Anglesey 008A,W01000008,1417,522,895
2021,Isle of Anglesey 007C,W01000009,1818,713,1105
2021,Isle of Anglesey 002A,W01000010,1775,1031,744
2021,Isle of Anglesey 008B,W01000011,999,621,378
2021,Isle of Anglesey 006B,W01000012,1656,593,1063
2021,Isle of Anglesey 005B,W01000013,2130,1093,1037
2021,Isle of Anglesey 006C,W01000014,2128,615,1513
2021,Isle of Anglesey 008C,W01000015,1431,577,854
2021,Isle of Anglesey 003A,W01000016,1157,827,330
2021,Isle of Anglesey 003B,W01000017,1635,1043,592
2021,Isle of Anglesey 001C,W01000018,1149,700,449
2021,Isle of Anglesey 005C,W01000019,1325,881,444
2021,Isle of Anglesey 002C,W01000021,2266,1240,1026
2021,Isle of Anglesey 004A,W01000022,1576,725,851
2021,Isle of Anglesey 007D,W01000023,1525,638,887
2021,Isle of Anglesey 007E,W01000024,1293,885,408
2021,Isle of Anglesey 009B,W01000025,2097,691,1406
2021,Isle of Anglesey 005D,W01000026,1229,784,445
2021,Isle of Anglesey 009C,W01000027,1812,828,984
2021,Isle of Anglesey 001D,W01000028,1921,772,1149
2021,Isle of Anglesey 003C,W01000029,1541,1021,520
2021,Isle of Anglesey 003D,W01000030,2236,1554,682
2021,Isle of Anglesey 001E,W01000031,1512,764,748
2021,Isle of Anglesey 003E,W01000033,1504,1110,394
2021,Isle of Anglesey 004B,W01000034,1400,898,502
2021,Isle of Anglesey 005E,W01000035,1743,953,790
2021,Isle of Anglesey 003F,W01000036,1070,807,263
2021,Isle of Anglesey 003G,W01000037,1126,784,342
2021,Isle of Anglesey 009D,W01000038,2178,1007,1171
2021,Isle of Anglesey 004D,W01000040,1041,761,280
2021,Isle of Anglesey 006D,W01000041,1529,571,958
2021,Isle of Anglesey 008D,W01000042,1982,1042,940
2021,Isle of Anglesey 004F,W01000044,1070,635,435
2021,Gwynedd 011A,W01000047,1233,333,900
2021,Gwynedd 003A,W01000050,1397,717,680
2021,Gwynedd 015A,W01000051,1945,689,1256
2021,Gwynedd 004A,W01000052,1061,208,853
2021,Gwynedd 004B,W01000053,1144,455,689
2021,Gwynedd 007A,W01000054,989,241,748
2021,Gwynedd 009A,W01000056,1718,536,1182
2021,Gwynedd 016C,W01000057,1358,615,743
2021,Gwynedd 006A,W01000059,2028,569,1459
2021,Gwynedd 015B,W01000060,1227,703,524
2021,Gwynedd 011B,W01000061,1698,802,896
2021,Gwynedd 001A,W01000062,1964,1637,327
2021,Gwynedd 005A,W01000063,1847,663,1184
2021,Gwynedd 002A,W01000064,1943,1137,806
2021,Gwynedd 009B,W01000065,995,335,660
2021,Gwynedd 010A,W01000066,1143,485,658
2021,Gwynedd 016D,W01000067,1165,554,611
2021,Gwynedd 016E,W01000068,1374,660,714
2021,Gwynedd 012A,W01000070,1263,417,846
2021,Gwynedd 003B,W01000071,2174,760,1414
2021,Gwynedd 002B,W01000072,1633,900,733
2021,Gwynedd 008A,W01000073,1620,445,1175
2021,Gwynedd 013B,W01000074,1770,921,849
2021,Gwynedd 002C,W01000075,1369,972,397
2021,Gwynedd 001B,W01000076,1273,924,349
2021,Gwynedd 001C,W01000077,1146,823,323
2021,Gwynedd 011C,W01000078,1517,551,966
2021,Gwynedd 014C,W01000080,1424,709,715
2021,Gwynedd 005B,W01000081,1958,723,1235
2021,Gwynedd 015C,W01000082,1067,433,634
2021,Gwynedd 015D,W01000083,1318,326,992
2021,Gwynedd 014D,W01000084,1047,455,592
2021,Gwynedd 017C,W01000085,1889,1259,630
2021,Gwynedd 008B,W01000086,2113,740,1373
2021,Gwynedd 004C,W01000087,1778,365,1413
2021,Gwynedd 007B,W01000088,2009,519,1490
2021,Gwynedd 011D,W01000089,1869,562,1307
2021,Gwynedd 002D,W01000090,1315,774,541
2021,Gwynedd 001D,W01000091,1048,647,401
2021,Gwynedd 001E,W01000092,3035,2404,631
2021,Gwynedd 006B,W01000093,2184,594,1590
2021,Gwynedd 012B,W01000094,1186,378,808
2021,Gwynedd 012C,W01000095,1261,393,868
2021,Gwynedd 003C,W01000096,1218,315,903
2021,Gwynedd 003D,W01000097,1105,371,734
2021,Gwynedd 006C,W01000098,2422,675,1747
2021,Gwynedd 005C,W01000099,1617,616,1001
2021,Gwynedd 010B,W01000100,1034,374,660
2021,Gwynedd 013D,W01000101,1330,424,906
2021,Gwynedd 002E,W01000102,1832,886,946
2021,Gwynedd 005D,W01000103,1141,583,558
2021,Gwynedd 008C,W01000104,1745,420,1325
2021,Gwynedd 010C,W01000105,1689,512,1177
2021,Gwynedd 010D,W01000106,1475,748,727
2021,Gwynedd 010E,W01000107,1167,483,684
2021,Gwynedd 012D,W01000108,2032,608,1424
2021,Gwynedd 012E,W01000109,1815,598,1217
2021,Gwynedd 006D,W01000110,1544,308,1236
2021,Gwynedd 007C,W01000111,1530,511,1019
2021,Gwynedd 008D,W01000112,1877,708,1169
2021,Gwynedd 009C,W01000113,1793,577,1216
2021,Gwynedd 009D,W01000114,1378,430,948
2021,Gwynedd 003E,W01000115,2066,842,1224
2021,Gwynedd 017D,W01000116,1650,1160,490
2021,Gwynedd 017E,W01000117,1437,975,462
2021,Gwynedd 007D,W01000118,1653,548,1105
2021,Gwynedd 004D,W01000119,2257,885,1372
2021,Conwy 015A,W01000121,1126,668,458
2021,Conwy 014A,W01000122,1916,1235,681
2021,Conwy 013A,W01000123,1700,1119,581
2021,Conwy 012A,W01000124,1906,1309,597
2021,Conwy 013B,W01000125,1494,1148,346
2021,Conwy 009A,W01000126,1641,1346,295
2021,Conwy 009B,W01000127,1334,1172,162
2021,Conwy 009C,W01000128,1452,1218,234
2021,Conwy 012B,W01000129,1151,945,206
2021,Conwy 012C,W01000130,1389,1135,254
2021,Conwy 012D,W01000131,1624,1179,445
2021,Conwy 001A,W01000132,1500,1282,218
2021,Conwy 002A,W01000133,1754,1478,276
2021,Conwy 015B,W01000134,1990,1049,941
2021,Conwy 006A,W01000135,1965,1665,300
2021,Conwy 006B,W01000136,1722,1414,308
2021,Conwy 015C,W01000137,1509,790,719
2021,Conwy 008A,W01000138,1891,1522,369
2021,Conwy 007A,W01000139,1574,1264,310
2021,Conwy 010B,W01000140,1721,1376,345
2021,Conwy 010C,W01000141,1500,1259,241
2021,Conwy 010D,W01000142,1493,1183,310
2021,Conwy 007B,W01000143,1524,1256,268
2021,Conwy 007C,W01000144,1594,1384,210
2021,Conwy 008B,W01000145,1259,1026,233
2021,Conwy 001B,W01000146,2002,1761,241
2021,Conwy 001C,W01000147,1473,1280,193
2021,Conwy 015D,W01000148,1046,512,534
2021,Conwy 005A,W01000149,1456,1349,107
2021,Conwy 005B,W01000150,1451,1295,156
2021,Conwy 005C,W01000151,1474,1331,143
2021,Conwy 005D,W01000152,1383,1256,127
2021,Conwy 009D,W01000153,1571,1325,246
2021,Conwy 003A,W01000154,1375,1168,207
2021,Conwy 004A,W01000155,1381,1188,193
2021,Conwy 004B,W01000156,1470,1293,177
2021,Conwy 004C,W01000157,1378,1222,156
2021,Conwy 004D,W01000158,1530,1299,231
2021,Conwy 014B,W01000159,1388,596,792
2021,Conwy 014C,W01000162,1771,816,955
2021,Conwy 009E,W01000163,1325,1143,182
2021,Conwy 009F,W01000164,1315,1095,220
2021,Conwy 006C,W01000165,1829,1445,384
2021,Conwy 006D,W01000166,2662,2078,584
2021,Conwy 011C,W01000167,1933,1610,323
2021,Conwy 002B,W01000168,1776,1519,257
2021,Conwy 001D,W01000169,1737,1506,231
2021,Conwy 013C,W01000170,1753,1126,627
2021,Conwy 013D,W01000171,1452,1098,354
2021,Conwy 013E,W01000172,1220,900,320
2021,Conwy 003B,W01000173,1418,1170,248
2021,Conwy 003C,W01000174,1557,1279,278
2021,Conwy 003D,W01000175,1502,1266,236
2021,Conwy 011D,W01000176,1556,1207,349
2021,Conwy 011E,W01000177,1392,1085,307
2021,Conwy 010E,W01000178,1949,1597,352
2021,Conwy 010F,W01000179,1948,1607,341
2021,Conwy 008C,W01000180,1477,1236,241
2021,Conwy 008D,W01000181,1425,1170,255
2021,Conwy 007D,W01000182,2036,1782,254
2021,Conwy 008E,W01000183,1442,1233,209
2021,Conwy 005E,W01000184,2222,2018,204
2021,Conwy 015E,W01000185,1205,797,408
2021,Conwy 001E,W01000186,1552,1325,227
2021,Conwy 002C,W01000187,1465,1233,232
2021,Conwy 002D,W01000188,1549,1312,237
2021,Conwy 015F,W01000189,1428,631,797
2021,Conwy 014D,W01000190,1359,537,822
2021,Denbighshire 009A,W01000191,2027,1757,270
2021,Denbighshire 016A,W01000192,975,656,319
2021,Denbighshire 015A,W01000193,1220,824,396
2021,Denbighshire 011A,W01000194,1848,1435,413
2021,Denbighshire 012A,W01000195,1412,860,552
2021,Denbighshire 012B,W01000196,1360,938,422
2021,Denbighshire 012C,W01000197,1647,1160,487
2021,Denbighshire 011B,W01000198,1323,1080,243
2021,Denbighshire 011C,W01000199,1661,1196,465
2021,Denbighshire 008A,W01000200,1256,1058,198
2021,Denbighshire 008B,W01000201,1667,1480,187
2021,Denbighshire 015B,W01000202,1597,927,670
2021,Denbighshire 013A,W01000203,2388,1969,419
2021,Denbighshire 013B,W01000204,1424,1032,392
2021,Denbighshire 016B,W01000205,1172,611,561
2021,Denbighshire 013C,W01000206,2171,1524,647
2021,Denbighshire 015C,W01000207,2243,1390,853
2021,Denbighshire 016C,W01000208,1257,1077,180
2021,Denbighshire 016D,W01000209,1373,1158,215
2021,Denbighshire 016E,W01000210,1306,1080,226
2021,Denbighshire 012D,W01000211,1761,1034,727
2021,Denbighshire 003A,W01000212,2132,1771,361
2021,Denbighshire 002A,W01000213,1278,1127,151
2021,Denbighshire 002B,W01000214,1124,1006,118
2021,Denbighshire 002C,W01000215,1437,1239,198
2021,Denbighshire 002D,W01000216,1258,1115,143
2021,Denbighshire 008C,W01000217,1948,1697,251
2021,Denbighshire 001A,W01000218,1548,1394,154
2021,Denbighshire 001B,W01000219,2546,2254,292
2021,Denbighshire 001C,W01000220,1611,1489,122
2021,Denbighshire 003B,W01000221,1305,1163,142
2021,Denbighshire 003C,W01000222,1749,1536,213
2021,Denbighshire 009B,W01000223,1272,1103,169
2021,Denbighshire 009C,W01000224,1521,1304,217
2021,Denbighshire 009D,W01000225,1403,1204,199
2021,Denbighshire 004A,W01000226,1485,1366,119
2021,Denbighshire 004B,W01000227,1454,1309,145
2021,Denbighshire 004C,W01000228,1596,1448,148
2021,Denbighshire 017E,W01000229,1496,1305,191
2021,Denbighshire 017F,W01000230,1866,1608,258
2021,Denbighshire 017A,W01000231,1297,1153,144
2021,Denbighshire 017B,W01000232,1584,1383,201
2021,Denbighshire 017C,W01000233,1261,1123,138
2021,Denbighshire 017G,W01000234,2182,1927,255
2021,Denbighshire 017D,W01000235,1290,1106,184
2021,Denbighshire 006A,W01000236,1902,1675,227
2021,Denbighshire 006B,W01000237,1704,1569,135
2021,Denbighshire 006C,W01000238,1734,1535,199
2021,Denbighshire 004D,W01000239,1652,1522,130
2021,Denbighshire 004E,W01000240,1590,1458,132
2021,Denbighshire 004F,W01000241,1449,1308,141
2021,Denbighshire 014A,W01000242,1909,1389,520
2021,Denbighshire 014B,W01000243,2047,1469,578
2021,Denbighshire 014C,W01000244,1567,898,669
2021,Denbighshire 010A,W01000245,1795,1439,356
2021,Denbighshire 010B,W01000246,1600,1369,231
2021,Denbighshire 010C,W01000247,1781,1362,419
2021,Denbighshire 008D,W01000248,1600,1251,349
2021,Flintshire 014A,W01000249,1166,1043,123
2021,Flintshire 014B,W01000250,1396,1229,167
2021,Flintshire 013A,W01000251,1503,1397,106
2021,Flintshire 010A,W01000252,1602,1495,107
2021,Flintshire 003A,W01000253,1787,1625,162
2021,Flintshire 003B,W01000254,2051,1866,185
2021,Flintshire 015A,W01000255,2207,2067,140
2021,Flintshire 015B,W01000256,1499,1401,98
2021,Flintshire 015C,W01000257,2610,2482,128
2021,Flintshire 006A,W01000258,2062,1799,263
2021,Flintshire 017A,W01000259,1628,1489,139
2021,Flintshire 017B,W01000260,1673,1535,138
2021,Flintshire 014C,W01000261,1378,1263,115
2021,Flintshire 017C,W01000262,1377,1277,100
2021,Flintshire 017D,W01000263,1298,1223,75
2021,Flintshire 012A,W01000264,1664,1510,154
2021,Flintshire 012B,W01000265,1447,1335,112
2021,Flintshire 017E,W01000266,1597,1442,155
2021,Flintshire 017F,W01000267,1978,1819,159
2021,Flintshire 013B,W01000268,1618,1471,147
2021,Flintshire 020A,W01000269,1522,1381,141
2021,Flintshire 006B,W01000270,1217,1027,190
2021,Flintshire 006C,W01000271,1217,1025,192
2021,Flintshire 006D,W01000272,1757,1504,253
2021,Flintshire 007A,W01000273,1499,1397,102
2021,Flintshire 007B,W01000274,1836,1730,106
2021,Flintshire 007C,W01000275,1159,1087,72
2021,Flintshire 008A,W01000276,1165,1070,95
2021,Flintshire 008B,W01000277,1327,1209,118
2021,Flintshire 007D,W01000278,1418,1333,85
2021,Flintshire 008C,W01000279,1151,1076,75
2021,Flintshire 010B,W01000280,1686,1567,119
2021,Flintshire 008D,W01000281,1142,1062,80
2021,Flintshire 010C,W01000282,1589,1465,124
2021,Flintshire 008E,W01000283,2252,2125,127
2021,Flintshire 013C,W01000284,1685,1551,134
2021,Flintshire 013D,W01000285,1566,1459,107
2021,Flintshire 013E,W01000286,2131,1921,210
2021,Flintshire 001A,W01000287,1821,1583,238
2021,Flintshire 004A,W01000288,2113,1934,179
2021,Flintshire 005A,W01000289,1300,1172,128
2021,Flintshire 004B,W01000290,1240,1144,96
2021,Flintshire 005B,W01000291,1265,1150,115
2021,Flintshire 004C,W01000292,1419,1291,128
2021,Flintshire 004D,W01000293,2558,2317,241
2021,Flintshire 005C,W01000294,1844,1659,185
2021,Flintshire 005D,W01000295,1536,1404,132
2021,Flintshire 003C,W01000296,1490,1353,137
2021,Flintshire 003D,W01000297,1195,1066,129
2021,Flintshire 001B,W01000298,1439,1257,182
2021,Flintshire 019A,W01000299,1860,1644,216
2021,Flintshire 019B,W01000300,1592,1357,235
2021,Flintshire 006E,W01000301,1688,1444,244
2021,Flintshire 013F,W01000302,1895,1747,148
2021,Flintshire 018A,W01000303,1682,1533,149
2021,Flintshire 003E,W01000304,2008,1827,181
2021,Flintshire 003F,W01000305,1854,1635,219
2021,Flintshire 002A,W01000306,2360,2077,283
2021,Flintshire 020B,W01000307,1392,1264,128
2021,Flintshire 020C,W01000308,1158,1035,123
2021,Flintshire 019C,W01000309,2058,1863,195
2021,Flintshire 020D,W01000310,1851,1606,245
2021,Flintshire 011A,W01000311,1634,1536,98
2021,Flintshire 011B,W01000312,1567,1485,82
2021,Flintshire 016A,W01000313,1554,1317,237
2021,Flintshire 016B,W01000314,1100,956,144
2021,Flintshire 016C,W01000315,1905,1655,250
2021,Flintshire 016D,W01000316,1199,935,264
2021,Flintshire 016E,W01000317,1563,1174,389
2021,Flintshire 016F,W01000318,1162,1063,99
2021,Flintshire 016G,W01000319,1396,1207,189
2021,Flintshire 002B,W01000320,1831,1621,210
2021,Flintshire 014D,W01000321,1598,1439,159
2021,Flintshire 014E,W01000322,1344,1199,145
2021,Flintshire 012C,W01000323,1536,1364,172
2021,Flintshire 012D,W01000324,1471,1286,185
2021,Flintshire 010D,W01000325,1761,1603,158
2021,Flintshire 018B,W01000326,2152,1934,218
2021,Flintshire 018C,W01000327,2385,2180,205
2021,Flintshire 011C,W01000328,1866,1769,97
2021,Flintshire 015D,W01000329,1555,1487,68
2021,Flintshire 015E,W01000330,2016,1946,70
2021,Flintshire 015F,W01000331,1421,1359,62
2021,Flintshire 009A,W01000332,1765,1666,99
2021,Flintshire 009B,W01000333,1425,1350,75
2021,Flintshire 009C,W01000334,1701,1595,106
2021,Flintshire 009D,W01000335,1144,1079,65
2021,Flintshire 009E,W01000336,1388,1289,99
2021,Flintshire 009F,W01000337,2095,1952,143
2021,Flintshire 001C,W01000338,1725,1453,272
2021,Flintshire 019D,W01000339,1636,1352,284
2021,Flintshire 002C,W01000340,2189,1877,312
2021,Wrexham 023C,W01000341,1508,1382,126
2021,Wrexham 023E,W01000342,1487,1358,129
2021,Wrexham 023B,W01000343,1010,917,93
2021,Wrexham 023A,W01000344,1221,1111,110
2021,Wrexham 018A,W01000345,1559,1459,100
2021,Wrexham 018B,W01000346,1461,1388,73
2021,Wrexham 006A,W01000347,2701,2372,329
2021,Wrexham 006B,W01000348,1374,1263,111
2021,Wrexham 011A,W01000349,2203,1957,246
2021,Wrexham 011B,W01000350,1759,1605,154
2021,Wrexham 005A,W01000351,1998,1793,205
2021,Wrexham 017A,W01000354,1604,1451,153
2021,Wrexham 017B,W01000355,1689,1509,180
2021,Wrexham 017C,W01000356,1574,1425,149
2021,Wrexham 019C,W01000359,1159,1061,98
2021,Wrexham 019D,W01000360,1193,1127,66
2021,Wrexham 019E,W01000361,1925,1778,147
2021,Wrexham 006C,W01000362,1443,1259,184
2021,Wrexham 006D,W01000363,1428,1224,204
2021,Wrexham 006E,W01000364,1430,1219,211
2021,Wrexham 011C,W01000365,1985,1713,272
2021,Wrexham 014A,W01000366,1419,1314,105
2021,Wrexham 014B,W01000367,1248,1135,113
2021,Wrexham 008A,W01000368,1935,1727,208
2021,Wrexham 021B,W01000369,1237,1145,92
2021,Wrexham 021D,W01000370,1508,1384,124
2021,Wrexham 008B,W01000371,1029,925,104
2021,Wrexham 008C,W01000372,1482,1356,126
2021,Wrexham 005B,W01000373,1698,1545,153
2021,Wrexham 003A,W01000374,1327,1196,131
2021,Wrexham 003B,W01000375,2034,1795,239
2021,Wrexham 003C,W01000376,1305,1152,153
2021,Wrexham 004A,W01000377,1494,1311,183
2021,Wrexham 004B,W01000378,1248,1146,102
2021,Wrexham 004C,W01000379,1559,1425,134
2021,Wrexham 004D,W01000380,1419,1211,208
2021,Wrexham 012A,W01000381,1084,974,110
2021,Wrexham 012B,W01000382,1337,1175,162
2021,Wrexham 022C,W01000384,1069,1004,65
2021,Wrexham 014C,W01000385,1691,1487,204
2021,Wrexham 015A,W01000386,1388,1265,123
2021,Wrexham 008D,W01000387,1105,1025,80
2021,Wrexham 008E,W01000388,1073,976,97
2021,Wrexham 017D,W01000389,1943,1726,217
2021,Wrexham 021A,W01000390,1696,1547,149
2021,Wrexham 003D,W01000391,1403,1267,136
2021,Wrexham 003E,W01000392,1561,1435,126
2021,Wrexham 023G,W01000393,1889,1691,198
2021,Wrexham 016A,W01000394,1137,1049,88
2021,Wrexham 016B,W01000395,1015,923,92
2021,Wrexham 013A,W01000398,1191,1017,174
2021,Wrexham 013B,W01000399,1060,916,144
2021,Wrexham 005C,W01000400,1775,1595,180
2021,Wrexham 005D,W01000401,1943,1757,186
2021,Wrexham 011D,W01000402,2467,2232,235
2021,Wrexham 018C,W01000403,1284,1204,80
2021,Wrexham 018D,W01000404,1956,1825,131
2021,Wrexham 015B,W01000405,2204,1790,414
2021,Wrexham 013C,W01000406,2095,1795,300
2021,Wrexham 016C,W01000407,1360,1218,142
2021,Wrexham 013D,W01000408,1194,1017,177
2021,Wrexham 017E,W01000409,1782,1667,115
2021,Wrexham 014D,W01000410,1644,1336,308
2021,Wrexham 015C,W01000411,1472,1233,239
2021,Wrexham 015D,W01000412,1446,1123,323
2021,Wrexham 010C,W01000413,1251,1167,84
2021,Wrexham 010D,W01000414,1153,1069,84
2021,Wrexham 023F,W01000415,1392,1275,117
2021,Wrexham 023D,W01000416,1141,1045,96
2021,Wrexham 022B,W01000417,1499,1400,99
2021,Wrexham 022A,W01000418,1703,1557,146
2021,Wrexham 016D,W01000419,1389,1244,145
2021,Wrexham 016E,W01000420,1483,1316,167
2021,Wrexham 008F,W01000422,2093,1914,179
2021,Wrexham 012D,W01000423,2104,1879,225
2021,Wrexham 012E,W01000424,1240,1104,136
2021,Wrexham 010E,W01000425,1969,1836,133
2021,Powys 021A,W01000426,1384,1038,346
2021,Powys 011A,W01000427,1310,1204,106
2021,Powys 005A,W01000428,1299,1166,133
2021,Powys 010A,W01000429,2272,1913,359
2021,Powys 015A,W01000430,1288,1180,108
2021,Powys 014A,W01000431,1226,1074,152
2021,Powys 014B,W01000432,1178,1033,145
2021,Powys 006A,W01000433,2219,1749,470
2021,Powys 007A,W01000434,1704,1645,59
2021,Powys 012A,W01000438,1203,1132,71
2021,Powys 007B,W01000439,1984,1779,205
2021,Powys 020A,W01000440,1287,1143,144
2021,Powys 005B,W01000441,1493,1376,117
2021,Powys 004A,W01000442,1999,1043,956
2021,Powys 015B,W01000443,2236,2086,150
2021,Powys 002A,W01000444,2199,1950,249
2021,Powys 015C,W01000445,1460,1393,67
2021,Powys 015D,W01000446,1642,1555,87
2021,Powys 007C,W01000447,1954,1801,153
2021,Powys 011B,W01000448,1352,1282,70
2021,Powys 011C,W01000449,1495,1402,93
2021,Powys 014C,W01000450,1364,1212,152
2021,Powys 012B,W01000451,1158,1074,84
2021,Powys 004B,W01000452,1964,1177,787
2021,Powys 010B,W01000453,1352,1163,189
2021,Powys 013A,W01000454,1244,1137,107
2021,Powys 013B,W01000455,2122,1944,178
2021,Powys 013C,W01000456,2120,1936,184
2021,Powys 002B,W01000457,2098,1904,194
2021,Powys 002C,W01000458,1814,1653,161
2021,Powys 014D,W01000459,1184,1071,113
2021,Powys 006B,W01000460,1668,1188,480
2021,Powys 001A,W01000461,1547,1134,413
2021,Powys 011D,W01000464,1154,1082,72
2021,Powys 018E,W01000465,1018,929,89
2021,Powys 010C,W01000466,1289,1140,149
2021,Powys 010D,W01000467,1422,1250,172
2021,Powys 001D,W01000470,1948,1692,256
2021,Powys 014E,W01000471,1723,1518,205
2021,Powys 012C,W01000472,1160,1050,110
2021,Powys 004C,W01000473,2092,1292,800
2021,Powys 020B,W01000474,1708,1391,317
2021,Powys 001E,W01000475,2349,1811,538
2021,Powys 005C,W01000476,1250,1159,91
2021,Powys 012D,W01000477,1487,1367,120
2021,Powys 009A,W01000478,1797,1631,166
2021,Powys 009B,W01000479,1401,1258,143
2021,Powys 008A,W01000480,2036,1847,189
2021,Powys 008B,W01000481,2139,1906,233
2021,Powys 008C,W01000482,1853,1635,218
2021,Powys 009C,W01000483,1772,1594,178
2021,Powys 011E,W01000484,1650,1559,91
2021,Powys 011F,W01000485,1553,1475,78
2021,Powys 011G,W01000486,1039,977,62
2021,Powys 012E,W01000487,2029,1819,210
2021,Powys 006C,W01000488,2124,1782,342
2021,Powys 017A,W01000489,1741,1562,179
2021,Powys 017D,W01000492,1492,1364,128
2021,Powys 017E,W01000493,1693,1536,157
2021,Powys 015E,W01000494,1661,1513,148
2021,Powys 021B,W01000496,2036,1684,352
2021,Powys 005D,W01000497,1339,1236,103
2021,Powys 003A,W01000498,1439,1322,117
2021,Powys 003B,W01000499,1208,1113,95
2021,Powys 003C,W01000500,1644,1476,168
2021,Powys 003D,W01000501,2158,1937,221
2021,Powys 021C,W01000502,2023,1503,520
2021,Powys 020C,W01000503,1034,919,115
2021,Powys 021D,W01000504,1097,918,179
2021,Powys 021E,W01000505,1399,1027,372
2021,Ceredigion 005A,W01000506,1250,618,632
2021,Ceredigion 009A,W01000507,1112,688,424
2021,Ceredigion 009B,W01000508,1010,638,372
2021,Ceredigion 009C,W01000509,1819,1006,813
2021,Ceredigion 009D,W01000510,1149,705,444
2021,Ceredigion 009E,W01000511,1135,767,368
2021,Ceredigion 002A,W01000512,1341,815,526
2021,Ceredigion 002B,W01000513,2085,1628,457
2021,Ceredigion 003A,W01000515,1276,934,342
2021,Ceredigion 003B,W01000516,1580,1190,390
2021,Ceredigion 002D,W01000517,1157,930,227
2021,Ceredigion 003C,W01000518,991,703,288
2021,Ceredigion 010A,W01000519,1721,977,744
2021,Ceredigion 010B,W01000522,1181,699,482
2021,Ceredigion 001C,W01000523,1836,1005,831
2021,Ceredigion 005B,W01000524,1877,1025,852
2021,Ceredigion 011A,W01000525,1210,723,487
2021,Ceredigion 008A,W01000527,1130,694,436
2021,Ceredigion 008B,W01000528,1312,774,538
2021,Ceredigion 010C,W01000531,1722,1010,712
2021,Ceredigion 010D,W01000533,1313,666,647
2021,Ceredigion 011B,W01000534,1485,798,687
2021,Ceredigion 008C,W01000535,1996,1092,904
2021,Ceredigion 011E,W01000536,1336,771,565
2021,Ceredigion 008D,W01000537,1366,866,500
2021,Ceredigion 005C,W01000538,1506,798,708
2021,Ceredigion 005D,W01000539,1150,671,479
2021,Ceredigion 005E,W01000540,1117,664,453
2021,Ceredigion 008E,W01000541,1699,906,793
2021,Ceredigion 011F,W01000542,2151,1171,980
2021,Ceredigion 011C,W01000543,1959,1125,834
2021,Ceredigion 007D,W01000545,1944,1177,767
2021,Ceredigion 009F,W01000546,1115,701,414
2021,Ceredigion 009G,W01000547,1120,583,537
2021,Ceredigion 001D,W01000548,1727,977,750
2021,Ceredigion 001E,W01000549,1716,946,770
2021,Ceredigion 011G,W01000550,1130,551,579
2021,Ceredigion 010E,W01000551,1346,758,588
2021,Ceredigion 011D,W01000552,1954,958,996
2021,Pembrokeshire 011A,W01000553,1212,1111,101
2021,Pembrokeshire 009A,W01000554,1812,1663,149
2021,Pembrokeshire 008A,W01000555,1491,1326,165
2021,Pembrokeshire 008B,W01000556,1153,1032,121
2021,Pembrokeshire 014A,W01000557,1488,1347,141
2021,Pembrokeshire 001A,W01000558,2066,1243,823
2021,Pembrokeshire 001B,W01000559,1427,819,608
2021,Pembrokeshire 001C,W01000560,1268,608,660
2021,Pembrokeshire 001D,W01000561,1269,643,626
2021,Pembrokeshire 002A,W01000562,1576,960,616
2021,Pembrokeshire 011B,W01000563,1100,980,120
2021,Pembrokeshire 011C,W01000564,1267,1141,126
2021,Pembrokeshire 002B,W01000565,1796,1418,378
2021,Pembrokeshire 002C,W01000566,1549,1184,365
2021,Pembrokeshire 002D,W01000567,1968,1543,425
2021,Pembrokeshire 005B,W01000569,1065,966,99
2021,Pembrokeshire 005C,W01000570,1366,1246,120
2021,Pembrokeshire 006A,W01000571,2355,2130,225
2021,Pembrokeshire 005D,W01000572,1783,1634,149
2021,Pembrokeshire 006B,W01000573,2494,2225,269
2021,Pembrokeshire 015A,W01000574,1684,1567,117
2021,Pembrokeshire 008C,W01000575,2716,2488,228
2021,Pembrokeshire 011D,W01000576,2243,2051,192
2021,Pembrokeshire 007A,W01000577,1523,1299,224
2021,Pembrokeshire 014B,W01000578,1679,1547,132
2021,Pembrokeshire 003A,W01000579,2308,1748,560
2021,Pembrokeshire 009B,W01000580,2264,2074,190
2021,Pembrokeshire 003B,W01000581,1376,971,405
2021,Pembrokeshire 004A,W01000582,1636,1052,584
2021,Pembrokeshire 004B,W01000583,1391,868,523
2021,Pembrokeshire 014C,W01000584,2023,1840,183
2021,Pembrokeshire 007B,W01000585,1332,1144,188
2021,Pembrokeshire 006C,W01000586,2142,1941,201
2021,Pembrokeshire 010A,W01000587,1935,1805,130
2021,Pembrokeshire 010B,W01000588,2259,2094,165
2021,Pembrokeshire 012A,W01000589,1106,1059,47
2021,Pembrokeshire 012B,W01000590,1110,1064,46
2021,Pembrokeshire 012C,W01000591,1587,1503,84
2021,Pembrokeshire 012D,W01000592,1280,1195,85
2021,Pembrokeshire 012E,W01000594,2103,1972,131
2021,Pembrokeshire 007C,W01000595,2300,1901,399
2021,Pembrokeshire 007D,W01000596,1677,1428,249
2021,Pembrokeshire 002E,W01000597,1038,702,336
2021,Pembrokeshire 009C,W01000598,2109,1982,127
2021,Pembrokeshire 009D,W01000599,1948,1822,126
2021,Pembrokeshire 013A,W01000600,1559,1460,99
2021,Pembrokeshire 013B,W01000601,1462,1390,72
2021,Pembrokeshire 013C,W01000602,1184,1100,84
2021,Pembrokeshire 013D,W01000603,1754,1651,103
2021,Pembrokeshire 013E,W01000604,1654,1559,95
2021,Pembrokeshire 013F,W01000605,1743,1644,99
2021,Pembrokeshire 015B,W01000606,1602,1535,67
2021,Pembrokeshire 015C,W01000607,2375,2194,181
2021,Pembrokeshire 015D,W01000608,1392,1292,100
2021,Pembrokeshire 014D,W01000609,2375,2199,176
2021,Pembrokeshire 016A,W01000610,1676,1487,189
2021,Pembrokeshire 004C,W01000611,2042,1768,274
2021,Pembrokeshire 003C,W01000612,1733,1419,314
2021,Pembrokeshire 001E,W01000613,2011,1308,703
2021,Pembrokeshire 008D,W01000614,1353,1227,126
2021,Pembrokeshire 002F,W01000617,1485,1133,352
2021,Pembrokeshire 003D,W01000618,1685,1421,264
2021,Pembrokeshire 016B,W01000619,1959,1765,194
2021,Pembrokeshire 008E,W01000622,1392,1257,135
2021,Pembrokeshire 004D,W01000623,1961,1638,323
2021,Carmarthenshire 005A,W01000624,2280,1186,1094
2021,Carmarthenshire 013A,W01000625,1087,745,342
2021,Carmarthenshire 013B,W01000626,1572,1005,567
2021,Carmarthenshire 013C,W01000627,2324,1415,909
2021,Carmarthenshire 024A,W01000628,1492,1208,284
2021,Carmarthenshire 024B,W01000629,1596,1317,279
2021,Carmarthenshire 024C,W01000630,1530,1256,274
2021,Carmarthenshire 024D,W01000631,1765,1590,175
2021,Carmarthenshire 021A,W01000632,1306,974,332
2021,Carmarthenshire 021B,W01000633,1383,1110,273
2021,Carmarthenshire 021C,W01000634,1273,963,310
2021,Carmarthenshire 025A,W01000635,2329,1830,499
2021,Carmarthenshire 025B,W01000636,2268,1807,461
2021,Carmarthenshire 007A,W01000637,1336,998,338
2021,Carmarthenshire 007B,W01000638,1101,877,224
2021,Carmarthenshire 007C,W01000639,1457,1059,398
2021,Carmarthenshire 007D,W01000640,1187,748,439
2021,Carmarthenshire 008A,W01000641,1998,1509,489
2021,Carmarthenshire 008B,W01000642,1714,1220,494
2021,Carmarthenshire 006A,W01000643,1620,1307,313
2021,Carmarthenshire 006B,W01000644,1812,1221,591
2021,Carmarthenshire 006C,W01000645,1898,1315,583
2021,Carmarthenshire 003A,W01000646,2077,1311,766
2021,Carmarthenshire 002A,W01000647,1394,905,489
2021,Carmarthenshire 006D,W01000648,1393,797,596
2021,Carmarthenshire 006E,W01000649,1506,850,656
2021,Carmarthenshire 002B,W01000650,1521,948,573
2021,Carmarthenshire 020A,W01000651,1465,1149,316
2021,Carmarthenshire 020B,W01000652,1732,1445,287
2021,Carmarthenshire 023A,W01000653,1427,1043,384
2021,Carmarthenshire 023B,W01000654,1618,1322,296
2021,Carmarthenshire 020C,W01000655,1849,1474,375
2021,Carmarthenshire 010A,W01000656,1987,1208,779
2021,Carmarthenshire 010B,W01000657,1130,709,421
2021,Carmarthenshire 010C,W01000658,1286,797,489
2021,Carmarthenshire 026A,W01000659,1713,1477,236
2021,Carmarthenshire 026B,W01000660,1445,1252,193
2021,Carmarthenshire 016A,W01000662,2107,1158,949
2021,Carmarthenshire 016B,W01000663,2402,1162,1240
2021,Carmarthenshire 016C,W01000664,2508,1340,1168
2021,Carmarthenshire 017A,W01000665,1768,1213,555
2021,Carmarthenshire 017B,W01000666,1596,1135,461
2021,Carmarthenshire 023C,W01000667,2039,1495,544
2021,Carmarthenshire 018A,W01000670,1532,1134,398
2021,Carmarthenshire 018B,W01000671,2086,1485,601
2021,Carmarthenshire 027E,W01000672,1464,1228,236
2021,Carmarthenshire 027F,W01000673,1082,896,186
2021,Carmarthenshire 027A,W01000674,2044,1212,832
2021,Carmarthenshire 012A,W01000675,2021,1030,991
2021,Carmarthenshire 004A,W01000676,1488,902,586
2021,Carmarthenshire 004B,W01000677,1411,942,469
2021,Carmarthenshire 002C,W01000678,1345,979,366
2021,Carmarthenshire 002D,W01000679,1206,829,377
2021,Carmarthenshire 011A,W01000680,2248,1352,896
2021,Carmarthenshire 011B,W01000681,2020,1222,798
2021,Carmarthenshire 005B,W01000682,1363,659,704
2021,Carmarthenshire 005C,W01000683,1039,726,313
2021,Carmarthenshire 005D,W01000684,1715,1060,655
2021,Carmarthenshire 001A,W01000685,1502,841,661
2021,Carmarthenshire 001B,W01000686,1188,584,604
2021,Carmarthenshire 004C,W01000687,1906,1138,768
2021,Carmarthenshire 003B,W01000688,1657,978,679
2021,Carmarthenshire 003C,W01000689,1696,959,737
2021,Carmarthenshire 019A,W01000690,1729,1162,567
2021,Carmarthenshire 019B,W01000691,1800,1326,474
2021,Carmarthenshire 019C,W01000692,1498,1055,443
2021,Carmarthenshire 008C,W01000693,1101,680,421
2021,Carmarthenshire 008D,W01000694,1464,891,573
2021,Carmarthenshire 012B,W01000695,2162,1384,778
2021,Carmarthenshire 012C,W01000696,1609,871,738
2021,Carmarthenshire 015A,W01000697,1876,1000,876
2021,Carmarthenshire 015B,W01000698,1908,999,909
2021,Carmarthenshire 015C,W01000699,1434,818,616
2021,Carmarthenshire 027G,W01000700,1938,1326,612
2021,Carmarthenshire 001C,W01000701,1566,873,693
2021,Carmarthenshire 001D,W01000702,1149,653,496
2021,Carmarthenshire 022A,W01000703,1719,1403,316
2021,Carmarthenshire 022B,W01000704,1609,1186,423
2021,Carmarthenshire 022C,W01000705,1852,1504,348
2021,Carmarthenshire 025C,W01000706,1505,1243,262
2021,Carmarthenshire 025D,W01000707,1392,1112,280
2021,Carmarthenshire 025E,W01000708,1329,1133,196
2021,Carmarthenshire 004D,W01000709,2144,1325,819
2021,Carmarthenshire 021D,W01000710,2124,1512,612
2021,Carmarthenshire 021E,W01000711,1975,1634,341
2021,Carmarthenshire 015D,W01000712,1643,917,726
2021,Carmarthenshire 015E,W01000713,1329,737,592
2021,Carmarthenshire 013D,W01000714,1377,932,445
2021,Carmarthenshire 013E,W01000715,1252,743,509
2021,Carmarthenshire 016D,W01000716,1371,667,704
2021,Carmarthenshire 016E,W01000717,1406,710,696
2021,Carmarthenshire 010D,W01000718,1361,702,659
2021,Carmarthenshire 010E,W01000719,1404,750,654
2021,Carmarthenshire 027B,W01000720,1770,1089,681
2021,Carmarthenshire 027C,W01000721,1355,836,519
2021,Carmarthenshire 012D,W01000722,1321,753,568
2021,Carmarthenshire 012E,W01000723,1344,929,415
2021,Carmarthenshire 011C,W01000724,1889,1220,669
2021,Carmarthenshire 011D,W01000725,2262,1424,838
2021,Carmarthenshire 003D,W01000728,2022,1246,776
2021,Carmarthenshire 018C,W01000729,1198,728,470
2021,Carmarthenshire 018D,W01000730,1234,856,378
2021,Carmarthenshire 017C,W01000731,2337,1619,718
2021,Carmarthenshire 026D,W01000732,1263,1081,182
2021,Carmarthenshire 026E,W01000733,1156,1003,153
2021,Carmarthenshire 026F,W01000734,1343,1142,201
2021,Carmarthenshire 027D,W01000735,2318,1647,671
2021,Swansea 028A,W01000736,1720,1553,167
2021,Swansea 028B,W01000737,1452,1321,131
2021,Swansea 014A,W01000738,1660,1568,92
2021,Swansea 014B,W01000739,2152,2008,144
2021,Swansea 014C,W01000740,1524,1429,95
2021,Swansea 014D,W01000741,1798,1666,132
2021,Swansea 016A,W01000742,1604,1519,85
2021,Swansea 016B,W01000744,1472,1387,85
2021,Swansea 025B,W01000745,2405,2245,160
2021,Swansea 025C,W01000746,1377,1283,94
2021,Swansea 024A,W01000747,1552,1434,118
2021,Swansea 026A,W01000749,1951,1815,136
2021,Swansea 002A,W01000750,1415,1171,244
2021,Swansea 002B,W01000751,1366,1080,286
2021,Swansea 002C,W01000752,1427,1272,155
2021,Swansea 002D,W01000753,1382,1175,207
2021,Swansea 002E,W01000754,1512,1287,225
2021,Swansea 017A,W01000755,1919,1778,141
2021,Swansea 017B,W01000756,1428,1310,118
2021,Swansea 017C,W01000757,1394,1294,100
2021,Swansea 017D,W01000758,1842,1653,189
2021,Swansea 012A,W01000759,1506,1370,136
2021,Swansea 013A,W01000760,1527,1372,155
2021,Swansea 013B,W01000761,1518,1392,126
2021,Swansea 013C,W01000762,1614,1534,80
2021,Swansea 015A,W01000763,1361,1286,75
2021,Swansea 015B,W01000764,1517,1426,91
2021,Swansea 015C,W01000765,1581,1477,104
2021,Swansea 015D,W01000766,1446,1359,87
2021,Swansea 015E,W01000767,1388,1326,62
2021,Swansea 032A,W01000768,1315,1224,91
2021,Swansea 032B,W01000769,1356,1273,83
2021,Swansea 032D,W01000770,1484,1392,92
2021,Swansea 032G,W01000771,1274,1178,96
2021,Swansea 018A,W01000772,1451,1326,125
2021,Swansea 005B,W01000774,1563,1378,185
2021,Swansea 030A,W01000775,1603,1497,106
2021,Swansea 030B,W01000776,1749,1583,166
2021,Swansea 012B,W01000777,1674,1518,156
2021,Swansea 012C,W01000778,1733,1571,162
2021,Swansea 012D,W01000779,1417,1273,144
2021,Swansea 032E,W01000781,1587,1445,142
2021,Swansea 032F,W01000782,1049,985,64
2021,Swansea 007A,W01000784,1263,1114,149
2021,Swansea 007B,W01000785,1718,1496,222
2021,Swansea 007C,W01000786,1229,1057,172
2021,Swansea 016C,W01000787,1396,1279,117
2021,Swansea 016D,W01000788,1438,1352,86
2021,Swansea 016E,W01000789,1368,1305,63
2021,Swansea 016F,W01000790,2618,2467,151
2021,Swansea 004A,W01000791,1377,1245,132
2021,Swansea 004B,W01000792,1536,1280,256
2021,Swansea 004C,W01000793,1813,1555,258
2021,Swansea 010A,W01000794,2135,1818,317
2021,Swansea 006A,W01000795,1524,1335,189
2021,Swansea 010B,W01000797,1475,1314,161
2021,Swansea 010C,W01000798,1383,1264,119
2021,Swansea 010D,W01000799,1783,1632,151
2021,Swansea 006C,W01000800,1425,1228,197
2021,Swansea 006D,W01000801,1666,1561,105
2021,Swansea 007D,W01000802,2284,2013,271
2021,Swansea 002F,W01000803,1778,1317,461
2021,Swansea 028C,W01000804,1404,1252,152
2021,Swansea 028D,W01000805,1118,1004,114
2021,Swansea 003A,W01000806,1367,1237,130
2021,Swansea 003B,W01000807,1267,1166,101
2021,Swansea 003C,W01000808,1362,1227,135
2021,Swansea 008A,W01000809,1463,1348,115
2021,Swansea 003D,W01000810,1303,1213,90
2021,Swansea 008B,W01000811,1347,1238,109
2021,Swansea 008C,W01000812,1409,1325,84
2021,Swansea 008D,W01000813,1531,1343,188
2021,Swansea 008E,W01000814,1382,1277,105
2021,Swansea 003E,W01000815,1463,1232,231
2021,Swansea 003F,W01000816,1726,1560,166
2021,Swansea 009A,W01000817,1877,1740,137
2021,Swansea 009B,W01000818,1447,1313,134
2021,Swansea 009C,W01000819,1410,1281,129
2021,Swansea 009D,W01000820,1352,1236,116
2021,Swansea 009E,W01000821,1431,1366,65
2021,Swansea 009F,W01000822,1171,1073,98
2021,Swansea 031A,W01000823,1789,1623,166
2021,Swansea 031B,W01000824,1625,1450,175
2021,Swansea 031C,W01000825,1247,1111,136
2021,Swansea 031D,W01000826,1236,1095,141
2021,Swansea 031E,W01000827,1227,1110,117
2021,Swansea 018B,W01000828,1607,1458,149
2021,Swansea 018C,W01000829,1873,1705,168
2021,Swansea 011A,W01000830,1696,1612,84
2021,Swansea 013D,W01000831,1668,1541,127
2021,Swansea 011B,W01000832,1522,1440,82
2021,Swansea 011C,W01000833,1567,1479,88
2021,Swansea 011D,W01000834,1393,1270,123
2021,Swansea 013E,W01000835,1405,1324,81
2021,Swansea 011E,W01000836,2280,2093,187
2021,Swansea 004D,W01000837,2238,1913,325
2021,Swansea 004E,W01000838,1225,1131,94
2021,Swansea 030C,W01000839,1027,932,95
2021,Swansea 030D,W01000840,1588,1447,141
2021,Swansea 005C,W01000841,1428,1301,127
2021,Swansea 005D,W01000842,1384,1251,133
2021,Swansea 005E,W01000843,1349,1185,164
2021,Swansea 005F,W01000844,1459,1320,139
2021,Swansea 001A,W01000845,1960,1492,468
2021,Swansea 001B,W01000846,1985,1550,435
2021,Swansea 001C,W01000847,1230,970,260
2021,Swansea 001D,W01000848,1168,1023,145
2021,Swansea 021A,W01000849,2119,1976,143
2021,Swansea 021C,W01000851,1564,1469,95
2021,Swansea 021D,W01000852,1432,1360,72
2021,Swansea 022A,W01000853,1634,1467,167
2021,Swansea 022B,W01000854,1462,1300,162
2021,Swansea 022C,W01000855,1390,1255,135
2021,Swansea 022D,W01000856,1696,1604,92
2021,Swansea 022E,W01000857,1873,1717,156
2021,Swansea 027A,W01000858,1603,1395,208
2021,Swansea 027B,W01000859,1376,1248,128
2021,Swansea 027C,W01000860,1503,1306,197
2021,Swansea 027D,W01000861,1930,1713,217
2021,Swansea 019A,W01000862,1492,1412,80
2021,Swansea 019B,W01000863,1561,1504,57
2021,Swansea 019C,W01000864,1568,1509,59
2021,Swansea 019D,W01000865,1367,1305,62
2021,Swansea 019E,W01000866,1134,1077,57
2021,Swansea 019F,W01000867,1238,1164,74
2021,Swansea 024B,W01000868,1066,934,132
2021,Swansea 024C,W01000869,1503,1347,156
2021,Swansea 024D,W01000870,1349,1209,140
2021,Swansea 026B,W01000871,1737,1591,146
2021,Swansea 024E,W01000872,1363,1168,195
2021,Swansea 026C,W01000873,1513,1368,145
2021,Swansea 024F,W01000874,1775,1569,206
2021,Swansea 026D,W01000875,1880,1713,167
2021,Swansea 026E,W01000876,1616,1435,181
2021,Swansea 007E,W01000877,1630,1395,235
2021,Swansea 007F,W01000878,1232,1076,156
2021,Swansea 029A,W01000879,1647,1474,173
2021,Swansea 029B,W01000880,1517,1368,149
2021,Swansea 029C,W01000881,1291,1186,105
2021,Swansea 029D,W01000882,1689,1557,132
2021,Neath Port Talbot 016A,W01000883,1300,1232,68
2021,Neath Port Talbot 017A,W01000884,1231,1163,68
2021,Neath Port Talbot 017B,W01000885,1406,1320,86
2021,Neath Port Talbot 017C,W01000886,1562,1495,67
2021,Neath Port Talbot 021C,W01000887,2316,2086,230
2021,Neath Port Talbot 004A,W01000888,2629,2146,483
2021,Neath Port Talbot 015A,W01000889,1762,1621,141
2021,Neath Port Talbot 015B,W01000890,1502,1407,95
2021,Neath Port Talbot 015C,W01000891,1403,1306,97
2021,Neath Port Talbot 015D,W01000892,1907,1758,149
2021,Neath Port Talbot 003A,W01000893,1871,1682,189
2021,Neath Port Talbot 013A,W01000894,1426,1315,111
2021,Neath Port Talbot 013B,W01000895,1421,1323,98
2021,Neath Port Talbot 013C,W01000896,1525,1383,142
2021,Neath Port Talbot 013D,W01000897,1279,1192,87
2021,Neath Port Talbot 014A,W01000898,1419,1268,151
2021,Neath Port Talbot 014B,W01000899,1817,1615,202
2021,Neath Port Talbot 014C,W01000900,1527,1398,129
2021,Neath Port Talbot 014D,W01000901,1616,1435,181
2021,Neath Port Talbot 006C,W01000904,1439,1294,145
2021,Neath Port Talbot 006D,W01000905,1451,1309,142
2021,Neath Port Talbot 007B,W01000907,1681,1551,130
2021,Neath Port Talbot 006E,W01000908,1555,1392,163
2021,Neath Port Talbot 009A,W01000909,1151,1079,72
2021,Neath Port Talbot 009B,W01000910,1339,1238,101
2021,Neath Port Talbot 009C,W01000911,1124,1017,107
2021,Neath Port Talbot 010A,W01000912,1169,1090,79
2021,Neath Port Talbot 010B,W01000913,1120,1017,103
2021,Neath Port Talbot 010C,W01000914,1598,1501,97
2021,Neath Port Talbot 010D,W01000915,1089,996,93
2021,Neath Port Talbot 010E,W01000916,1154,1054,100
2021,Neath Port Talbot 002A,W01000918,1884,1610,274
2021,Neath Port Talbot 020A,W01000919,1120,629,491
2021,Neath Port Talbot 021G,W01000921,1405,1338,67
2021,Neath Port Talbot 007C,W01000922,1540,1424,116
2021,Neath Port Talbot 003B,W01000925,1486,1292,194
2021,Neath Port Talbot 003C,W01000926,1798,1476,322
2021,Neath Port Talbot 020B,W01000927,1993,1591,402
2021,Neath Port Talbot 020C,W01000928,1544,905,639
2021,Neath Port Talbot 020D,W01000929,1223,832,391
2021,Neath Port Talbot 021F,W01000930,1111,1066,45
2021,Neath Port Talbot 020E,W01000931,1316,811,505
2021,Neath Port Talbot 019A,W01000932,1001,936,65
2021,Neath Port Talbot 019B,W01000933,1943,1748,195
2021,Neath Port Talbot 008A,W01000934,1205,1136,69
2021,Neath Port Talbot 008B,W01000935,1508,1414,94
2021,Neath Port Talbot 012A,W01000936,1327,1255,72
2021,Neath Port Talbot 013E,W01000937,1873,1717,156
2021,Neath Port Talbot 008C,W01000938,1356,1210,146
2021,Neath Port Talbot 008D,W01000939,1122,1054,68
2021,Neath Port Talbot 008E,W01000940,1228,1141,87
2021,Neath Port Talbot 012B,W01000941,1487,1373,114
2021,Neath Port Talbot 012C,W01000942,1735,1624,111
2021,Neath Port Talbot 012D,W01000943,1442,1291,151
2021,Neath Port Talbot 002B,W01000944,1145,1016,129
2021,Neath Port Talbot 014E,W01000945,1131,1010,121
2021,Neath Port Talbot 004B,W01000946,1751,1401,350
2021,Neath Port Talbot 004C,W01000947,2109,1691,418
2021,Neath Port Talbot 004D,W01000948,1777,1396,381
2021,Neath Port Talbot 018A,W01000949,1291,1187,104
2021,Neath Port Talbot 018B,W01000950,1417,1318,99
2021,Neath Port Talbot 018C,W01000951,1736,1610,126
2021,Neath Port Talbot 018D,W01000952,1135,1051,84
2021,Neath Port Talbot 021B,W01000953,1559,1407,152
2021,Neath Port Talbot 021A,W01000954,1312,1201,111
2021,Neath Port Talbot 004E,W01000955,1341,1092,249
2021,Neath Port Talbot 004F,W01000956,1172,1001,171
2021,Neath Port Talbot 017D,W01000957,1571,1481,90
2021,Neath Port Talbot 016B,W01000958,1513,1439,74
2021,Neath Port Talbot 017E,W01000959,1688,1572,116
2021,Neath Port Talbot 017F,W01000960,1719,1619,100
2021,Neath Port Talbot 016C,W01000961,1544,1442,102
2021,Neath Port Talbot 016D,W01000962,1487,1385,102
2021,Neath Port Talbot 016E,W01000963,1798,1700,98
2021,Neath Port Talbot 016F,W01000964,1755,1642,113
2021,Neath Port Talbot 002C,W01000965,1968,1646,322
2021,Neath Port Talbot 018E,W01000966,1401,1302,99
2021,Neath Port Talbot 019C,W01000967,1372,1317,55
2021,Neath Port Talbot 019D,W01000968,1906,1755,151
2021,Neath Port Talbot 009D,W01000969,1498,1347,151
2021,Neath Port Talbot 021D,W01000970,1079,992,87
2021,Neath Port Talbot 004G,W01000971,1357,1011,346
2021,Neath Port Talbot 020F,W01000973,1294,931,363
2021,Bridgend 006A,W01000974,2301,2114,187
2021,Bridgend 004A,W01000975,2165,2040,125
2021,Bridgend 003A,W01000976,1060,998,62
2021,Bridgend 003B,W01000977,1380,1283,97
2021,Bridgend 004B,W01000978,1725,1584,141
2021,Bridgend 015A,W01000979,1558,1430,128
2021,Bridgend 016A,W01000980,1303,1213,90
2021,Bridgend 016B,W01000981,1202,1094,108
2021,Bridgend 016C,W01000982,1393,1304,89
2021,Bridgend 015B,W01000983,1463,1328,135
2021,Bridgend 016D,W01000984,2103,1912,191
2021,Bridgend 015C,W01000985,1236,1136,100
2021,Bridgend 007A,W01000986,1617,1445,172
2021,Bridgend 007B,W01000987,2334,2169,165
2021,Bridgend 013A,W01000989,1530,1384,146
2021,Bridgend 017B,W01000990,1508,1414,94
2021,Bridgend 001A,W01000991,1104,1022,82
2021,Bridgend 001B,W01000992,1348,1268,80
2021,Bridgend 001C,W01000993,1315,1240,75
2021,Bridgend 001D,W01000994,1351,1257,94
2021,Bridgend 001E,W01000995,1326,1209,117
2021,Bridgend 008A,W01000996,1494,1386,108
2021,Bridgend 012A,W01000997,1653,1557,96
2021,Bridgend 010A,W01000999,1355,1257,98
2021,Bridgend 010B,W01001000,1686,1546,140
2021,Bridgend 010C,W01001001,1757,1609,148
2021,Bridgend 010D,W01001002,2338,2161,177
2021,Bridgend 015D,W01001003,1310,1223,87
2021,Bridgend 009A,W01001004,1014,926,88
2021,Bridgend 009B,W01001005,1558,1428,130
2021,Bridgend 009C,W01001006,2186,1982,204
2021,Bridgend 009D,W01001007,1829,1665,164
2021,Bridgend 011B,W01001008,2474,2257,217
2021,Bridgend 004C,W01001009,1208,1098,110
2021,Bridgend 012B,W01001010,1126,1059,67
2021,Bridgend 012C,W01001011,1246,1178,68
2021,Bridgend 005A,W01001012,1469,1266,203
2021,Bridgend 005B,W01001013,1437,1278,159
2021,Bridgend 002A,W01001014,1575,1436,139
2021,Bridgend 002B,W01001015,1423,1270,153
2021,Bridgend 005C,W01001016,1595,1463,132
2021,Bridgend 002C,W01001017,1426,1241,185
2021,Bridgend 002D,W01001018,1253,1114,139
2021,Bridgend 005D,W01001019,1539,1384,155
2021,Bridgend 002E,W01001020,1316,1201,115
2021,Bridgend 014A,W01001021,1558,1449,109
2021,Bridgend 014B,W01001022,1381,1301,80
2021,Bridgend 014C,W01001023,1607,1509,98
2021,Bridgend 003C,W01001024,1103,1033,70
2021,Bridgend 003D,W01001025,1195,1125,70
2021,Bridgend 012D,W01001026,1942,1817,125
2021,Bridgend 017C,W01001027,1461,1366,95
2021,Bridgend 014D,W01001028,1846,1687,159
2021,Bridgend 019A,W01001029,1684,1566,118
2021,Bridgend 019B,W01001030,1918,1781,137
2021,Bridgend 018A,W01001031,1443,1360,83
2021,Bridgend 018B,W01001032,1728,1607,121
2021,Bridgend 003E,W01001033,1701,1599,102
2021,Bridgend 003F,W01001034,1299,1206,93
2021,Bridgend 014E,W01001035,1689,1564,125
2021,Bridgend 017D,W01001036,1582,1402,180
2021,Bridgend 013B,W01001037,1763,1602,161
2021,Bridgend 011C,W01001038,2494,2310,184
2021,Bridgend 009E,W01001039,1661,1521,140
2021,Bridgend 009F,W01001040,1521,1417,104
2021,Bridgend 013C,W01001041,2240,2035,205
2021,Bridgend 004D,W01001042,1219,1076,143
2021,Bridgend 004E,W01001043,1132,1017,115
2021,Bridgend 019C,W01001044,1558,1486,72
2021,Bridgend 019D,W01001045,1668,1572,96
2021,Bridgend 018C,W01001046,1885,1782,103
2021,Bridgend 018D,W01001047,1633,1500,133
2021,Bridgend 008B,W01001048,1381,1298,83
2021,Bridgend 008C,W01001049,1258,1164,94
2021,Bridgend 008D,W01001050,1501,1376,125
2021,Bridgend 008E,W01001051,1764,1618,146
2021,Bridgend 008F,W01001052,1240,1164,76
2021,Bridgend 018E,W01001053,992,895,97
2021,Bridgend 018F,W01001054,1334,1242,92
2021,Bridgend 007C,W01001055,1164,1087,77
2021,Bridgend 007D,W01001056,1152,1076,76
2021,Bridgend 006B,W01001057,1679,1549,130
2021,Bridgend 006C,W01001058,1840,1671,169
2021,Vale of Glamorgan 015A,W01001059,1702,1470,232
2021,Vale of Glamorgan 015B,W01001060,1383,1212,171
2021,Vale of Glamorgan 013A,W01001062,1304,1127,177
2021,Vale of Glamorgan 012A,W01001063,1543,1408,135
2021,Vale of Glamorgan 013B,W01001064,1371,1253,118
2021,Vale of Glamorgan 012B,W01001065,1518,1341,177
2021,Vale of Glamorgan 015D,W01001066,1575,1401,174
2021,Vale of Glamorgan 009A,W01001067,1344,1242,102
2021,Vale of Glamorgan 009B,W01001068,1604,1490,114
2021,Vale of Glamorgan 012C,W01001069,1474,1370,104
2021,Vale of Glamorgan 009C,W01001070,993,929,64
2021,Vale of Glamorgan 009D,W01001071,1436,1324,112
2021,Vale of Glamorgan 009E,W01001072,2630,2339,291
2021,Vale of Glamorgan 015E,W01001073,2017,1856,161
2021,Vale of Glamorgan 004A,W01001075,1143,1012,131
2021,Vale of Glamorgan 004B,W01001076,1344,1229,115
2021,Vale of Glamorgan 004C,W01001077,1384,1264,120
2021,Vale of Glamorgan 004D,W01001078,1255,1106,149
2021,Vale of Glamorgan 012E,W01001079,1438,1295,143
2021,Vale of Glamorgan 012F,W01001080,1528,1395,133
2021,Vale of Glamorgan 007A,W01001081,1675,1523,152
2021,Vale of Glamorgan 002A,W01001082,1524,1337,187
2021,Vale of Glamorgan 002B,W01001083,1668,1447,221
2021,Vale of Glamorgan 002C,W01001084,1623,1436,187
2021,Vale of Glamorgan 002D,W01001085,1610,1408,202
2021,Vale of Glamorgan 006A,W01001086,1468,1291,177
2021,Vale of Glamorgan 006B,W01001087,1472,1327,145
2021,Vale of Glamorgan 006C,W01001088,2073,1900,173
2021,Vale of Glamorgan 006D,W01001089,1552,1422,130
2021,Vale of Glamorgan 006E,W01001090,1412,1264,148
2021,Vale of Glamorgan 010A,W01001091,1589,1442,147
2021,Vale of Glamorgan 007B,W01001092,2046,1815,231
2021,Vale of Glamorgan 013C,W01001093,1719,1556,163
2021,Vale of Glamorgan 007C,W01001094,1196,1084,112
2021,Vale of Glamorgan 007D,W01001095,1320,1198,122
2021,Vale of Glamorgan 007E,W01001096,1274,1159,115
2021,Vale of Glamorgan 007F,W01001097,1468,1365,103
2021,Vale of Glamorgan 010B,W01001098,1010,905,105
2021,Vale of Glamorgan 013D,W01001099,1165,1051,114
2021,Vale of Glamorgan 010C,W01001100,1452,1296,156
2021,Vale of Glamorgan 013E,W01001101,1473,1322,151
2021,Vale of Glamorgan 013F,W01001102,1467,1284,183
2021,Vale of Glamorgan 010D,W01001103,1150,1061,89
2021,Vale of Glamorgan 004E,W01001104,2039,1849,190
2021,Vale of Glamorgan 001A,W01001105,2757,2404,353
2021,Vale of Glamorgan 011A,W01001106,1417,1293,124
2021,Vale of Glamorgan 011B,W01001107,1476,1367,109
2021,Vale of Glamorgan 014A,W01001108,1756,1606,150
2021,Vale of Glamorgan 011C,W01001109,1345,1220,125
2021,Vale of Glamorgan 011D,W01001110,1661,1507,154
2021,Vale of Glamorgan 011E,W01001111,1314,1219,95
2021,Vale of Glamorgan 011F,W01001112,1279,1132,147
2021,Vale of Glamorgan 003A,W01001113,2262,1986,276
2021,Vale of Glamorgan 008A,W01001114,1545,1353,192
2021,Vale of Glamorgan 008B,W01001115,2100,1889,211
2021,Vale of Glamorgan 005A,W01001116,1905,1671,234
2021,Vale of Glamorgan 014B,W01001117,1263,1161,102
2021,Vale of Glamorgan 003B,W01001119,1817,1625,192
2021,Vale of Glamorgan 014D,W01001120,1320,1201,119
2021,Vale of Glamorgan 014E,W01001121,1659,1529,130
2021,Vale of Glamorgan 014F,W01001122,2369,2181,188
2021,Vale of Glamorgan 005B,W01001123,1447,1297,150
2021,Vale of Glamorgan 005C,W01001124,1419,1265,154
2021,Vale of Glamorgan 005D,W01001125,1387,1244,143
2021,Vale of Glamorgan 001B,W01001127,1589,1423,166
2021,Vale of Glamorgan 001C,W01001128,1638,1477,161
2021,Vale of Glamorgan 004F,W01001129,1598,1445,153
2021,Vale of Glamorgan 005F,W01001130,1240,1090,150
2021,Vale of Glamorgan 008C,W01001131,1650,1493,157
2021,Vale of Glamorgan 008D,W01001132,1307,1194,113
2021,Vale of Glamorgan 008E,W01001133,2187,2005,182
2021,Vale of Glamorgan 008F,W01001134,1087,985,102
2021,Vale of Glamorgan 003C,W01001135,2240,1989,251
2021,Vale of Glamorgan 003D,W01001136,1465,1330,135
2021,Rhondda Cynon Taf 005A,W01001137,2291,2120,171
2021,Rhondda Cynon Taf 005B,W01001138,1289,1188,101
2021,Rhondda Cynon Taf 005C,W01001139,1354,1244,110
2021,Rhondda Cynon Taf 005D,W01001140,1365,1260,105
2021,Rhondda Cynon Taf 005E,W01001141,1463,1374,89
2021,Rhondda Cynon Taf 005F,W01001142,1840,1684,156
2021,Rhondda Cynon Taf 012A,W01001143,1433,1281,152
2021,Rhondda Cynon Taf 012B,W01001144,1672,1535,137
2021,Rhondda Cynon Taf 012C,W01001145,1686,1514,172
2021,Rhondda Cynon Taf 012D,W01001146,1366,1207,159
2021,Rhondda Cynon Taf 004A,W01001147,1759,1586,173
2021,Rhondda Cynon Taf 002A,W01001148,1684,1517,167
2021,Rhondda Cynon Taf 003A,W01001149,1357,1227,130
2021,Rhondda Cynon Taf 003B,W01001150,1820,1637,183
2021,Rhondda Cynon Taf 003C,W01001151,1770,1580,190
2021,Rhondda Cynon Taf 002B,W01001152,1882,1652,230
2021,Rhondda Cynon Taf 002C,W01001153,1515,1377,138
2021,Rhondda Cynon Taf 003D,W01001154,1370,1256,114
2021,Rhondda Cynon Taf 002D,W01001155,1482,1344,138
2021,Rhondda Cynon Taf 003E,W01001156,1375,1174,201
2021,Rhondda Cynon Taf 028A,W01001157,1266,1133,133
2021,Rhondda Cynon Taf 028B,W01001158,1437,1301,136
2021,Rhondda Cynon Taf 028C,W01001159,1513,1312,201
2021,Rhondda Cynon Taf 029A,W01001160,1584,1436,148
2021,Rhondda Cynon Taf 025A,W01001162,2434,2052,382
2021,Rhondda Cynon Taf 019A,W01001164,1518,1352,166
2021,Rhondda Cynon Taf 019B,W01001165,1307,1141,166
2021,Rhondda Cynon Taf 016A,W01001166,1325,1268,57
2021,Rhondda Cynon Taf 016B,W01001167,1362,1237,125
2021,Rhondda Cynon Taf 004B,W01001168,1357,1247,110
2021,Rhondda Cynon Taf 004C,W01001169,2444,2255,189
2021,Rhondda Cynon Taf 004D,W01001170,1163,1067,96
2021,Rhondda Cynon Taf 017A,W01001171,1256,1148,108
2021,Rhondda Cynon Taf 020A,W01001172,1352,1210,142
2021,Rhondda Cynon Taf 020B,W01001173,1312,1233,79
2021,Rhondda Cynon Taf 020C,W01001174,1364,1284,80
2021,Rhondda Cynon Taf 009A,W01001175,1260,1129,131
2021,Rhondda Cynon Taf 013A,W01001176,1401,1263,138
2021,Rhondda Cynon Taf 009B,W01001177,1257,1152,105
2021,Rhondda Cynon Taf 023A,W01001178,1570,1432,138
2021,Rhondda Cynon Taf 023B,W01001179,1658,1557,101
2021,Rhondda Cynon Taf 015A,W01001180,1478,1331,147
2021,Rhondda Cynon Taf 015B,W01001181,1348,1204,144
2021,Rhondda Cynon Taf 026A,W01001184,2021,1810,211
2021,Rhondda Cynon Taf 022A,W01001185,2003,1791,212
2021,Rhondda Cynon Taf 001A,W01001186,1687,1435,252
2021,Rhondda Cynon Taf 001B,W01001187,1322,1126,196
2021,Rhondda Cynon Taf 001C,W01001188,1264,1147,117
2021,Rhondda Cynon Taf 029C,W01001189,1462,1327,135
2021,Rhondda Cynon Taf 029D,W01001190,2879,2472,407
2021,Rhondda Cynon Taf 031B,W01001192,1380,1245,135
2021,Rhondda Cynon Taf 030A,W01001193,1112,949,163
2021,Rhondda Cynon Taf 030B,W01001194,2058,1755,303
2021,Rhondda Cynon Taf 030C,W01001195,1424,1201,223
2021,Rhondda Cynon Taf 027B,W01001196,1401,1185,216
2021,Rhondda Cynon Taf 027C,W01001197,1184,916,268
2021,Rhondda Cynon Taf 027D,W01001198,1457,1295,162
2021,Rhondda Cynon Taf 027E,W01001199,1615,1396,219
2021,Rhondda Cynon Taf 009C,W01001202,1712,1585,127
2021,Rhondda Cynon Taf 009D,W01001203,1316,1215,101
2021,Rhondda Cynon Taf 006A,W01001204,1471,1302,169
2021,Rhondda Cynon Taf 006B,W01001205,1427,1277,150
2021,Rhondda Cynon Taf 006C,W01001206,1425,1306,119
2021,Rhondda Cynon Taf 006D,W01001207,1231,1123,108
2021,Rhondda Cynon Taf 006E,W01001208,1475,1327,148
2021,Rhondda Cynon Taf 008A,W01001209,1400,1276,124
2021,Rhondda Cynon Taf 008B,W01001210,1415,1308,107
2021,Rhondda Cynon Taf 008C,W01001211,1474,1358,116
2021,Rhondda Cynon Taf 008D,W01001212,1263,1164,99
2021,Rhondda Cynon Taf 011B,W01001214,1272,1110,162
2021,Rhondda Cynon Taf 011D,W01001216,1462,1323,139
2021,Rhondda Cynon Taf 018A,W01001217,1081,985,96
2021,Rhondda Cynon Taf 018B,W01001218,1476,1378,98
2021,Rhondda Cynon Taf 018C,W01001219,1178,1120,58
2021,Rhondda Cynon Taf 018D,W01001220,1448,1338,110
2021,Rhondda Cynon Taf 001D,W01001221,1386,1258,128
2021,Rhondda Cynon Taf 001E,W01001222,1496,1383,113
2021,Rhondda Cynon Taf 031C,W01001223,1691,1513,178
2021,Rhondda Cynon Taf 031D,W01001224,1982,1506,476
2021,Rhondda Cynon Taf 031E,W01001225,1537,1300,237
2021,Rhondda Cynon Taf 031F,W01001226,1642,1408,234
2021,Rhondda Cynon Taf 021C,W01001227,1233,1012,221
2021,Rhondda Cynon Taf 021D,W01001228,1575,1345,230
2021,Rhondda Cynon Taf 017B,W01001229,1365,1206,159
2021,Rhondda Cynon Taf 017C,W01001230,1506,1313,193
2021,Rhondda Cynon Taf 017D,W01001231,1387,1222,165
2021,Rhondda Cynon Taf 020D,W01001232,1237,1095,142
2021,Rhondda Cynon Taf 001F,W01001233,1779,1553,226
2021,Rhondda Cynon Taf 021E,W01001234,1452,1290,162
2021,Rhondda Cynon Taf 021F,W01001235,1601,1452,149
2021,Rhondda Cynon Taf 021G,W01001236,1563,1357,206
2021,Rhondda Cynon Taf 022B,W01001237,1409,1291,118
2021,Rhondda Cynon Taf 022C,W01001238,1650,1500,150
2021,Rhondda Cynon Taf 026B,W01001239,1269,1140,129
2021,Rhondda Cynon Taf 026C,W01001240,1855,1650,205
2021,Rhondda Cynon Taf 026D,W01001241,1612,1386,226
2021,Rhondda Cynon Taf 030D,W01001242,1324,1140,184
2021,Rhondda Cynon Taf 030E,W01001243,1368,1241,127
2021,Rhondda Cynon Taf 025B,W01001244,1351,1186,165
2021,Rhondda Cynon Taf 025C,W01001245,1201,1048,153
2021,Rhondda Cynon Taf 025D,W01001246,1308,1155,153
2021,Rhondda Cynon Taf 016C,W01001247,1541,1416,125
2021,Rhondda Cynon Taf 016D,W01001248,1928,1735,193
2021,Rhondda Cynon Taf 024A,W01001249,1420,1293,127
2021,Rhondda Cynon Taf 024B,W01001250,1491,1321,170
2021,Rhondda Cynon Taf 024C,W01001251,1449,1325,124
2021,Rhondda Cynon Taf 024D,W01001252,1521,1386,135
2021,Rhondda Cynon Taf 023C,W01001253,1403,1302,101
2021,Rhondda Cynon Taf 023E,W01001255,1939,1761,178
2021,Rhondda Cynon Taf 019C,W01001256,1155,1010,145
2021,Rhondda Cynon Taf 019D,W01001257,1203,1031,172
2021,Rhondda Cynon Taf 019E,W01001258,1211,1084,127
2021,Rhondda Cynon Taf 018E,W01001259,1558,1450,108
2021,Rhondda Cynon Taf 014C,W01001260,1140,1022,118
2021,Rhondda Cynon Taf 018F,W01001261,1208,1097,111
2021,Rhondda Cynon Taf 022D,W01001262,1534,1403,131
2021,Rhondda Cynon Taf 022E,W01001263,1642,1511,131
2021,Rhondda Cynon Taf 022F,W01001264,1884,1707,177
2021,Rhondda Cynon Taf 007A,W01001265,1493,1278,215
2021,Rhondda Cynon Taf 007B,W01001266,1332,1213,119
2021,Rhondda Cynon Taf 007C,W01001267,1439,1311,128
2021,Rhondda Cynon Taf 007D,W01001268,1277,1096,181
2021,Rhondda Cynon Taf 010A,W01001269,1411,1221,190
2021,Rhondda Cynon Taf 010B,W01001270,1406,1249,157
2021,Rhondda Cynon Taf 010C,W01001271,1479,1289,190
2021,Rhondda Cynon Taf 010D,W01001272,1426,1249,177
2021,Rhondda Cynon Taf 010E,W01001273,1710,1431,279
2021,Rhondda Cynon Taf 013B,W01001274,1144,1048,96
2021,Rhondda Cynon Taf 013C,W01001275,1729,1530,199
2021,Rhondda Cynon Taf 013D,W01001276,1225,1142,83
2021,Rhondda Cynon Taf 028D,W01001277,1089,994,95
2021,Rhondda Cynon Taf 028E,W01001278,1107,978,129
2021,Rhondda Cynon Taf 028F,W01001279,1069,987,82
2021,Rhondda Cynon Taf 017E,W01001280,1518,1398,120
2021,Rhondda Cynon Taf 017F,W01001281,1629,1421,208
2021,Rhondda Cynon Taf 015C,W01001282,1961,1746,215
2021,Rhondda Cynon Taf 015D,W01001283,1404,1205,199
2021,Rhondda Cynon Taf 015E,W01001284,1046,853,193
2021,Rhondda Cynon Taf 014D,W01001285,1332,1181,151
2021,Rhondda Cynon Taf 014E,W01001286,1420,1223,197
2021,Rhondda Cynon Taf 014F,W01001287,1417,1283,134
2021,Rhondda Cynon Taf 014G,W01001288,1384,1188,196
2021,Merthyr Tydfil 006A,W01001289,1314,1215,99
2021,Merthyr Tydfil 007A,W01001290,2304,2098,206
2021,Merthyr Tydfil 003A,W01001291,2002,1781,221
2021,Merthyr Tydfil 004A,W01001292,1759,1637,122
2021,Merthyr Tydfil 004B,W01001293,1638,1525,113
2021,Merthyr Tydfil 003B,W01001294,1628,1492,136
2021,Merthyr Tydfil 002A,W01001295,1454,1371,83
2021,Merthyr Tydfil 002B,W01001296,1521,1407,114
2021,Merthyr Tydfil 002C,W01001297,1762,1640,122
2021,Merthyr Tydfil 002D,W01001298,1678,1573,105
2021,Merthyr Tydfil 008A,W01001299,1617,1542,75
2021,Merthyr Tydfil 008B,W01001300,1676,1592,84
2021,Merthyr Tydfil 008C,W01001301,1835,1766,69
2021,Merthyr Tydfil 006B,W01001302,1370,1228,142
2021,Merthyr Tydfil 003C,W01001305,1193,1110,83
2021,Merthyr Tydfil 003D,W01001306,1387,1278,109
2021,Merthyr Tydfil 004C,W01001307,1490,1400,90
2021,Merthyr Tydfil 008D,W01001308,1194,1149,45
2021,Merthyr Tydfil 008E,W01001309,1257,1192,65
2021,Merthyr Tydfil 002E,W01001310,1494,1404,90
2021,Merthyr Tydfil 002F,W01001311,1103,1034,69
2021,Merthyr Tydfil 006E,W01001312,1431,1332,99
2021,Merthyr Tydfil 006F,W01001313,1437,1338,99
2021,Merthyr Tydfil 005A,W01001314,2050,1872,178
2021,Merthyr Tydfil 004D,W01001315,1658,1535,123
2021,Merthyr Tydfil 005C,W01001317,1689,1525,164
2021,Merthyr Tydfil 005D,W01001318,1438,1319,119
2021,Merthyr Tydfil 007B,W01001319,1566,1353,213
2021,Merthyr Tydfil 007C,W01001320,1386,1254,132
2021,Merthyr Tydfil 007D,W01001321,1564,1419,145
2021,Merthyr Tydfil 007E,W01001322,1578,1419,159
2021,Merthyr Tydfil 003E,W01001324,1878,1723,155
2021,Caerphilly 003A,W01001325,1602,1421,181
2021,Caerphilly 003B,W01001326,2079,1876,203
2021,Caerphilly 014A,W01001327,2361,2110,251
2021,Caerphilly 014B,W01001328,1464,1323,141
2021,Caerphilly 014C,W01001329,1447,1325,122
2021,Caerphilly 018A,W01001330,1401,1164,237
2021,Caerphilly 018B,W01001331,1679,1465,214
2021,Caerphilly 018C,W01001332,1781,1570,211
2021,Caerphilly 018D,W01001333,1420,1248,172
2021,Caerphilly 005A,W01001334,1396,1291,105
2021,Caerphilly 005B,W01001335,1237,1100,137
2021,Caerphilly 004A,W01001336,1369,1239,130
2021,Caerphilly 004B,W01001337,1408,1308,100
2021,Caerphilly 004C,W01001338,1663,1542,121
2021,Caerphilly 004D,W01001339,1367,1247,120
2021,Caerphilly 020A,W01001340,1826,1620,206
2021,Caerphilly 020B,W01001341,1652,1520,132
2021,Caerphilly 021A,W01001342,1158,1071,87
2021,Caerphilly 021B,W01001343,1071,959,112
2021,Caerphilly 020C,W01001344,1631,1488,143
2021,Caerphilly 021C,W01001345,1338,1244,94
2021,Caerphilly 020D,W01001346,1477,1341,136
2021,Caerphilly 005C,W01001347,1452,1343,109
2021,Caerphilly 009A,W01001348,1700,1602,98
2021,Caerphilly 009B,W01001349,1680,1494,186
2021,Caerphilly 009C,W01001350,1681,1567,114
2021,Caerphilly 005D,W01001351,1372,1284,88
2021,Caerphilly 007A,W01001352,1699,1599,100
2021,Caerphilly 007B,W01001353,1493,1414,79
2021,Caerphilly 014D,W01001354,1631,1499,132
2021,Caerphilly 015A,W01001355,1495,1385,110
2021,Caerphilly 006A,W01001356,1166,1082,84
2021,Caerphilly 006B,W01001357,1656,1525,131
2021,Caerphilly 006C,W01001358,1442,1345,97
2021,Caerphilly 006D,W01001359,1365,1278,87
2021,Caerphilly 002A,W01001360,1265,1161,104
2021,Caerphilly 002B,W01001361,1120,1051,69
2021,Caerphilly 003C,W01001362,1942,1769,173
2021,Caerphilly 012A,W01001363,1746,1564,182
2021,Caerphilly 012B,W01001364,1724,1596,128
2021,Caerphilly 012C,W01001365,1888,1694,194
2021,Caerphilly 019A,W01001366,1528,1392,136
2021,Caerphilly 019B,W01001367,1411,1288,123
2021,Caerphilly 019C,W01001368,1391,1259,132
2021,Caerphilly 012D,W01001369,2350,2137,213
2021,Caerphilly 023A,W01001370,1791,1586,205
2021,Caerphilly 022A,W01001371,1834,1608,226
2021,Caerphilly 022B,W01001372,1759,1497,262
2021,Caerphilly 022C,W01001373,1877,1603,274
2021,Caerphilly 001A,W01001374,1375,1287,88
2021,Caerphilly 001B,W01001375,1435,1264,171
2021,Caerphilly 001C,W01001376,1378,1277,101
2021,Caerphilly 013A,W01001377,1418,1283,135
2021,Caerphilly 013B,W01001378,1459,1340,119
2021,Caerphilly 013C,W01001379,1485,1304,181
2021,Caerphilly 010A,W01001380,1733,1622,111
2021,Caerphilly 010B,W01001381,1428,1350,78
2021,Caerphilly 010C,W01001382,1508,1396,112
2021,Caerphilly 010D,W01001383,1410,1290,120
2021,Caerphilly 002C,W01001384,1448,1358,90
2021,Caerphilly 002D,W01001385,1476,1398,78
2021,Caerphilly 002E,W01001386,1527,1452,75
2021,Caerphilly 007C,W01001387,1162,1033,129
2021,Caerphilly 007D,W01001388,1739,1569,170
2021,Caerphilly 007E,W01001389,1071,950,121
2021,Caerphilly 006E,W01001390,2046,1845,201
2021,Caerphilly 006F,W01001391,1583,1454,129
2021,Caerphilly 009D,W01001392,1890,1746,144
2021,Caerphilly 019D,W01001393,1302,1159,143
2021,Caerphilly 023B,W01001394,1257,1134,123
2021,Caerphilly 023C,W01001395,1282,1170,112
2021,Caerphilly 023D,W01001396,1498,1353,145
2021,Caerphilly 019E,W01001397,1533,1314,219
2021,Caerphilly 024A,W01001398,2683,2330,353
2021,Caerphilly 023E,W01001399,1221,1112,109
2021,Caerphilly 019F,W01001400,1358,1211,147
2021,Caerphilly 011A,W01001401,2002,1873,129
2021,Caerphilly 011B,W01001402,1548,1425,123
2021,Caerphilly 011C,W01001403,1543,1414,129
2021,Caerphilly 011D,W01001404,1321,1224,97
2021,Caerphilly 011E,W01001405,1734,1573,161
2021,Caerphilly 001D,W01001406,1777,1643,134
2021,Caerphilly 016A,W01001407,1276,1208,68
2021,Caerphilly 016B,W01001408,1388,1322,66
2021,Caerphilly 016C,W01001409,1532,1435,97
2021,Caerphilly 016D,W01001410,1746,1633,113
2021,Caerphilly 017A,W01001411,1569,1467,102
2021,Caerphilly 017B,W01001412,1605,1509,96
2021,Caerphilly 017C,W01001413,1767,1644,123
2021,Caerphilly 008A,W01001414,1527,1374,153
2021,Caerphilly 008B,W01001415,1673,1499,174
2021,Caerphilly 008C,W01001416,1341,1222,119
2021,Caerphilly 008D,W01001417,1340,1192,148
2021,Caerphilly 008E,W01001418,1355,1211,144
2021,Caerphilly 021D,W01001419,1570,1406,164
2021,Caerphilly 022D,W01001420,1184,1051,133
2021,Caerphilly 022E,W01001421,1391,1296,95
2021,Caerphilly 022F,W01001422,1423,1292,131
2021,Caerphilly 024B,W01001423,1341,1209,132
2021,Caerphilly 024C,W01001424,1370,1209,161
2021,Caerphilly 024D,W01001425,1685,1470,215
2021,Caerphilly 024E,W01001426,1411,1222,189
2021,Caerphilly 024F,W01001427,1798,1557,241
2021,Caerphilly 001E,W01001428,1188,1122,66
2021,Caerphilly 001F,W01001429,1129,995,134
2021,Caerphilly 015B,W01001430,2307,2133,174
2021,Caerphilly 015C,W01001431,1535,1418,117
2021,Caerphilly 013D,W01001432,2657,2296,361
2021,Caerphilly 013E,W01001433,1325,1161,164
2021,Caerphilly 013F,W01001434,1340,1142,198
2021,Blaenau Gwent 008A,W01001435,1313,1241,72
2021,Blaenau Gwent 008B,W01001436,1329,1276,53
2021,Blaenau Gwent 008C,W01001437,1401,1322,79
2021,Blaenau Gwent 004A,W01001438,1437,1372,65
2021,Blaenau Gwent 004B,W01001439,1560,1477,83
2021,Blaenau Gwent 001A,W01001440,1303,1229,74
2021,Blaenau Gwent 001B,W01001441,1115,1069,46
2021,Blaenau Gwent 001C,W01001442,1070,1000,70
2021,Blaenau Gwent 005A,W01001443,1200,1146,54
2021,Blaenau Gwent 005B,W01001444,1901,1783,118
2021,Blaenau Gwent 005C,W01001445,1306,1205,101
2021,Blaenau Gwent 002A,W01001446,1197,1127,70
2021,Blaenau Gwent 002B,W01001447,1424,1335,89
2021,Blaenau Gwent 002C,W01001448,1129,1062,67
2021,Blaenau Gwent 002D,W01001449,1330,1247,83
2021,Blaenau Gwent 007A,W01001450,1177,1129,48
2021,Blaenau Gwent 007B,W01001451,1258,1195,63
2021,Blaenau Gwent 007C,W01001452,1398,1310,88
2021,Blaenau Gwent 008D,W01001453,1443,1365,78
2021,Blaenau Gwent 008E,W01001454,1239,1189,50
2021,Blaenau Gwent 008F,W01001455,1614,1530,84
2021,Blaenau Gwent 004C,W01001456,1218,1158,60
2021,Blaenau Gwent 004D,W01001457,1719,1664,55
2021,Blaenau Gwent 004E,W01001458,1575,1500,75
2021,Blaenau Gwent 007D,W01001459,1152,1113,39
2021,Blaenau Gwent 007E,W01001460,1684,1565,119
2021,Blaenau Gwent 007F,W01001461,1232,1172,60
2021,Blaenau Gwent 006A,W01001462,1748,1632,116
2021,Blaenau Gwent 006B,W01001463,1740,1640,100
2021,Blaenau Gwent 009A,W01001464,1398,1327,71
2021,Blaenau Gwent 009B,W01001465,1481,1400,81
2021,Blaenau Gwent 009C,W01001466,1408,1354,54
2021,Blaenau Gwent 005D,W01001467,1825,1696,129
2021,Blaenau Gwent 005E,W01001468,1285,1206,79
2021,Blaenau Gwent 005F,W01001469,1266,1196,70
2021,Blaenau Gwent 001D,W01001470,1368,1305,63
2021,Blaenau Gwent 001E,W01001471,1562,1500,62
2021,Blaenau Gwent 003A,W01001472,1342,1239,103
2021,Blaenau Gwent 003B,W01001473,1225,1179,46
2021,Blaenau Gwent 003C,W01001474,1383,1301,82
2021,Blaenau Gwent 003D,W01001475,1089,1016,73
2021,Blaenau Gwent 006C,W01001478,1327,1243,84
2021,Blaenau Gwent 006D,W01001479,1408,1343,65
2021,Blaenau Gwent 003E,W01001480,1420,1327,93
2021,Blaenau Gwent 006E,W01001481,1598,1511,87
2021,Torfaen 002A,W01001482,1193,1065,128
2021,Torfaen 002B,W01001483,1376,1264,112
2021,Torfaen 002C,W01001484,1595,1453,142
2021,Torfaen 002D,W01001485,1213,1109,104
2021,Torfaen 002E,W01001486,1428,1302,126
2021,Torfaen 001A,W01001487,1611,1450,161
2021,Torfaen 001B,W01001488,1443,1346,97
2021,Torfaen 001C,W01001489,1395,1279,116
2021,Torfaen 001D,W01001490,1367,1254,113
2021,Torfaen 004A,W01001491,1633,1540,93
2021,Torfaen 012A,W01001492,2359,2183,176
2021,Torfaen 008A,W01001493,1753,1669,84
2021,Torfaen 008B,W01001494,1500,1385,115
2021,Torfaen 008C,W01001495,1743,1607,136
2021,Torfaen 004B,W01001496,1404,1317,87
2021,Torfaen 011A,W01001497,1346,1252,94
2021,Torfaen 011B,W01001498,1209,1102,107
2021,Torfaen 011C,W01001499,1116,1020,96
2021,Torfaen 011D,W01001500,1214,1138,76
2021,Torfaen 009A,W01001501,1279,1182,97
2021,Torfaen 011E,W01001502,1175,1109,66
2021,Torfaen 009B,W01001503,1196,1117,79
2021,Torfaen 013A,W01001504,2251,2100,151
2021,Torfaen 013B,W01001505,2546,2358,188
2021,Torfaen 010A,W01001506,1479,1402,77
2021,Torfaen 008D,W01001507,1894,1776,118
2021,Torfaen 013C,W01001508,1158,1092,66
2021,Torfaen 013D,W01001509,1366,1263,103
2021,Torfaen 005A,W01001510,1556,1466,90
2021,Torfaen 005B,W01001511,1491,1402,89
2021,Torfaen 005C,W01001512,1270,1230,40
2021,Torfaen 005D,W01001513,1430,1325,105
2021,Torfaen 006A,W01001514,1054,978,76
2021,Torfaen 006B,W01001515,1366,1245,121
2021,Torfaen 006C,W01001516,1381,1281,100
2021,Torfaen 006D,W01001517,2373,2166,207
2021,Torfaen 006E,W01001518,1111,1038,73
2021,Torfaen 007A,W01001519,1236,1166,70
2021,Torfaen 007B,W01001520,2493,2264,229
2021,Torfaen 007C,W01001521,1370,1263,107
2021,Torfaen 007D,W01001522,1563,1441,122
2021,Torfaen 004C,W01001523,1379,1273,106
2021,Torfaen 004D,W01001524,1809,1689,120
2021,Torfaen 003A,W01001525,1792,1681,111
2021,Torfaen 010B,W01001526,1332,1222,110
2021,Torfaen 010C,W01001527,1151,1080,71
2021,Torfaen 010D,W01001528,1697,1556,141
2021,Torfaen 003B,W01001529,1937,1815,122
2021,Torfaen 003C,W01001530,1706,1592,114
2021,Torfaen 003D,W01001531,1621,1514,107
2021,Torfaen 010E,W01001532,1706,1589,117
2021,Torfaen 012B,W01001533,1469,1351,118
2021,Torfaen 012C,W01001534,1365,1269,96
2021,Torfaen 012D,W01001535,1222,1161,61
2021,Torfaen 009C,W01001536,1091,1032,59
2021,Torfaen 007E,W01001537,1140,1054,86
2021,Torfaen 009D,W01001538,1288,1205,83
2021,Torfaen 009E,W01001539,1386,1288,98
2021,Torfaen 004E,W01001540,1229,1137,92
2021,Torfaen 004F,W01001541,1133,1041,92
2021,Monmouthshire 009A,W01001542,2067,1910,157
2021,Monmouthshire 009B,W01001543,1739,1561,178
2021,Monmouthshire 001A,W01001545,1497,1360,137
2021,Monmouthshire 002A,W01001546,1509,1392,117
2021,Monmouthshire 001B,W01001548,2049,1880,169
2021,Monmouthshire 007A,W01001549,1371,1274,97
2021,Monmouthshire 010C,W01001551,1137,1056,81
2021,Monmouthshire 004A,W01001552,1485,1385,100
2021,Monmouthshire 004C,W01001554,1508,1419,89
2021,Monmouthshire 006A,W01001555,1120,1022,98
2021,Monmouthshire 006B,W01001556,1331,1217,114
2021,Monmouthshire 001C,W01001557,1767,1615,152
2021,Monmouthshire 002C,W01001558,1545,1419,126
2021,Monmouthshire 008A,W01001559,1248,1174,74
2021,Monmouthshire 006C,W01001560,1349,1265,84
2021,Monmouthshire 003A,W01001561,1560,1447,113
2021,Monmouthshire 003B,W01001562,1330,1223,107
2021,Monmouthshire 003C,W01001563,1107,1031,76
2021,Monmouthshire 006D,W01001565,1780,1673,107
2021,Monmouthshire 005C,W01001568,1742,1598,144
2021,Monmouthshire 003E,W01001569,1315,1200,115
2021,Monmouthshire 001D,W01001571,1460,1323,137
2021,Monmouthshire 011A,W01001572,1576,1452,124
2021,Monmouthshire 011B,W01001573,1391,1273,118
2021,Monmouthshire 011C,W01001574,1276,1177,99
2021,Monmouthshire 005D,W01001575,1218,1122,96
2021,Monmouthshire 004D,W01001576,1042,982,60
2021,Monmouthshire 004E,W01001577,1255,1169,86
2021,Monmouthshire 009C,W01001578,2425,2245,180
2021,Monmouthshire 001E,W01001579,1539,1429,110
2021,Monmouthshire 002E,W01001580,1713,1593,120
2021,Monmouthshire 005E,W01001581,1901,1743,158
2021,Monmouthshire 011D,W01001582,1728,1569,159
2021,Monmouthshire 007B,W01001583,1491,1369,122
2021,Monmouthshire 008B,W01001584,1716,1601,115
2021,Monmouthshire 007C,W01001585,1252,1157,95
2021,Monmouthshire 007D,W01001586,2424,2203,221
2021,Monmouthshire 008C,W01001587,1819,1718,101
2021,Monmouthshire 010D,W01001588,1580,1475,105
2021,Monmouthshire 010E,W01001589,1382,1300,82
2021,Monmouthshire 009D,W01001590,2078,1940,138
2021,Monmouthshire 011E,W01001591,1534,1384,150
2021,Monmouthshire 008D,W01001592,1581,1465,116
2021,Monmouthshire 008E,W01001593,1573,1492,81
2021,Monmouthshire 007E,W01001594,1375,1265,110
2021,Monmouthshire 007F,W01001595,1262,1191,71
2021,Monmouthshire 006E,W01001596,1202,1136,66
2021,Monmouthshire 006F,W01001597,1392,1302,90
2021,Monmouthshire 010F,W01001598,1606,1491,115
2021,Monmouthshire 004F,W01001599,2084,1951,133
2021,Newport 012A,W01001600,1783,1641,142
2021,Newport 006A,W01001601,1491,1375,116
2021,Newport 012B,W01001602,1573,1439,134
2021,Newport 012C,W01001603,1481,1364,117
2021,Newport 012D,W01001604,1454,1344,110
2021,Newport 014A,W01001605,1425,1316,109
2021,Newport 008A,W01001606,1235,1126,109
2021,Newport 015A,W01001607,1304,1225,79
2021,Newport 008B,W01001608,1450,1343,107
2021,Newport 015B,W01001609,1827,1707,120
2021,Newport 015C,W01001610,1279,1195,84
2021,Newport 011A,W01001611,1161,1104,57
2021,Newport 011B,W01001612,1481,1397,84
2021,Newport 011C,W01001613,1458,1336,122
2021,Newport 005A,W01001614,1529,1447,82
2021,Newport 005B,W01001615,1528,1444,84
2021,Newport 005C,W01001616,1368,1264,104
2021,Newport 003A,W01001617,1392,1307,85
2021,Newport 003B,W01001618,1090,1031,59
2021,Newport 003C,W01001619,1309,1236,73
2021,Newport 003D,W01001620,1620,1505,115
2021,Newport 003E,W01001621,1379,1284,95
2021,Newport 003F,W01001622,1170,1108,62
2021,Newport 001A,W01001623,1382,1285,97
2021,Newport 001B,W01001624,1184,1121,63
2021,Newport 001C,W01001625,1162,1081,81
2021,Newport 001D,W01001626,1468,1344,124
2021,Newport 001E,W01001627,1574,1462,112
2021,Newport 001F,W01001628,1026,980,46
2021,Newport 017A,W01001629,1347,1270,77
2021,Newport 017B,W01001630,1585,1520,65
2021,Newport 017C,W01001631,1295,1227,68
2021,Newport 017D,W01001632,1366,1298,68
2021,Newport 019A,W01001633,1626,1535,91
2021,Newport 019B,W01001634,1440,1338,102
2021,Newport 016A,W01001635,1295,1211,84
2021,Newport 020A,W01001636,1872,1717,155
2021,Newport 016B,W01001637,2064,1926,138
2021,Newport 016C,W01001638,1182,1084,98
2021,Newport 004A,W01001639,2090,1931,159
2021,Newport 004B,W01001640,1088,1023,65
2021,Newport 004C,W01001641,1335,1245,90
2021,Newport 013A,W01001642,1587,1501,86
2021,Newport 013B,W01001643,1822,1719,103
2021,Newport 015D,W01001645,1248,1180,68
2021,Newport 015E,W01001646,1568,1433,135
2021,Newport 015G,W01001648,1509,1439,70
2021,Newport 004E,W01001650,1612,1522,90
2021,Newport 002A,W01001651,1402,1328,74
2021,Newport 002B,W01001652,1593,1530,63
2021,Newport 002C,W01001653,1327,1244,83
2021,Newport 002D,W01001654,1536,1440,96
2021,Newport 002E,W01001655,1528,1445,83
2021,Newport 020C,W01001657,1414,1304,110
2021,Newport 020D,W01001658,2018,1860,158
2021,Newport 018A,W01001659,1828,1754,74
2021,Newport 018B,W01001660,2586,2409,177
2021,Newport 018C,W01001661,2847,2674,173
2021,Newport 018D,W01001662,1628,1498,130
2021,Newport 008C,W01001663,1351,1289,62
2021,Newport 010A,W01001664,1171,1123,48
2021,Newport 008D,W01001665,1597,1498,99
2021,Newport 010B,W01001666,1452,1370,82
2021,Newport 010C,W01001667,1259,1196,63
2021,Newport 010D,W01001668,1183,1103,80
2021,Newport 009A,W01001669,1232,1149,83
2021,Newport 009B,W01001670,2227,2032,195
2021,Newport 016D,W01001671,2208,2066,142
2021,Newport 009D,W01001673,1389,1306,83
2021,Newport 009E,W01001674,1513,1421,92
2021,Newport 007A,W01001675,1523,1444,79
2021,Newport 007B,W01001676,1780,1639,141
2021,Newport 007C,W01001677,1350,1266,84
2021,Newport 005D,W01001678,1578,1487,91
2021,Newport 007D,W01001679,1079,981,98
2021,Newport 007E,W01001680,1241,1134,107
2021,Newport 006B,W01001681,1285,1204,81
2021,Newport 006C,W01001682,1353,1290,63
2021,Newport 006D,W01001683,1058,977,81
2021,Newport 006E,W01001684,1363,1252,111
2021,Newport 014B,W01001685,1642,1537,105
2021,Newport 014C,W01001686,1266,1170,96
2021,Newport 014D,W01001687,2263,2167,96
2021,Newport 019D,W01001689,2018,1861,157
2021,Newport 013D,W01001690,2106,1981,125
2021,Newport 011D,W01001691,1641,1572,69
2021,Newport 011E,W01001692,2192,2062,130
2021,Newport 013E,W01001693,2743,2648,95
2021,Cardiff 036A,W01001694,1931,1821,110
2021,Cardiff 036B,W01001695,3932,3694,238
2021,Cardiff 036C,W01001696,1478,1372,106
2021,Cardiff 036D,W01001697,1867,1697,170
2021,Cardiff 036E,W01001698,2012,1860,152
2021,Cardiff 049A,W01001699,2422,2284,138
2021,Cardiff 045A,W01001702,1721,1553,168
2021,Cardiff 045B,W01001703,1162,1079,83
2021,Cardiff 041A,W01001704,1612,1511,101
2021,Cardiff 045C,W01001705,1899,1742,157
2021,Cardiff 041B,W01001706,1336,1226,110
2021,Cardiff 041C,W01001707,1958,1786,172
2021,Cardiff 045D,W01001708,1597,1461,136
2021,Cardiff 040B,W01001710,1775,1409,366
2021,Cardiff 040C,W01001711,2026,1827,199
2021,Cardiff 040D,W01001712,1412,1125,287
2021,Cardiff 040E,W01001713,1672,1256,416
2021,Cardiff 035A,W01001714,1527,1037,490
2021,Cardiff 035B,W01001715,1517,1142,375
2021,Cardiff 035C,W01001716,1242,937,305
2021,Cardiff 035D,W01001717,1470,1149,321
2021,Cardiff 028A,W01001718,1728,1545,183
2021,Cardiff 028B,W01001719,1985,1771,214
2021,Cardiff 028C,W01001720,2223,1998,225
2021,Cardiff 032A,W01001721,2875,2646,229
2021,Cardiff 028D,W01001722,1748,1589,159
2021,Cardiff 032C,W01001724,2392,2156,236
2021,Cardiff 032D,W01001725,2299,2088,211
2021,Cardiff 028E,W01001726,1758,1576,182
2021,Cardiff 014A,W01001727,1172,964,208
2021,Cardiff 014B,W01001728,1386,1055,331
2021,Cardiff 014C,W01001729,2787,2430,357
2021,Cardiff 008A,W01001730,1516,1339,177
2021,Cardiff 008B,W01001731,1419,1247,172
2021,Cardiff 019A,W01001732,1698,1508,190
2021,Cardiff 019B,W01001733,1465,1318,147
2021,Cardiff 019C,W01001734,1566,1370,196
2021,Cardiff 019D,W01001735,1998,1757,241
2021,Cardiff 008C,W01001736,1457,1297,160
2021,Cardiff 039A,W01001737,1573,1458,115
2021,Cardiff 039B,W01001738,1365,1287,78
2021,Cardiff 039C,W01001739,1408,1300,108
2021,Cardiff 039D,W01001740,1449,1349,100
2021,Cardiff 039E,W01001741,1573,1466,107
2021,Cardiff 043A,W01001742,1533,1402,131
2021,Cardiff 043B,W01001743,1412,1279,133
2021,Cardiff 043C,W01001744,1644,1538,106
2021,Cardiff 043D,W01001745,1235,1140,95
2021,Cardiff 041D,W01001746,1475,1368,107
2021,Cardiff 027A,W01001747,1627,1469,158
2021,Cardiff 027B,W01001748,1509,1376,133
2021,Cardiff 027C,W01001749,1493,1350,143
2021,Cardiff 031A,W01001750,1562,1427,135
2021,Cardiff 027D,W01001751,1730,1592,138
2021,Cardiff 031B,W01001752,1541,1366,175
2021,Cardiff 031C,W01001753,1589,1450,139
2021,Cardiff 031D,W01001754,1563,1394,169
2021,Cardiff 025A,W01001755,1452,1246,206
2021,Cardiff 025B,W01001756,4209,3844,365
2021,Cardiff 025C,W01001757,1420,1216,204
2021,Cardiff 025D,W01001758,2141,1835,306
2021,Cardiff 046A,W01001759,1531,1410,121
2021,Cardiff 046B,W01001760,1596,1433,163
2021,Cardiff 046C,W01001761,1711,1488,223
2021,Cardiff 046D,W01001762,1757,1589,168
2021,Cardiff 044A,W01001764,1961,1763,198
2021,Cardiff 044B,W01001765,1389,1232,157
2021,Cardiff 044C,W01001766,1626,1425,201
2021,Cardiff 044D,W01001767,1756,1561,195
2021,Cardiff 044E,W01001768,1605,1461,144
2021,Cardiff 018A,W01001769,1539,1291,248
2021,Cardiff 018B,W01001770,1013,864,149
2021,Cardiff 018C,W01001771,1612,1386,226
2021,Cardiff 021A,W01001772,1361,1197,164
2021,Cardiff 012A,W01001773,2464,2228,236
2021,Cardiff 018D,W01001774,1358,1143,215
2021,Cardiff 021B,W01001775,1550,1388,162
2021,Cardiff 021C,W01001776,1257,1128,129
2021,Cardiff 001A,W01001777,1714,1519,195
2021,Cardiff 001B,W01001778,1714,1502,212
2021,Cardiff 026A,W01001779,1473,1263,210
2021,Cardiff 026B,W01001780,1606,1307,299
2021,Cardiff 026C,W01001781,1636,1284,352
2021,Cardiff 026D,W01001782,1416,1130,286
2021,Cardiff 026E,W01001783,1183,1061,122
2021,Cardiff 026F,W01001784,1279,1138,141
2021,Cardiff 023A,W01001785,1167,1057,110
2021,Cardiff 023B,W01001786,1440,1222,218
2021,Cardiff 023C,W01001787,1340,1207,133
2021,Cardiff 023D,W01001788,1538,1399,139
2021,Cardiff 023E,W01001789,1497,1220,277
2021,Cardiff 023F,W01001790,1178,1064,114
2021,Cardiff 005A,W01001791,1772,1541,231
2021,Cardiff 005B,W01001792,1566,1434,132
2021,Cardiff 002A,W01001793,1314,1169,145
2021,Cardiff 001C,W01001794,1297,1148,149
2021,Cardiff 002B,W01001795,1456,1289,167
2021,Cardiff 002C,W01001796,1394,1234,160
2021,Cardiff 005C,W01001797,1390,1227,163
2021,Cardiff 002D,W01001798,1359,1220,139
2021,Cardiff 001D,W01001799,1241,1074,167
2021,Cardiff 005D,W01001800,1370,1244,126
2021,Cardiff 007A,W01001802,1656,1578,78
2021,Cardiff 015A,W01001803,1617,1524,93
2021,Cardiff 015B,W01001804,1538,1425,113
2021,Cardiff 015C,W01001805,1495,1355,140
2021,Cardiff 015D,W01001806,1667,1498,169
2021,Cardiff 007B,W01001807,1593,1479,114
2021,Cardiff 007C,W01001808,1660,1556,104
2021,Cardiff 017A,W01001809,1185,1074,111
2021,Cardiff 017B,W01001810,1682,1570,112
2021,Cardiff 009A,W01001811,1521,1401,120
2021,Cardiff 017C,W01001812,1236,1170,66
2021,Cardiff 017D,W01001813,1774,1636,138
2021,Cardiff 017E,W01001814,1401,1304,97
2021,Cardiff 008D,W01001815,1350,1268,82
2021,Cardiff 009B,W01001816,2673,2444,229
2021,Cardiff 009C,W01001817,1346,1245,101
2021,Cardiff 009D,W01001818,1503,1383,120
2021,Cardiff 014D,W01001819,2327,1916,411
2021,Cardiff 006A,W01001820,1170,915,255
2021,Cardiff 024A,W01001821,1693,1525,168
2021,Cardiff 029A,W01001822,1797,1594,203
2021,Cardiff 029B,W01001823,1232,1031,201
2021,Cardiff 029C,W01001824,1510,1332,178
2021,Cardiff 029D,W01001825,1909,1656,253
2021,Cardiff 024B,W01001826,1343,1147,196
2021,Cardiff 024C,W01001827,1608,1428,180
2021,Cardiff 024D,W01001828,1472,1275,197
2021,Cardiff 033A,W01001829,1963,1819,144
2021,Cardiff 033B,W01001830,1595,1451,144
2021,Cardiff 030A,W01001831,1459,1293,166
2021,Cardiff 033C,W01001832,1743,1605,138
2021,Cardiff 033D,W01001833,1500,1310,190
2021,Cardiff 033E,W01001834,1609,1459,150
2021,Cardiff 033F,W01001835,2161,2001,160
2021,Cardiff 030B,W01001836,1302,1119,183
2021,Cardiff 030C,W01001837,1438,1323,115
2021,Cardiff 030D,W01001838,1596,1382,214
2021,Cardiff 030E,W01001839,1554,1383,171
2021,Cardiff 007D,W01001840,1885,1777,108
2021,Cardiff 003A,W01001841,1859,1687,172
2021,Cardiff 003B,W01001842,1696,1526,170
2021,Cardiff 003D,W01001844,1832,1656,176
2021,Cardiff 006C,W01001846,1699,1451,248
2021,Cardiff 006D,W01001847,1508,1340,168
2021,Cardiff 012B,W01001848,1416,1202,214
2021,Cardiff 004A,W01001849,1518,1323,195
2021,Cardiff 012C,W01001850,1868,1565,303
2021,Cardiff 012D,W01001851,1519,1355,164
2021,Cardiff 004B,W01001852,1827,1578,249
2021,Cardiff 004C,W01001853,1569,1404,165
2021,Cardiff 004D,W01001854,1498,1345,153
2021,Cardiff 042A,W01001855,1726,1533,193
2021,Cardiff 042B,W01001856,1661,1538,123
2021,Cardiff 042C,W01001857,2014,1862,152
2021,Cardiff 034A,W01001858,1556,1275,281
2021,Cardiff 034B,W01001859,1462,1147,315
2021,Cardiff 034C,W01001860,1615,1297,318
2021,Cardiff 034D,W01001861,1501,1169,332
2021,Cardiff 042D,W01001862,1808,1654,154
2021,Cardiff 022A,W01001863,1457,1335,122
2021,Cardiff 022B,W01001864,1432,1336,96
2021,Cardiff 022C,W01001865,1254,1143,111
2021,Cardiff 016A,W01001866,1520,1419,101
2021,Cardiff 016B,W01001867,1366,1260,106
2021,Cardiff 022D,W01001868,1470,1345,125
2021,Cardiff 038A,W01001869,1347,1237,110
2021,Cardiff 037A,W01001870,1404,1235,169
2021,Cardiff 037B,W01001871,1587,1462,125
2021,Cardiff 038B,W01001872,1555,1419,136
2021,Cardiff 038C,W01001873,1759,1595,164
2021,Cardiff 038D,W01001874,1467,1330,137
2021,Cardiff 037D,W01001876,1570,1464,106
2021,Cardiff 011A,W01001877,1770,1616,154
2021,Cardiff 011B,W01001878,1521,1415,106
2021,Cardiff 013A,W01001879,1831,1701,130
2021,Cardiff 013B,W01001880,1585,1473,112
2021,Cardiff 013C,W01001881,1423,1351,72
2021,Cardiff 011C,W01001882,1681,1545,136
2021,Cardiff 016C,W01001883,1608,1502,106
2021,Cardiff 013D,W01001884,1376,1261,115
2021,Cardiff 011D,W01001885,2496,2303,193
2021,Cardiff 016D,W01001886,1274,1181,93
2021,Cardiff 020A,W01001887,1579,1144,435
2021,Cardiff 010A,W01001888,1604,1333,271
2021,Cardiff 020B,W01001889,1433,1253,180
2021,Cardiff 021D,W01001890,1522,1366,156
2021,Cardiff 020C,W01001891,1587,1332,255
2021,Cardiff 020D,W01001892,1386,1206,180
2021,Cardiff 010B,W01001893,1781,1587,194
2021,Cardiff 010C,W01001894,1483,1262,221
2021,Cardiff 010D,W01001895,1589,1348,241
2021,Cardiff 020E,W01001896,1414,1088,326
2021,Powys 020D,W01001897,1833,1640,193
2021,Merthyr Tydfil 008F,W01001898,1427,1320,107
2021,Powys 021F,W01001899,2137,1530,607
2021,Neath Port Talbot 020G,W01001900,1373,1007,366
2021,Powys 017F,W01001901,1773,1602,171
2021,Powys 017G,W01001902,1344,1236,108
2021,Powys 018F,W01001903,2068,1895,173
2021,Powys 018G,W01001904,1614,1489,125
2021,Powys 018H,W01001905,2107,1904,203
2021,Powys 001F,W01001906,1907,1262,645
2021,Powys 001G,W01001907,1347,1016,331
2021,Monmouthshire 010G,W01001908,2073,1911,162
2021,Vale of Glamorgan 012G,W01001910,1602,1433,169
2021,Vale of Glamorgan 012H,W01001911,1102,1009,93
2021,Newport 020E,W01001912,1485,1401,84
2021,Newport 020F,W01001913,1407,1280,127
2021,Rhondda Cynon Taf 023F,W01001914,1870,1618,252
2021,Rhondda Cynon Taf 027F,W01001915,1601,1298,303
2021,Rhondda Cynon Taf 027G,W01001916,1448,1112,336
2021,Rhondda Cynon Taf 023G,W01001917,1427,1322,105
2021,Bridgend 017E,W01001918,1818,1615,203
2021,Bridgend 017F,W01001919,1328,1209,119
2021,Bridgend 017G,W01001920,1167,1040,127
2021,Bridgend 017H,W01001921,1477,1350,127
2021,Cardiff 032E,W01001922,2009,1818,191
2021,Carmarthenshire 026G,W01001923,1690,1378,312
2021,Carmarthenshire 026H,W01001924,1324,1160,164
2021,Carmarthenshire 023F,W01001925,2139,1612,527
2021,Conwy 011F,W01001926,2064,1532,532
2021,Conwy 010G,W01001927,1312,1172,140
2021,Conwy 010H,W01001928,1059,967,92
2021,Wrexham 012F,W01001929,1131,1059,72
2021,Wrexham 019F,W01001930,2026,1536,490
2021,Wrexham 012G,W01001931,1367,1270,97
2021,Gwynedd 014E,W01001932,2694,775,1919
2021,Gwynedd 017F,W01001933,1878,1191,687
2021,Ceredigion 003E,W01001935,1006,652,354
2021,Ceredigion 003F,W01001936,1434,1084,350
2021,Ceredigion 001F,W01001937,1916,1230,686
2021,Cardiff 048A,W01001940,1028,931,97
2021,Cardiff 049B,W01001942,1536,1412,124
2021,Cardiff 048B,W01001943,1162,1042,120
2021,Cardiff 048C,W01001944,1152,1018,134
2021,Cardiff 049C,W01001946,1283,1195,88
2021,Cardiff 048E,W01001947,1657,1502,155
2021,Cardiff 006E,W01001948,2184,1879,305
2021,Cardiff 005F,W01001949,1266,1158,108
2021,Cardiff 049D,W01001950,1131,1038,93
2021,Cardiff 049E,W01001951,1498,1351,147
2021,Cardiff 049F,W01001952,1848,1734,114
2021,Cardiff 005G,W01001953,1457,1273,184
2021,Cardiff 006F,W01001954,1500,1287,213
2021,Swansea 025F,W01001955,1903,1835,68
2021,Swansea 032C,W01001956,2196,2010,186
2021,Swansea 025H,W01001958,1285,1192,93
2021,Merthyr Tydfil 005E,W01001959,1499,1373,126
2021,Merthyr Tydfil 005F,W01001960,1395,1241,154
2021,Merthyr Tydfil 006G,W01001961,2281,2042,239
2021,Rhondda Cynon Taf 011E,W01001962,2391,2146,245
2021,Rhondda Cynon Taf 014H,W01001963,2189,2013,176
2021,Rhondda Cynon Taf 021H,W01001964,2197,1973,224
2021,Rhondda Cynon Taf 029E,W01001965,1653,1454,199
2021,Rhondda Cynon Taf 029F,W01001966,1650,1359,291
2021,Rhondda Cynon Taf 031G,W01001967,1452,1201,251
2021,Rhondda Cynon Taf 031H,W01001968,1438,1208,230
2021,Wrexham 010F,W01001969,2210,2043,167
2021,Wrexham 021C,W01001970,2111,1952,159
2021,Wrexham 022D,W01001971,2637,2491,146
2021,Wrexham 022E,W01001972,1271,1152,119
2021,Blaenau Gwent 009F,W01001973,2191,2078,113
2021,Monmouthshire 002G,W01001974,1366,1275,91
2021,Monmouthshire 002H,W01001975,1272,1155,117
2021,Monmouthshire 003F,W01001976,1570,1437,133
2021,Monmouthshire 003G,W01001977,1406,1295,111
2021,Monmouthshire 004G,W01001978,1455,1351,104
2021,Monmouthshire 004H,W01001979,1964,1798,166
2021,Monmouthshire 005F,W01001980,2154,2010,144
2021,Bridgend 011D,W01001981,2890,2670,220
2021,Bridgend 011E,W01001982,1269,1129,140
2021,Bridgend 011F,W01001983,1404,1224,180
2021,Bridgend 011G,W01001984,1134,1014,120
2021,Neath Port Talbot 006F,W01001985,2005,1774,231
2021,Neath Port Talbot 007E,W01001986,2383,2154,229
2021,Neath Port Talbot 010G,W01001987,1437,1306,131
2021,Neath Port Talbot 010H,W01001988,1408,1225,183
2021,Neath Port Talbot 010I,W01001989,3364,3117,247
2021,Neath Port Talbot 021E,W01001990,2085,1978,107
2021,Swansea 005G,W01001991,1359,1216,143
2021,Swansea 005H,W01001992,1381,1249,132
2021,Swansea 006E,W01001993,1639,1380,259
2021,Swansea 006F,W01001994,1427,1273,154
2021,Swansea 021E,W01001995,1329,1243,86
2021,Swansea 021F,W01001996,1386,1288,98
2021,Swansea 025I,W01001997,1958,1839,119
2021,Vale of Glamorgan 015G,W01001998,2157,1966,191
2021,Carmarthenshire 019F,W01001999,2427,1854,573
2021,Ceredigion 002G,W01002000,2896,2360,536
2021,Ceredigion 002H,W01002001,1404,1163,241
2021,Ceredigion 007E,W01002002,4232,2574,1658
2021,Gwynedd 013E,W01002003,2337,1391,946
2021,Gwynedd 016F,W01002004,2098,1419,679
2021,Isle of Anglesey 002E,W01002005,2190,1083,1107
2021,Isle of Anglesey 004G,W01002007,2165,1303,862
2021,Isle of Anglesey 007F,W01002008,2047,1173,874
2021,Pembrokeshire 005E,W01002009,1174,1039,135
2021,Pembrokeshire 005F,W01002010,1076,992,84
2021,Pembrokeshire 010D,W01002011,1529,1432,97
2021,Pembrokeshire 010E,W01002012,1393,1311,82
2021,Pembrokeshire 011G,W01002013,2321,2130,191
2021,Pembrokeshire 016E,W01002014,2050,1862,188
2021,Cardiff 003E,W01002016,1155,1036,119
2021,Cardiff 003F,W01002017,1297,1152,145
2021,Cardiff 003G,W01002018,1480,1309,171
2021,Cardiff 032H,W01002019,2583,2422,161
2021,Cardiff 037E,W01002020,1503,1394,109
2021,Cardiff 037F,W01002021,1442,1303,139
2021,Cardiff 040F,W01002022,1150,909,241
2021,Cardiff 040G,W01002023,1750,1411,339
2021,Cardiff 048F,W01002024,1088,1001,87
2021,Cardiff 048G,W01002025,1074,985,89
2021,Newport 004F,W01002026,1745,1619,126
2021,Newport 004G,W01002027,1734,1639,95
2021,Newport 009F,W01002028,1891,1778,113
2021,Newport 009G,W01002029,1635,1490,145
2021,Newport 013F,W01002030,1359,1279,80
2021,Newport 013G,W01002031,1605,1490,115
2021,Newport 015H,W01002032,1247,1181,66
2021,Newport 015I,W01002033,1332,1244,88
2021,Newport 019E,W01002034,1631,1497,134
2021,Newport 019F,W01002035,1528,1403,125
2021,Vale of Glamorgan 005G,W01002036,1505,1368,137
2021,Vale of Glamorgan 005H,W01002037,1042,922,120
2021,Vale of Glamorgan 014G,W01002038,1239,1132,107
2021,Vale of Glamorgan 014H,W01002039,1681,1456,225
2021,Vale of Glamorgan 015F,W01002040,1821,1610,211
