date,geography,geography code,Proficiency in English language: Total: All usual residents aged 3 years and over,Proficiency in English language: Main language is English (English or Welsh in Wales),Proficiency in English language: Main language is not English (English or Welsh in Wales),Proficiency in English language: Main language is not English (English or Welsh in Wales): Can speak English very well,Proficiency in English language: Main language is not English (English or Welsh in Wales): Can speak English well,Proficiency in English language: Main language is not English (English or Welsh in Wales): Cannot speak English well,Proficiency in English language: Main language is not English (English or Welsh in Wales): Cannot speak English
2021,City of London 001A,E01000001,1449,1246,203,166,32,4,1
2021,City of London 001B,E01000002,1363,1124,239,199,35,5,0
2021,City of London 001C,E01000003,1586,1336,250,183,54,13,0
2021,City of London 001E,E01000005,1071,756,315,132,111,60,12
2021,Barking and Dagenham 016A,E01000006,1749,1123,626,202,294,108,22
2021,Barking and Dagenham 015A,E01000007,2745,1839,906,358,376,149,23
2021,Barking and Dagenham 015B,E01000008,1720,1299,421,130,187,94,10
2021,Barking and Dagenham 016B,E01000009,1725,973,752,263,287,176,26
2021,Barking and Dagenham 016C,E01000011,1641,920,721,232,271,196,22
2021,Barking and Dagenham 015D,E01000012,2173,1404,769,246,336,158,29
2021,Barking and Dagenham 013A,E01000013,1813,1374,439,146,213,75,5
2021,Barking and Dagenham 013B,E01000014,1673,1288,385,135,155,81,14
2021,Barking and Dagenham 009A,E01000015,2295,1775,520,193,215,104,8
2021,Barking and Dagenham 009B,E01000016,1786,1403,383,162,160,53,8
2021,Barking and Dagenham 009C,E01000017,1666,1333,333,123,137,65,8
2021,Barking and Dagenham 009D,E01000018,1708,1314,394,157,177,53,7
2021,Barking and Dagenham 023A,E01000019,1589,1169,420,144,186,83,7
2021,Barking and Dagenham 023B,E01000020,2095,1641,454,163,201,81,9
2021,Barking and Dagenham 008A,E01000021,1628,1197,431,164,178,77,12
2021,Barking and Dagenham 008B,E01000022,1424,1098,326,112,141,65,8
2021,Barking and Dagenham 008D,E01000024,1434,1080,354,137,138,68,11
2021,Barking and Dagenham 008E,E01000025,1834,1429,405,175,162,57,11
2021,Barking and Dagenham 001A,E01000027,1988,1645,343,137,135,66,5
2021,Barking and Dagenham 001B,E01000028,1742,1351,391,147,158,78,8
2021,Barking and Dagenham 001C,E01000029,1757,1383,374,160,152,54,8
2021,Barking and Dagenham 001D,E01000030,2437,2078,359,141,151,57,10
2021,Barking and Dagenham 002A,E01000031,1700,1333,367,171,128,62,6
2021,Barking and Dagenham 002B,E01000032,1981,1428,553,229,206,102,16
2021,Barking and Dagenham 006A,E01000033,1486,1285,201,61,89,45,6
2021,Barking and Dagenham 003A,E01000034,1529,1293,236,107,91,30,8
2021,Barking and Dagenham 010A,E01000035,1790,1346,444,167,166,95,16
2021,Barking and Dagenham 010B,E01000036,1415,1041,374,124,159,81,10
2021,Barking and Dagenham 003B,E01000037,1645,1412,233,86,107,36,4
2021,Barking and Dagenham 003C,E01000038,1572,1295,277,119,111,41,6
2021,Barking and Dagenham 003D,E01000039,1677,1422,255,108,99,42,6
2021,Barking and Dagenham 019A,E01000040,1790,1247,543,146,272,118,7
2021,Barking and Dagenham 017A,E01000041,1771,1360,411,134,188,76,13
2021,Barking and Dagenham 017B,E01000042,1779,1387,392,150,140,95,7
2021,Barking and Dagenham 019B,E01000043,1491,1100,391,134,154,94,9
2021,Barking and Dagenham 016D,E01000044,1900,1218,682,242,274,148,18
2021,Barking and Dagenham 017C,E01000045,1643,1269,374,124,163,76,11
2021,Barking and Dagenham 017D,E01000046,1874,1459,415,156,186,65,8
2021,Barking and Dagenham 021C,E01000049,1871,1361,510,222,172,104,12
2021,Barking and Dagenham 019C,E01000050,1743,1076,667,238,288,122,19
2021,Barking and Dagenham 021D,E01000051,1012,679,333,171,126,28,8
2021,Barking and Dagenham 019D,E01000052,2230,1446,784,282,316,168,18
2021,Barking and Dagenham 020A,E01000053,1537,1223,314,111,138,59,6
2021,Barking and Dagenham 018A,E01000054,1782,1432,350,154,140,45,11
2021,Barking and Dagenham 018B,E01000055,1642,1316,326,117,143,59,7
2021,Barking and Dagenham 018C,E01000056,1637,1350,287,111,116,51,9
2021,Barking and Dagenham 012A,E01000057,1492,1155,337,128,125,76,8
2021,Barking and Dagenham 018D,E01000058,2048,1504,544,187,247,102,8
2021,Barking and Dagenham 013C,E01000059,1650,1307,343,125,140,63,15
2021,Barking and Dagenham 006B,E01000060,2084,1733,351,154,133,54,10
2021,Barking and Dagenham 006C,E01000061,1831,1553,278,114,117,39,8
2021,Barking and Dagenham 006D,E01000062,2133,1716,417,171,153,83,10
2021,Barking and Dagenham 004A,E01000063,1718,1363,355,146,150,52,7
2021,Barking and Dagenham 006E,E01000064,2191,1697,494,190,201,86,17
2021,Barking and Dagenham 007A,E01000065,1909,1502,407,160,162,77,8
2021,Barking and Dagenham 011A,E01000066,2422,1761,661,294,205,138,24
2021,Barking and Dagenham 011B,E01000067,2145,1664,481,189,171,100,21
2021,Barking and Dagenham 016E,E01000068,1728,1266,462,149,163,129,21
2021,Barking and Dagenham 011C,E01000069,2019,1630,389,136,150,89,14
2021,Barking and Dagenham 011D,E01000070,1986,1511,475,146,212,111,6
2021,Barking and Dagenham 011E,E01000071,2496,1863,633,245,252,111,25
2021,Barking and Dagenham 017E,E01000072,2048,1615,433,157,168,88,20
2021,Barking and Dagenham 012B,E01000073,1769,1388,381,147,159,66,9
2021,Barking and Dagenham 012C,E01000074,1686,1290,396,145,150,86,15
2021,Barking and Dagenham 012D,E01000075,1964,1550,414,140,188,80,6
2021,Barking and Dagenham 012E,E01000076,2086,1600,486,190,176,102,18
2021,Barking and Dagenham 008F,E01000077,1638,1269,369,135,139,78,17
2021,Barking and Dagenham 007B,E01000078,1821,1407,414,143,176,80,15
2021,Barking and Dagenham 009E,E01000079,1647,1305,342,145,130,62,5
2021,Barking and Dagenham 007C,E01000080,1722,1381,341,130,147,61,3
2021,Barking and Dagenham 007D,E01000081,1902,1476,426,152,199,66,9
2021,Barking and Dagenham 007E,E01000082,1846,1498,348,127,154,49,18
2021,Barking and Dagenham 007F,E01000083,1848,1462,386,162,149,67,8
2021,Barking and Dagenham 013D,E01000084,1388,1078,310,119,114,67,10
2021,Barking and Dagenham 013E,E01000085,1581,1229,352,131,136,77,8
2021,Barking and Dagenham 013F,E01000086,1394,1104,290,104,113,68,5
2021,Barking and Dagenham 020B,E01000087,1578,1230,348,110,162,60,16
2021,Barking and Dagenham 020C,E01000088,1906,1429,477,187,197,81,12
2021,Barking and Dagenham 020D,E01000089,1754,1366,388,159,144,72,13
2021,Barking and Dagenham 020E,E01000090,1630,1195,435,158,186,76,15
2021,Barking and Dagenham 022A,E01000091,2020,1604,416,153,170,84,9
2021,Barking and Dagenham 022B,E01000093,1731,1397,334,110,152,68,4
2021,Barking and Dagenham 022C,E01000094,2317,1747,570,252,233,71,14
2021,Barking and Dagenham 018E,E01000095,2062,1643,419,186,160,59,14
2021,Barking and Dagenham 022D,E01000096,1593,1286,307,149,115,32,11
2021,Barking and Dagenham 023C,E01000097,1856,1438,418,164,160,81,13
2021,Barking and Dagenham 023D,E01000098,1851,1466,385,130,154,89,12
2021,Barking and Dagenham 023E,E01000099,2637,1960,677,318,240,108,11
2021,Barking and Dagenham 004B,E01000100,1841,1421,420,169,156,81,14
2021,Barking and Dagenham 004C,E01000101,1631,1282,349,132,146,58,13
2021,Barking and Dagenham 007G,E01000102,1713,1332,381,139,180,52,10
2021,Barking and Dagenham 014A,E01000103,1711,1421,290,113,120,53,4
2021,Barking and Dagenham 014B,E01000104,1829,1527,302,118,124,54,6
2021,Barking and Dagenham 014C,E01000105,2243,1792,451,163,197,79,12
2021,Barking and Dagenham 014D,E01000106,2072,1625,447,164,177,93,13
2021,Barking and Dagenham 010C,E01000107,1722,1339,383,135,151,85,12
2021,Barking and Dagenham 010D,E01000108,1810,1366,444,166,187,82,9
2021,Barking and Dagenham 002C,E01000110,1518,1157,361,142,137,75,7
2021,Barking and Dagenham 002D,E01000111,2033,1478,555,213,221,113,8
2021,Barking and Dagenham 002E,E01000112,1840,1343,497,196,211,81,9
2021,Barking and Dagenham 002F,E01000113,1916,1370,546,164,227,139,16
2021,Barking and Dagenham 004E,E01000114,2294,1821,473,179,204,81,9
2021,Barnet 009A,E01000115,1368,1175,193,104,55,30,4
2021,Barnet 009B,E01000116,1702,1456,246,133,76,30,7
2021,Barnet 010A,E01000117,1690,1481,209,97,81,28,3
2021,Barnet 010B,E01000118,2006,1692,314,148,103,59,4
2021,Barnet 009C,E01000119,1760,1371,389,172,134,70,13
2021,Barnet 009D,E01000120,1478,1269,209,92,77,35,5
2021,Barnet 010C,E01000121,1437,1217,220,87,86,40,7
2021,Barnet 009E,E01000122,1478,1250,228,107,95,22,4
2021,Barnet 010D,E01000123,1706,1361,345,156,126,53,10
2021,Barnet 010E,E01000124,1809,1348,461,233,163,52,13
2021,Barnet 026A,E01000126,2181,1537,644,241,261,127,15
2021,Barnet 024B,E01000127,1497,1067,430,165,162,88,15
2021,Barnet 024C,E01000128,1980,1350,630,246,278,94,12
2021,Barnet 024D,E01000129,1554,941,613,218,260,118,17
2021,Barnet 021A,E01000130,1869,1313,556,217,222,102,15
2021,Barnet 024E,E01000131,1912,1236,676,275,275,115,11
2021,Barnet 021B,E01000132,1547,1072,475,170,208,84,13
2021,Barnet 021C,E01000133,1595,1168,427,184,176,61,6
2021,Barnet 024F,E01000134,1719,1131,588,233,238,105,12
2021,Barnet 038A,E01000135,1639,1266,373,182,126,53,12
2021,Barnet 038B,E01000136,1459,1221,238,129,68,38,3
2021,Barnet 041A,E01000137,1593,1134,459,200,186,69,4
2021,Barnet 040A,E01000138,1569,1082,487,175,199,102,11
2021,Barnet 041B,E01000139,1349,1040,309,162,103,39,5
2021,Barnet 041C,E01000140,1882,1442,440,232,139,52,17
2021,Barnet 039A,E01000141,1806,1198,608,230,243,121,14
2021,Barnet 040B,E01000142,2147,1475,672,322,239,94,17
2021,Barnet 041D,E01000143,1543,1180,363,153,137,69,4
2021,Barnet 038C,E01000144,1593,1011,582,267,175,118,22
2021,Barnet 037A,E01000145,1550,1248,302,148,110,39,5
2021,Barnet 038D,E01000146,1822,1305,517,273,151,88,5
2021,Barnet 043F,E01000147,1852,1069,783,288,359,118,18
2021,Barnet 036A,E01000150,2168,1453,715,292,291,123,9
2021,Barnet 026B,E01000151,1635,1143,492,185,193,99,15
2021,Barnet 026C,E01000152,2544,1875,669,339,230,74,26
2021,Barnet 026D,E01000153,1844,1399,445,170,179,76,20
2021,Barnet 026E,E01000154,1842,1241,601,232,246,108,15
2021,Barnet 022A,E01000156,1968,1593,375,206,129,39,1
2021,Barnet 022B,E01000157,1530,1240,290,143,99,44,4
2021,Barnet 015A,E01000158,1420,1161,259,114,93,49,3
2021,Barnet 015B,E01000159,1741,1446,295,139,105,46,5
2021,Barnet 015C,E01000160,1887,1408,479,229,157,82,11
2021,Barnet 015D,E01000161,1953,1419,534,235,182,101,16
2021,Barnet 015E,E01000162,1609,1282,327,155,97,65,10
2021,Barnet 022C,E01000163,1626,1171,455,206,160,69,20
2021,Barnet 022D,E01000164,1655,1285,370,171,134,52,13
2021,Barnet 022E,E01000165,1748,1322,426,181,169,67,9
2021,Barnet 003A,E01000166,1557,1340,217,103,76,35,3
2021,Barnet 002A,E01000167,1348,1154,194,98,63,31,2
2021,Barnet 003B,E01000168,1490,1313,177,91,63,17,6
2021,Barnet 003C,E01000169,1570,1355,215,93,84,31,7
2021,Barnet 006A,E01000170,1839,1524,315,134,117,58,6
2021,Barnet 006B,E01000171,2149,1601,548,215,193,117,23
2021,Barnet 003D,E01000172,1604,1443,161,83,56,21,1
2021,Barnet 006C,E01000173,1643,1456,187,107,51,25,4
2021,Barnet 006D,E01000174,1683,1361,322,118,131,57,16
2021,Barnet 006E,E01000175,1915,1602,313,112,157,39,5
2021,Barnet 027A,E01000176,1681,1440,241,107,88,37,9
2021,Barnet 029A,E01000177,1589,1348,241,149,69,22,1
2021,Barnet 027B,E01000178,1627,1395,232,111,74,41,6
2021,Barnet 029B,E01000179,1688,1304,384,234,123,27,0
2021,Barnet 029C,E01000180,1559,1217,342,180,101,50,11
2021,Barnet 029D,E01000181,1646,1364,282,173,77,31,1
2021,Barnet 029E,E01000182,1581,1345,236,146,64,23,3
2021,Barnet 033A,E01000183,1468,1227,241,137,71,28,5
2021,Barnet 027C,E01000184,1825,1309,516,233,215,60,8
2021,Barnet 029F,E01000185,1448,1082,366,175,111,73,7
2021,Barnet 014A,E01000186,1696,1454,242,126,85,21,10
2021,Barnet 014B,E01000187,1665,1465,200,76,85,35,4
2021,Barnet 014C,E01000188,1539,1344,195,116,53,23,3
2021,Barnet 014D,E01000189,2329,1778,551,269,186,81,15
2021,Barnet 014E,E01000190,1680,1418,262,104,114,38,6
2021,Barnet 014F,E01000191,1502,1254,248,121,97,26,4
2021,Barnet 018A,E01000192,1923,1417,506,206,206,80,14
2021,Barnet 018B,E01000193,1876,1315,561,238,226,80,17
2021,Barnet 018C,E01000194,1836,1209,627,249,255,110,13
2021,Barnet 013A,E01000195,1943,1416,527,187,219,114,7
2021,Barnet 028A,E01000196,2049,1341,708,320,252,119,17
2021,Barnet 023A,E01000197,1786,1331,455,204,157,84,10
2021,Barnet 025A,E01000198,2096,1739,357,177,131,48,1
2021,Barnet 025B,E01000199,1526,1322,204,108,71,23,2
2021,Barnet 028B,E01000200,1914,1546,368,182,122,60,4
2021,Barnet 028C,E01000201,1506,1301,205,123,50,26,6
2021,Barnet 028D,E01000202,1611,1309,302,168,97,30,7
2021,Barnet 028E,E01000203,1788,1334,454,171,176,94,13
2021,Barnet 025C,E01000204,1649,1427,222,123,66,27,6
2021,Barnet 035A,E01000205,1436,1274,162,121,23,16,2
2021,Barnet 033B,E01000206,1477,1286,191,100,67,22,2
2021,Barnet 033C,E01000207,1534,1308,226,109,71,42,4
2021,Barnet 033D,E01000208,1567,1312,255,157,56,36,6
2021,Barnet 035B,E01000209,1426,1291,135,105,24,6,0
2021,Barnet 033E,E01000210,1479,1261,218,135,54,20,9
2021,Barnet 035C,E01000211,2044,1380,664,275,263,114,12
2021,Barnet 035D,E01000212,1317,1072,245,128,84,31,2
2021,Barnet 033F,E01000213,1309,1215,94,66,21,7,0
2021,Barnet 038E,E01000214,1583,1283,300,154,106,37,3
2021,Barnet 037B,E01000215,1984,1687,297,156,84,52,5
2021,Barnet 035E,E01000216,1894,1507,387,216,115,49,7
2021,Barnet 035F,E01000217,1690,1453,237,90,114,29,4
2021,Barnet 037C,E01000218,1746,1435,311,159,105,42,5
2021,Barnet 037D,E01000219,2037,1576,461,190,189,76,6
2021,Barnet 037E,E01000220,1762,1387,375,157,128,77,13
2021,Barnet 039B,E01000221,1350,982,368,133,159,67,9
2021,Barnet 040C,E01000222,1984,1345,639,243,257,130,9
2021,Barnet 039C,E01000223,1956,1322,634,253,234,128,19
2021,Barnet 040D,E01000224,1634,1098,536,194,226,91,25
2021,Barnet 037F,E01000225,1786,1641,145,78,46,16,5
2021,Barnet 018D,E01000226,1683,1167,516,182,230,89,15
2021,Barnet 018E,E01000227,1816,1395,421,188,150,73,10
2021,Barnet 007A,E01000228,1412,1193,219,101,87,25,6
2021,Barnet 013B,E01000229,1617,1240,377,160,144,63,10
2021,Barnet 013C,E01000230,1872,1612,260,119,105,31,5
2021,Barnet 013D,E01000231,1741,1373,368,180,140,40,8
2021,Barnet 013E,E01000232,1822,1502,320,155,109,44,12
2021,Barnet 013F,E01000233,1865,1474,391,176,154,54,7
2021,Barnet 021D,E01000234,1702,1406,296,132,109,49,6
2021,Barnet 021E,E01000235,1803,1360,443,186,172,75,10
2021,Barnet 034A,E01000236,1792,1486,306,124,131,40,11
2021,Barnet 032A,E01000237,2009,1331,678,300,238,127,13
2021,Barnet 034B,E01000238,1994,1539,455,204,183,62,6
2021,Barnet 031A,E01000239,1971,1309,662,295,248,110,9
2021,Barnet 031B,E01000240,1679,1182,497,218,203,71,5
2021,Barnet 031C,E01000241,1729,1348,381,144,162,70,5
2021,Barnet 032B,E01000242,1541,1339,202,101,64,36,1
2021,Barnet 032C,E01000243,2068,1396,672,318,259,85,10
2021,Barnet 032D,E01000244,1588,1032,556,243,217,86,10
2021,Barnet 032E,E01000245,1988,1332,656,268,289,89,10
2021,Barnet 002B,E01000246,1481,1349,132,77,35,17,3
2021,Barnet 002C,E01000247,1635,1463,172,92,54,23,3
2021,Barnet 001A,E01000248,1627,1496,131,79,34,14,4
2021,Barnet 001B,E01000249,1568,1438,130,90,28,9,3
2021,Barnet 001C,E01000250,2536,2066,470,222,153,83,12
2021,Barnet 002D,E01000251,2172,1800,372,159,157,45,11
2021,Barnet 002E,E01000252,1658,1393,265,116,107,37,5
2021,Barnet 007B,E01000253,1899,1728,171,102,52,14,3
2021,Barnet 001D,E01000254,1569,1453,116,65,35,13,3
2021,Barnet 017A,E01000255,1651,1377,274,141,81,42,10
2021,Barnet 016A,E01000256,1843,1499,344,148,130,62,4
2021,Barnet 017B,E01000257,2000,1578,422,202,143,70,7
2021,Barnet 016B,E01000258,1828,1530,298,135,113,42,8
2021,Barnet 025D,E01000259,2545,2002,543,305,156,71,11
2021,Barnet 025E,E01000260,2065,1543,522,224,209,79,10
2021,Barnet 017C,E01000261,1723,1523,200,91,89,18,2
2021,Barnet 016C,E01000263,1468,1398,70,43,23,2,2
2021,Barnet 016D,E01000264,1737,1307,430,164,183,74,9
2021,Barnet 011A,E01000265,1844,1408,436,198,146,82,10
2021,Barnet 011B,E01000266,1398,1282,116,65,37,12,2
2021,Barnet 005A,E01000267,1476,1234,242,112,87,36,7
2021,Barnet 005B,E01000268,1995,1535,460,188,181,80,11
2021,Barnet 005C,E01000269,1347,1216,131,57,51,23,0
2021,Barnet 005D,E01000270,1494,1300,194,98,62,28,6
2021,Barnet 008A,E01000271,1598,1344,254,109,95,44,6
2021,Barnet 008B,E01000272,1392,1261,131,68,38,23,2
2021,Barnet 008C,E01000273,1613,1269,344,158,120,57,9
2021,Barnet 011C,E01000274,1878,1527,351,156,127,63,5
2021,Barnet 012A,E01000275,1691,1263,428,224,132,59,13
2021,Barnet 020A,E01000276,1493,1233,260,127,77,53,3
2021,Barnet 012B,E01000277,1593,1131,462,229,163,65,5
2021,Barnet 020B,E01000278,1441,1151,290,141,102,40,7
2021,Barnet 007C,E01000279,1340,1207,133,78,42,10,3
2021,Barnet 007D,E01000280,1311,1178,133,62,45,24,2
2021,Barnet 008D,E01000281,1692,1354,338,177,110,40,11
2021,Barnet 008E,E01000282,1740,1418,322,166,109,40,7
2021,Barnet 012C,E01000283,1335,1169,166,84,70,11,1
2021,Barnet 012D,E01000284,1750,1260,490,204,188,88,10
2021,Barnet 004A,E01000285,1464,1240,224,114,72,31,7
2021,Barnet 007E,E01000286,1671,1375,296,173,86,30,7
2021,Barnet 004B,E01000287,1587,1369,218,104,89,21,4
2021,Barnet 004C,E01000288,1509,1287,222,118,80,22,2
2021,Barnet 004D,E01000289,1538,1256,282,121,112,43,6
2021,Barnet 007F,E01000290,1590,1428,162,81,58,21,2
2021,Barnet 004E,E01000291,1501,1258,243,113,76,42,12
2021,Barnet 001E,E01000292,1506,1300,206,119,62,24,1
2021,Barnet 001F,E01000293,1719,1490,229,119,79,24,7
2021,Barnet 004F,E01000294,1752,1418,334,192,109,27,6
2021,Barnet 023B,E01000295,1551,1194,357,175,127,50,5
2021,Barnet 023C,E01000296,1711,1189,522,236,193,82,11
2021,Barnet 027D,E01000297,1364,950,414,189,135,76,14
2021,Barnet 023D,E01000298,1653,1168,485,216,192,64,13
2021,Barnet 019A,E01000299,2086,1266,820,343,294,157,26
2021,Barnet 019B,E01000300,1608,1242,366,203,103,50,10
2021,Barnet 020C,E01000301,1443,1124,319,155,99,59,6
2021,Barnet 019C,E01000302,1730,1120,610,280,209,99,22
2021,Barnet 020D,E01000303,1447,1123,324,166,100,51,7
2021,Barnet 020E,E01000304,1507,1141,366,179,123,57,7
2021,Barnet 036B,E01000305,1564,933,631,257,252,107,15
2021,Barnet 036C,E01000306,1876,920,956,322,411,201,22
2021,Barnet 039D,E01000307,1594,1036,558,211,245,85,17
2021,Barnet 036D,E01000308,1995,1477,518,255,187,68,8
2021,Barnet 031D,E01000309,1984,1300,684,285,289,90,20
2021,Barnet 034C,E01000310,2121,1344,777,306,284,162,25
2021,Barnet 034D,E01000311,1689,1476,213,93,79,38,3
2021,Barnet 036E,E01000312,1702,1143,559,218,243,92,6
2021,Barnet 036F,E01000313,1835,1091,744,311,299,117,17
2021,Barnet 032F,E01000314,2107,1334,773,338,310,106,19
2021,Barnet 022F,E01000315,1671,1301,370,133,144,75,18
2021,Barnet 027E,E01000316,2204,1547,657,289,239,114,15
2021,Barnet 019D,E01000317,1537,1161,376,186,114,57,19
2021,Barnet 019E,E01000318,1901,1429,472,207,170,82,13
2021,Barnet 027F,E01000319,1353,1151,202,92,72,30,8
2021,Barnet 011D,E01000320,1879,1487,392,185,144,51,12
2021,Barnet 012E,E01000321,1896,1337,559,252,183,106,18
2021,Barnet 011E,E01000322,1798,1331,467,207,179,72,9
2021,Barnet 019F,E01000323,2314,1494,820,313,346,143,18
2021,Barnet 015F,E01000324,1786,1472,314,131,129,49,5
2021,Bexley 014A,E01000325,1590,1528,62,30,17,13,2
2021,Bexley 014B,E01000326,1310,1213,97,51,39,7,0
2021,Bexley 017A,E01000327,1587,1449,138,65,56,16,1
2021,Bexley 017B,E01000328,1584,1503,81,44,27,7,3
2021,Bexley 017C,E01000329,1630,1459,171,94,46,25,6
2021,Bexley 017D,E01000330,1593,1419,174,81,57,29,7
2021,Bexley 017E,E01000331,1619,1518,101,57,34,10,0
2021,Bexley 005A,E01000332,1545,1370,175,83,53,33,6
2021,Bexley 003A,E01000333,1824,1632,192,83,77,29,3
2021,Bexley 006A,E01000334,1619,1423,196,87,76,30,3
2021,Bexley 003B,E01000335,2594,2032,562,208,223,112,19
2021,Bexley 003C,E01000336,1911,1539,372,155,140,61,16
2021,Bexley 003D,E01000337,1660,1436,224,98,82,42,2
2021,Bexley 003E,E01000338,1787,1453,334,132,143,47,12
2021,Bexley 025A,E01000339,1568,1478,90,50,27,9,4
2021,Bexley 018A,E01000340,1512,1428,84,36,32,14,2
2021,Bexley 022A,E01000341,1500,1427,73,42,23,6,2
2021,Bexley 022B,E01000342,1471,1387,84,45,24,13,2
2021,Bexley 022C,E01000343,1461,1370,91,54,30,7,0
2021,Bexley 025B,E01000344,1548,1480,68,35,26,7,0
2021,Bexley 022D,E01000345,1306,1276,30,21,7,2,0
2021,Bexley 021A,E01000346,1535,1459,76,37,16,21,2
2021,Bexley 021B,E01000347,1453,1350,103,61,30,11,1
2021,Bexley 020A,E01000348,1466,1421,45,28,10,6,1
2021,Bexley 020B,E01000349,1660,1585,75,45,16,13,1
2021,Bexley 021C,E01000350,1434,1368,66,27,18,18,3
2021,Bexley 024A,E01000351,1540,1474,66,36,18,10,2
2021,Bexley 021D,E01000352,1562,1453,109,51,41,12,5
2021,Bexley 011A,E01000353,1611,1524,87,59,17,7,4
2021,Bexley 011B,E01000354,1450,1340,110,63,31,12,4
2021,Bexley 011C,E01000355,1411,1331,80,46,24,10,0
2021,Bexley 009A,E01000356,1512,1359,153,85,38,28,2
2021,Bexley 009B,E01000357,1355,1261,94,60,21,10,3
2021,Bexley 011D,E01000358,1604,1437,167,102,46,19,0
2021,Bexley 009C,E01000359,1225,1143,82,43,14,22,3
2021,Bexley 015A,E01000360,1839,1575,264,122,96,42,4
2021,Bexley 020C,E01000361,1547,1444,103,52,26,21,4
2021,Bexley 015B,E01000362,1807,1628,179,97,62,19,1
2021,Bexley 020D,E01000363,1498,1363,135,71,41,19,4
2021,Bexley 023A,E01000364,1647,1512,135,63,57,13,2
2021,Bexley 015C,E01000365,1659,1492,167,64,67,26,10
2021,Bexley 015D,E01000366,1577,1382,195,109,52,30,4
2021,Bexley 010A,E01000367,2164,1935,229,119,74,31,5
2021,Bexley 010B,E01000368,1611,1468,143,59,55,25,4
2021,Bexley 014C,E01000369,1680,1572,108,44,47,13,4
2021,Bexley 014D,E01000370,1518,1407,111,55,39,14,3
2021,Bexley 014E,E01000371,1541,1445,96,51,28,14,3
2021,Bexley 010C,E01000372,1646,1483,163,71,58,27,7
2021,Bexley 008A,E01000373,1217,1014,203,93,88,20,2
2021,Bexley 019A,E01000374,1522,1397,125,64,41,14,6
2021,Bexley 019B,E01000375,2033,1778,255,126,88,38,3
2021,Bexley 019C,E01000376,1555,1399,156,99,40,17,0
2021,Bexley 019D,E01000377,1423,1350,73,37,27,8,1
2021,Bexley 019F,E01000379,1667,1526,141,62,61,11,7
2021,Bexley 010D,E01000380,1683,1576,107,49,41,16,1
2021,Bexley 028A,E01000381,1551,1494,57,34,14,8,1
2021,Bexley 027A,E01000382,1533,1461,72,37,22,9,4
2021,Bexley 028B,E01000383,1539,1474,65,33,21,8,3
2021,Bexley 027B,E01000384,1647,1547,100,56,30,13,1
2021,Bexley 028C,E01000385,1926,1766,160,79,56,21,4
2021,Bexley 028D,E01000386,1486,1339,147,57,67,21,2
2021,Bexley 027C,E01000387,1507,1443,64,34,21,8,1
2021,Bexley 016A,E01000388,1475,1342,133,84,37,11,1
2021,Bexley 020E,E01000389,1652,1499,153,101,41,8,3
2021,Bexley 020F,E01000390,1290,1224,66,41,13,10,2
2021,Bexley 021E,E01000391,1687,1541,146,54,66,21,5
2021,Bexley 016B,E01000392,1883,1548,335,154,134,42,5
2021,Bexley 020G,E01000393,1648,1441,207,120,57,30,0
2021,Bexley 015E,E01000394,1579,1433,146,91,41,13,1
2021,Bexley 018B,E01000395,1486,1353,133,68,38,23,4
2021,Bexley 018C,E01000396,1408,1300,108,69,27,9,3
2021,Bexley 029A,E01000398,1550,1360,190,91,56,37,6
2021,Bexley 029B,E01000399,1521,1297,224,116,75,25,8
2021,Bexley 029C,E01000400,1525,1286,239,113,82,35,9
2021,Bexley 013A,E01000401,1750,1494,256,123,79,47,7
2021,Bexley 005B,E01000402,1533,1358,175,67,74,27,7
2021,Bexley 004A,E01000403,2289,2079,210,84,86,33,7
2021,Bexley 004B,E01000404,2276,1943,333,141,127,55,10
2021,Bexley 004C,E01000405,1487,1251,236,124,72,36,4
2021,Bexley 005C,E01000406,2022,1732,290,118,109,56,7
2021,Bexley 005D,E01000407,1805,1586,219,129,68,16,6
2021,Bexley 004D,E01000408,1713,1360,353,150,130,68,5
2021,Bexley 016C,E01000409,1679,1521,158,74,54,25,5
2021,Bexley 018D,E01000410,1592,1429,163,90,46,21,6
2021,Bexley 016D,E01000411,1453,1344,109,56,33,19,1
2021,Bexley 018E,E01000412,1703,1505,198,110,53,32,3
2021,Bexley 018F,E01000413,1308,1216,92,43,33,13,3
2021,Bexley 016E,E01000414,1838,1494,344,161,119,58,6
2021,Bexley 016F,E01000415,1430,1265,165,99,44,21,1
2021,Bexley 002A,E01000416,1599,1270,329,119,127,71,12
2021,Bexley 006B,E01000417,1673,1448,225,110,76,34,5
2021,Bexley 002B,E01000418,1870,1510,360,154,121,75,10
2021,Bexley 006C,E01000419,1452,1283,169,84,60,22,3
2021,Bexley 006D,E01000420,1475,1360,115,66,39,8,2
2021,Bexley 009D,E01000421,1479,1385,94,49,31,12,2
2021,Bexley 002C,E01000422,1286,1131,155,56,55,39,5
2021,Bexley 025C,E01000423,1559,1474,85,47,30,7,1
2021,Bexley 026A,E01000424,1696,1640,56,33,13,7,3
2021,Bexley 025D,E01000425,1737,1670,67,42,18,6,1
2021,Bexley 026B,E01000426,1606,1493,113,51,49,13,0
2021,Bexley 026C,E01000427,1943,1861,82,39,37,6,0
2021,Bexley 027D,E01000428,1818,1641,177,118,42,15,2
2021,Bexley 008B,E01000429,1602,1449,153,72,59,20,2
2021,Bexley 008C,E01000430,1989,1797,192,105,61,22,4
2021,Bexley 008D,E01000431,1147,1032,115,66,35,12,2
2021,Bexley 008F,E01000433,1873,1700,173,65,62,43,3
2021,Bexley 008G,E01000434,1537,1430,107,50,42,13,2
2021,Bexley 010E,E01000435,1424,1308,116,55,46,14,1
2021,Bexley 011E,E01000436,1699,1578,121,60,39,17,5
2021,Bexley 007A,E01000437,1331,1235,96,33,41,18,4
2021,Bexley 007B,E01000438,1609,1467,142,63,50,26,3
2021,Bexley 007C,E01000439,1380,1266,114,56,42,12,4
2021,Bexley 007D,E01000440,1352,1254,98,43,37,17,1
2021,Bexley 007E,E01000441,1735,1567,168,79,62,23,4
2021,Bexley 006E,E01000442,1626,1503,123,59,45,19,0
2021,Bexley 024B,E01000443,1284,1236,48,30,11,5,2
2021,Bexley 023B,E01000444,1587,1529,58,36,17,4,1
2021,Bexley 024C,E01000445,1614,1538,76,44,18,14,0
2021,Bexley 024D,E01000446,1453,1413,40,32,5,3,0
2021,Bexley 023C,E01000447,1881,1774,107,59,33,13,2
2021,Bexley 023D,E01000448,1315,1280,35,19,9,6,1
2021,Bexley 023E,E01000449,1512,1456,56,38,11,6,1
2021,Bexley 009E,E01000450,1742,1569,173,82,63,22,6
2021,Bexley 009F,E01000451,1696,1529,167,96,41,29,1
2021,Bexley 009G,E01000452,1376,1224,152,87,42,20,3
2021,Bexley 013B,E01000453,1427,1272,155,74,53,20,8
2021,Bexley 013C,E01000454,1562,1334,228,98,90,36,4
2021,Bexley 013D,E01000455,1746,1449,297,156,98,34,9
2021,Bexley 013E,E01000456,1377,1232,145,83,38,20,4
2021,Bexley 026D,E01000457,2098,1893,205,110,69,24,2
2021,Bexley 027E,E01000458,1509,1449,60,34,14,11,1
2021,Bexley 027F,E01000459,1821,1673,148,76,51,18,3
2021,Bexley 022E,E01000460,1222,1163,59,36,20,3,0
2021,Bexley 024E,E01000461,1587,1521,66,38,17,8,3
2021,Bexley 026E,E01000462,1998,1822,176,103,44,26,3
2021,Bexley 025E,E01000463,1202,1154,48,30,13,3,2
2021,Bexley 002D,E01000464,1485,1315,170,63,50,45,12
2021,Bexley 002E,E01000465,1620,1416,204,93,69,29,13
2021,Bexley 001A,E01000466,1647,1427,220,101,57,49,13
2021,Bexley 001B,E01000467,1616,1410,206,98,71,34,3
2021,Bexley 001C,E01000468,2837,2475,362,157,151,43,11
2021,Bexley 001D,E01000469,1673,1386,287,144,98,36,9
2021,Bexley 002F,E01000470,1232,1061,171,56,67,44,4
2021,Brent 026A,E01000471,1689,840,849,276,343,183,47
2021,Brent 029A,E01000472,2298,1336,962,396,368,147,51
2021,Brent 029B,E01000473,2620,1244,1376,410,444,370,152
2021,Brent 026B,E01000474,2192,1078,1114,294,460,265,95
2021,Brent 029C,E01000475,2054,1075,979,348,383,194,54
2021,Brent 026C,E01000476,2114,1030,1084,289,382,326,87
2021,Brent 026D,E01000477,2295,955,1340,385,466,373,116
2021,Brent 029D,E01000478,2414,1147,1267,393,460,331,83
2021,Brent 009A,E01000479,1717,1231,486,221,178,64,23
2021,Brent 006A,E01000480,1654,1102,552,254,205,75,18
2021,Brent 009B,E01000481,1575,1080,495,191,220,75,9
2021,Brent 009D,E01000483,1779,1180,599,189,239,158,13
2021,Brent 006B,E01000484,1712,1283,429,200,147,69,13
2021,Brent 006C,E01000485,1562,1042,520,217,182,98,23
2021,Brent 006D,E01000486,1641,1088,553,240,211,96,6
2021,Brent 006E,E01000487,1926,1122,804,305,312,166,21
2021,Brent 022A,E01000488,1593,1105,488,231,158,86,13
2021,Brent 030A,E01000489,1678,1258,420,217,117,73,13
2021,Brent 023A,E01000490,1703,1230,473,249,154,62,8
2021,Brent 030B,E01000491,1991,1561,430,224,150,47,9
2021,Brent 030C,E01000492,1237,981,256,111,89,45,11
2021,Brent 030D,E01000493,1556,1256,300,141,113,34,12
2021,Brent 023B,E01000494,1708,1183,525,208,183,97,37
2021,Brent 023C,E01000495,1549,1153,396,196,138,43,19
2021,Brent 011A,E01000497,2007,1367,640,255,262,108,15
2021,Brent 010B,E01000498,1619,977,642,220,237,152,33
2021,Brent 011B,E01000499,1817,1170,647,204,272,141,30
2021,Brent 011C,E01000501,1954,1449,505,184,215,96,10
2021,Brent 011D,E01000502,1779,1244,535,188,249,82,16
2021,Brent 011E,E01000503,2024,1395,629,214,271,123,21
2021,Brent 018A,E01000504,1730,1316,414,200,160,49,5
2021,Brent 018B,E01000505,1583,1207,376,174,150,44,8
2021,Brent 014A,E01000506,1593,965,628,258,229,116,25
2021,Brent 018C,E01000507,1573,1105,468,204,168,86,10
2021,Brent 025A,E01000508,2462,1798,664,230,262,154,18
2021,Brent 014B,E01000509,1407,835,572,162,249,135,26
2021,Brent 014C,E01000510,1601,916,685,229,268,148,40
2021,Brent 014D,E01000511,1645,1119,526,163,222,125,16
2021,Brent 018D,E01000512,1655,1234,421,174,152,82,13
2021,Brent 002A,E01000513,1625,1067,558,210,220,112,16
2021,Brent 002B,E01000514,1529,1001,528,196,214,101,17
2021,Brent 003A,E01000515,1796,1156,640,235,270,115,20
2021,Brent 002C,E01000516,2237,1302,935,348,369,193,25
2021,Brent 003B,E01000517,1580,1003,577,224,246,91,16
2021,Brent 005A,E01000518,1861,1180,681,254,308,103,16
2021,Brent 005B,E01000519,1933,1142,791,262,369,140,20
2021,Brent 002D,E01000520,1619,1068,551,207,226,107,11
2021,Brent 025B,E01000521,2199,1426,773,228,326,195,24
2021,Brent 025C,E01000522,1966,1479,487,140,217,98,32
2021,Brent 031A,E01000523,2212,1494,718,247,279,162,30
2021,Brent 031B,E01000524,2332,1584,748,261,304,156,27
2021,Brent 031C,E01000525,1787,1308,479,187,185,91,16
2021,Brent 025D,E01000526,2126,1567,559,192,224,130,13
2021,Brent 025E,E01000527,1825,1269,556,204,227,110,15
2021,Brent 025F,E01000528,1656,1189,467,188,183,88,8
2021,Brent 033A,E01000530,1763,1441,322,131,120,60,11
2021,Brent 033B,E01000531,1736,1336,400,155,158,66,21
2021,Brent 033C,E01000532,1450,1248,202,107,60,32,3
2021,Brent 031E,E01000533,2101,1559,542,180,207,136,19
2021,Brent 033D,E01000534,1688,1401,287,149,99,34,5
2021,Brent 031F,E01000535,1980,1473,507,204,210,84,9
2021,Brent 004A,E01000536,1521,1065,456,234,136,73,13
2021,Brent 004B,E01000538,1552,1133,419,205,146,61,7
2021,Brent 004C,E01000539,1536,1063,473,219,174,67,13
2021,Brent 004D,E01000540,1416,1028,388,211,134,40,3
2021,Brent 004E,E01000541,1345,770,575,217,235,106,17
2021,Brent 003E,E01000543,1581,879,702,306,265,109,22
2021,Brent 034A,E01000544,1722,1257,465,237,150,63,15
2021,Brent 028A,E01000545,1847,1312,535,252,165,106,12
2021,Brent 028B,E01000546,1591,1185,406,205,125,69,7
2021,Brent 028C,E01000547,1589,1268,321,158,119,31,13
2021,Brent 028D,E01000548,1932,1378,554,265,202,77,10
2021,Brent 028E,E01000549,1745,1376,369,226,101,40,2
2021,Brent 034B,E01000550,1967,1475,492,221,191,65,15
2021,Brent 034C,E01000551,2807,2195,612,276,230,91,15
2021,Brent 034D,E01000552,1458,1100,358,168,135,43,12
2021,Brent 015A,E01000553,1966,1248,718,306,268,117,27
2021,Brent 015B,E01000554,1890,1318,572,261,201,94,16
2021,Brent 015C,E01000555,1543,1143,400,224,132,39,5
2021,Brent 015D,E01000556,2011,1234,777,271,342,131,33
2021,Brent 015E,E01000557,1814,1174,640,226,257,139,18
2021,Brent 015F,E01000558,1356,1091,265,140,71,46,8
2021,Brent 018E,E01000559,1344,915,429,167,153,74,35
2021,Brent 023D,E01000560,1514,1134,380,220,108,46,6
2021,Brent 023E,E01000561,1876,1420,456,210,153,83,10
2021,Brent 008A,E01000562,1477,1134,343,169,116,49,9
2021,Brent 008B,E01000563,1553,1137,416,218,131,59,8
2021,Brent 013A,E01000564,1553,912,641,267,253,107,14
2021,Brent 013B,E01000565,1498,1066,432,181,171,65,15
2021,Brent 008C,E01000566,1504,987,517,242,193,68,14
2021,Brent 016A,E01000567,1351,894,457,171,199,73,14
2021,Brent 008D,E01000568,2138,1317,821,437,286,85,13
2021,Brent 008E,E01000569,1423,1043,380,187,135,51,7
2021,Brent 012A,E01000570,1508,950,558,203,233,107,15
2021,Brent 012B,E01000571,1724,1151,573,235,215,105,18
2021,Brent 007A,E01000572,1434,953,481,211,187,65,18
2021,Brent 007B,E01000573,1590,876,714,289,290,117,18
2021,Brent 007C,E01000574,1564,946,618,202,298,101,17
2021,Brent 007D,E01000575,2048,1035,1013,369,431,188,25
2021,Brent 012C,E01000576,1819,1115,704,269,317,103,15
2021,Brent 007E,E01000577,2467,1473,994,386,390,176,42
2021,Brent 012D,E01000578,2243,1521,722,295,291,120,16
2021,Brent 032A,E01000579,1532,1275,257,142,72,39,4
2021,Brent 032B,E01000580,1983,1604,379,219,106,48,6
2021,Brent 030E,E01000581,1476,1272,204,119,53,28,4
2021,Brent 032C,E01000582,1761,1529,232,136,66,26,4
2021,Brent 032D,E01000583,1982,1620,362,207,101,39,15
2021,Brent 033E,E01000584,1496,1161,335,148,125,50,12
2021,Brent 033F,E01000585,1429,1183,246,120,82,40,4
2021,Brent 032E,E01000586,2290,1707,583,281,201,89,12
2021,Brent 001A,E01000587,1577,891,686,271,284,104,27
2021,Brent 001B,E01000589,2467,1404,1063,422,414,194,33
2021,Brent 001C,E01000590,1857,1181,676,238,279,140,19
2021,Brent 003F,E01000591,2092,1091,1001,341,445,187,28
2021,Brent 001D,E01000592,1783,1133,650,254,282,101,13
2021,Brent 001E,E01000593,2044,1292,752,280,342,110,20
2021,Brent 001F,E01000594,1757,912,845,299,391,135,20
2021,Brent 027A,E01000595,1695,1227,468,132,215,105,16
2021,Brent 021A,E01000596,1787,1301,486,161,209,90,26
2021,Brent 027D,E01000599,1829,1414,415,152,156,90,17
2021,Brent 021B,E01000601,1350,1035,315,90,135,83,7
2021,Brent 021C,E01000602,1425,1042,383,127,154,91,11
2021,Brent 021D,E01000603,1368,928,440,148,162,112,18
2021,Brent 021E,E01000604,1698,1285,413,140,167,90,16
2021,Brent 021F,E01000605,1729,1302,427,163,181,72,11
2021,Brent 016B,E01000606,1813,938,875,361,347,140,27
2021,Brent 013C,E01000607,2479,1347,1132,448,466,189,29
2021,Brent 013D,E01000608,2255,1340,915,327,394,165,29
2021,Brent 016C,E01000609,1999,1179,820,280,350,171,19
2021,Brent 019A,E01000610,2107,1277,830,345,321,139,25
2021,Brent 016D,E01000611,1844,1180,664,290,238,123,13
2021,Brent 019B,E01000612,1710,996,714,269,292,123,30
2021,Brent 013E,E01000613,1683,1010,673,270,257,130,16
2021,Brent 036A,E01000615,3087,2119,968,508,319,117,24
2021,Brent 020A,E01000616,1888,1148,740,265,290,165,20
2021,Brent 036B,E01000617,2197,1482,715,312,269,113,21
2021,Brent 036D,E01000618,1626,1032,594,210,244,127,13
2021,Brent 036C,E01000619,1659,1066,593,216,229,120,28
2021,Brent 020B,E01000620,1702,1148,554,187,220,118,29
2021,Brent 020C,E01000621,1759,1097,662,195,276,155,36
2021,Brent 010D,E01000622,1820,1105,715,234,306,156,19
2021,Brent 005C,E01000623,1812,1148,664,216,316,122,10
2021,Brent 005D,E01000624,1687,1161,526,196,230,82,18
2021,Brent 009E,E01000625,1604,1078,526,189,206,114,17
2021,Brent 010E,E01000626,1486,1028,458,153,190,100,15
2021,Brent 014E,E01000627,1986,1158,828,217,385,183,43
2021,Brent 014F,E01000628,1725,1005,720,217,324,151,28
2021,Brent 005E,E01000629,1908,1159,749,289,302,135,23
2021,Brent 026E,E01000630,2622,1628,994,401,346,199,48
2021,Brent 019C,E01000631,1994,1045,949,360,354,196,39
2021,Brent 029E,E01000632,2401,1078,1323,432,467,311,113
2021,Brent 019D,E01000633,2501,1112,1389,349,571,350,119
2021,Brent 019E,E01000634,2543,1459,1084,424,417,203,40
2021,Brent 020E,E01000636,2504,1619,885,324,376,168,17
2021,Brent 022B,E01000637,1461,953,508,186,203,93,26
2021,Brent 024A,E01000638,2031,1161,870,327,323,182,38
2021,Brent 022C,E01000639,1666,1075,591,257,203,93,38
2021,Brent 024B,E01000640,2114,1205,909,255,352,238,64
2021,Brent 024C,E01000641,1865,1216,649,236,246,139,28
2021,Brent 022D,E01000642,2149,1414,735,305,287,126,17
2021,Brent 024D,E01000643,2179,1672,507,171,214,98,24
2021,Brent 022E,E01000644,1849,1354,495,222,177,74,22
2021,Bromley 007A,E01000645,1409,1341,68,44,13,11,0
2021,Bromley 016A,E01000646,1747,1553,194,123,46,17,8
2021,Bromley 016B,E01000647,1638,1523,115,79,29,7,0
2021,Bromley 016C,E01000648,1821,1695,126,69,39,17,1
2021,Bromley 007B,E01000649,1996,1889,107,72,19,14,2
2021,Bromley 022A,E01000650,1766,1670,96,63,22,10,1
2021,Bromley 020A,E01000651,1640,1560,80,51,17,11,1
2021,Bromley 022B,E01000652,1666,1589,77,48,20,9,0
2021,Bromley 016D,E01000653,1501,1423,78,54,14,9,1
2021,Bromley 039A,E01000654,1252,1224,28,16,8,4,0
2021,Bromley 039B,E01000655,1281,1250,31,20,7,3,1
2021,Bromley 039C,E01000656,1464,1431,33,27,3,2,1
2021,Bromley 039D,E01000657,1515,1477,38,26,10,2,0
2021,Bromley 042A,E01000658,1311,1297,14,7,3,3,1
2021,Bromley 039E,E01000659,1423,1401,22,9,8,5,0
2021,Bromley 026A,E01000661,2704,2405,299,181,72,35,11
2021,Bromley 026B,E01000662,1736,1636,100,63,26,9,2
2021,Bromley 026C,E01000663,1615,1495,120,65,38,12,5
2021,Bromley 026D,E01000664,1609,1518,91,55,28,8,0
2021,Bromley 033A,E01000665,1796,1722,74,40,23,10,1
2021,Bromley 033B,E01000666,1850,1798,52,33,12,5,2
2021,Bromley 033C,E01000667,1632,1580,52,26,16,4,6
2021,Bromley 020B,E01000668,2113,1922,191,110,58,22,1
2021,Bromley 020C,E01000669,1657,1584,73,40,21,10,2
2021,Bromley 018A,E01000670,1877,1625,252,159,66,24,3
2021,Bromley 020D,E01000671,2185,1912,273,164,84,22,3
2021,Bromley 011A,E01000672,1619,1452,167,110,43,13,1
2021,Bromley 011B,E01000673,1609,1490,119,72,37,7,3
2021,Bromley 008A,E01000674,1651,1400,251,127,90,29,5
2021,Bromley 008B,E01000676,1945,1450,495,282,149,55,9
2021,Bromley 018C,E01000677,1817,1541,276,176,76,21,3
2021,Bromley 016E,E01000678,1788,1610,178,103,56,13,6
2021,Bromley 020E,E01000679,1704,1585,119,71,34,14,0
2021,Bromley 037A,E01000680,1618,1554,64,44,9,9,2
2021,Bromley 035A,E01000681,1703,1582,121,91,23,4,3
2021,Bromley 035B,E01000682,1567,1434,133,89,32,9,3
2021,Bromley 035C,E01000683,1659,1458,201,135,48,12,6
2021,Bromley 035D,E01000684,2041,1841,200,161,33,5,1
2021,Bromley 037B,E01000685,1561,1435,126,98,19,7,2
2021,Bromley 037C,E01000686,1451,1365,86,64,16,3,3
2021,Bromley 037D,E01000687,1525,1447,78,42,24,11,1
2021,Bromley 037E,E01000688,1349,1266,83,59,16,8,0
2021,Bromley 002A,E01000689,1575,1454,121,73,38,9,1
2021,Bromley 002B,E01000690,1336,1255,81,56,17,8,0
2021,Bromley 002C,E01000691,1474,1386,88,52,26,9,1
2021,Bromley 002D,E01000692,1604,1507,97,58,23,10,6
2021,Bromley 010A,E01000693,1480,1393,87,42,33,11,1
2021,Bromley 007C,E01000694,2216,2093,123,87,27,8,1
2021,Bromley 007D,E01000695,1476,1432,44,33,9,2,0
2021,Bromley 007E,E01000696,1584,1517,67,47,15,5,0
2021,Bromley 007F,E01000697,1732,1617,115,77,29,7,2
2021,Bromley 010B,E01000698,1161,1096,65,44,13,5,3
2021,Bromley 015A,E01000699,1386,1234,152,75,57,18,2
2021,Bromley 013A,E01000700,1460,1337,123,66,40,14,3
2021,Bromley 015B,E01000701,1361,1260,101,57,29,13,2
2021,Bromley 013B,E01000702,1360,1234,126,70,36,18,2
2021,Bromley 013C,E01000703,1677,1546,131,71,42,16,2
2021,Bromley 015C,E01000704,1409,1288,121,59,37,20,5
2021,Bromley 015D,E01000705,1303,1164,139,77,41,20,1
2021,Bromley 013D,E01000706,1326,1233,93,46,31,12,4
2021,Bromley 041A,E01000707,1441,1367,74,50,19,4,1
2021,Bromley 041B,E01000708,1621,1503,118,60,43,8,7
2021,Bromley 006A,E01000709,1315,1168,147,104,29,12,2
2021,Bromley 006B,E01000710,2241,1964,277,188,62,26,1
2021,Bromley 006C,E01000711,1797,1555,242,152,70,18,2
2021,Bromley 012A,E01000712,1742,1531,211,132,65,12,2
2021,Bromley 012B,E01000713,1756,1563,193,139,39,14,1
2021,Bromley 006D,E01000714,2076,1790,286,170,83,26,7
2021,Bromley 012C,E01000715,1708,1564,144,85,47,10,2
2021,Bromley 011C,E01000716,1614,1516,98,67,22,6,3
2021,Bromley 011D,E01000717,1631,1433,198,113,58,24,3
2021,Bromley 006E,E01000718,1996,1792,204,103,74,22,5
2021,Bromley 019A,E01000719,2010,1792,218,119,73,23,3
2021,Bromley 019B,E01000720,1727,1562,165,79,71,13,2
2021,Bromley 019C,E01000721,1521,1359,162,78,57,22,5
2021,Bromley 023A,E01000722,1782,1610,172,96,51,21,4
2021,Bromley 029A,E01000723,1206,1160,46,30,10,5,1
2021,Bromley 019D,E01000724,1598,1427,171,96,54,19,2
2021,Bromley 023B,E01000725,1674,1538,136,86,34,14,2
2021,Bromley 029B,E01000726,1257,1179,78,47,20,9,2
2021,Bromley 028A,E01000727,1633,1484,149,84,47,17,1
2021,Bromley 019E,E01000728,1557,1407,150,65,54,26,5
2021,Bromley 014A,E01000729,1865,1694,171,86,63,18,4
2021,Bromley 014B,E01000730,1727,1585,142,65,54,21,2
2021,Bromley 023C,E01000731,1324,1212,112,53,37,21,1
2021,Bromley 023D,E01000732,1458,1376,82,47,24,6,5
2021,Bromley 023E,E01000733,1619,1512,107,61,33,11,2
2021,Bromley 028B,E01000734,1331,1246,85,54,26,5,0
2021,Bromley 014C,E01000735,1486,1360,126,69,47,9,1
2021,Bromley 010C,E01000736,1579,1485,94,52,29,11,2
2021,Bromley 010D,E01000737,1344,1233,111,65,29,15,2
2021,Bromley 014D,E01000738,1618,1472,146,80,49,17,0
2021,Bromley 014E,E01000739,1607,1485,122,55,46,17,4
2021,Bromley 005B,E01000741,1722,1525,197,117,43,35,2
2021,Bromley 005C,E01000742,2029,1722,307,176,96,28,7
2021,Bromley 009A,E01000743,1803,1522,281,121,99,52,9
2021,Bromley 009B,E01000744,1498,1299,199,80,71,35,13
2021,Bromley 005D,E01000745,1791,1578,213,125,62,22,4
2021,Bromley 005E,E01000746,1906,1695,211,121,64,24,2
2021,Bromley 042B,E01000747,1965,1916,49,26,16,7,0
2021,Bromley 042C,E01000748,1655,1628,27,17,8,1,1
2021,Bromley 036A,E01000749,1631,1603,28,15,9,4,0
2021,Bromley 036B,E01000750,1432,1375,57,34,17,6,0
2021,Bromley 036C,E01000751,2191,1976,215,135,59,17,4
2021,Bromley 036D,E01000752,1705,1642,63,41,18,2,2
2021,Bromley 031A,E01000753,1903,1818,85,67,16,2,0
2021,Bromley 031B,E01000754,1704,1581,123,80,31,11,1
2021,Bromley 031C,E01000755,1601,1507,94,61,26,7,0
2021,Bromley 033D,E01000756,1673,1575,98,57,27,11,3
2021,Bromley 031D,E01000757,1543,1472,71,68,2,1,0
2021,Bromley 031E,E01000758,1421,1317,104,80,20,4,0
2021,Bromley 034A,E01000759,1615,1577,38,27,8,2,1
2021,Bromley 034B,E01000760,1595,1527,68,30,30,6,2
2021,Bromley 034C,E01000761,1507,1468,39,22,13,3,1
2021,Bromley 018D,E01000762,1680,1519,161,112,43,5,1
2021,Bromley 027A,E01000763,1442,1385,57,41,11,4,1
2021,Bromley 027B,E01000764,1769,1655,114,73,26,11,4
2021,Bromley 034D,E01000765,1753,1672,81,46,26,8,1
2021,Bromley 027C,E01000766,1777,1705,72,53,13,5,1
2021,Bromley 027D,E01000767,1601,1559,42,31,11,0,0
2021,Bromley 034E,E01000768,1472,1418,54,32,20,2,0
2021,Bromley 024A,E01000769,1360,1317,43,24,11,8,0
2021,Bromley 012D,E01000770,1486,1392,94,63,27,3,1
2021,Bromley 041C,E01000771,1614,1520,94,52,29,11,2
2021,Bromley 012E,E01000772,1547,1434,113,73,32,7,1
2021,Bromley 024B,E01000773,1552,1471,81,52,17,12,0
2021,Bromley 041D,E01000774,1446,1324,122,68,42,11,1
2021,Bromley 024C,E01000775,2225,2094,131,88,32,10,1
2021,Bromley 024D,E01000777,1583,1500,83,43,23,16,1
2021,Bromley 024E,E01000778,1572,1482,90,53,24,11,2
2021,Bromley 001A,E01000779,1357,1224,133,68,39,22,4
2021,Bromley 001B,E01000780,1548,1355,193,106,64,22,1
2021,Bromley 001C,E01000781,1504,1346,158,86,47,23,2
2021,Bromley 001D,E01000782,1468,1287,181,83,58,36,4
2021,Bromley 001E,E01000783,1553,1345,208,117,67,23,1
2021,Bromley 002E,E01000784,1487,1367,120,67,33,18,2
2021,Bromley 001F,E01000785,1523,1347,176,85,65,21,5
2021,Bromley 032A,E01000786,1421,1320,101,75,20,4,2
2021,Bromley 029C,E01000787,1441,1333,108,53,40,12,3
2021,Bromley 029D,E01000788,1560,1401,159,77,54,22,6
2021,Bromley 032B,E01000789,1790,1606,184,100,70,11,3
2021,Bromley 028C,E01000790,2228,1864,364,224,105,33,2
2021,Bromley 029E,E01000791,1463,1358,105,68,24,11,2
2021,Bromley 032C,E01000792,1451,1314,137,60,63,11,3
2021,Bromley 032D,E01000793,1518,1427,91,66,19,5,1
2021,Bromley 035E,E01000794,1500,1413,87,63,19,5,0
2021,Bromley 032E,E01000795,1329,1236,93,65,18,10,0
2021,Bromley 009C,E01000796,1485,1277,208,90,84,29,5
2021,Bromley 013E,E01000797,1588,1491,97,46,32,18,1
2021,Bromley 009D,E01000798,1459,1248,211,90,80,37,4
2021,Bromley 004A,E01000799,1721,1445,276,129,96,49,2
2021,Bromley 009E,E01000800,1605,1351,254,142,85,22,5
2021,Bromley 015E,E01000801,1458,1299,159,72,58,22,7
2021,Bromley 004B,E01000802,1756,1602,154,77,49,22,6
2021,Bromley 004C,E01000803,1548,1419,129,62,51,15,1
2021,Bromley 004D,E01000804,1427,1317,110,73,29,6,2
2021,Bromley 004E,E01000805,1635,1491,144,66,46,26,6
2021,Bromley 009F,E01000806,1648,1417,231,94,99,33,5
2021,Bromley 022C,E01000807,1593,1476,117,77,23,17,0
2021,Bromley 025A,E01000808,1500,1414,86,62,17,7,0
2021,Bromley 022D,E01000809,1494,1446,48,32,14,1,1
2021,Bromley 025B,E01000810,1487,1425,62,47,11,3,1
2021,Bromley 025C,E01000811,1308,1202,106,65,35,6,0
2021,Bromley 028D,E01000812,1583,1428,155,86,47,18,4
2021,Bromley 025D,E01000813,1508,1404,104,68,28,7,1
2021,Bromley 028E,E01000814,1471,1366,105,58,39,5,3
2021,Bromley 025E,E01000815,1470,1420,50,38,7,3,2
2021,Bromley 040A,E01000816,1475,1310,165,92,54,18,1
2021,Bromley 040B,E01000818,1633,1497,136,78,44,12,2
2021,Bromley 040C,E01000819,1777,1525,252,113,101,31,7
2021,Bromley 008C,E01000820,1558,1447,111,67,26,17,1
2021,Bromley 008D,E01000822,1538,1366,172,98,55,16,3
2021,Bromley 008E,E01000823,1632,1518,114,61,37,13,3
2021,Bromley 008F,E01000824,1346,1165,181,92,57,29,3
2021,Bromley 008G,E01000825,1590,1402,188,103,66,14,5
2021,Bromley 021A,E01000826,1610,1549,61,40,16,5,0
2021,Bromley 021B,E01000827,1700,1513,187,118,53,16,0
2021,Bromley 011E,E01000828,1650,1530,120,69,43,8,0
2021,Bromley 018E,E01000829,1697,1453,244,148,72,22,2
2021,Bromley 021C,E01000830,1578,1531,47,29,9,8,1
2021,Bromley 021D,E01000831,1652,1495,157,108,36,12,1
2021,Bromley 030A,E01000832,1535,1460,75,36,19,17,3
2021,Bromley 021E,E01000833,1419,1377,42,28,11,3,0
2021,Bromley 027E,E01000834,1316,1257,59,44,10,5,0
2021,Bromley 030B,E01000835,1714,1563,151,65,54,28,4
2021,Bromley 030C,E01000836,1345,1303,42,24,11,5,2
2021,Bromley 030D,E01000837,1532,1465,67,37,20,9,1
2021,Bromley 030E,E01000838,1390,1347,43,26,15,2,0
2021,Bromley 030F,E01000839,1359,1320,39,23,10,5,1
2021,Bromley 030G,E01000840,1477,1448,29,18,8,2,1
2021,Bromley 030H,E01000841,1654,1581,73,35,29,8,1
2021,Camden 011A,E01000842,1377,1082,295,197,67,27,4
2021,Camden 014A,E01000843,1166,946,220,167,44,8,1
2021,Camden 011B,E01000844,1576,1278,298,226,56,14,2
2021,Camden 014B,E01000845,1448,1160,288,217,48,22,1
2021,Camden 014C,E01000846,1411,1083,328,169,117,34,8
2021,Camden 014D,E01000847,1548,1217,331,171,96,57,7
2021,Camden 011C,E01000848,1443,1139,304,239,50,10,5
2021,Camden 011D,E01000849,1317,1030,287,206,60,21,0
2021,Camden 026A,E01000850,1411,930,481,343,117,20,1
2021,Camden 026B,E01000851,1457,1071,386,272,84,25,5
2021,Camden 029H,E01000853,1376,1077,299,130,91,67,11
2021,Camden 028A,E01000855,1283,936,347,230,92,25,0
2021,Camden 019A,E01000856,1549,1208,341,172,90,73,6
2021,Camden 018A,E01000857,1356,1164,192,129,43,12,8
2021,Camden 018B,E01000858,1882,1487,395,194,128,62,11
2021,Camden 018C,E01000859,1420,1218,202,149,44,7,2
2021,Camden 018D,E01000860,1078,915,163,114,33,14,2
2021,Camden 019B,E01000861,1336,1060,276,166,77,30,3
2021,Camden 018E,E01000862,1618,1393,225,164,43,14,4
2021,Camden 021A,E01000863,1444,1112,332,213,89,20,10
2021,Camden 009A,E01000866,1912,1581,331,186,93,44,8
2021,Camden 015C,E01000867,1697,1245,452,226,123,83,20
2021,Camden 015D,E01000868,1680,1338,342,172,110,50,10
2021,Camden 015E,E01000869,1913,1561,352,207,101,36,8
2021,Camden 009B,E01000870,1556,1355,201,115,58,26,2
2021,Camden 005A,E01000871,1603,1336,267,142,87,35,3
2021,Camden 005B,E01000872,1676,1187,489,231,176,71,11
2021,Camden 005C,E01000873,1534,1312,222,177,33,11,1
2021,Camden 005D,E01000874,1434,1180,254,176,55,18,5
2021,Camden 013A,E01000875,1520,1148,372,214,105,48,5
2021,Camden 013B,E01000876,1866,1447,419,245,112,59,3
2021,Camden 005E,E01000877,1429,1143,286,194,71,19,2
2021,Camden 004A,E01000878,1662,1305,357,203,110,40,4
2021,Camden 004B,E01000879,1262,990,272,176,71,22,3
2021,Camden 004C,E01000880,1349,1067,282,210,52,20,0
2021,Camden 008A,E01000881,1322,952,370,265,75,26,4
2021,Camden 008B,E01000882,1392,1112,280,239,33,8,0
2021,Camden 008C,E01000883,1460,1072,388,261,90,35,2
2021,Camden 004D,E01000884,1406,1172,234,157,49,21,7
2021,Camden 004E,E01000885,1237,1052,185,121,43,20,1
2021,Camden 006A,E01000886,1303,1158,145,117,16,9,3
2021,Camden 006B,E01000887,1349,1088,261,174,53,32,2
2021,Camden 006C,E01000888,1436,1222,214,135,59,18,2
2021,Camden 007A,E01000889,1719,1455,264,105,105,49,5
2021,Camden 007B,E01000890,1252,985,267,110,94,54,9
2021,Camden 007C,E01000891,1445,1146,299,141,97,52,9
2021,Camden 006D,E01000892,1737,1436,301,201,62,30,8
2021,Camden 002A,E01000893,1342,1174,168,145,15,8,0
2021,Camden 002B,E01000894,1233,1059,174,134,32,6,2
2021,Camden 002C,E01000895,1502,1225,277,195,55,27,0
2021,Camden 002D,E01000896,1399,1212,187,150,29,8,0
2021,Camden 008D,E01000897,1482,1196,286,228,50,8,0
2021,Camden 008E,E01000898,1538,1150,388,246,110,27,5
2021,Camden 002E,E01000899,1509,1299,210,150,45,13,2
2021,Camden 012A,E01000900,1639,1396,243,155,44,35,9
2021,Camden 007D,E01000901,1899,1511,388,157,140,82,9
2021,Camden 012B,E01000902,1376,1101,275,130,94,48,3
2021,Camden 006E,E01000903,1371,1171,200,121,44,28,7
2021,Camden 012C,E01000904,2011,1592,419,209,116,77,17
2021,Camden 012D,E01000905,1815,1467,348,137,119,71,21
2021,Camden 012E,E01000906,1393,1111,282,213,45,20,4
2021,Camden 001A,E01000907,1430,1269,161,89,50,20,2
2021,Camden 001B,E01000908,1490,1327,163,101,45,15,2
2021,Camden 001C,E01000909,1517,1379,138,107,25,6,0
2021,Camden 003A,E01000910,1315,1178,137,91,32,12,2
2021,Camden 003B,E01000911,1395,1240,155,87,43,18,7
2021,Camden 001D,E01000912,1535,1353,182,87,55,34,6
2021,Camden 001E,E01000913,1567,1445,122,87,28,5,2
2021,Camden 028B,E01000914,1398,1099,299,190,81,23,5
2021,Camden 027A,E01000915,1484,1121,363,147,131,62,23
2021,Camden 027B,E01000916,1830,1408,422,271,101,44,6
2021,Camden 027C,E01000917,1616,1291,325,142,115,51,17
2021,Camden 028C,E01000918,1767,1333,434,269,99,58,8
2021,Camden 028D,E01000919,1423,1110,313,201,75,32,5
2021,Camden 027D,E01000920,1596,1270,326,193,71,52,10
2021,Camden 003C,E01000921,1831,1513,318,196,77,39,6
2021,Camden 007E,E01000922,1879,1427,452,223,112,104,13
2021,Camden 003D,E01000923,1402,1251,151,99,34,15,3
2021,Camden 009C,E01000924,1524,1287,237,163,57,16,1
2021,Camden 009D,E01000925,1452,1186,266,128,82,52,4
2021,Camden 009E,E01000926,1430,1205,225,137,64,19,5
2021,Camden 007F,E01000927,1489,1215,274,174,60,35,5
2021,Camden 003E,E01000928,1667,1439,228,132,65,25,6
2021,Camden 020A,E01000929,1865,1393,472,209,177,78,8
2021,Camden 020B,E01000930,2012,1349,663,287,249,110,17
2021,Camden 013C,E01000931,1963,1397,566,258,185,101,22
2021,Camden 013D,E01000932,1708,1341,367,229,95,32,11
2021,Camden 020C,E01000933,1713,1299,414,237,107,65,5
2021,Camden 020D,E01000934,1481,1072,409,184,144,72,9
2021,Camden 020E,E01000935,1535,1134,401,197,140,54,10
2021,Camden 029G,E01000937,1103,740,363,260,76,25,2
2021,Camden 029A,E01000938,1324,942,382,215,106,54,7
2021,Camden 029B,E01000939,1412,970,442,171,174,85,12
2021,Camden 029D,E01000941,1156,877,279,100,101,61,17
2021,Camden 029C,E01000942,998,748,250,145,77,26,2
2021,Camden 029F,E01000943,1579,1115,464,332,100,25,7
2021,Camden 023A,E01000944,1432,1042,390,173,148,55,14
2021,Camden 021B,E01000946,1511,1168,343,220,79,36,8
2021,Camden 021C,E01000947,1630,1205,425,273,102,47,3
2021,Camden 021D,E01000948,1490,1238,252,162,64,24,2
2021,Camden 023C,E01000949,1547,1218,329,180,95,45,9
2021,Camden 023E,E01000951,1480,1085,395,166,152,70,7
2021,Camden 022A,E01000952,1652,1283,369,163,137,57,12
2021,Camden 022C,E01000954,1681,1282,399,164,149,68,18
2021,Camden 022D,E01000955,1302,1031,271,114,105,42,10
2021,Camden 022E,E01000956,1464,1085,379,151,130,82,16
2021,Camden 019C,E01000957,1277,984,293,192,60,39,2
2021,Camden 019D,E01000958,2845,2063,782,413,277,79,13
2021,Camden 019E,E01000959,1647,1244,403,188,135,66,14
2021,Camden 017A,E01000960,1793,1324,469,272,132,63,2
2021,Camden 017B,E01000961,1731,1239,492,249,163,71,9
2021,Camden 016A,E01000962,1495,1162,333,276,44,8,5
2021,Camden 017C,E01000963,1831,1190,641,296,234,94,17
2021,Camden 016B,E01000964,1669,1320,349,243,87,15,4
2021,Camden 016C,E01000965,1659,1260,399,267,105,25,2
2021,Camden 016D,E01000966,1548,1180,368,302,47,17,2
2021,Camden 017D,E01000967,1475,1173,302,216,57,27,2
2021,Camden 016E,E01000968,1411,1138,273,205,40,25,3
2021,Camden 010A,E01000969,1770,1433,337,240,74,21,2
2021,Camden 010B,E01000970,1351,1095,256,167,54,30,5
2021,Camden 010C,E01000971,1274,1046,228,146,61,18,3
2021,Camden 010D,E01000972,1900,1433,467,241,157,57,12
2021,Camden 010E,E01000973,2488,1907,581,377,125,69,10
2021,Camden 013E,E01000974,1535,1177,358,189,96,65,8
2021,Croydon 022A,E01000975,2237,1742,495,260,170,58,7
2021,Croydon 022B,E01000976,2021,1508,513,205,194,103,11
2021,Croydon 022C,E01000977,1856,1424,432,179,149,83,21
2021,Croydon 022D,E01000978,1638,1295,343,174,122,43,4
2021,Croydon 022E,E01000979,1672,1321,351,159,137,49,6
2021,Croydon 017A,E01000980,1439,1223,216,88,75,45,8
2021,Croydon 017B,E01000981,1666,1415,251,106,102,38,5
2021,Croydon 017C,E01000982,1602,1361,241,115,75,44,7
2021,Croydon 017D,E01000983,1756,1482,274,105,115,49,5
2021,Croydon 022F,E01000984,1787,1417,370,153,135,77,5
2021,Croydon 021A,E01000985,1423,1300,123,50,50,19,4
2021,Croydon 021B,E01000986,1700,1514,186,79,69,31,7
2021,Croydon 021C,E01000987,1319,1193,126,69,38,16,3
2021,Croydon 018A,E01000989,1689,1546,143,78,45,18,2
2021,Croydon 045A,E01000990,1403,1216,187,85,64,34,4
2021,Croydon 018B,E01000991,1701,1548,153,82,50,18,3
2021,Croydon 014A,E01000992,1816,1623,193,77,80,32,4
2021,Croydon 021D,E01000993,1578,1366,212,95,82,26,9
2021,Croydon 009A,E01000994,1547,1175,372,118,148,99,7
2021,Croydon 009B,E01000995,1652,1101,551,185,217,127,22
2021,Croydon 009C,E01000996,1286,970,316,132,111,64,9
2021,Croydon 009D,E01000997,1463,1107,356,138,138,70,10
2021,Croydon 010A,E01000998,1426,1061,365,137,146,73,9
2021,Croydon 009E,E01000999,1289,950,339,125,152,54,8
2021,Croydon 010B,E01001000,1296,912,384,125,172,74,13
2021,Croydon 013A,E01001001,1352,1027,325,94,152,73,6
2021,Croydon 009F,E01001002,1413,1061,352,125,137,79,11
2021,Croydon 010C,E01001003,1524,1160,364,173,132,48,11
2021,Croydon 015A,E01001004,2087,1649,438,184,174,69,11
2021,Croydon 019A,E01001005,1672,1063,609,251,246,105,7
2021,Croydon 016A,E01001006,1714,1289,425,185,176,54,10
2021,Croydon 016B,E01001007,1940,1175,765,293,355,103,14
2021,Croydon 019B,E01001008,1613,1215,398,160,147,81,10
2021,Croydon 019C,E01001009,1940,1372,568,230,234,94,10
2021,Croydon 019D,E01001010,1658,1343,315,122,131,54,8
2021,Croydon 019E,E01001011,2172,1499,673,250,288,117,18
2021,Croydon 020A,E01001012,1993,1474,519,204,201,101,13
2021,Croydon 020B,E01001013,2068,1485,583,172,257,133,21
2021,Croydon 041A,E01001015,1437,1331,106,65,34,6,1
2021,Croydon 041B,E01001016,1704,1568,136,82,33,16,5
2021,Croydon 043A,E01001017,1580,1530,50,35,9,6,0
2021,Croydon 044A,E01001018,1594,1553,41,33,6,2,0
2021,Croydon 044B,E01001019,1411,1357,54,38,10,5,1
2021,Croydon 044C,E01001020,1567,1511,56,34,15,6,1
2021,Croydon 044D,E01001021,1328,1226,102,38,42,16,6
2021,Croydon 044E,E01001022,1444,1391,53,33,16,4,0
2021,Croydon 041C,E01001023,2448,2140,308,161,102,39,6
2021,Croydon 043B,E01001024,1290,1224,66,38,19,7,2
2021,Croydon 043C,E01001025,1290,1231,59,28,13,16,2
2021,Croydon 043D,E01001026,1793,1717,76,47,19,8,2
2021,Croydon 043E,E01001027,2725,2457,268,201,53,10,4
2021,Croydon 038A,E01001028,1615,1465,150,106,31,10,3
2021,Croydon 038B,E01001029,1656,1418,238,139,64,30,5
2021,Croydon 038C,E01001030,1406,1261,145,91,42,9,3
2021,Croydon 038D,E01001031,1412,1311,101,47,36,16,2
2021,Croydon 035A,E01001032,1504,1418,86,58,22,4,2
2021,Croydon 031A,E01001033,1584,1313,271,109,117,38,7
2021,Croydon 031B,E01001034,1524,1327,197,88,72,31,6
2021,Croydon 047C,E01001035,1773,1475,298,153,108,32,5
2021,Croydon 029A,E01001036,1579,1417,162,107,39,13,3
2021,Croydon 029B,E01001037,1447,1248,199,110,56,30,3
2021,Croydon 029C,E01001038,1837,1529,308,152,124,28,4
2021,Croydon 029D,E01001039,1514,1386,128,80,37,10,1
2021,Croydon 029E,E01001040,1643,1359,284,129,110,38,7
2021,Croydon 031C,E01001041,1646,1347,299,130,110,47,12
2021,Croydon 024B,E01001042,2065,1528,537,237,187,86,27
2021,Croydon 023A,E01001044,2006,1521,485,293,132,55,5
2021,Croydon 023B,E01001046,1843,1238,605,387,155,48,15
2021,Croydon 047A,E01001047,1657,1288,369,178,128,52,11
2021,Croydon 023C,E01001049,1390,1209,181,115,43,23,0
2021,Croydon 023D,E01001050,1657,1288,369,206,103,49,11
2021,Croydon 030A,E01001051,1546,1379,167,69,72,24,2
2021,Croydon 030B,E01001052,1430,1310,120,46,46,27,1
2021,Croydon 032A,E01001053,1538,1402,136,67,48,17,4
2021,Croydon 030C,E01001054,1805,1652,153,77,48,25,3
2021,Croydon 032B,E01001055,1526,1408,118,56,41,15,6
2021,Croydon 030D,E01001056,1747,1512,235,111,91,29,4
2021,Croydon 030E,E01001057,1722,1535,187,82,57,47,1
2021,Croydon 034A,E01001058,1307,1223,84,45,24,13,2
2021,Croydon 034B,E01001059,1383,1274,109,66,31,11,1
2021,Croydon 034C,E01001060,1556,1432,124,63,48,11,2
2021,Croydon 034D,E01001061,1560,1429,131,72,47,12,0
2021,Croydon 026A,E01001062,1480,1341,139,78,41,17,3
2021,Croydon 026B,E01001063,1492,1351,141,75,42,17,7
2021,Croydon 026C,E01001064,1566,1434,132,72,46,13,1
2021,Croydon 034E,E01001065,1289,1211,78,47,22,7,2
2021,Croydon 034F,E01001066,1412,1253,159,59,64,34,2
2021,Croydon 041D,E01001067,1617,1543,74,38,24,11,1
2021,Croydon 042A,E01001068,1771,1668,103,68,27,7,1
2021,Croydon 040A,E01001069,1316,1226,90,58,19,10,3
2021,Croydon 040B,E01001070,1733,1587,146,62,52,28,4
2021,Croydon 042B,E01001071,1839,1721,118,70,37,11,0
2021,Croydon 042C,E01001072,1450,1355,95,62,25,7,1
2021,Croydon 037A,E01001073,1376,1233,143,77,42,15,9
2021,Croydon 041E,E01001074,1875,1693,182,105,54,18,5
2021,Croydon 040C,E01001075,1562,1411,151,88,47,15,1
2021,Croydon 036A,E01001076,1602,1468,134,59,49,23,3
2021,Croydon 032C,E01001077,1294,1166,128,61,44,20,3
2021,Croydon 032D,E01001078,1408,1257,151,51,71,25,4
2021,Croydon 036B,E01001079,1568,1470,98,58,29,11,0
2021,Croydon 036C,E01001080,1430,1304,126,66,38,16,6
2021,Croydon 036D,E01001081,1421,1318,103,62,27,12,2
2021,Croydon 032E,E01001082,1507,1389,118,77,30,11,0
2021,Croydon 003A,E01001083,1574,1260,314,132,124,53,5
2021,Croydon 002A,E01001084,1883,1577,306,139,117,43,7
2021,Croydon 004A,E01001085,1646,1137,509,198,215,80,16
2021,Croydon 003B,E01001086,1676,1326,350,137,130,70,13
2021,Croydon 003C,E01001087,2667,1839,828,348,316,141,23
2021,Croydon 004B,E01001088,1634,1331,303,127,125,46,5
2021,Croydon 004C,E01001089,1737,1240,497,221,178,81,17
2021,Croydon 004D,E01001090,2186,1593,593,202,235,131,25
2021,Croydon 004E,E01001091,1539,1250,289,113,109,47,20
2021,Croydon 037B,E01001092,1873,1675,198,106,64,25,3
2021,Croydon 037C,E01001093,1728,1479,249,116,84,39,10
2021,Croydon 038E,E01001094,1602,1473,129,73,39,15,2
2021,Croydon 031D,E01001095,1455,1270,185,103,57,24,1
2021,Croydon 037D,E01001096,1431,1315,116,79,24,13,0
2021,Croydon 037E,E01001097,2294,1936,358,192,119,40,7
2021,Croydon 037F,E01001098,1423,1343,80,52,20,8,0
2021,Croydon 040D,E01001099,1526,1369,157,99,43,11,4
2021,Croydon 031E,E01001100,1454,1305,149,81,48,16,4
2021,Croydon 035B,E01001101,1386,1337,49,33,13,3,0
2021,Croydon 035C,E01001102,1478,1405,73,41,23,8,1
2021,Croydon 039A,E01001103,1590,1530,60,32,13,14,1
2021,Croydon 042D,E01001104,1613,1503,110,83,19,6,2
2021,Croydon 039B,E01001105,1688,1593,95,50,35,6,4
2021,Croydon 039C,E01001106,1463,1386,77,35,25,15,2
2021,Croydon 035D,E01001107,1623,1456,167,116,37,11,3
2021,Croydon 035E,E01001108,1734,1634,100,74,14,10,2
2021,Croydon 013B,E01001109,2240,1813,427,178,165,72,12
2021,Croydon 020D,E01001110,2044,1583,461,181,199,75,6
2021,Croydon 010D,E01001111,1690,1316,374,146,141,73,14
2021,Croydon 013C,E01001112,1922,1617,305,132,114,51,8
2021,Croydon 013D,E01001113,1866,1522,344,136,121,73,14
2021,Croydon 013E,E01001114,1442,1146,296,96,145,48,7
2021,Croydon 015B,E01001115,1731,1321,410,163,144,85,18
2021,Croydon 013F,E01001116,1466,1148,318,123,123,64,8
2021,Croydon 020E,E01001118,2058,1655,403,140,148,105,10
2021,Croydon 034G,E01001119,1403,1357,46,30,11,3,2
2021,Croydon 033A,E01001120,1295,1198,97,58,27,9,3
2021,Croydon 039D,E01001121,1297,1222,75,53,15,6,1
2021,Croydon 033B,E01001122,1411,1226,185,105,61,16,3
2021,Croydon 033C,E01001123,1580,1469,111,71,27,13,0
2021,Croydon 033D,E01001124,1529,1427,102,65,24,9,4
2021,Croydon 033E,E01001125,1593,1430,163,95,46,18,4
2021,Croydon 034H,E01001126,1370,1291,79,54,12,10,3
2021,Croydon 025A,E01001127,1582,1472,110,53,49,8,0
2021,Croydon 025B,E01001128,1550,1397,153,56,62,34,1
2021,Croydon 026D,E01001129,1364,1277,87,62,20,4,1
2021,Croydon 025C,E01001130,1689,1425,264,114,110,37,3
2021,Croydon 018C,E01001131,1505,1379,126,56,53,14,3
2021,Croydon 018D,E01001132,1575,1438,137,78,42,16,1
2021,Croydon 026E,E01001133,1550,1428,122,53,45,21,3
2021,Croydon 018E,E01001134,1562,1405,157,84,55,18,0
2021,Croydon 025D,E01001135,1650,1508,142,80,38,23,1
2021,Croydon 007A,E01001136,1933,1567,366,145,148,61,12
2021,Croydon 001A,E01001137,2009,1736,273,119,117,29,8
2021,Croydon 001B,E01001138,1449,1330,119,71,27,13,8
2021,Croydon 007B,E01001139,1619,1423,196,83,76,33,4
2021,Croydon 007C,E01001140,1554,1346,208,100,67,31,10
2021,Croydon 008A,E01001141,1233,1017,216,107,74,33,2
2021,Croydon 007D,E01001142,1864,1586,278,176,71,26,5
2021,Croydon 008B,E01001143,1851,1559,292,100,124,62,6
2021,Croydon 007E,E01001144,1681,1376,305,141,103,53,8
2021,Croydon 008C,E01001145,1755,1453,302,104,124,64,10
2021,Croydon 006A,E01001146,1485,1278,207,90,83,25,9
2021,Croydon 005A,E01001147,1704,1385,319,128,124,53,14
2021,Croydon 005B,E01001148,1702,1463,239,107,84,42,6
2021,Croydon 006B,E01001149,1508,1284,224,89,95,38,2
2021,Croydon 006C,E01001150,1648,1470,178,80,57,33,8
2021,Croydon 005C,E01001151,1682,1339,343,126,127,74,16
2021,Croydon 005D,E01001152,1979,1364,615,177,242,174,22
2021,Croydon 006D,E01001153,1591,1319,272,104,109,45,14
2021,Croydon 006E,E01001154,1880,1445,435,184,158,76,17
2021,Croydon 010E,E01001155,1715,1352,363,144,131,72,16
2021,Croydon 001C,E01001156,1707,1449,258,124,79,47,8
2021,Croydon 002B,E01001157,1789,1488,301,136,107,46,12
2021,Croydon 005E,E01001158,1478,1291,187,70,76,33,8
2021,Croydon 002C,E01001159,1872,1560,312,148,96,61,7
2021,Croydon 002D,E01001160,1889,1491,398,178,143,66,11
2021,Croydon 003D,E01001161,1706,1379,327,119,125,72,11
2021,Croydon 001D,E01001162,1755,1557,198,98,60,36,4
2021,Croydon 002E,E01001163,1893,1637,256,121,97,34,4
2021,Croydon 001E,E01001164,1901,1647,254,127,92,34,1
2021,Croydon 024C,E01001165,1778,1408,370,162,135,70,3
2021,Croydon 024D,E01001166,1880,1500,380,178,136,59,7
2021,Croydon 028A,E01001167,2240,1826,414,205,141,62,6
2021,Croydon 024E,E01001168,1761,1368,393,189,155,42,7
2021,Croydon 028B,E01001169,1738,1506,232,98,91,37,6
2021,Croydon 047D,E01001170,1860,1550,310,146,116,37,11
2021,Croydon 028C,E01001171,1690,1429,261,138,82,36,5
2021,Croydon 028D,E01001172,2131,1835,296,110,134,44,8
2021,Croydon 028E,E01001173,2618,2248,370,184,138,42,6
2021,Croydon 011A,E01001174,1627,1181,446,207,166,65,8
2021,Croydon 011B,E01001175,1574,1141,433,139,173,100,21
2021,Croydon 011C,E01001176,1779,1265,514,213,192,92,17
2021,Croydon 016C,E01001177,1609,1154,455,183,191,78,3
2021,Croydon 015D,E01001178,1512,1083,429,162,167,85,15
2021,Croydon 016D,E01001179,1593,1118,475,182,194,90,9
2021,Croydon 016E,E01001180,1891,1285,606,239,226,115,26
2021,Croydon 015E,E01001181,2020,1517,503,200,198,94,11
2021,Croydon 011D,E01001182,1312,910,402,175,160,52,15
2021,Croydon 011E,E01001183,1736,1233,503,203,182,103,15
2021,Croydon 011F,E01001184,1252,953,299,112,129,49,9
2021,Croydon 014B,E01001185,1630,1393,237,107,82,41,7
2021,Croydon 014C,E01001186,1623,1401,222,99,79,38,6
2021,Croydon 017E,E01001187,1914,1616,298,140,96,56,6
2021,Croydon 014D,E01001188,1862,1643,219,92,74,42,11
2021,Croydon 045B,E01001189,1165,1063,102,55,37,9,1
2021,Croydon 045C,E01001190,1494,1363,131,69,40,20,2
2021,Croydon 008D,E01001191,1976,1661,315,124,127,55,9
2021,Croydon 008E,E01001192,1517,1320,197,99,67,26,5
2021,Croydon 014E,E01001193,1652,1512,140,65,53,19,3
2021,Croydon 045D,E01001194,1540,1383,157,66,55,34,2
2021,Ealing 021A,E01001195,1759,1099,660,183,293,146,38
2021,Ealing 015A,E01001196,1556,1101,455,184,180,84,7
2021,Ealing 021B,E01001197,1802,1114,688,229,220,201,38
2021,Ealing 021C,E01001198,1493,1152,341,164,135,41,1
2021,Ealing 021D,E01001199,1604,1176,428,190,166,67,5
2021,Ealing 025A,E01001200,1533,1236,297,162,92,40,3
2021,Ealing 025B,E01001201,1536,1286,250,132,86,26,6
2021,Ealing 025C,E01001202,2395,1636,759,322,289,131,17
2021,Ealing 025D,E01001203,1631,1172,459,194,176,82,7
2021,Ealing 018A,E01001204,1579,1302,277,136,95,44,2
2021,Ealing 018B,E01001205,1708,1265,443,198,138,91,16
2021,Ealing 018C,E01001206,1503,1082,421,145,161,101,14
2021,Ealing 018D,E01001207,1686,1328,358,199,110,44,5
2021,Ealing 018E,E01001208,1338,1169,169,103,42,20,4
2021,Ealing 013A,E01001209,1632,1393,239,139,73,24,3
2021,Ealing 016A,E01001210,1817,1344,473,192,172,97,12
2021,Ealing 013B,E01001211,1698,1361,337,183,108,39,7
2021,Ealing 018F,E01001212,1737,1372,365,188,126,46,5
2021,Ealing 023A,E01001213,1945,1152,793,267,314,185,27
2021,Ealing 023B,E01001214,1705,916,789,335,282,151,21
2021,Ealing 023C,E01001215,2004,1142,862,270,343,209,40
2021,Ealing 023D,E01001216,1691,876,815,326,279,180,30
2021,Ealing 014A,E01001217,1419,963,456,160,189,91,16
2021,Ealing 012A,E01001218,1938,1161,777,279,318,149,31
2021,Ealing 029A,E01001219,2127,1428,699,206,303,165,25
2021,Ealing 029B,E01001220,1462,957,505,186,182,119,18
2021,Ealing 041B,E01001223,1406,1039,367,206,101,54,6
2021,Ealing 019B,E01001224,1521,1360,161,81,54,26,0
2021,Ealing 041A,E01001225,1772,1370,402,230,118,48,6
2021,Ealing 019C,E01001226,1453,1117,336,205,93,32,6
2021,Ealing 019D,E01001227,1485,1152,333,165,123,42,3
2021,Ealing 019E,E01001228,1787,1276,511,255,165,69,22
2021,Ealing 031A,E01001229,1481,1161,320,161,115,40,4
2021,Ealing 031B,E01001230,1332,1112,220,121,68,29,2
2021,Ealing 027A,E01001231,1993,1475,518,273,191,45,9
2021,Ealing 031C,E01001232,1518,1151,367,177,116,63,11
2021,Ealing 031D,E01001233,1384,1075,309,149,98,51,11
2021,Ealing 027B,E01001234,1324,1021,303,177,92,32,2
2021,Ealing 042D,E01001235,1721,1184,537,250,188,81,18
2021,Ealing 042C,E01001236,1429,1093,336,201,97,36,2
2021,Ealing 031E,E01001237,1523,1270,253,156,75,19,3
2021,Ealing 015C,E01001239,1432,1042,390,174,137,70,9
2021,Ealing 024A,E01001240,1784,1134,650,312,239,87,12
2021,Ealing 024B,E01001241,1807,1140,667,264,279,106,18
2021,Ealing 024C,E01001242,1569,1184,385,170,142,61,12
2021,Ealing 024D,E01001243,2299,1471,828,401,281,126,20
2021,Ealing 024E,E01001244,2693,1843,850,386,328,112,24
2021,Ealing 024F,E01001245,2040,1574,466,253,157,41,15
2021,Ealing 015D,E01001246,1763,1239,524,213,200,100,11
2021,Ealing 015E,E01001247,2218,1440,778,320,306,131,21
2021,Ealing 035A,E01001248,1558,1292,266,130,86,44,6
2021,Ealing 028A,E01001249,2359,1650,709,348,244,104,13
2021,Ealing 028B,E01001250,2093,1541,552,232,200,113,7
2021,Ealing 030A,E01001251,1735,1378,357,186,113,50,8
2021,Ealing 030B,E01001252,2377,1674,703,279,254,146,24
2021,Ealing 030C,E01001253,2058,1633,425,187,163,65,10
2021,Ealing 030D,E01001254,1686,1435,251,107,100,38,6
2021,Ealing 028C,E01001255,1532,1342,190,87,74,25,4
2021,Ealing 008A,E01001257,2137,1476,661,278,256,106,21
2021,Ealing 010B,E01001258,1807,1189,618,259,233,108,18
2021,Ealing 014B,E01001259,1537,907,630,244,250,116,20
2021,Ealing 012B,E01001260,1974,1279,695,265,280,128,22
2021,Ealing 012C,E01001261,2235,1458,777,271,351,137,18
2021,Ealing 010C,E01001262,1572,1130,442,166,167,83,26
2021,Ealing 010D,E01001263,1865,1325,540,218,207,93,22
2021,Ealing 010E,E01001264,1769,1252,517,187,236,82,12
2021,Ealing 006A,E01001265,1668,1082,586,202,267,105,12
2021,Ealing 006B,E01001266,1791,1193,598,243,246,97,12
2021,Ealing 006C,E01001267,1971,1324,647,243,236,144,24
2021,Ealing 012D,E01001268,1906,1382,524,213,187,95,29
2021,Ealing 001A,E01001269,2187,1335,852,367,313,164,8
2021,Ealing 004A,E01001270,1715,1139,576,212,253,95,16
2021,Ealing 001B,E01001271,1848,1207,641,226,284,116,15
2021,Ealing 006D,E01001272,1673,1023,650,253,242,131,24
2021,Ealing 041C,E01001273,1636,1144,492,236,154,86,16
2021,Ealing 041E,E01001274,1559,863,696,257,216,172,51
2021,Ealing 041D,E01001275,1738,1285,453,272,123,52,6
2021,Ealing 011A,E01001276,1728,1049,679,272,296,102,9
2021,Ealing 011B,E01001277,1918,1178,740,321,287,108,24
2021,Ealing 011C,E01001278,1979,1158,821,344,282,158,37
2021,Ealing 013C,E01001279,1454,1216,238,148,63,27,0
2021,Ealing 011D,E01001280,1765,1217,548,289,183,66,10
2021,Ealing 013D,E01001281,1521,1309,212,119,68,17,8
2021,Ealing 016B,E01001282,1549,1126,423,176,159,73,15
2021,Ealing 016C,E01001283,1727,1268,459,159,181,93,26
2021,Ealing 022A,E01001284,1683,1262,421,168,194,53,6
2021,Ealing 016D,E01001285,1707,1202,505,206,191,98,10
2021,Ealing 016E,E01001286,1620,1236,384,147,158,64,15
2021,Ealing 016F,E01001287,1583,1161,422,145,193,73,11
2021,Ealing 022B,E01001288,1423,1153,270,103,104,58,5
2021,Ealing 022C,E01001289,1302,1048,254,112,103,37,2
2021,Ealing 022D,E01001290,1991,1513,478,202,193,79,4
2021,Ealing 014C,E01001291,1681,1023,658,243,275,116,24
2021,Ealing 014D,E01001292,1634,1041,593,241,233,105,14
2021,Ealing 014E,E01001293,1759,1082,677,264,269,120,24
2021,Ealing 017A,E01001294,1960,1051,909,318,365,192,34
2021,Ealing 017B,E01001295,1750,986,764,283,314,137,30
2021,Ealing 017C,E01001296,1400,837,563,211,214,121,17
2021,Ealing 017D,E01001297,1779,945,834,277,308,201,48
2021,Ealing 017E,E01001298,2055,1095,960,348,361,203,48
2021,Ealing 035B,E01001299,1713,1474,239,114,96,27,2
2021,Ealing 039A,E01001300,1550,1318,232,134,76,18,4
2021,Ealing 039B,E01001301,1832,1283,549,294,177,67,11
2021,Ealing 039C,E01001302,1547,1302,245,151,71,22,1
2021,Ealing 032A,E01001303,1662,1331,331,164,112,47,8
2021,Ealing 039D,E01001304,1556,1287,269,166,74,28,1
2021,Ealing 035C,E01001305,1684,1460,224,121,72,30,1
2021,Ealing 035D,E01001306,1576,1366,210,121,64,25,0
2021,Ealing 002A,E01001307,1816,1150,666,268,263,120,15
2021,Ealing 002B,E01001308,1893,1219,674,277,265,117,15
2021,Ealing 001C,E01001309,1808,1168,640,245,259,117,19
2021,Ealing 001D,E01001310,2077,1363,714,261,352,91,10
2021,Ealing 001E,E01001311,2407,1637,770,320,305,126,19
2021,Ealing 002C,E01001312,1902,1123,779,321,327,118,13
2021,Ealing 002D,E01001313,1683,1110,573,210,241,101,21
2021,Ealing 002E,E01001314,1479,1017,462,183,204,65,10
2021,Ealing 003A,E01001315,1413,863,550,225,216,92,17
2021,Ealing 003B,E01001316,1657,1104,553,226,233,85,9
2021,Ealing 003C,E01001317,2102,1372,730,295,311,107,17
2021,Ealing 003D,E01001318,1889,1260,629,235,265,105,24
2021,Ealing 004B,E01001319,1492,1025,467,201,187,69,10
2021,Ealing 003E,E01001320,1540,1169,371,160,137,67,7
2021,Ealing 003F,E01001321,2179,1518,661,250,282,108,21
2021,Ealing 004C,E01001322,2006,1343,663,272,276,101,14
2021,Ealing 004D,E01001323,1915,1224,691,267,281,125,18
2021,Ealing 008B,E01001324,1578,1023,555,238,215,75,27
2021,Ealing 009A,E01001325,1928,1401,527,226,217,71,13
2021,Ealing 008C,E01001326,1814,1325,489,215,204,64,6
2021,Ealing 009B,E01001327,1830,1250,580,222,249,83,26
2021,Ealing 009C,E01001328,1757,1202,555,220,223,91,21
2021,Ealing 009D,E01001329,1877,1273,604,275,229,83,17
2021,Ealing 008D,E01001330,1775,1260,515,194,206,99,16
2021,Ealing 009E,E01001331,1699,1112,587,198,253,117,19
2021,Ealing 008E,E01001332,1514,1065,449,181,183,71,14
2021,Ealing 038A,E01001333,2379,1353,1026,333,409,221,63
2021,Ealing 029C,E01001334,1607,930,677,215,227,177,58
2021,Ealing 038B,E01001335,1742,1140,602,295,161,114,32
2021,Ealing 038C,E01001336,1783,1108,675,247,234,151,43
2021,Ealing 029D,E01001337,2029,1498,531,218,205,103,5
2021,Ealing 029E,E01001338,1794,1059,735,270,281,159,25
2021,Ealing 029F,E01001339,2095,1497,598,272,213,93,20
2021,Ealing 029G,E01001340,1501,1149,352,137,124,81,10
2021,Ealing 005A,E01001341,1738,1045,693,316,244,115,18
2021,Ealing 005B,E01001342,1838,1028,810,305,321,158,26
2021,Ealing 005C,E01001343,1402,905,497,181,209,94,13
2021,Ealing 007A,E01001344,2187,1372,815,314,351,133,17
2021,Ealing 005D,E01001345,1712,1049,663,238,293,117,15
2021,Ealing 007B,E01001346,1902,1247,655,292,259,90,14
2021,Ealing 007C,E01001347,1929,1236,693,265,247,142,39
2021,Ealing 007D,E01001348,1598,1050,548,242,206,82,18
2021,Ealing 006E,E01001349,1366,1018,348,135,137,68,8
2021,Ealing 027C,E01001350,1410,1007,403,173,141,77,12
2021,Ealing 025E,E01001351,1899,1302,597,251,198,127,21
2021,Ealing 027D,E01001352,1542,1089,453,225,152,62,14
2021,Ealing 033A,E01001353,1373,976,397,199,130,56,12
2021,Ealing 027E,E01001354,1997,1466,531,259,186,67,19
2021,Ealing 033B,E01001355,1889,1396,493,243,169,68,13
2021,Ealing 033C,E01001356,1417,955,462,171,165,106,20
2021,Ealing 033D,E01001357,2588,1938,650,354,207,76,13
2021,Ealing 033E,E01001358,1879,1411,468,262,143,55,8
2021,Ealing 026A,E01001359,2387,1248,1139,366,459,262,52
2021,Ealing 026B,E01001360,2156,1309,847,277,332,204,34
2021,Ealing 023E,E01001361,2189,1289,900,254,382,218,46
2021,Ealing 026C,E01001362,2526,1441,1085,391,402,246,46
2021,Ealing 026D,E01001363,1925,971,954,348,365,216,25
2021,Ealing 026E,E01001364,1769,1065,704,224,295,152,33
2021,Ealing 026F,E01001365,2491,1328,1163,360,466,283,54
2021,Ealing 044C,E01001366,1976,1004,972,321,375,232,44
2021,Ealing 043B,E01001367,2604,1431,1173,332,477,297,67
2021,Ealing 044D,E01001368,1725,912,813,271,308,192,42
2021,Ealing 038D,E01001369,2000,1100,900,285,350,212,53
2021,Ealing 044A,E01001370,2111,1135,976,327,374,233,42
2021,Ealing 044B,E01001371,2238,1315,923,320,335,221,47
2021,Ealing 043C,E01001372,2446,1388,1058,375,381,240,62
2021,Ealing 043A,E01001373,2009,1135,874,333,315,170,56
2021,Ealing 040A,E01001374,1878,1581,297,190,71,34,2
2021,Ealing 034A,E01001375,1634,1410,224,157,51,14,2
2021,Ealing 040B,E01001376,1634,1314,320,165,104,48,3
2021,Ealing 034B,E01001377,1600,1379,221,164,44,12,1
2021,Ealing 034C,E01001379,1665,1444,221,173,38,10,0
2021,Ealing 040C,E01001380,2218,1818,400,265,94,40,1
2021,Ealing 034D,E01001381,1799,1359,440,247,127,59,7
2021,Ealing 032B,E01001382,1440,1265,175,120,36,17,2
2021,Ealing 028D,E01001383,1692,1388,304,148,109,39,8
2021,Ealing 032C,E01001384,1670,1348,322,157,110,52,3
2021,Ealing 032D,E01001385,1614,1333,281,160,85,32,4
2021,Ealing 031F,E01001386,1747,1466,281,171,62,35,13
2021,Ealing 032E,E01001387,1491,1156,335,174,106,47,8
2021,Ealing 028E,E01001388,1392,1057,335,155,118,54,8
2021,Ealing 028F,E01001389,1750,1209,541,197,168,164,12
2021,Enfield 036A,E01001390,1753,1249,504,235,184,75,10
2021,Enfield 036B,E01001391,1712,1077,635,233,273,119,10
2021,Enfield 032A,E01001392,1815,1355,460,198,163,85,14
2021,Enfield 036C,E01001393,1892,1315,577,252,225,90,10
2021,Enfield 035A,E01001394,1964,1118,846,409,258,156,23
2021,Enfield 035B,E01001395,1588,1094,494,172,191,115,16
2021,Enfield 036D,E01001396,1425,833,592,190,257,123,22
2021,Enfield 035C,E01001397,2048,1268,780,258,330,173,19
2021,Enfield 021A,E01001398,1297,1185,112,54,40,16,2
2021,Enfield 021B,E01001399,1442,1157,285,108,112,56,9
2021,Enfield 021C,E01001400,1524,1356,168,71,60,34,3
2021,Enfield 016A,E01001401,1344,1126,218,80,93,38,7
2021,Enfield 021D,E01001402,1789,1440,349,146,128,63,12
2021,Enfield 021E,E01001403,1616,1350,266,105,97,50,14
2021,Enfield 026A,E01001404,1423,1152,271,113,97,52,9
2021,Enfield 015A,E01001405,1736,1456,280,100,111,62,7
2021,Enfield 015B,E01001406,1571,1313,258,97,95,54,12
2021,Enfield 005A,E01001407,1550,1372,178,78,68,25,7
2021,Enfield 004A,E01001408,1588,1457,131,72,36,22,1
2021,Enfield 005B,E01001409,1927,1570,357,158,121,72,6
2021,Enfield 005C,E01001410,2094,1678,416,153,145,101,17
2021,Enfield 004B,E01001411,1826,1645,181,88,66,24,3
2021,Enfield 004C,E01001412,1687,1501,186,59,69,51,7
2021,Enfield 004D,E01001413,1586,1510,76,43,19,10,4
2021,Enfield 004E,E01001414,1609,1350,259,80,105,66,8
2021,Enfield 011A,E01001415,1962,1507,455,192,177,77,9
2021,Enfield 013A,E01001416,1688,1492,196,99,71,24,2
2021,Enfield 011B,E01001417,1845,1691,154,78,55,17,4
2021,Enfield 011C,E01001418,1689,1386,303,120,115,57,11
2021,Enfield 020A,E01001419,1908,1502,406,151,173,68,14
2021,Enfield 020B,E01001420,1720,1373,347,154,122,59,12
2021,Enfield 020C,E01001421,1606,1164,442,186,167,75,14
2021,Enfield 011D,E01001422,1636,1525,111,43,52,13,3
2021,Enfield 027A,E01001423,1659,1162,497,138,179,162,18
2021,Enfield 030A,E01001424,1163,854,309,98,113,87,11
2021,Enfield 027B,E01001425,1933,1259,674,174,224,232,44
2021,Enfield 030B,E01001426,1758,1187,571,127,236,173,35
2021,Enfield 030C,E01001427,1681,1106,575,151,226,163,35
2021,Enfield 027C,E01001428,1674,1193,481,149,212,103,17
2021,Enfield 030D,E01001429,2226,1480,746,203,256,236,51
2021,Enfield 030E,E01001430,1933,1236,697,239,242,183,33
2021,Enfield 033A,E01001431,1702,1130,572,164,219,168,21
2021,Enfield 033B,E01001432,1801,1151,650,187,242,178,43
2021,Enfield 007A,E01001433,1773,1381,392,133,152,95,12
2021,Enfield 007B,E01001434,1538,1171,367,111,150,93,13
2021,Enfield 007C,E01001435,1469,1144,325,113,134,64,14
2021,Enfield 007D,E01001436,1861,1423,438,122,187,108,21
2021,Enfield 014A,E01001437,2186,1632,554,177,198,153,26
2021,Enfield 007E,E01001438,1604,1215,389,136,137,99,17
2021,Enfield 006A,E01001439,2026,1422,604,179,221,172,32
2021,Enfield 012A,E01001440,1621,1183,438,141,178,102,17
2021,Enfield 006B,E01001441,1562,1185,377,99,154,108,16
2021,Enfield 002A,E01001442,1661,1184,477,120,193,133,31
2021,Enfield 001A,E01001444,1812,1419,393,146,155,86,6
2021,Enfield 003B,E01001445,2643,2036,607,208,236,144,19
2021,Enfield 001B,E01001446,1804,1436,368,131,116,101,20
2021,Enfield 003C,E01001447,1924,1480,444,148,151,124,21
2021,Enfield 003D,E01001448,1906,1496,410,165,129,101,15
2021,Enfield 003E,E01001449,1606,1295,311,100,111,84,16
2021,Enfield 015C,E01001450,2279,1700,579,218,228,112,21
2021,Enfield 017A,E01001451,1613,1427,186,76,67,31,12
2021,Enfield 017B,E01001452,1346,1239,107,62,31,10,4
2021,Enfield 017C,E01001453,1613,1464,149,63,58,24,4
2021,Enfield 017D,E01001454,1655,1451,204,92,69,37,6
2021,Enfield 021F,E01001455,1408,1231,177,81,57,33,6
2021,Enfield 022A,E01001456,1362,1260,102,46,40,16,0
2021,Enfield 010A,E01001457,1766,1564,202,92,66,40,4
2021,Enfield 037A,E01001458,1712,1060,652,198,239,182,33
2021,Enfield 024A,E01001459,1661,1136,525,154,237,121,13
2021,Enfield 024B,E01001460,1978,1230,748,227,327,160,34
2021,Enfield 027D,E01001461,1508,1024,484,135,184,129,36
2021,Enfield 024C,E01001462,1384,1015,369,96,156,102,15
2021,Enfield 031A,E01001463,1521,1059,462,154,174,111,23
2021,Enfield 027E,E01001464,1273,925,348,115,128,94,11
2021,Enfield 031B,E01001465,1516,994,522,133,181,194,14
2021,Enfield 031C,E01001466,1900,1253,647,182,240,191,34
2021,Enfield 031D,E01001467,1934,1373,561,134,246,146,35
2021,Enfield 010B,E01001468,1360,1214,146,86,42,17,1
2021,Enfield 008A,E01001469,1704,1507,197,88,70,38,1
2021,Enfield 013B,E01001470,1608,1462,146,58,59,25,4
2021,Enfield 010C,E01001471,1824,1577,247,102,90,47,8
2021,Enfield 010D,E01001472,1593,1384,209,75,97,33,4
2021,Enfield 013C,E01001473,1539,1389,150,64,54,28,4
2021,Enfield 010E,E01001474,1834,1637,197,94,64,35,4
2021,Enfield 013D,E01001475,1759,1585,174,92,56,23,3
2021,Enfield 018A,E01001476,1692,1174,518,139,212,145,22
2021,Enfield 018B,E01001477,1930,1393,537,194,184,128,31
2021,Enfield 016B,E01001478,1595,1245,350,110,106,119,15
2021,Enfield 023A,E01001479,1705,1067,638,179,255,167,37
2021,Enfield 024D,E01001480,1501,1094,407,116,157,125,9
2021,Enfield 018C,E01001481,1739,1264,475,141,192,124,18
2021,Enfield 023B,E01001482,1862,1185,677,200,256,194,27
2021,Enfield 025A,E01001483,1118,747,371,75,173,104,19
2021,Enfield 016C,E01001484,1347,1008,339,115,118,93,13
2021,Enfield 025B,E01001485,1808,1186,622,162,264,168,28
2021,Enfield 025C,E01001486,2067,1405,662,170,262,196,34
2021,Enfield 023C,E01001487,1871,1235,636,165,269,168,34
2021,Enfield 024E,E01001488,1922,1297,625,190,232,163,40
2021,Enfield 023D,E01001489,1812,1238,574,167,223,153,31
2021,Enfield 023E,E01001491,1894,1348,546,167,202,140,37
2021,Enfield 025E,E01001492,1973,1400,573,187,224,146,16
2021,Enfield 026B,E01001493,1862,1447,415,151,170,84,10
2021,Enfield 026C,E01001494,1432,1095,337,116,139,62,20
2021,Enfield 029A,E01001495,1785,1197,588,284,203,93,8
2021,Enfield 026D,E01001496,1844,1287,557,154,251,134,18
2021,Enfield 031E,E01001497,1401,1019,382,130,149,88,15
2021,Enfield 029B,E01001498,1765,1153,612,232,224,135,21
2021,Enfield 031F,E01001499,1494,1091,403,123,192,80,8
2021,Enfield 035D,E01001500,1505,1026,479,158,171,125,25
2021,Enfield 036E,E01001501,2103,1466,637,239,237,139,22
2021,Enfield 018D,E01001502,1894,1414,480,153,186,123,18
2021,Enfield 018E,E01001503,1824,1354,470,140,172,139,19
2021,Enfield 012B,E01001504,2041,1378,663,170,268,180,45
2021,Enfield 012C,E01001505,1910,1373,537,130,200,187,20
2021,Enfield 012D,E01001507,2496,1744,752,181,292,242,37
2021,Enfield 012E,E01001508,2332,1652,680,214,275,162,29
2021,Enfield 014C,E01001509,1688,1168,520,153,219,131,17
2021,Enfield 016D,E01001511,1834,1503,331,128,132,62,9
2021,Enfield 015D,E01001512,2183,1732,451,190,159,79,23
2021,Enfield 012F,E01001513,1885,1465,420,114,187,100,19
2021,Enfield 016E,E01001514,1689,1393,296,105,104,79,8
2021,Enfield 015E,E01001515,1946,1437,509,143,229,118,19
2021,Enfield 005D,E01001516,2037,1651,386,116,158,91,21
2021,Enfield 006C,E01001517,1986,1440,546,156,209,152,29
2021,Enfield 016F,E01001518,1634,1385,249,95,88,58,8
2021,Enfield 019A,E01001520,1780,1390,390,161,125,89,15
2021,Enfield 028A,E01001521,1820,1478,342,180,92,59,11
2021,Enfield 019B,E01001522,1747,1414,333,138,126,62,7
2021,Enfield 019C,E01001523,1771,1483,288,115,107,55,11
2021,Enfield 019D,E01001524,1521,1253,268,98,114,53,3
2021,Enfield 020E,E01001525,1913,1484,429,171,154,77,27
2021,Enfield 019E,E01001526,1568,1302,266,93,116,50,7
2021,Enfield 036F,E01001527,1946,1469,477,210,153,98,16
2021,Enfield 032B,E01001528,1622,1163,459,157,195,98,9
2021,Enfield 032C,E01001529,1704,1058,646,235,248,143,20
2021,Enfield 032D,E01001530,1674,1248,426,166,149,99,12
2021,Enfield 028B,E01001531,1389,1261,128,63,40,21,4
2021,Enfield 028C,E01001532,1615,1393,222,92,75,47,8
2021,Enfield 028D,E01001533,1602,1372,230,118,82,26,4
2021,Enfield 032E,E01001534,1640,1220,420,199,148,64,9
2021,Enfield 028E,E01001535,1362,1074,288,117,111,53,7
2021,Enfield 008B,E01001536,1913,1656,257,99,101,47,10
2021,Enfield 005E,E01001537,1648,1458,190,87,64,34,5
2021,Enfield 009A,E01001538,1631,1538,93,44,38,10,1
2021,Enfield 009B,E01001539,1589,1443,146,63,50,28,5
2021,Enfield 008C,E01001540,1789,1557,232,92,63,64,13
2021,Enfield 008D,E01001541,1462,1385,77,41,27,7,2
2021,Enfield 008E,E01001542,1518,1264,254,99,101,46,8
2021,Enfield 009C,E01001543,1571,1409,162,74,52,31,5
2021,Enfield 009D,E01001544,1645,1429,216,70,97,42,7
2021,Enfield 002B,E01001545,1815,1433,382,106,131,124,21
2021,Enfield 001C,E01001546,1749,1443,306,85,129,84,8
2021,Enfield 002C,E01001547,2041,1465,576,144,200,178,54
2021,Enfield 002D,E01001548,1860,1468,392,115,165,92,20
2021,Enfield 006D,E01001549,2225,1732,493,126,177,157,33
2021,Enfield 006E,E01001550,1701,1335,366,112,144,102,8
2021,Enfield 002E,E01001551,1730,1392,338,82,144,98,14
2021,Enfield 001D,E01001552,1884,1498,386,120,132,105,29
2021,Enfield 037B,E01001553,1689,1129,560,171,227,142,20
2021,Enfield 037C,E01001554,1729,1132,597,155,211,188,43
2021,Enfield 033C,E01001555,2173,1466,707,212,297,175,23
2021,Enfield 035E,E01001556,1540,1120,420,133,172,103,12
2021,Enfield 033D,E01001557,1643,1183,460,150,175,110,25
2021,Enfield 033E,E01001558,1956,1193,763,214,308,207,34
2021,Enfield 033F,E01001559,2027,1357,670,194,240,199,37
2021,Enfield 035F,E01001560,1518,1033,485,130,196,142,17
2021,Enfield 037D,E01001562,2141,1432,709,223,231,207,48
2021,Enfield 029C,E01001563,1647,1236,411,134,177,81,19
2021,Enfield 022B,E01001564,1594,1404,190,81,67,41,1
2021,Enfield 029D,E01001565,1627,1335,292,132,111,45,4
2021,Enfield 029E,E01001566,1715,1466,249,113,85,41,10
2021,Enfield 022C,E01001567,1490,1384,106,56,34,12,4
2021,Enfield 022D,E01001568,1844,1668,176,82,63,28,3
2021,Enfield 022E,E01001569,1701,1449,252,92,101,54,5
2021,Enfield 026E,E01001570,1828,1501,327,122,127,62,16
2021,Greenwich 008A,E01001571,1759,1313,446,160,210,61,15
2021,Greenwich 008B,E01001572,1662,1334,328,139,119,60,10
2021,Greenwich 008C,E01001573,1530,1232,298,111,113,55,19
2021,Greenwich 008D,E01001574,1835,1553,282,107,122,50,3
2021,Greenwich 003A,E01001575,1755,1519,236,101,100,31,4
2021,Greenwich 003B,E01001576,1915,1611,304,135,123,41,5
2021,Greenwich 003C,E01001577,1880,1593,287,128,99,52,8
2021,Greenwich 003D,E01001578,2195,1714,481,172,203,98,8
2021,Greenwich 003E,E01001579,1679,1401,278,126,98,47,7
2021,Greenwich 021A,E01001580,1591,1392,199,148,29,20,2
2021,Greenwich 016A,E01001581,1538,1332,206,112,55,26,13
2021,Greenwich 021B,E01001582,1482,1277,205,108,54,37,6
2021,Greenwich 021C,E01001583,1520,1376,144,96,35,12,1
2021,Greenwich 021D,E01001584,1452,1323,129,99,20,8,2
2021,Greenwich 016B,E01001585,1475,1331,144,100,34,10,0
2021,Greenwich 016C,E01001586,1367,1232,135,88,33,11,3
2021,Greenwich 016D,E01001587,1930,1713,217,143,50,22,2
2021,Greenwich 012A,E01001588,1648,1323,325,172,93,51,9
2021,Greenwich 012B,E01001589,1774,1433,341,165,106,57,13
2021,Greenwich 014A,E01001590,1656,1324,332,159,97,61,15
2021,Greenwich 012C,E01001591,2011,1725,286,114,114,48,10
2021,Greenwich 014B,E01001592,1853,1582,271,164,65,36,6
2021,Greenwich 014C,E01001593,1715,1520,195,125,54,13,3
2021,Greenwich 014D,E01001594,2306,1892,414,170,154,75,15
2021,Greenwich 012D,E01001595,2129,1773,356,147,132,65,12
2021,Greenwich 032A,E01001596,1663,1513,150,86,42,19,3
2021,Greenwich 031A,E01001597,1502,1269,233,117,75,35,6
2021,Greenwich 031B,E01001598,1559,1346,213,109,69,33,2
2021,Greenwich 032B,E01001599,1614,1454,160,84,53,19,4
2021,Greenwich 032C,E01001600,1455,1307,148,71,59,15,3
2021,Greenwich 032D,E01001601,1462,1376,86,47,27,10,2
2021,Greenwich 031C,E01001602,2058,1768,290,137,102,37,14
2021,Greenwich 031D,E01001603,1685,1548,137,75,36,18,8
2021,Greenwich 027A,E01001604,1495,1306,189,88,58,35,8
2021,Greenwich 023A,E01001605,1469,1379,90,47,30,10,3
2021,Greenwich 023B,E01001606,1551,1439,112,69,30,12,1
2021,Greenwich 027B,E01001607,1547,1422,125,56,46,19,4
2021,Greenwich 027C,E01001608,1402,1313,89,48,29,10,2
2021,Greenwich 027D,E01001609,1638,1460,178,80,55,38,5
2021,Greenwich 023C,E01001610,1688,1530,158,89,44,20,5
2021,Greenwich 023D,E01001611,1694,1476,218,106,60,39,13
2021,Greenwich 028A,E01001613,1688,1454,234,105,77,46,6
2021,Greenwich 028B,E01001614,1459,1382,77,39,22,14,2
2021,Greenwich 028C,E01001615,1902,1549,353,156,118,64,15
2021,Greenwich 028D,E01001617,1568,1386,182,100,57,20,5
2021,Greenwich 030C,E01001618,1834,1662,172,102,51,13,6
2021,Greenwich 030D,E01001619,1878,1609,269,168,73,22,6
2021,Greenwich 025A,E01001620,1541,1295,246,88,99,51,8
2021,Greenwich 025B,E01001621,1629,1423,206,92,77,28,9
2021,Greenwich 025C,E01001623,1741,1425,316,170,103,40,3
2021,Greenwich 025D,E01001624,1561,1366,195,112,45,37,1
2021,Greenwich 025E,E01001625,1723,1495,228,110,80,35,3
2021,Greenwich 009A,E01001629,2058,1667,391,166,135,81,9
2021,Greenwich 007B,E01001631,2023,1619,404,147,170,71,16
2021,Greenwich 007C,E01001632,1955,1252,703,219,291,151,42
2021,Greenwich 009B,E01001633,1950,1459,491,156,220,82,33
2021,Greenwich 009C,E01001634,1673,1385,288,115,109,58,6
2021,Greenwich 007D,E01001635,1579,1247,332,142,128,52,10
2021,Greenwich 007E,E01001636,1600,1067,533,207,201,97,28
2021,Greenwich 009D,E01001637,1735,1344,391,134,167,74,16
2021,Greenwich 038A,E01001638,1702,1410,292,126,94,67,5
2021,Greenwich 038B,E01001641,1797,1556,241,155,62,16,8
2021,Greenwich 038C,E01001642,1666,1530,136,102,29,4,1
2021,Greenwich 038D,E01001644,2497,2044,453,312,83,47,11
2021,Greenwich 022A,E01001645,1790,1483,307,144,115,42,6
2021,Greenwich 019A,E01001646,2685,2206,479,223,154,87,15
2021,Greenwich 022B,E01001647,1436,1255,181,87,67,22,5
2021,Greenwich 022C,E01001648,1644,1388,256,136,74,40,6
2021,Greenwich 022D,E01001649,1511,1285,226,122,68,30,6
2021,Greenwich 019B,E01001650,1769,1405,364,143,151,55,15
2021,Greenwich 019C,E01001651,1788,1441,347,160,127,48,12
2021,Greenwich 019D,E01001652,1652,1380,272,118,90,59,5
2021,Greenwich 029A,E01001653,1520,1334,186,73,69,36,8
2021,Greenwich 029B,E01001654,1541,1361,180,77,68,27,8
2021,Greenwich 029C,E01001655,1517,1368,149,64,47,36,2
2021,Greenwich 034A,E01001656,1289,1159,130,87,22,18,3
2021,Greenwich 034B,E01001657,1518,1375,143,93,35,13,2
2021,Greenwich 034C,E01001658,1575,1326,249,129,82,31,7
2021,Greenwich 034D,E01001659,1544,1314,230,91,96,33,10
2021,Greenwich 029D,E01001660,1508,1316,192,83,67,36,6
2021,Greenwich 029E,E01001661,1601,1366,235,105,89,39,2
2021,Greenwich 037B,E01001664,2015,1736,279,183,61,29,6
2021,Greenwich 037C,E01001665,1827,1532,295,166,93,35,1
2021,Greenwich 041G,E01001666,1907,1466,441,208,142,78,13
2021,Greenwich 033A,E01001669,2408,1952,456,203,178,58,17
2021,Greenwich 033B,E01001671,1599,1352,247,111,91,43,2
2021,Greenwich 006A,E01001672,1855,1140,715,233,316,139,27
2021,Greenwich 006B,E01001673,2262,1368,894,281,362,188,63
2021,Greenwich 006C,E01001674,2113,1340,773,286,297,145,45
2021,Greenwich 006D,E01001675,2251,1290,961,290,434,171,66
2021,Greenwich 033C,E01001676,1731,1293,438,178,166,78,16
2021,Greenwich 006E,E01001677,2077,1464,613,212,274,98,29
2021,Greenwich 017A,E01001678,1693,1400,293,128,103,55,7
2021,Greenwich 020A,E01001679,1301,1151,150,83,44,20,3
2021,Greenwich 020B,E01001680,1457,1299,158,101,45,12,0
2021,Greenwich 020C,E01001681,1347,1135,212,88,68,50,6
2021,Greenwich 020D,E01001682,1333,1199,134,66,38,27,3
2021,Greenwich 017B,E01001683,1479,1205,274,106,98,59,11
2021,Greenwich 017C,E01001684,1402,1209,193,96,68,22,7
2021,Greenwich 017D,E01001685,1500,1272,228,100,89,36,3
2021,Greenwich 020E,E01001686,1718,1429,289,121,101,55,12
2021,Greenwich 002A,E01001687,1620,1342,278,117,104,52,5
2021,Greenwich 002B,E01001688,2552,2127,425,189,148,77,11
2021,Greenwich 001A,E01001690,1660,1419,241,106,96,34,5
2021,Greenwich 001B,E01001692,1420,1242,178,82,72,24,0
2021,Greenwich 001C,E01001693,1477,1297,180,77,65,31,7
2021,Greenwich 001D,E01001694,1672,1414,258,122,82,49,5
2021,Greenwich 011A,E01001695,1468,1052,416,166,172,64,14
2021,Greenwich 011B,E01001696,2473,1862,611,300,201,99,11
2021,Greenwich 011C,E01001697,2516,1714,802,295,300,186,21
2021,Greenwich 015A,E01001698,1832,1527,305,103,131,55,16
2021,Greenwich 015B,E01001699,1381,1166,215,108,73,31,3
2021,Greenwich 011D,E01001700,2293,1484,809,319,295,138,57
2021,Greenwich 015C,E01001701,1675,1427,248,127,77,36,8
2021,Greenwich 015D,E01001702,1438,1153,285,84,96,91,14
2021,Greenwich 011E,E01001703,1980,1476,504,169,184,124,27
2021,Greenwich 011F,E01001704,1592,1337,255,114,79,50,12
2021,Greenwich 005A,E01001705,2150,1666,484,189,204,76,15
2021,Greenwich 005C,E01001708,1634,1396,238,115,70,47,6
2021,Greenwich 005D,E01001710,1695,1217,478,159,176,126,17
2021,Greenwich 042A,E01001712,2005,1544,461,201,179,66,15
2021,Hackney 002A,E01001714,1982,1486,496,203,200,72,21
2021,Hackney 007A,E01001715,1242,1008,234,146,65,18,5
2021,Hackney 007B,E01001716,1691,1277,414,176,141,77,20
2021,Hackney 007C,E01001717,1094,861,233,94,86,46,7
2021,Hackney 007D,E01001718,1671,1341,330,175,102,47,6
2021,Hackney 007E,E01001719,1590,1234,356,165,97,80,14
2021,Hackney 007F,E01001720,1644,1451,193,143,34,14,2
2021,Hackney 029A,E01001722,2163,1596,567,202,163,172,30
2021,Hackney 006A,E01001723,1863,1556,307,142,108,51,6
2021,Hackney 006B,E01001724,2768,2002,766,306,255,185,20
2021,Hackney 004A,E01001725,1712,1308,404,126,131,121,26
2021,Hackney 004B,E01001726,1273,968,305,116,96,79,14
2021,Hackney 006C,E01001727,1894,1415,479,152,185,104,38
2021,Hackney 029B,E01001728,1735,1292,443,125,150,141,27
2021,Hackney 019A,E01001729,1908,1531,377,135,147,81,14
2021,Hackney 019B,E01001730,2645,2080,565,230,176,132,27
2021,Hackney 017A,E01001731,2572,1976,596,266,187,121,22
2021,Hackney 019C,E01001732,1815,1484,331,140,95,78,18
2021,Hackney 015A,E01001733,1809,1517,292,131,95,52,14
2021,Hackney 017B,E01001734,1780,1442,338,161,98,72,7
2021,Hackney 019D,E01001735,1533,1306,227,107,60,45,15
2021,Hackney 012A,E01001736,1507,1303,204,113,47,38,6
2021,Hackney 012B,E01001737,1691,1476,215,126,50,36,3
2021,Hackney 012C,E01001738,1692,1419,273,130,81,54,8
2021,Hackney 012D,E01001739,1918,1690,228,129,56,35,8
2021,Hackney 014A,E01001740,1509,1140,369,157,104,87,21
2021,Hackney 009A,E01001741,1394,1260,134,78,33,19,4
2021,Hackney 008A,E01001742,1701,1452,249,114,76,52,7
2021,Hackney 031A,E01001744,1943,1642,301,155,79,59,8
2021,Hackney 016A,E01001745,2076,1644,432,162,145,110,15
2021,Hackney 016B,E01001746,1615,1268,347,123,130,77,17
2021,Hackney 014B,E01001747,2286,1846,440,203,134,85,18
2021,Hackney 020B,E01001749,1447,1267,180,108,45,25,2
2021,Hackney 031D,E01001750,2038,1672,366,217,88,50,11
2021,Hackney 031B,E01001751,1429,1289,140,101,29,9,1
2021,Hackney 025B,E01001753,1470,1119,351,138,127,75,11
2021,Hackney 025D,E01001755,1624,1299,325,146,90,71,18
2021,Hackney 030C,E01001756,1970,1675,295,193,58,37,7
2021,Hackney 016C,E01001757,1540,1194,346,122,122,91,11
2021,Hackney 016D,E01001758,2519,1995,524,259,131,113,21
2021,Hackney 016E,E01001759,1602,1349,253,140,59,48,6
2021,Hackney 017C,E01001760,1843,1476,367,211,94,51,11
2021,Hackney 016F,E01001761,1768,1435,333,151,103,70,9
2021,Hackney 017D,E01001762,1632,1390,242,154,39,42,7
2021,Hackney 020C,E01001763,1720,1452,268,143,62,49,14
2021,Hackney 010A,E01001764,1714,1385,329,122,101,93,13
2021,Hackney 010B,E01001765,1762,1376,386,139,123,103,21
2021,Hackney 010D,E01001767,1554,1244,310,123,99,75,13
2021,Hackney 006D,E01001768,1794,1493,301,160,81,51,9
2021,Hackney 006E,E01001769,1474,1220,254,113,62,60,19
2021,Hackney 010E,E01001770,1663,1312,351,126,92,113,20
2021,Hackney 024A,E01001772,1719,1339,380,168,101,81,30
2021,Hackney 025E,E01001773,2409,1935,474,262,106,93,13
2021,Hackney 024B,E01001774,1940,1478,462,266,112,76,8
2021,Hackney 024C,E01001775,1590,1246,344,135,117,79,13
2021,Hackney 025F,E01001776,1656,1329,327,139,89,83,16
2021,Hackney 033A,E01001777,2588,1931,657,376,177,93,11
2021,Hackney 032D,E01001780,1765,1310,455,252,118,74,11
2021,Hackney 026B,E01001781,1563,1182,381,195,119,61,6
2021,Hackney 026D,E01001783,1553,1087,466,226,148,83,9
2021,Hackney 032A,E01001784,1721,1334,387,200,86,87,14
2021,Hackney 015B,E01001785,1519,1289,230,115,70,40,5
2021,Hackney 013A,E01001786,2143,1755,388,174,126,73,15
2021,Hackney 013B,E01001787,1559,1261,298,95,104,83,16
2021,Hackney 013C,E01001788,1456,1190,266,94,77,79,16
2021,Hackney 015C,E01001789,1656,1343,313,152,84,51,26
2021,Hackney 013D,E01001790,1456,1190,266,106,78,69,13
2021,Hackney 015D,E01001791,1417,1199,218,95,65,49,9
2021,Hackney 011A,E01001792,1862,1469,393,177,127,70,19
2021,Hackney 011B,E01001793,1496,1351,145,87,34,20,4
2021,Hackney 011C,E01001794,1841,1591,250,124,73,45,8
2021,Hackney 011D,E01001795,1269,1085,184,100,44,33,7
2021,Hackney 011E,E01001796,1425,1180,245,111,76,53,5
2021,Hackney 028A,E01001798,2177,1626,551,217,212,95,27
2021,Hackney 003A,E01001799,1375,1129,246,84,80,64,18
2021,Hackney 004C,E01001800,1612,1230,382,104,136,118,24
2021,Hackney 008B,E01001801,1576,1286,290,112,107,60,11
2021,Hackney 003B,E01001802,1305,1020,285,95,109,70,11
2021,Hackney 008C,E01001803,1752,1402,350,112,139,89,10
2021,Hackney 003C,E01001804,1533,1206,327,107,131,68,21
2021,Hackney 009B,E01001805,1172,943,229,96,66,61,6
2021,Hackney 008D,E01001806,1415,1222,193,90,47,48,8
2021,Hackney 003D,E01001807,1719,1296,423,122,156,120,25
2021,Hackney 001A,E01001808,1499,1112,387,124,142,107,14
2021,Hackney 001B,E01001809,1756,1426,330,91,147,79,13
2021,Hackney 002D,E01001811,1710,1252,458,206,138,101,13
2021,Hackney 003E,E01001812,1671,1252,419,116,183,98,22
2021,Hackney 002E,E01001813,1820,1265,555,183,182,159,31
2021,Hackney 001C,E01001814,1571,1133,438,115,195,110,18
2021,Hackney 024D,E01001815,1712,1396,316,113,91,91,21
2021,Hackney 020D,E01001816,1503,1315,188,94,45,42,7
2021,Hackney 020E,E01001819,1545,1341,204,85,50,53,16
2021,Hackney 024E,E01001820,1356,1129,227,92,63,62,10
2021,Hackney 024F,E01001821,1308,1041,267,128,80,44,15
2021,Hackney 029C,E01001822,1840,1378,462,157,152,133,20
2021,Hackney 001D,E01001823,1531,1171,360,141,133,73,13
2021,Hackney 004D,E01001824,1498,1153,345,88,124,100,33
2021,Hackney 001E,E01001825,1257,1040,217,67,92,50,8
2021,Hackney 004E,E01001826,1456,1079,377,111,134,108,24
2021,Hackney 029D,E01001827,1567,1238,329,106,118,89,16
2021,Hackney 028B,E01001828,1968,1557,411,135,150,101,25
2021,Hackney 009C,E01001829,1687,1498,189,123,42,19,5
2021,Hackney 014C,E01001830,1831,1391,440,184,151,88,17
2021,Hackney 009D,E01001831,1647,1361,286,154,63,62,7
2021,Hackney 009E,E01001832,1617,1364,253,101,86,54,12
2021,Hackney 014D,E01001833,2052,1678,374,163,114,86,11
2021,Hackney 014E,E01001834,1909,1527,382,202,90,68,22
2021,Hackney 014F,E01001835,1190,1016,174,102,54,14,4
2021,Hackney 022A,E01001836,1802,1542,260,164,61,30,5
2021,Hackney 023B,E01001837,1409,1228,181,111,38,28,4
2021,Hackney 019E,E01001838,1741,1316,425,175,113,114,23
2021,Hackney 023C,E01001839,2281,1776,505,322,99,66,18
2021,Hackney 022B,E01001840,1558,1292,266,106,78,69,13
2021,Hackney 022C,E01001841,1317,1193,124,57,36,29,2
2021,Hackney 023D,E01001842,1487,1263,224,111,57,49,7
2021,Hackney 023E,E01001843,1177,1082,95,53,23,14,5
2021,Hackney 022D,E01001844,1865,1637,228,122,53,42,11
2021,Hackney 022E,E01001845,1545,1319,226,78,76,64,8
2021,Hackney 018A,E01001846,1174,1015,159,60,56,36,7
2021,Hackney 018B,E01001847,1301,1090,211,105,67,32,7
2021,Hackney 018C,E01001848,1909,1635,274,114,76,72,12
2021,Hackney 018D,E01001849,2380,2036,344,162,116,58,8
2021,Hackney 019F,E01001850,1792,1440,352,134,118,80,20
2021,Hammersmith and Fulham 010A,E01001851,1418,1110,308,235,55,17,1
2021,Hammersmith and Fulham 007A,E01001852,1601,1212,389,251,86,46,6
2021,Hammersmith and Fulham 007B,E01001853,1462,1159,303,207,67,26,3
2021,Hammersmith and Fulham 007C,E01001854,1712,1248,464,289,130,36,9
2021,Hammersmith and Fulham 010B,E01001855,1606,1210,396,269,85,38,4
2021,Hammersmith and Fulham 010C,E01001856,1602,1208,394,237,99,51,7
2021,Hammersmith and Fulham 007D,E01001857,1488,1022,466,238,170,54,4
2021,Hammersmith and Fulham 006A,E01001858,1718,1311,407,228,136,43,0
2021,Hammersmith and Fulham 008A,E01001859,2597,1974,623,356,177,79,11
2021,Hammersmith and Fulham 006B,E01001860,1655,1242,413,189,165,56,3
2021,Hammersmith and Fulham 006C,E01001861,1352,1079,273,148,88,35,2
2021,Hammersmith and Fulham 005A,E01001862,1704,1356,348,205,108,31,4
2021,Hammersmith and Fulham 006D,E01001863,1361,1119,242,159,67,14,2
2021,Hammersmith and Fulham 006E,E01001864,1457,1223,234,120,93,18,3
2021,Hammersmith and Fulham 008B,E01001865,1519,1278,241,156,66,15,4
2021,Hammersmith and Fulham 012A,E01001866,1473,1043,430,290,105,27,8
2021,Hammersmith and Fulham 012B,E01001867,1113,832,281,173,71,32,5
2021,Hammersmith and Fulham 012C,E01001868,1238,958,280,133,95,45,7
2021,Hammersmith and Fulham 010D,E01001869,1316,1111,205,146,44,15,0
2021,Hammersmith and Fulham 012D,E01001870,1657,1160,497,325,133,37,2
2021,Hammersmith and Fulham 012E,E01001871,1468,1073,395,272,88,33,2
2021,Hammersmith and Fulham 012F,E01001872,1328,1024,304,210,75,11,8
2021,Hammersmith and Fulham 010E,E01001873,1447,1116,331,213,90,24,4
2021,Hammersmith and Fulham 001B,E01001875,1775,1363,412,154,171,76,11
2021,Hammersmith and Fulham 001C,E01001876,2313,1713,600,302,198,88,12
2021,Hammersmith and Fulham 001D,E01001877,1302,999,303,137,124,35,7
2021,Hammersmith and Fulham 001E,E01001878,1585,1240,345,152,142,40,11
2021,Hammersmith and Fulham 019A,E01001879,1405,1111,294,138,108,39,9
2021,Hammersmith and Fulham 017A,E01001880,1423,1164,259,178,59,22,0
2021,Hammersmith and Fulham 017B,E01001881,1822,1383,439,339,81,14,5
2021,Hammersmith and Fulham 017C,E01001882,1600,1318,282,193,65,22,2
2021,Hammersmith and Fulham 017D,E01001883,1810,1395,415,275,108,26,6
2021,Hammersmith and Fulham 017E,E01001884,1767,1400,367,211,115,33,8
2021,Hammersmith and Fulham 015A,E01001885,1247,930,317,141,122,49,5
2021,Hammersmith and Fulham 016A,E01001886,1480,1185,295,178,83,31,3
2021,Hammersmith and Fulham 016B,E01001887,1424,1124,300,162,96,34,8
2021,Hammersmith and Fulham 018A,E01001888,1514,1277,237,158,59,19,1
2021,Hammersmith and Fulham 014A,E01001889,1351,1110,241,156,65,16,4
2021,Hammersmith and Fulham 016C,E01001890,1687,1223,464,313,131,20,0
2021,Hammersmith and Fulham 018B,E01001891,2467,1765,702,445,188,61,8
2021,Hammersmith and Fulham 016D,E01001892,1279,1044,235,143,72,15,5
2021,Hammersmith and Fulham 013A,E01001893,1450,1080,370,194,121,49,6
2021,Hammersmith and Fulham 013B,E01001894,1345,1023,322,179,96,38,9
2021,Hammersmith and Fulham 009A,E01001895,1411,1175,236,156,61,17,2
2021,Hammersmith and Fulham 009B,E01001896,1363,1071,292,166,85,33,8
2021,Hammersmith and Fulham 009C,E01001897,1262,1066,196,131,48,16,1
2021,Hammersmith and Fulham 013C,E01001898,2038,1432,606,382,173,48,3
2021,Hammersmith and Fulham 013D,E01001899,1555,1175,380,227,110,39,4
2021,Hammersmith and Fulham 013E,E01001900,1677,1313,364,186,125,52,1
2021,Hammersmith and Fulham 019B,E01001901,1576,1314,262,191,47,24,0
2021,Hammersmith and Fulham 019C,E01001902,1598,1288,310,204,74,29,3
2021,Hammersmith and Fulham 019D,E01001903,1401,1139,262,156,71,32,3
2021,Hammersmith and Fulham 022A,E01001904,1562,1303,259,187,62,7,3
2021,Hammersmith and Fulham 022B,E01001905,1594,1303,291,220,58,13,0
2021,Hammersmith and Fulham 022C,E01001906,1381,1158,223,160,47,14,2
2021,Hammersmith and Fulham 022D,E01001907,1201,1016,185,146,28,11,0
2021,Hammersmith and Fulham 015B,E01001908,1351,998,353,227,89,32,5
2021,Hammersmith and Fulham 015C,E01001909,1717,1352,365,198,115,45,7
2021,Hammersmith and Fulham 014B,E01001910,1298,1012,286,180,83,19,4
2021,Hammersmith and Fulham 015D,E01001911,1655,1299,356,164,137,54,1
2021,Hammersmith and Fulham 015E,E01001912,1417,1089,328,145,126,48,9
2021,Hammersmith and Fulham 014C,E01001913,1358,1138,220,163,49,6,2
2021,Hammersmith and Fulham 014D,E01001914,1470,1060,410,264,107,36,3
2021,Hammersmith and Fulham 024A,E01001915,1410,1200,210,146,42,16,6
2021,Hammersmith and Fulham 024B,E01001916,1196,1035,161,111,41,7,2
2021,Hammersmith and Fulham 018C,E01001917,1449,1188,261,179,47,31,4
2021,Hammersmith and Fulham 018D,E01001918,1456,1233,223,149,48,24,2
2021,Hammersmith and Fulham 018E,E01001919,1507,1285,222,165,43,12,2
2021,Hammersmith and Fulham 020A,E01001920,1418,1152,266,160,80,26,0
2021,Hammersmith and Fulham 020B,E01001921,1406,1170,236,148,59,23,6
2021,Hammersmith and Fulham 020C,E01001922,1555,1326,229,180,37,9,3
2021,Hammersmith and Fulham 020D,E01001923,1475,1197,278,197,54,24,3
2021,Hammersmith and Fulham 020E,E01001924,1489,1256,233,182,38,9,4
2021,Hammersmith and Fulham 025A,E01001925,1513,1273,240,173,40,18,9
2021,Hammersmith and Fulham 024C,E01001926,1307,1124,183,132,35,14,2
2021,Hammersmith and Fulham 008C,E01001927,1332,1206,126,85,29,11,1
2021,Hammersmith and Fulham 011A,E01001928,1764,1423,341,200,104,30,7
2021,Hammersmith and Fulham 009D,E01001929,1289,1115,174,121,34,16,3
2021,Hammersmith and Fulham 008D,E01001930,1687,1359,328,189,94,38,7
2021,Hammersmith and Fulham 011B,E01001931,1261,958,303,186,87,24,6
2021,Hammersmith and Fulham 011C,E01001932,1535,1193,342,213,91,32,6
2021,Hammersmith and Fulham 011D,E01001933,1453,1199,254,123,74,46,11
2021,Hammersmith and Fulham 025B,E01001934,1901,1470,431,256,119,49,7
2021,Hammersmith and Fulham 023A,E01001935,1967,1659,308,216,64,26,2
2021,Hammersmith and Fulham 025C,E01001937,1715,1379,336,241,66,26,3
2021,Hammersmith and Fulham 025D,E01001938,1538,1274,264,149,74,31,10
2021,Hammersmith and Fulham 005B,E01001940,1487,1129,358,178,127,42,11
2021,Hammersmith and Fulham 005C,E01001941,1539,1098,441,249,151,35,6
2021,Hammersmith and Fulham 005D,E01001942,1785,1296,489,285,134,53,17
2021,Hammersmith and Fulham 004A,E01001943,2188,1621,567,320,177,64,6
2021,Hammersmith and Fulham 004B,E01001944,1621,1197,424,198,168,50,8
2021,Hammersmith and Fulham 004C,E01001945,1613,1292,321,176,101,38,6
2021,Hammersmith and Fulham 004D,E01001946,1823,1368,455,257,155,40,3
2021,Hammersmith and Fulham 021A,E01001947,1382,1104,278,114,118,39,7
2021,Hammersmith and Fulham 021B,E01001948,1805,1549,256,162,69,21,4
2021,Hammersmith and Fulham 021C,E01001949,1424,1229,195,160,32,3,0
2021,Hammersmith and Fulham 021D,E01001950,1442,1179,263,203,44,12,4
2021,Hammersmith and Fulham 021E,E01001951,1472,1213,259,185,44,27,3
2021,Hammersmith and Fulham 024D,E01001952,1607,1283,324,223,84,13,4
2021,Hammersmith and Fulham 021F,E01001953,1430,1126,304,178,93,30,3
2021,Hammersmith and Fulham 003A,E01001954,1472,1211,261,145,96,19,1
2021,Hammersmith and Fulham 002A,E01001955,2036,1592,444,229,150,53,12
2021,Hammersmith and Fulham 003B,E01001956,1529,1213,316,163,101,47,5
2021,Hammersmith and Fulham 002B,E01001957,1572,1175,397,151,162,73,11
2021,Hammersmith and Fulham 002C,E01001958,1675,1262,413,165,166,72,10
2021,Hammersmith and Fulham 003C,E01001959,1968,1488,480,233,170,69,8
2021,Hammersmith and Fulham 003D,E01001960,1721,1311,410,230,139,39,2
2021,Hammersmith and Fulham 002D,E01001961,1523,1111,412,183,162,62,5
2021,Haringey 004A,E01001962,1757,1537,220,122,71,24,3
2021,Haringey 009A,E01001963,1762,1586,176,105,52,18,1
2021,Haringey 009B,E01001964,1540,1322,218,98,76,37,7
2021,Haringey 009C,E01001965,1582,1456,126,76,34,12,4
2021,Haringey 009D,E01001966,1378,1262,116,72,29,11,4
2021,Haringey 014A,E01001967,1456,1317,139,96,25,15,3
2021,Haringey 014B,E01001968,1596,1389,207,147,48,9,3
2021,Haringey 001A,E01001969,1898,1179,719,309,246,145,19
2021,Haringey 004B,E01001970,1859,1243,616,240,226,127,23
2021,Haringey 001B,E01001971,1865,1307,558,196,209,127,26
2021,Haringey 004C,E01001972,1669,1262,407,149,137,102,19
2021,Haringey 004D,E01001973,2454,1837,617,264,219,119,15
2021,Haringey 001C,E01001974,2132,1335,797,354,268,153,22
2021,Haringey 001D,E01001975,1753,1126,627,228,250,128,21
2021,Haringey 011A,E01001976,1793,1130,663,175,269,178,41
2021,Haringey 011B,E01001977,1467,932,535,182,201,135,17
2021,Haringey 011C,E01001978,1864,1198,666,173,236,211,46
2021,Haringey 011D,E01001979,2228,1459,769,203,294,209,63
2021,Haringey 018A,E01001980,1754,1236,518,182,209,115,12
2021,Haringey 018B,E01001981,1746,988,758,299,319,124,16
2021,Haringey 018C,E01001982,1711,1136,575,182,223,143,27
2021,Haringey 018D,E01001983,1586,1123,463,146,180,122,15
2021,Haringey 033A,E01001984,1690,1374,316,204,71,39,2
2021,Haringey 033B,E01001985,1557,1370,187,131,38,15,3
2021,Haringey 034A,E01001986,1513,1373,140,81,33,21,5
2021,Haringey 033C,E01001987,1657,1472,185,140,28,16,1
2021,Haringey 034B,E01001988,1609,1394,215,145,56,11,3
2021,Haringey 033D,E01001989,1665,1488,177,110,39,22,6
2021,Haringey 034C,E01001990,1868,1518,350,207,104,34,5
2021,Haringey 017A,E01001991,1594,1306,288,194,61,29,4
2021,Haringey 017B,E01001992,1706,1512,194,124,47,20,3
2021,Haringey 017C,E01001993,1620,1477,143,108,22,10,3
2021,Haringey 030A,E01001994,1756,1454,302,162,102,31,7
2021,Haringey 017D,E01001995,2590,2193,397,190,128,70,9
2021,Haringey 014C,E01001996,1452,1241,211,125,53,29,4
2021,Haringey 014D,E01001997,1722,1412,310,178,99,25,8
2021,Haringey 023A,E01001998,1856,1310,546,241,183,93,29
2021,Haringey 023B,E01001999,2348,1403,945,395,299,211,40
2021,Haringey 031A,E01002000,1704,1248,456,191,166,81,18
2021,Haringey 031B,E01002001,1547,1197,350,165,114,63,8
2021,Haringey 031C,E01002002,1633,1104,529,215,184,109,21
2021,Haringey 023C,E01002003,2481,1487,994,330,342,271,51
2021,Haringey 023D,E01002004,1751,1297,454,200,143,91,20
2021,Haringey 035A,E01002005,1411,1170,241,175,47,19,0
2021,Haringey 035B,E01002006,1494,1245,249,149,60,38,2
2021,Haringey 035C,E01002007,1404,1231,173,129,29,12,3
2021,Haringey 030B,E01002008,1307,1180,127,86,26,12,3
2021,Haringey 035D,E01002009,1383,1230,153,117,27,8,1
2021,Haringey 030C,E01002010,1555,1363,192,130,44,17,1
2021,Haringey 030D,E01002011,1684,1461,223,154,45,21,3
2021,Haringey 022A,E01002013,1308,1197,111,69,26,14,2
2021,Haringey 020B,E01002014,1678,1411,267,141,83,38,5
2021,Haringey 020C,E01002015,1377,1183,194,81,62,41,10
2021,Haringey 028A,E01002016,1857,1596,261,123,87,45,6
2021,Haringey 028B,E01002017,1527,1333,194,121,42,24,7
2021,Haringey 020D,E01002018,1321,1175,146,74,41,21,10
2021,Haringey 022B,E01002019,1330,1244,86,56,20,10,0
2021,Haringey 021A,E01002020,1500,1254,246,150,59,30,7
2021,Haringey 022C,E01002021,1404,1292,112,62,26,15,9
2021,Haringey 021B,E01002022,2107,1772,335,203,84,37,11
2021,Haringey 021C,E01002023,1342,1216,126,92,22,11,1
2021,Haringey 022D,E01002024,1244,1087,157,79,37,26,15
2021,Haringey 021D,E01002025,1432,1309,123,83,29,9,2
2021,Haringey 016A,E01002026,1733,1170,563,179,221,137,26
2021,Haringey 010A,E01002027,1386,916,470,166,195,92,17
2021,Haringey 010B,E01002028,1613,1077,536,195,203,125,13
2021,Haringey 016B,E01002029,2061,1308,753,237,324,176,16
2021,Haringey 016C,E01002030,1523,1053,470,186,171,99,14
2021,Haringey 016D,E01002031,1810,1126,684,244,285,136,19
2021,Haringey 010C,E01002032,1786,1134,652,223,208,197,24
2021,Haringey 010D,E01002033,1738,1159,579,174,229,148,28
2021,Haringey 037A,E01002034,2330,1557,773,228,242,248,55
2021,Haringey 002A,E01002036,1799,1103,696,196,263,192,45
2021,Haringey 002B,E01002037,1651,1138,513,146,181,159,27
2021,Haringey 037B,E01002038,1733,1046,687,183,240,212,52
2021,Haringey 002C,E01002039,1609,1088,521,138,165,178,40
2021,Haringey 002D,E01002040,2180,1411,769,217,336,197,19
2021,Haringey 037C,E01002041,1815,1286,529,160,189,150,30
2021,Haringey 027A,E01002042,1512,1124,388,161,127,84,16
2021,Haringey 026A,E01002043,1732,1130,602,212,226,149,15
2021,Haringey 027B,E01002044,1737,1045,692,243,201,198,50
2021,Haringey 026B,E01002045,2015,1312,703,178,270,208,47
2021,Haringey 026C,E01002046,1565,1095,470,142,175,130,23
2021,Haringey 027C,E01002047,1599,1038,561,237,211,96,17
2021,Haringey 027D,E01002048,1862,1263,599,204,184,161,50
2021,Haringey 026D,E01002049,1844,1200,644,204,250,162,28
2021,Haringey 029A,E01002050,1851,1398,453,108,210,121,14
2021,Haringey 029B,E01002051,1767,1099,668,155,294,168,51
2021,Haringey 029C,E01002052,2085,1652,433,124,195,92,22
2021,Haringey 032A,E01002053,1943,1299,644,205,238,178,23
2021,Haringey 032B,E01002054,1642,1086,556,165,210,147,34
2021,Haringey 029D,E01002055,1916,1381,535,142,210,161,22
2021,Haringey 032C,E01002056,2797,1972,825,337,302,152,34
2021,Haringey 032D,E01002057,1740,1244,496,187,186,96,27
2021,Haringey 031D,E01002058,1520,1018,502,214,180,97,11
2021,Haringey 028C,E01002059,1512,1331,181,77,49,48,7
2021,Haringey 028D,E01002060,1650,1481,169,123,30,14,2
2021,Haringey 036A,E01002061,1511,1341,170,107,36,20,7
2021,Haringey 034D,E01002062,1689,1488,201,133,47,17,4
2021,Haringey 036B,E01002063,1449,1259,190,84,65,37,4
2021,Haringey 036C,E01002064,1452,1207,245,97,86,54,8
2021,Haringey 036D,E01002065,1510,1192,318,162,83,58,15
2021,Haringey 025A,E01002066,2507,1510,997,289,295,340,73
2021,Haringey 024A,E01002067,1696,1098,598,172,251,147,28
2021,Haringey 025B,E01002068,2171,1411,760,272,246,198,44
2021,Haringey 024B,E01002069,1980,1217,763,210,311,195,47
2021,Haringey 024C,E01002070,2461,1729,732,280,288,148,16
2021,Haringey 025C,E01002071,1680,1125,555,162,193,163,37
2021,Haringey 025D,E01002072,1825,1265,560,171,214,139,36
2021,Haringey 024D,E01002073,1589,1056,533,148,225,129,31
2021,Haringey 012A,E01002074,2134,1442,692,200,262,181,49
2021,Haringey 015A,E01002075,1876,1207,669,175,269,188,37
2021,Haringey 015B,E01002076,1801,1161,640,166,265,170,39
2021,Haringey 012B,E01002077,2206,1442,764,259,289,192,24
2021,Haringey 015C,E01002078,2451,1750,701,277,261,131,32
2021,Haringey 012C,E01002079,1730,1032,698,207,306,156,29
2021,Haringey 012D,E01002081,1880,1232,648,204,245,176,23
2021,Haringey 013A,E01002082,1388,972,416,107,160,123,26
2021,Haringey 019A,E01002083,1354,853,501,174,207,102,18
2021,Haringey 019B,E01002084,1685,1131,554,183,233,114,24
2021,Haringey 019C,E01002085,2097,1375,722,275,273,153,21
2021,Haringey 013B,E01002086,1454,1103,351,134,135,73,9
2021,Haringey 019D,E01002087,1862,1122,740,272,267,153,48
2021,Haringey 013C,E01002088,1722,1058,664,235,237,171,21
2021,Haringey 013D,E01002089,1299,900,399,120,136,116,27
2021,Haringey 005A,E01002090,1687,1167,520,172,196,130,22
2021,Haringey 006A,E01002091,1811,1212,599,150,225,187,37
2021,Haringey 006B,E01002092,1516,1004,512,138,201,148,25
2021,Haringey 005B,E01002093,1789,1251,538,139,197,173,29
2021,Haringey 006C,E01002094,1402,996,406,138,132,102,34
2021,Haringey 006D,E01002095,1531,1133,398,85,150,135,28
2021,Haringey 005C,E01002096,1658,1210,448,150,152,127,19
2021,Haringey 005D,E01002097,1556,1108,448,124,166,136,22
2021,Haringey 007A,E01002098,1481,1118,363,155,143,52,13
2021,Haringey 008A,E01002099,1970,1273,697,205,271,190,31
2021,Haringey 008B,E01002100,1734,1031,703,243,261,162,37
2021,Haringey 007B,E01002101,1862,1088,774,277,325,150,22
2021,Haringey 007C,E01002102,1819,1117,702,231,284,159,28
2021,Haringey 008C,E01002103,1805,1096,709,216,303,164,26
2021,Haringey 008D,E01002104,1416,820,596,165,245,165,21
2021,Haringey 007D,E01002105,2018,1102,916,330,357,205,24
2021,Harrow 008A,E01002106,1955,1439,516,248,181,76,11
2021,Harrow 012A,E01002107,1775,1341,434,226,148,52,8
2021,Harrow 008B,E01002108,1790,1340,450,209,182,53,6
2021,Harrow 008C,E01002109,1810,1515,295,133,108,47,7
2021,Harrow 008D,E01002110,1626,1190,436,204,171,46,15
2021,Harrow 008E,E01002111,2133,1354,779,318,307,134,20
2021,Harrow 001A,E01002112,1918,1560,358,164,128,60,6
2021,Harrow 002A,E01002113,1533,1247,286,152,86,42,6
2021,Harrow 001B,E01002114,2162,1643,519,230,186,88,15
2021,Harrow 002B,E01002115,1434,1114,320,144,131,35,10
2021,Harrow 002C,E01002116,1534,1208,326,141,130,51,4
2021,Harrow 002E,E01002118,1793,1160,633,223,259,128,23
2021,Harrow 007A,E01002119,2406,1435,971,413,387,142,29
2021,Harrow 007B,E01002120,1301,848,453,186,159,93,15
2021,Harrow 007C,E01002121,1749,1062,687,269,274,126,18
2021,Harrow 007D,E01002122,1790,1051,739,259,324,142,14
2021,Harrow 007E,E01002123,1649,927,722,229,314,149,30
2021,Harrow 010A,E01002124,1728,959,769,277,319,145,28
2021,Harrow 010B,E01002125,1907,997,910,282,419,186,23
2021,Harrow 023B,E01002127,1768,1184,584,302,204,65,13
2021,Harrow 020A,E01002128,2032,1297,735,327,271,123,14
2021,Harrow 023C,E01002129,2611,1717,894,469,321,85,19
2021,Harrow 020B,E01002130,2772,1631,1141,457,466,191,27
2021,Harrow 023D,E01002131,1631,1054,577,242,202,114,19
2021,Harrow 029A,E01002132,1942,1495,447,204,165,67,11
2021,Harrow 027A,E01002133,1981,1332,649,233,266,117,33
2021,Harrow 029B,E01002134,1443,1115,328,184,95,42,7
2021,Harrow 029C,E01002135,1937,1197,740,321,283,111,25
2021,Harrow 027B,E01002136,1973,1334,639,276,250,102,11
2021,Harrow 029D,E01002137,1704,1540,164,105,46,11,2
2021,Harrow 027C,E01002138,1566,992,574,276,197,91,10
2021,Harrow 006A,E01002139,1460,1128,332,134,129,55,14
2021,Harrow 005A,E01002140,1740,1231,509,220,190,94,5
2021,Harrow 005B,E01002141,1738,1323,415,158,159,80,18
2021,Harrow 005C,E01002142,1779,1291,488,212,185,80,11
2021,Harrow 005D,E01002143,1575,1184,391,157,163,55,16
2021,Harrow 004A,E01002144,1580,1295,285,142,88,48,7
2021,Harrow 005E,E01002145,1640,1265,375,166,147,49,13
2021,Harrow 004B,E01002146,1421,1200,221,138,67,14,2
2021,Harrow 004C,E01002147,1326,1109,217,134,55,20,8
2021,Harrow 006B,E01002148,1426,1141,285,146,98,34,7
2021,Harrow 004D,E01002149,1279,1107,172,115,41,16,0
2021,Harrow 006C,E01002150,2229,1606,623,317,216,81,9
2021,Harrow 006D,E01002151,1523,1133,390,165,140,74,11
2021,Harrow 006E,E01002152,1588,1341,247,146,76,20,5
2021,Harrow 019A,E01002153,1813,1306,507,252,184,67,4
2021,Harrow 019B,E01002155,1675,1384,291,178,71,36,6
2021,Harrow 015B,E01002156,1535,1296,239,132,77,26,4
2021,Harrow 019C,E01002157,1644,1165,479,231,172,71,5
2021,Harrow 019D,E01002158,1377,1162,215,138,56,18,3
2021,Harrow 021A,E01002159,1865,1375,490,230,195,57,8
2021,Harrow 021B,E01002160,2357,1461,896,433,309,141,13
2021,Harrow 021C,E01002161,1989,1366,623,299,220,88,16
2021,Harrow 015C,E01002162,1860,1296,564,261,207,85,11
2021,Harrow 015D,E01002163,1604,1245,359,182,136,36,5
2021,Harrow 021D,E01002164,1833,1410,423,196,167,53,7
2021,Harrow 017A,E01002165,1685,854,831,284,349,171,27
2021,Harrow 017B,E01002166,1641,936,705,270,276,133,26
2021,Harrow 017C,E01002167,1561,927,634,233,253,119,29
2021,Harrow 017D,E01002168,1505,952,553,209,213,106,25
2021,Harrow 017E,E01002169,1599,913,686,217,298,148,23
2021,Harrow 033A,E01002170,1321,819,502,217,190,77,18
2021,Harrow 033B,E01002171,1634,939,695,266,290,114,25
2021,Harrow 033C,E01002172,1546,1053,493,244,180,59,10
2021,Harrow 033D,E01002173,1849,1130,719,301,281,118,19
2021,Harrow 033E,E01002174,1527,954,573,284,190,80,19
2021,Harrow 033F,E01002175,1366,889,477,215,170,74,18
2021,Harrow 033G,E01002176,1637,990,647,342,207,89,9
2021,Harrow 033H,E01002177,1434,983,451,207,164,69,11
2021,Harrow 033I,E01002178,1599,1099,500,239,175,70,16
2021,Harrow 013A,E01002179,2502,1511,991,419,365,173,34
2021,Harrow 020C,E01002181,2224,1442,782,370,291,98,23
2021,Harrow 020D,E01002182,2054,1345,709,289,278,117,25
2021,Harrow 013C,E01002183,2029,1240,789,269,318,168,34
2021,Harrow 013D,E01002184,1846,1191,655,257,254,132,12
2021,Harrow 009A,E01002185,1778,1324,454,199,181,62,12
2021,Harrow 009B,E01002186,1850,1406,444,230,145,62,7
2021,Harrow 009C,E01002187,1918,1601,317,174,103,34,6
2021,Harrow 016A,E01002188,1566,1442,124,75,33,13,3
2021,Harrow 016B,E01002189,1680,1414,266,160,69,32,5
2021,Harrow 009D,E01002190,1671,1460,211,130,60,21,0
2021,Harrow 022A,E01002191,1973,1577,396,256,102,37,1
2021,Harrow 016C,E01002192,1636,1370,266,153,80,26,7
2021,Harrow 016D,E01002193,1968,1609,359,170,114,69,6
2021,Harrow 022B,E01002194,1781,1552,229,141,59,28,1
2021,Harrow 022C,E01002195,1624,1359,265,144,92,25,4
2021,Harrow 022D,E01002196,1782,1532,250,159,65,19,7
2021,Harrow 012B,E01002197,1376,887,489,220,178,68,23
2021,Harrow 010C,E01002198,1747,891,856,241,388,192,35
2021,Harrow 012C,E01002199,1524,908,616,278,222,97,19
2021,Harrow 010D,E01002200,2066,1051,1015,403,396,194,22
2021,Harrow 012D,E01002201,1658,936,722,332,272,100,18
2021,Harrow 012E,E01002202,2096,961,1135,382,509,213,31
2021,Harrow 010E,E01002203,1737,943,794,316,328,133,17
2021,Harrow 032A,E01002204,1812,997,815,352,335,116,12
2021,Harrow 032B,E01002206,1350,875,475,229,177,60,9
2021,Harrow 032C,E01002207,1740,1180,560,247,227,76,10
2021,Harrow 025A,E01002208,1336,1087,249,154,69,22,4
2021,Harrow 025B,E01002209,1811,1288,523,234,190,89,10
2021,Harrow 032D,E01002210,1506,1006,500,243,184,65,8
2021,Harrow 028A,E01002211,1443,1048,395,157,168,58,12
2021,Harrow 028B,E01002212,1804,1067,737,311,303,112,11
2021,Harrow 031A,E01002214,1856,1231,625,277,235,101,12
2021,Harrow 031B,E01002215,1684,1107,577,228,223,103,23
2021,Harrow 028C,E01002216,1673,1119,554,268,207,70,9
2021,Harrow 028D,E01002217,2099,1484,615,317,206,79,13
2021,Harrow 030A,E01002218,1736,1135,601,250,218,114,19
2021,Harrow 030B,E01002219,1869,937,932,360,377,165,30
2021,Harrow 031C,E01002220,1588,1077,511,207,220,72,12
2021,Harrow 030C,E01002221,1584,967,617,233,260,103,21
2021,Harrow 030D,E01002222,1554,1045,509,231,186,78,14
2021,Harrow 031D,E01002223,1750,1153,597,273,233,83,8
2021,Harrow 031E,E01002224,1589,1105,484,197,206,58,23
2021,Harrow 001C,E01002225,1721,1518,203,134,47,19,3
2021,Harrow 001D,E01002226,2552,1974,578,267,209,89,13
2021,Harrow 003A,E01002227,2188,1606,582,203,268,97,14
2021,Harrow 003B,E01002228,2171,1619,552,245,199,82,26
2021,Harrow 003C,E01002229,1759,1312,447,201,164,71,11
2021,Harrow 003D,E01002230,1784,1349,435,196,183,48,8
2021,Harrow 013E,E01002231,1977,1407,570,226,233,94,17
2021,Harrow 011A,E01002232,2093,1335,758,290,265,166,37
2021,Harrow 011B,E01002233,2310,1445,865,303,369,160,33
2021,Harrow 011C,E01002234,1811,1313,498,187,199,96,16
2021,Harrow 011D,E01002235,1839,1156,683,284,256,120,23
2021,Harrow 011E,E01002236,2223,1370,853,356,355,120,22
2021,Harrow 024A,E01002237,2028,1436,592,257,260,62,13
2021,Harrow 024B,E01002238,1809,1240,569,249,225,83,12
2021,Harrow 025C,E01002239,1881,1333,548,299,175,64,10
2021,Harrow 024C,E01002240,1891,1428,463,201,157,89,16
2021,Harrow 025D,E01002241,1842,1260,582,287,204,81,10
2021,Harrow 024D,E01002242,1819,1346,473,240,154,69,10
2021,Havering 013A,E01002243,1875,1609,266,124,102,36,4
2021,Havering 011A,E01002244,1733,1518,215,102,84,25,4
2021,Havering 011B,E01002245,1585,1349,236,92,84,50,10
2021,Havering 017A,E01002246,1789,1553,236,111,90,30,5
2021,Havering 017B,E01002247,2335,1923,412,181,159,58,14
2021,Havering 017C,E01002248,1651,1334,317,107,120,69,21
2021,Havering 017E,E01002250,1747,1467,280,122,114,38,6
2021,Havering 017F,E01002251,1515,1266,249,121,77,41,10
2021,Havering 018A,E01002252,1532,1483,49,29,16,3,1
2021,Havering 019A,E01002253,1541,1491,50,30,13,6,1
2021,Havering 019B,E01002254,1603,1563,40,22,10,8,0
2021,Havering 022A,E01002255,1491,1406,85,48,26,10,1
2021,Havering 018B,E01002256,1467,1404,63,30,24,9,0
2021,Havering 019C,E01002257,1698,1658,40,30,6,2,2
2021,Havering 018C,E01002258,1774,1666,108,56,34,16,2
2021,Havering 018D,E01002259,1501,1443,58,23,26,8,1
2021,Havering 026A,E01002260,1753,1498,255,116,87,44,8
2021,Havering 026B,E01002261,1716,1431,285,122,105,51,7
2021,Havering 026C,E01002262,1706,1548,158,81,58,17,2
2021,Havering 026D,E01002263,1553,1463,90,49,27,14,0
2021,Havering 026E,E01002264,1602,1428,174,105,52,11,6
2021,Havering 025A,E01002265,1447,1332,115,55,34,18,8
2021,Havering 027A,E01002266,1489,1387,102,35,43,21,3
2021,Havering 027B,E01002267,1713,1569,144,61,58,22,3
2021,Havering 010A,E01002268,1452,1314,138,87,36,11,4
2021,Havering 010B,E01002269,1798,1698,100,55,37,7,1
2021,Havering 015A,E01002270,1696,1479,217,142,46,28,1
2021,Havering 015B,E01002271,1554,1400,154,80,50,22,2
2021,Havering 014A,E01002272,1302,1215,87,48,29,10,0
2021,Havering 015C,E01002273,1316,1237,79,39,23,11,6
2021,Havering 014B,E01002274,1618,1532,86,56,21,8,1
2021,Havering 015D,E01002275,1285,1182,103,54,30,16,3
2021,Havering 001A,E01002276,2018,1864,154,80,52,18,4
2021,Havering 002A,E01002277,1569,1416,153,64,54,31,4
2021,Havering 001B,E01002278,1651,1471,180,91,57,27,5
2021,Havering 002B,E01002279,1686,1486,200,86,91,17,6
2021,Havering 004A,E01002280,1769,1585,184,69,81,28,6
2021,Havering 002C,E01002281,2297,1942,355,174,126,51,4
2021,Havering 004B,E01002282,1847,1592,255,131,88,31,5
2021,Havering 002D,E01002283,1649,1409,240,107,91,36,6
2021,Havering 004C,E01002284,1990,1739,251,105,97,38,11
2021,Havering 025B,E01002285,1324,1243,81,41,29,11,0
2021,Havering 025C,E01002286,1570,1518,52,26,14,9,3
2021,Havering 023A,E01002287,1546,1387,159,103,39,15,2
2021,Havering 025D,E01002288,1560,1457,103,57,31,14,1
2021,Havering 022B,E01002289,1608,1542,66,31,25,7,3
2021,Havering 025E,E01002290,1459,1404,55,28,19,7,1
2021,Havering 023B,E01002291,1456,1378,78,24,33,21,0
2021,Havering 022C,E01002292,1632,1517,115,59,39,12,5
2021,Havering 007B,E01002294,1496,1419,77,39,22,13,3
2021,Havering 010C,E01002295,1905,1748,157,77,54,22,4
2021,Havering 007C,E01002296,1638,1551,87,34,40,10,3
2021,Havering 004D,E01002297,1585,1335,250,111,108,26,5
2021,Havering 007D,E01002298,1551,1426,125,60,41,19,5
2021,Havering 002E,E01002299,1766,1533,233,122,78,26,7
2021,Havering 007E,E01002300,1940,1746,194,109,51,29,5
2021,Havering 003A,E01002301,1591,1457,134,58,47,26,3
2021,Havering 005A,E01002302,1658,1505,153,51,70,28,4
2021,Havering 003B,E01002303,2062,1897,165,76,57,28,4
2021,Havering 003C,E01002304,1502,1407,95,44,33,16,2
2021,Havering 005B,E01002305,1651,1468,183,86,67,24,6
2021,Havering 003D,E01002306,1733,1555,178,71,78,25,4
2021,Havering 003E,E01002307,1813,1701,112,40,50,22,0
2021,Havering 005C,E01002308,1781,1627,154,59,66,25,4
2021,Havering 006A,E01002309,1717,1478,239,107,89,33,10
2021,Havering 006B,E01002310,1790,1559,231,95,94,35,7
2021,Havering 006C,E01002311,1809,1551,258,96,103,48,11
2021,Havering 001C,E01002312,1625,1501,124,60,42,17,5
2021,Havering 001D,E01002313,2167,1906,261,108,114,32,7
2021,Havering 004E,E01002314,1794,1618,176,82,72,19,3
2021,Havering 006D,E01002315,1656,1359,297,142,103,47,5
2021,Havering 004F,E01002316,1977,1768,209,77,93,34,5
2021,Havering 014C,E01002317,1510,1436,74,47,16,10,1
2021,Havering 014D,E01002318,1606,1557,49,24,17,6,2
2021,Havering 016A,E01002319,1781,1577,204,93,76,30,5
2021,Havering 021A,E01002320,1447,1357,90,44,31,8,7
2021,Havering 021B,E01002321,1756,1622,134,50,52,24,8
2021,Havering 021C,E01002322,1858,1746,112,47,42,20,3
2021,Havering 021D,E01002323,1667,1574,93,54,27,11,1
2021,Havering 021E,E01002324,1498,1406,92,34,39,15,4
2021,Havering 011C,E01002325,2038,1835,203,97,78,24,4
2021,Havering 005D,E01002326,1617,1438,179,73,79,26,1
2021,Havering 009A,E01002327,1509,1390,119,48,43,23,5
2021,Havering 009B,E01002328,1734,1560,174,74,74,21,5
2021,Havering 011D,E01002329,1673,1497,176,81,63,30,2
2021,Havering 011E,E01002330,1769,1580,189,79,77,28,5
2021,Havering 005E,E01002331,1609,1459,150,64,66,17,3
2021,Havering 009C,E01002332,1703,1586,117,52,46,14,5
2021,Havering 008A,E01002333,1309,1268,41,26,12,3,0
2021,Havering 008B,E01002334,1675,1560,115,65,37,12,1
2021,Havering 009D,E01002335,1425,1289,136,64,52,17,3
2021,Havering 008C,E01002336,1592,1428,164,65,72,20,7
2021,Havering 012A,E01002337,1300,1214,86,51,24,9,2
2021,Havering 009E,E01002338,1350,1155,195,87,69,37,2
2021,Havering 008D,E01002339,1613,1538,75,37,28,9,1
2021,Havering 009F,E01002340,1431,1269,162,74,63,21,4
2021,Havering 008E,E01002341,1431,1333,98,56,31,11,0
2021,Havering 030A,E01002342,1644,1339,305,135,113,51,6
2021,Havering 029A,E01002343,1697,1585,112,56,42,12,2
2021,Havering 029B,E01002344,1906,1721,185,80,71,28,6
2021,Havering 030B,E01002345,1839,1549,290,114,128,43,5
2021,Havering 030C,E01002346,1481,1290,191,85,64,36,6
2021,Havering 030D,E01002347,1470,1264,206,87,80,30,9
2021,Havering 029C,E01002348,1514,1434,80,32,35,13,0
2021,Havering 029D,E01002349,1503,1417,86,29,33,16,8
2021,Havering 016B,E01002350,1634,1254,380,116,187,69,8
2021,Havering 016C,E01002351,1687,1399,288,108,107,58,15
2021,Havering 016D,E01002352,1894,1682,212,102,71,33,6
2021,Havering 013B,E01002353,1980,1675,305,124,127,46,8
2021,Havering 012B,E01002354,1338,1263,75,44,23,6,2
2021,Havering 014E,E01002355,1443,1379,64,29,23,10,2
2021,Havering 013C,E01002356,1965,1443,522,193,221,91,17
2021,Havering 016E,E01002358,2007,1576,431,195,175,56,5
2021,Havering 020A,E01002359,1276,1230,46,27,14,3,2
2021,Havering 020B,E01002360,1444,1350,94,39,40,10,5
2021,Havering 020C,E01002361,1898,1652,246,116,77,45,8
2021,Havering 022D,E01002362,1454,1374,80,34,27,18,1
2021,Havering 020D,E01002363,1441,1370,71,35,28,7,1
2021,Havering 023C,E01002364,1326,1279,47,30,10,7,0
2021,Havering 023D,E01002365,1305,1153,152,64,61,22,5
2021,Havering 023E,E01002366,1482,1386,96,42,29,22,3
2021,Havering 020E,E01002367,1677,1593,84,41,28,9,6
2021,Havering 028A,E01002368,2370,2044,326,147,126,46,7
2021,Havering 028B,E01002369,1976,1753,223,103,90,26,4
2021,Havering 028C,E01002370,2353,2047,306,120,125,53,8
2021,Havering 028D,E01002371,1653,1477,176,91,56,24,5
2021,Havering 027C,E01002372,1644,1515,129,54,57,14,4
2021,Havering 027D,E01002373,1642,1453,189,94,63,27,5
2021,Havering 027E,E01002374,1658,1466,192,89,80,21,2
2021,Havering 028E,E01002375,1858,1610,248,100,103,42,3
2021,Havering 012C,E01002376,1413,1356,57,24,23,8,2
2021,Havering 010D,E01002377,1697,1548,149,75,42,29,3
2021,Havering 010E,E01002378,1631,1519,112,63,35,11,3
2021,Havering 012D,E01002379,1526,1354,172,90,53,25,4
2021,Havering 012E,E01002380,2197,1986,211,98,86,21,6
2021,Havering 012F,E01002381,1485,1395,90,40,37,10,3
2021,Havering 014F,E01002382,1740,1558,182,95,67,20,0
2021,Havering 010F,E01002383,1606,1497,109,53,28,25,3
2021,Havering 019D,E01002384,1600,1532,68,34,24,7,3
2021,Havering 024A,E01002385,1542,1516,26,16,5,5,0
2021,Havering 022E,E01002386,1999,1825,174,93,54,26,1
2021,Havering 024B,E01002387,1576,1542,34,18,11,4,1
2021,Havering 024C,E01002388,1611,1564,47,29,13,5,0
2021,Havering 024D,E01002389,1567,1540,27,10,15,1,1
2021,Havering 024E,E01002390,1448,1429,19,16,2,1,0
2021,Havering 018E,E01002391,1696,1670,26,12,8,5,1
2021,Hillingdon 020A,E01002392,1676,1260,416,186,169,59,2
2021,Hillingdon 020B,E01002393,2021,1393,628,302,218,88,20
2021,Hillingdon 021A,E01002394,1680,1004,676,249,281,120,26
2021,Hillingdon 021B,E01002395,1353,842,511,179,211,104,17
2021,Hillingdon 026A,E01002396,1777,1149,628,243,213,145,27
2021,Hillingdon 021C,E01002397,1891,1060,831,296,351,150,34
2021,Hillingdon 021D,E01002398,1803,1115,688,304,257,110,17
2021,Hillingdon 021E,E01002399,1620,961,659,300,253,91,15
2021,Hillingdon 024A,E01002400,1929,1478,451,201,171,62,17
2021,Hillingdon 024B,E01002401,2221,1474,747,305,297,129,16
2021,Hillingdon 024C,E01002402,1594,1108,486,213,187,66,20
2021,Hillingdon 024D,E01002403,2378,1598,780,314,299,142,25
2021,Hillingdon 024E,E01002404,1917,1403,514,209,215,74,16
2021,Hillingdon 027A,E01002405,1892,1300,592,230,242,86,34
2021,Hillingdon 019A,E01002408,1585,1227,358,172,107,65,14
2021,Hillingdon 019B,E01002409,1922,1438,484,219,156,82,27
2021,Hillingdon 017A,E01002410,1864,1384,480,222,181,67,10
2021,Hillingdon 022A,E01002411,2065,1754,311,144,121,43,3
2021,Hillingdon 017B,E01002412,2247,1785,462,260,155,37,10
2021,Hillingdon 022B,E01002413,1562,1225,337,156,131,42,8
2021,Hillingdon 015A,E01002414,2661,2115,546,356,148,37,5
2021,Hillingdon 010A,E01002415,1651,1464,187,111,51,22,3
2021,Hillingdon 008A,E01002416,1677,1501,176,111,47,13,5
2021,Hillingdon 008B,E01002417,1735,1472,263,137,80,41,5
2021,Hillingdon 006A,E01002418,1728,1531,197,112,60,20,5
2021,Hillingdon 006B,E01002419,1624,1400,224,111,82,28,3
2021,Hillingdon 008C,E01002420,1561,1402,159,94,47,17,1
2021,Hillingdon 008D,E01002421,1638,1469,169,91,55,20,3
2021,Hillingdon 018A,E01002422,1517,1079,438,210,156,58,14
2021,Hillingdon 018B,E01002423,1757,1289,468,238,161,52,17
2021,Hillingdon 018C,E01002424,1617,1148,469,212,189,62,6
2021,Hillingdon 018D,E01002425,1632,1186,446,200,159,74,13
2021,Hillingdon 021F,E01002426,1937,1171,766,307,308,132,19
2021,Hillingdon 018E,E01002427,1544,1117,427,183,174,59,11
2021,Hillingdon 018F,E01002428,1501,1114,387,170,154,53,10
2021,Hillingdon 019C,E01002429,1507,1155,352,139,139,59,15
2021,Hillingdon 007A,E01002430,1375,1296,79,49,23,7,0
2021,Hillingdon 006C,E01002431,1308,1184,124,78,40,5,1
2021,Hillingdon 006D,E01002432,1446,1209,237,128,65,37,7
2021,Hillingdon 004A,E01002433,2393,2112,281,151,105,22,3
2021,Hillingdon 007B,E01002434,1303,1229,74,44,22,6,2
2021,Hillingdon 007C,E01002435,1493,1346,147,83,43,17,4
2021,Hillingdon 004B,E01002436,1633,1498,135,86,36,12,1
2021,Hillingdon 006E,E01002437,1402,1287,115,84,18,13,0
2021,Hillingdon 003A,E01002438,1404,1313,91,56,27,8,0
2021,Hillingdon 003B,E01002439,1515,1376,139,85,45,8,1
2021,Hillingdon 003C,E01002440,1525,1449,76,50,18,7,1
2021,Hillingdon 003D,E01002441,1555,1422,133,58,57,16,2
2021,Hillingdon 003E,E01002442,1573,1450,123,72,37,11,3
2021,Hillingdon 032A,E01002443,1948,1290,658,291,270,80,17
2021,Hillingdon 031A,E01002444,1838,1427,411,169,152,78,12
2021,Hillingdon 029A,E01002445,1703,1374,329,117,147,58,7
2021,Hillingdon 031B,E01002446,1891,1387,504,237,180,73,14
2021,Hillingdon 031C,E01002447,1976,1347,629,238,281,95,15
2021,Hillingdon 032B,E01002448,2060,1446,614,261,229,110,14
2021,Hillingdon 032C,E01002449,2055,1354,701,283,295,110,13
2021,Hillingdon 014A,E01002450,1447,1240,207,104,76,24,3
2021,Hillingdon 014B,E01002451,1462,1242,220,113,65,37,5
2021,Hillingdon 014C,E01002452,1487,1196,291,157,96,34,4
2021,Hillingdon 014D,E01002453,1725,1428,297,161,101,27,8
2021,Hillingdon 014E,E01002454,1847,1555,292,124,113,46,9
2021,Hillingdon 019D,E01002455,1892,1402,490,222,196,60,12
2021,Hillingdon 017C,E01002456,1668,1435,233,114,77,34,8
2021,Hillingdon 019E,E01002457,1537,1206,331,146,124,52,9
2021,Hillingdon 011A,E01002458,1405,1280,125,75,33,14,3
2021,Hillingdon 011B,E01002459,1633,1533,100,71,18,8,3
2021,Hillingdon 011C,E01002460,1385,1240,145,83,43,17,2
2021,Hillingdon 013A,E01002461,1475,1236,239,129,71,31,8
2021,Hillingdon 011D,E01002462,1448,1307,141,99,28,12,2
2021,Hillingdon 013B,E01002463,1460,1320,140,77,48,11,4
2021,Hillingdon 011E,E01002464,1561,1447,114,59,31,22,2
2021,Hillingdon 009A,E01002465,1642,1339,303,149,106,42,6
2021,Hillingdon 010B,E01002466,1645,1547,98,54,29,15,0
2021,Hillingdon 009B,E01002467,1544,1410,134,66,55,13,0
2021,Hillingdon 010C,E01002468,1652,1488,164,100,47,14,3
2021,Hillingdon 010D,E01002469,1613,1444,169,77,62,22,8
2021,Hillingdon 007D,E01002470,1764,1510,254,104,104,39,7
2021,Hillingdon 008E,E01002471,1570,1421,149,97,38,12,2
2021,Hillingdon 002A,E01002472,1618,1300,318,182,91,39,6
2021,Hillingdon 001A,E01002473,1638,1491,147,82,35,22,8
2021,Hillingdon 002B,E01002474,1688,1388,300,150,108,40,2
2021,Hillingdon 001B,E01002475,1587,1343,244,125,91,23,5
2021,Hillingdon 001C,E01002476,1585,1369,216,133,58,23,2
2021,Hillingdon 001D,E01002477,1319,1132,187,107,58,19,3
2021,Hillingdon 002C,E01002478,1540,1279,261,124,105,22,10
2021,Hillingdon 004C,E01002479,1780,1607,173,92,63,15,3
2021,Hillingdon 004D,E01002480,1803,1522,281,180,74,21,6
2021,Hillingdon 004E,E01002481,1601,1361,240,129,77,29,5
2021,Hillingdon 001E,E01002482,1624,1390,234,144,62,24,4
2021,Hillingdon 002D,E01002483,1874,1421,453,215,176,53,9
2021,Hillingdon 002E,E01002484,1379,1141,238,128,82,25,3
2021,Hillingdon 002F,E01002485,1938,1442,496,214,206,66,10
2021,Hillingdon 028A,E01002486,2168,1548,620,244,252,107,17
2021,Hillingdon 028B,E01002487,1855,1214,641,246,256,117,22
2021,Hillingdon 030B,E01002488,1692,1100,592,238,221,109,24
2021,Hillingdon 030C,E01002489,1870,1157,713,309,278,108,18
2021,Hillingdon 030D,E01002490,2078,1356,722,292,285,131,14
2021,Hillingdon 032D,E01002491,1658,1138,520,200,228,76,16
2021,Hillingdon 030E,E01002492,1639,972,667,278,256,113,20
2021,Hillingdon 032E,E01002493,1915,1312,603,255,232,99,17
2021,Hillingdon 009C,E01002494,1722,1461,261,138,87,28,8
2021,Hillingdon 010E,E01002495,1789,1486,303,175,92,25,11
2021,Hillingdon 033A,E01002496,1855,1475,380,183,130,55,12
2021,Hillingdon 033B,E01002497,2366,1807,559,280,197,74,8
2021,Hillingdon 033C,E01002498,1373,1233,140,74,42,19,5
2021,Hillingdon 033D,E01002499,1984,1600,384,165,151,57,11
2021,Hillingdon 026B,E01002501,1689,1136,553,199,227,95,32
2021,Hillingdon 026C,E01002502,1902,1343,559,238,207,97,17
2021,Hillingdon 027C,E01002503,1868,1237,631,247,232,112,40
2021,Hillingdon 026D,E01002505,1715,1207,508,198,209,85,16
2021,Hillingdon 027E,E01002506,1961,1189,772,260,314,169,29
2021,Hillingdon 027F,E01002507,1894,1211,683,274,265,124,20
2021,Hillingdon 026E,E01002508,2119,1470,649,251,225,147,26
2021,Hillingdon 017D,E01002509,1450,1231,219,124,73,21,1
2021,Hillingdon 017E,E01002511,1574,1358,216,101,79,27,9
2021,Hillingdon 013C,E01002512,1989,1690,299,182,90,26,1
2021,Hillingdon 013D,E01002513,1394,1251,143,74,49,19,1
2021,Hillingdon 015C,E01002514,1876,1512,364,201,120,39,4
2021,Hillingdon 013E,E01002516,1442,1182,260,146,70,41,3
2021,Hillingdon 022C,E01002518,1271,1060,211,100,72,28,11
2021,Hillingdon 022D,E01002519,1891,1572,319,138,122,49,10
2021,Hillingdon 016B,E01002520,1939,1539,400,162,121,99,18
2021,Hillingdon 016C,E01002521,1971,1426,545,243,205,83,14
2021,Hillingdon 016D,E01002523,1490,1135,355,145,135,70,5
2021,Hillingdon 029B,E01002525,1725,1407,318,157,104,54,3
2021,Hillingdon 028C,E01002526,2826,2159,667,334,225,97,11
2021,Hillingdon 031D,E01002527,1539,1261,278,125,104,40,9
2021,Hillingdon 028D,E01002528,1821,1414,407,182,144,63,18
2021,Hillingdon 029C,E01002529,2418,1820,598,261,223,99,15
2021,Hillingdon 029D,E01002530,1713,1395,318,121,144,47,6
2021,Hillingdon 029E,E01002531,1622,1362,260,127,101,24,8
2021,Hillingdon 005A,E01002533,1406,1303,103,65,33,4,1
2021,Hillingdon 005B,E01002534,1481,1359,122,76,32,10,4
2021,Hillingdon 007E,E01002535,2122,1721,401,206,143,45,7
2021,Hillingdon 009D,E01002536,1265,1067,198,112,63,20,3
2021,Hillingdon 009E,E01002537,2345,2042,303,167,101,30,5
2021,Hillingdon 005C,E01002538,1628,1513,115,61,40,12,2
2021,Hillingdon 005D,E01002539,1663,1546,117,69,32,12,4
2021,Hillingdon 020C,E01002540,1729,1173,556,192,254,94,16
2021,Hillingdon 023A,E01002541,1933,1366,567,266,223,71,7
2021,Hillingdon 020D,E01002542,1994,1212,782,323,317,112,30
2021,Hillingdon 020E,E01002543,1835,1255,580,238,231,101,10
2021,Hillingdon 023B,E01002544,1632,1092,540,234,204,79,23
2021,Hillingdon 023C,E01002545,1442,1081,361,134,146,59,22
2021,Hillingdon 023D,E01002546,1694,941,753,305,313,112,23
2021,Hillingdon 023E,E01002547,1640,948,692,239,288,138,27
2021,Hillingdon 025A,E01002548,1829,1527,302,120,124,50,8
2021,Hillingdon 025B,E01002549,1796,1491,305,152,105,40,8
2021,Hillingdon 022E,E01002550,1743,1353,390,200,145,39,6
2021,Hillingdon 025C,E01002551,2065,1593,472,198,151,110,13
2021,Hillingdon 025D,E01002552,1672,1289,383,177,144,56,6
2021,Hillingdon 025E,E01002553,1716,1392,324,147,108,54,15
2021,Hounslow 022A,E01002555,2010,1367,643,295,246,86,16
2021,Hounslow 022B,E01002556,1764,1304,460,237,151,64,8
2021,Hounslow 023A,E01002557,2022,1462,560,226,228,93,13
2021,Hounslow 023B,E01002558,2103,1584,519,215,200,85,19
2021,Hounslow 023C,E01002559,2470,1838,632,285,236,95,16
2021,Hounslow 023D,E01002560,1948,1425,523,217,194,99,13
2021,Hounslow 023E,E01002561,1610,1209,401,211,129,43,18
2021,Hounslow 030D,E01002562,1440,1121,319,151,115,45,8
2021,Hounslow 006A,E01002563,1851,1494,357,206,110,37,4
2021,Hounslow 031E,E01002564,1831,1470,361,168,122,62,9
2021,Hounslow 006B,E01002565,2403,1861,542,264,188,78,12
2021,Hounslow 006C,E01002567,1763,1483,280,141,99,38,2
2021,Hounslow 001A,E01002569,2042,1685,357,222,86,47,2
2021,Hounslow 001B,E01002570,1573,1220,353,195,99,57,2
2021,Hounslow 007A,E01002571,1250,1099,151,113,27,4,7
2021,Hounslow 007B,E01002572,1495,1247,248,123,85,37,3
2021,Hounslow 001C,E01002573,1519,1299,220,157,49,12,2
2021,Hounslow 001D,E01002574,1675,1445,230,164,48,16,2
2021,Hounslow 001E,E01002575,1577,1325,252,176,56,19,1
2021,Hounslow 008A,E01002576,1636,1451,185,90,58,27,10
2021,Hounslow 007C,E01002577,1612,1275,337,229,76,30,2
2021,Hounslow 007D,E01002578,1487,1289,198,118,55,20,5
2021,Hounslow 008B,E01002579,1676,1499,177,112,45,17,3
2021,Hounslow 008C,E01002580,1401,1126,275,166,64,40,5
2021,Hounslow 008D,E01002581,1798,1509,289,193,67,22,7
2021,Hounslow 008E,E01002582,1610,1435,175,127,33,14,1
2021,Hounslow 013A,E01002583,1749,1137,612,262,225,105,20
2021,Hounslow 013B,E01002584,2058,1298,760,268,306,153,33
2021,Hounslow 013C,E01002585,1781,1177,604,215,254,104,31
2021,Hounslow 013D,E01002586,1780,1117,663,264,264,119,16
2021,Hounslow 016A,E01002587,2303,1512,791,343,286,145,17
2021,Hounslow 016B,E01002588,1913,1432,481,190,192,85,14
2021,Hounslow 013E,E01002589,2411,1625,786,321,317,125,23
2021,Hounslow 022C,E01002590,2523,1762,761,364,259,114,24
2021,Hounslow 024A,E01002591,1844,1416,428,154,185,71,18
2021,Hounslow 022D,E01002592,2055,1437,618,263,255,82,18
2021,Hounslow 024B,E01002593,2199,1437,762,313,334,93,22
2021,Hounslow 024C,E01002594,2222,1466,756,327,283,109,37
2021,Hounslow 022E,E01002595,2190,1634,556,216,225,89,26
2021,Hounslow 027A,E01002596,2049,1551,498,231,192,60,15
2021,Hounslow 025B,E01002598,1858,1379,479,201,169,89,20
2021,Hounslow 025C,E01002599,1529,1186,343,166,116,46,15
2021,Hounslow 025D,E01002600,1614,1233,381,151,163,52,15
2021,Hounslow 027B,E01002601,1798,1395,403,168,155,58,22
2021,Hounslow 027C,E01002602,1451,1245,206,110,68,25,3
2021,Hounslow 025E,E01002603,1889,1344,545,257,194,81,13
2021,Hounslow 026A,E01002604,1581,1245,336,130,136,58,12
2021,Hounslow 026B,E01002605,2209,1627,582,231,224,118,9
2021,Hounslow 026C,E01002606,1638,1267,371,146,131,83,11
2021,Hounslow 026D,E01002607,2349,1691,658,315,222,113,8
2021,Hounslow 028A,E01002608,1827,1425,402,183,155,52,12
2021,Hounslow 028B,E01002609,1755,1413,342,173,121,38,10
2021,Hounslow 028C,E01002610,1698,1352,346,143,127,63,13
2021,Hounslow 024D,E01002611,1973,1495,478,226,185,50,17
2021,Hounslow 024E,E01002612,2027,1515,512,269,162,74,7
2021,Hounslow 024F,E01002613,1878,1380,498,194,223,68,13
2021,Hounslow 027D,E01002614,2016,1407,609,278,217,94,20
2021,Hounslow 026E,E01002615,1585,1201,384,163,140,73,8
2021,Hounslow 027E,E01002616,1577,1171,406,190,147,56,13
2021,Hounslow 028D,E01002617,1571,1276,295,146,106,37,6
2021,Hounslow 011A,E01002618,2002,1183,819,368,267,151,33
2021,Hounslow 010A,E01002619,2021,1262,759,330,260,131,38
2021,Hounslow 004A,E01002620,2627,1607,1020,496,343,137,44
2021,Hounslow 011B,E01002621,1939,1200,739,269,256,167,47
2021,Hounslow 010B,E01002622,1853,1258,595,264,222,90,19
2021,Hounslow 011C,E01002623,1853,1325,528,206,204,97,21
2021,Hounslow 017A,E01002624,1717,1176,541,258,190,79,14
2021,Hounslow 004B,E01002625,1666,989,677,282,251,115,29
2021,Hounslow 004C,E01002626,1579,963,616,290,207,90,29
2021,Hounslow 004D,E01002627,1722,1139,583,211,222,114,36
2021,Hounslow 011D,E01002628,2098,1311,787,359,265,126,37
2021,Hounslow 011E,E01002629,2561,1620,941,408,350,164,19
2021,Hounslow 012A,E01002630,2001,1097,904,399,321,161,23
2021,Hounslow 004E,E01002631,1734,962,772,316,283,132,41
2021,Hounslow 010C,E01002632,1855,1179,676,306,223,121,26
2021,Hounslow 005A,E01002633,2143,1525,618,253,223,120,22
2021,Hounslow 005B,E01002634,1698,1175,523,205,204,98,16
2021,Hounslow 010D,E01002635,1939,1250,689,281,263,120,25
2021,Hounslow 010E,E01002636,2066,1222,844,413,277,125,29
2021,Hounslow 005C,E01002637,1832,981,851,348,305,154,44
2021,Hounslow 005D,E01002638,2122,1302,820,342,313,128,37
2021,Hounslow 012B,E01002639,1717,977,740,282,322,126,10
2021,Hounslow 012C,E01002640,2197,1230,967,444,342,152,29
2021,Hounslow 018A,E01002641,2557,1543,1014,482,340,168,24
2021,Hounslow 015B,E01002643,2631,1914,717,315,264,121,17
2021,Hounslow 015C,E01002645,2184,1330,854,293,368,163,30
2021,Hounslow 017B,E01002646,2230,1489,741,282,289,145,25
2021,Hounslow 021A,E01002647,2129,1424,705,341,246,96,22
2021,Hounslow 018D,E01002649,1956,1280,676,281,268,106,21
2021,Hounslow 021B,E01002650,2415,1578,837,392,309,125,11
2021,Hounslow 021C,E01002651,1867,1090,777,281,313,146,37
2021,Hounslow 021D,E01002652,1862,1163,699,281,263,130,25
2021,Hounslow 019A,E01002653,1819,1189,630,302,233,82,13
2021,Hounslow 019B,E01002654,1864,1298,566,249,217,88,12
2021,Hounslow 019C,E01002655,1821,1252,569,237,218,102,12
2021,Hounslow 019D,E01002656,1385,1129,256,125,93,34,4
2021,Hounslow 018E,E01002657,1868,1378,490,218,172,86,14
2021,Hounslow 015D,E01002658,1307,1095,212,108,70,26,8
2021,Hounslow 019E,E01002659,1410,1029,381,170,140,58,13
2021,Hounslow 016C,E01002660,2022,1302,720,291,270,134,25
2021,Hounslow 016D,E01002661,2261,1416,845,331,341,143,30
2021,Hounslow 017C,E01002662,2418,1507,911,439,283,155,34
2021,Hounslow 017D,E01002663,2076,1290,786,303,291,150,42
2021,Hounslow 016E,E01002665,1686,1109,577,221,222,108,26
2021,Hounslow 021E,E01002666,1796,1135,661,279,238,121,23
2021,Hounslow 020A,E01002667,2103,1671,432,221,148,52,11
2021,Hounslow 014A,E01002668,2203,1750,453,232,167,46,8
2021,Hounslow 014B,E01002669,1855,1510,345,160,135,41,9
2021,Hounslow 020B,E01002670,1880,1482,398,194,153,45,6
2021,Hounslow 020C,E01002671,1776,1591,185,97,60,24,4
2021,Hounslow 020D,E01002672,1540,1138,402,177,156,63,6
2021,Hounslow 020E,E01002673,1599,1124,475,190,191,83,11
2021,Hounslow 012D,E01002674,1996,1403,593,303,205,76,9
2021,Hounslow 009A,E01002675,2477,1981,496,285,166,34,11
2021,Hounslow 012E,E01002676,1605,1144,461,246,149,58,8
2021,Hounslow 015E,E01002677,1981,1438,543,254,193,90,6
2021,Hounslow 009B,E01002678,1996,1543,453,239,146,65,3
2021,Hounslow 009C,E01002679,1785,1261,524,243,191,73,17
2021,Hounslow 009D,E01002680,2014,1484,530,278,172,74,6
2021,Hounslow 014C,E01002681,2348,1832,516,246,190,70,10
2021,Hounslow 014D,E01002682,2250,1709,541,286,191,55,9
2021,Hounslow 006E,E01002686,1729,1383,346,138,161,39,8
2021,Hounslow 029A,E01002687,1597,1226,371,219,115,35,2
2021,Hounslow 007E,E01002689,1506,1286,220,126,64,27,3
2021,Hounslow 007F,E01002690,1340,1165,175,120,40,14,1
2021,Hounslow 029B,E01002691,1598,1032,566,323,165,66,12
2021,Hounslow 029C,E01002692,2038,1544,494,308,133,48,5
2021,Hounslow 029D,E01002693,1736,1444,292,193,69,26,4
2021,Islington 019A,E01002694,1634,1313,321,123,119,69,10
2021,Islington 021A,E01002695,1442,1130,312,200,72,39,1
2021,Islington 020A,E01002696,1692,1417,275,215,27,27,6
2021,Islington 019B,E01002697,1924,1349,575,269,158,134,14
2021,Islington 017A,E01002698,1969,1668,301,225,53,17,6
2021,Islington 017B,E01002699,1450,1309,141,103,25,12,1
2021,Islington 017C,E01002700,1327,1192,135,100,25,6,4
2021,Islington 023A,E01002701,1439,1138,301,165,86,45,5
2021,Islington 023B,E01002702,2387,1764,623,333,203,81,6
2021,Islington 023C,E01002703,2251,1737,514,317,129,58,10
2021,Islington 023D,E01002704,2288,1827,461,283,134,43,1
2021,Islington 023E,E01002706,1980,1589,391,245,107,36,3
2021,Islington 022B,E01002707,1759,1342,417,267,90,49,11
2021,Islington 015A,E01002708,2052,1551,501,280,139,79,3
2021,Islington 019C,E01002709,1651,1282,369,217,100,44,8
2021,Islington 019D,E01002710,1562,1229,333,200,88,39,6
2021,Islington 021B,E01002711,1988,1434,554,359,140,51,4
2021,Islington 015B,E01002712,1327,1070,257,161,71,18,7
2021,Islington 015C,E01002713,2702,2293,409,211,118,71,9
2021,Islington 017D,E01002714,1483,1271,212,140,53,16,3
2021,Islington 019E,E01002715,1610,1234,376,164,121,78,13
2021,Islington 014A,E01002716,2194,1785,409,201,115,78,15
2021,Islington 016A,E01002717,1169,973,196,120,54,20,2
2021,Islington 014B,E01002718,1535,1341,194,135,42,12,5
2021,Islington 016B,E01002719,1429,1255,174,125,29,18,2
2021,Islington 016C,E01002720,2045,1673,372,162,131,65,14
2021,Islington 014C,E01002721,1542,1363,179,114,48,16,1
2021,Islington 018A,E01002722,1352,1081,271,146,96,23,6
2021,Islington 022C,E01002723,1590,1237,353,214,93,43,3
2021,Islington 022D,E01002724,1883,1504,379,270,86,22,1
2021,Islington 022E,E01002725,1311,1058,253,138,68,44,3
2021,Islington 022F,E01002726,1583,1244,339,194,114,28,3
2021,Islington 021C,E01002727,1474,1259,215,152,40,23,0
2021,Islington 021D,E01002728,1291,949,342,226,79,30,7
2021,Islington 021E,E01002729,1456,1259,197,115,56,25,1
2021,Islington 007A,E01002730,1708,1270,438,217,114,94,13
2021,Islington 005A,E01002732,1755,1391,364,136,128,81,19
2021,Islington 007C,E01002733,1409,1119,290,170,86,30,4
2021,Islington 005B,E01002734,2286,1576,710,314,226,134,36
2021,Islington 003A,E01002735,2887,2285,602,323,182,74,23
2021,Islington 005C,E01002736,1414,1038,376,128,144,89,15
2021,Islington 005D,E01002737,1873,1377,496,202,159,124,11
2021,Islington 009A,E01002738,1817,1556,261,170,57,27,7
2021,Islington 013A,E01002739,1775,1568,207,159,32,15,1
2021,Islington 013B,E01002740,2100,1780,320,255,51,12,2
2021,Islington 009B,E01002741,1482,1195,287,113,93,64,17
2021,Islington 006A,E01002742,1939,1598,341,151,91,79,20
2021,Islington 009C,E01002743,1470,1283,187,118,48,21,0
2021,Islington 009D,E01002744,1272,1090,182,106,42,28,6
2021,Islington 013C,E01002745,1369,1218,151,93,38,17,3
2021,Islington 006B,E01002747,1501,1308,193,102,55,34,2
2021,Islington 006C,E01002748,1605,1299,306,137,89,70,10
2021,Islington 006D,E01002749,1460,1224,236,121,66,43,6
2021,Islington 005E,E01002751,1734,1315,419,191,152,66,10
2021,Islington 009E,E01002752,1581,1332,249,153,49,39,8
2021,Islington 002A,E01002753,1413,1138,275,146,75,44,10
2021,Islington 002B,E01002754,1509,1265,244,147,60,29,8
2021,Islington 001A,E01002755,1269,1056,213,99,66,42,6
2021,Islington 001B,E01002756,1269,1135,134,83,37,9,5
2021,Islington 002C,E01002757,1398,1215,183,84,62,27,10
2021,Islington 001C,E01002758,1677,1279,398,152,146,82,18
2021,Islington 002D,E01002759,1469,1319,150,91,34,22,3
2021,Islington 002E,E01002760,1674,1348,326,154,111,53,8
2021,Islington 011C,E01002762,1821,1442,379,274,76,26,3
2021,Islington 007D,E01002763,1266,982,284,158,83,40,3
2021,Islington 010A,E01002764,1761,1358,403,198,113,77,15
2021,Islington 015D,E01002765,2811,2045,766,377,281,98,10
2021,Islington 015E,E01002766,2127,1645,482,232,161,75,14
2021,Islington 011D,E01002767,2090,1630,460,239,144,65,12
2021,Islington 004A,E01002768,1563,1342,221,129,68,21,3
2021,Islington 008A,E01002769,1807,1460,347,190,103,39,15
2021,Islington 004B,E01002770,1788,1415,373,243,93,27,10
2021,Islington 004C,E01002771,1510,1268,242,154,64,22,2
2021,Islington 002F,E01002772,1837,1498,339,199,100,36,4
2021,Islington 004D,E01002773,1582,1260,322,138,125,52,7
2021,Islington 004E,E01002774,2074,1720,354,229,90,28,7
2021,Islington 014D,E01002775,1362,1164,198,125,51,16,6
2021,Islington 014E,E01002776,1793,1531,262,152,63,42,5
2021,Islington 012A,E01002777,1631,1407,224,123,61,32,8
2021,Islington 012B,E01002778,1878,1501,377,152,126,90,9
2021,Islington 012C,E01002779,1687,1400,287,182,86,15,4
2021,Islington 014F,E01002780,1654,1443,211,116,45,44,6
2021,Islington 012D,E01002781,1691,1422,269,131,95,35,8
2021,Islington 012E,E01002782,1397,1104,293,110,108,57,18
2021,Islington 010B,E01002783,1659,1355,304,170,91,38,5
2021,Islington 010C,E01002784,1713,1396,317,154,102,54,7
2021,Islington 008B,E01002785,1817,1507,310,206,73,26,5
2021,Islington 010D,E01002786,1881,1432,449,262,112,65,10
2021,Islington 010E,E01002787,1421,1042,379,191,133,51,4
2021,Islington 008C,E01002788,1775,1484,291,183,70,31,7
2021,Islington 008D,E01002789,1802,1612,190,129,45,15,1
2021,Islington 016D,E01002790,1380,1209,171,83,53,25,10
2021,Islington 016E,E01002791,1791,1518,273,190,54,24,5
2021,Islington 017E,E01002792,1798,1547,251,191,39,19,2
2021,Islington 016F,E01002793,1794,1469,325,180,75,58,12
2021,Islington 020B,E01002794,1972,1666,306,227,56,23,0
2021,Islington 013D,E01002795,1885,1538,347,204,88,47,8
2021,Islington 013E,E01002796,1085,959,126,65,31,22,8
2021,Islington 018B,E01002797,1771,1416,355,247,68,36,4
2021,Islington 018C,E01002798,1889,1679,210,143,43,21,3
2021,Islington 018D,E01002799,1834,1415,419,245,115,53,6
2021,Islington 018E,E01002800,1685,1298,387,246,82,48,11
2021,Islington 020C,E01002801,1419,1247,172,131,23,15,3
2021,Islington 020D,E01002802,1796,1495,301,190,79,24,8
2021,Islington 001D,E01002804,1484,1249,235,112,73,46,4
2021,Islington 003B,E01002805,1397,1133,264,163,67,26,8
2021,Islington 003C,E01002806,1580,1382,198,116,50,28,4
2021,Islington 001E,E01002807,1655,1293,362,182,123,43,14
2021,Islington 003D,E01002808,1829,1486,343,188,93,50,12
2021,Islington 003E,E01002809,1658,1344,314,154,78,74,8
2021,Islington 003F,E01002810,1705,1380,325,193,88,39,5
2021,Islington 001F,E01002811,1681,1390,291,129,107,47,8
2021,Kensington and Chelsea 013A,E01002812,1460,988,472,324,119,28,1
2021,Kensington and Chelsea 011A,E01002813,1443,1163,280,203,54,20,3
2021,Kensington and Chelsea 015A,E01002814,2174,1471,703,382,228,84,9
2021,Kensington and Chelsea 011B,E01002815,1137,770,367,222,105,39,1
2021,Kensington and Chelsea 011C,E01002816,1017,751,266,196,55,14,1
2021,Kensington and Chelsea 011D,E01002817,1312,1009,303,190,97,14,2
2021,Kensington and Chelsea 012A,E01002818,1352,961,391,267,106,17,1
2021,Kensington and Chelsea 012B,E01002819,1058,796,262,187,57,17,1
2021,Kensington and Chelsea 014A,E01002821,1057,770,287,209,66,11,1
2021,Kensington and Chelsea 014B,E01002823,1207,950,257,157,84,13,3
2021,Kensington and Chelsea 008A,E01002824,1196,914,282,182,77,21,2
2021,Kensington and Chelsea 008B,E01002825,1726,1350,376,253,101,19,3
2021,Kensington and Chelsea 008C,E01002826,1214,939,275,193,63,12,7
2021,Kensington and Chelsea 008D,E01002827,1665,1313,352,273,54,22,3
2021,Kensington and Chelsea 008E,E01002828,1166,924,242,169,51,16,6
2021,Kensington and Chelsea 004A,E01002829,1366,1106,260,162,79,19,0
2021,Kensington and Chelsea 004B,E01002830,1690,1367,323,137,125,49,12
2021,Kensington and Chelsea 004C,E01002831,1673,1354,319,156,104,53,6
2021,Kensington and Chelsea 004D,E01002832,1600,1313,287,147,76,47,17
2021,Kensington and Chelsea 007A,E01002833,1174,952,222,174,40,7,1
2021,Kensington and Chelsea 013B,E01002834,1207,839,368,263,85,18,2
2021,Kensington and Chelsea 016C,E01002835,1373,931,442,336,83,18,5
2021,Kensington and Chelsea 016D,E01002836,1281,931,350,271,67,9,3
2021,Kensington and Chelsea 016E,E01002837,1015,745,270,222,38,10,0
2021,Kensington and Chelsea 013C,E01002839,1518,1012,506,313,121,49,23
2021,Kensington and Chelsea 021A,E01002840,1019,810,209,97,74,35,3
2021,Kensington and Chelsea 021B,E01002841,1194,995,199,129,41,28,1
2021,Kensington and Chelsea 021C,E01002842,986,709,277,98,107,63,9
2021,Kensington and Chelsea 021D,E01002843,1265,980,285,142,107,33,3
2021,Kensington and Chelsea 019A,E01002844,1117,927,190,114,65,9,2
2021,Kensington and Chelsea 019B,E01002845,1142,929,213,128,64,19,2
2021,Kensington and Chelsea 017A,E01002846,1268,859,409,294,85,26,4
2021,Kensington and Chelsea 015B,E01002847,1360,904,456,278,130,44,4
2021,Kensington and Chelsea 015C,E01002848,1219,823,396,262,101,29,4
2021,Kensington and Chelsea 017B,E01002849,1432,974,458,339,87,31,1
2021,Kensington and Chelsea 013D,E01002850,1377,910,467,307,109,49,2
2021,Kensington and Chelsea 015D,E01002851,1317,921,396,221,131,35,9
2021,Kensington and Chelsea 001A,E01002852,2164,1609,555,238,241,67,9
2021,Kensington and Chelsea 001B,E01002853,1399,1103,296,147,92,51,6
2021,Kensington and Chelsea 001C,E01002854,1075,844,231,98,94,34,5
2021,Kensington and Chelsea 001D,E01002855,1550,1162,388,166,117,83,22
2021,Kensington and Chelsea 004E,E01002856,1405,1140,265,151,82,30,2
2021,Kensington and Chelsea 001E,E01002857,1354,1032,322,125,137,50,10
2021,Kensington and Chelsea 014C,E01002858,1246,971,275,154,80,39,2
2021,Kensington and Chelsea 012C,E01002859,1226,893,333,253,50,26,4
2021,Kensington and Chelsea 012D,E01002860,1119,940,179,148,24,7,0
2021,Kensington and Chelsea 014D,E01002861,1236,854,382,257,74,48,3
2021,Kensington and Chelsea 014E,E01002862,1078,803,275,186,70,16,3
2021,Kensington and Chelsea 012E,E01002863,1084,766,318,216,84,17,1
2021,Kensington and Chelsea 009A,E01002864,1438,1086,352,201,126,24,1
2021,Kensington and Chelsea 011E,E01002865,1416,1059,357,248,83,22,4
2021,Kensington and Chelsea 009B,E01002866,1795,1376,419,240,123,52,4
2021,Kensington and Chelsea 009C,E01002867,1643,1186,457,264,129,49,15
2021,Kensington and Chelsea 009D,E01002868,1271,1001,270,198,53,19,0
2021,Kensington and Chelsea 009E,E01002869,1708,1187,521,325,134,50,12
2021,Kensington and Chelsea 005A,E01002870,1571,1252,319,145,108,65,1
2021,Kensington and Chelsea 007B,E01002871,1408,1161,247,182,60,4,1
2021,Kensington and Chelsea 005B,E01002872,1318,1076,242,115,75,46,6
2021,Kensington and Chelsea 007C,E01002873,1339,1129,210,150,44,15,1
2021,Kensington and Chelsea 007D,E01002874,1107,914,193,148,32,11,2
2021,Kensington and Chelsea 007E,E01002875,1229,1017,212,142,61,9,0
2021,Kensington and Chelsea 003A,E01002876,1783,1541,242,146,69,26,1
2021,Kensington and Chelsea 003B,E01002877,2056,1634,422,177,169,68,8
2021,Kensington and Chelsea 003C,E01002878,1414,1142,272,176,63,27,6
2021,Kensington and Chelsea 005C,E01002879,1885,1475,410,161,141,90,18
2021,Kensington and Chelsea 005D,E01002880,1114,856,258,99,104,53,2
2021,Kensington and Chelsea 005E,E01002881,1331,1079,252,102,96,51,3
2021,Kensington and Chelsea 006A,E01002882,1015,830,185,147,28,9,1
2021,Kensington and Chelsea 006B,E01002883,1430,1128,302,196,84,20,2
2021,Kensington and Chelsea 006C,E01002884,1356,957,399,256,106,34,3
2021,Kensington and Chelsea 006D,E01002885,1290,957,333,259,56,17,1
2021,Kensington and Chelsea 006E,E01002886,1272,1042,230,147,59,20,4
2021,Kensington and Chelsea 010A,E01002887,1012,709,303,222,68,12,1
2021,Kensington and Chelsea 013E,E01002888,1536,980,556,380,149,25,2
2021,Kensington and Chelsea 010B,E01002889,1536,1092,444,244,129,68,3
2021,Kensington and Chelsea 010C,E01002890,1362,1020,342,249,73,18,2
2021,Kensington and Chelsea 010D,E01002891,1159,783,376,237,112,27,0
2021,Kensington and Chelsea 010E,E01002892,1257,876,381,295,75,10,1
2021,Kensington and Chelsea 017C,E01002893,1541,1172,369,250,86,27,6
2021,Kensington and Chelsea 017D,E01002894,1286,937,349,265,72,11,1
2021,Kensington and Chelsea 020C,E01002896,1537,1142,395,299,76,17,3
2021,Kensington and Chelsea 020D,E01002897,1461,1147,314,235,63,16,0
2021,Kensington and Chelsea 017E,E01002898,1613,1028,585,414,104,58,9
2021,Kensington and Chelsea 018A,E01002899,1219,983,236,159,51,23,3
2021,Kensington and Chelsea 018B,E01002900,1666,1332,334,242,56,29,7
2021,Kensington and Chelsea 018C,E01002901,1029,882,147,107,28,12,0
2021,Kensington and Chelsea 018D,E01002902,1204,933,271,196,64,10,1
2021,Kensington and Chelsea 018E,E01002903,1246,1045,201,155,35,10,1
2021,Kensington and Chelsea 002A,E01002904,1257,1027,230,91,93,41,5
2021,Kensington and Chelsea 002B,E01002905,1600,1266,334,174,113,42,5
2021,Kensington and Chelsea 002C,E01002906,1721,1407,314,157,110,42,5
2021,Kensington and Chelsea 002D,E01002907,1228,1007,221,77,109,29,6
2021,Kensington and Chelsea 003D,E01002908,1352,1129,223,134,68,18,3
2021,Kensington and Chelsea 003E,E01002909,2071,1789,282,182,76,21,3
2021,Kensington and Chelsea 019C,E01002910,1320,997,323,182,75,64,2
2021,Kensington and Chelsea 019D,E01002911,1256,1053,203,161,33,7,2
2021,Kensington and Chelsea 020E,E01002912,1457,1072,385,280,88,9,8
2021,Kensington and Chelsea 021E,E01002913,1716,1394,322,215,78,24,5
2021,Kensington and Chelsea 019E,E01002914,1154,909,245,192,37,10,6
2021,Kingston upon Thames 014A,E01002915,1355,1123,232,111,84,31,6
2021,Kingston upon Thames 014B,E01002916,1435,1222,213,111,71,27,4
2021,Kingston upon Thames 014C,E01002917,1381,1191,190,97,64,24,5
2021,Kingston upon Thames 017A,E01002918,1738,1335,403,175,147,71,10
2021,Kingston upon Thames 017B,E01002919,1907,1343,564,258,193,102,11
2021,Kingston upon Thames 014D,E01002920,1550,1431,119,71,32,11,5
2021,Kingston upon Thames 011A,E01002921,1657,1259,398,188,148,55,7
2021,Kingston upon Thames 010A,E01002922,1592,1449,143,87,41,12,3
2021,Kingston upon Thames 013A,E01002923,1621,1339,282,120,92,55,15
2021,Kingston upon Thames 014E,E01002924,1511,1429,82,62,14,5,1
2021,Kingston upon Thames 013B,E01002925,1506,1328,178,103,51,22,2
2021,Kingston upon Thames 010B,E01002926,1559,1398,161,91,49,17,4
2021,Kingston upon Thames 008A,E01002927,1629,1303,326,147,121,52,6
2021,Kingston upon Thames 008B,E01002928,1877,1405,472,186,195,78,13
2021,Kingston upon Thames 007A,E01002929,1650,1436,214,103,74,36,1
2021,Kingston upon Thames 007B,E01002930,1886,1405,481,191,164,112,14
2021,Kingston upon Thames 007C,E01002931,1938,1605,333,159,119,50,5
2021,Kingston upon Thames 006A,E01002932,1977,1513,464,211,171,68,14
2021,Kingston upon Thames 004A,E01002933,1964,1735,229,115,76,33,5
2021,Kingston upon Thames 004B,E01002934,1820,1628,192,127,53,12,0
2021,Kingston upon Thames 003A,E01002935,1819,1413,406,238,99,59,10
2021,Kingston upon Thames 004D,E01002937,1740,1571,169,107,43,17,2
2021,Kingston upon Thames 003B,E01002938,1920,1727,193,106,58,23,6
2021,Kingston upon Thames 018A,E01002939,1597,1348,249,113,92,38,6
2021,Kingston upon Thames 020A,E01002940,1619,1422,197,91,83,17,6
2021,Kingston upon Thames 018B,E01002941,1593,1387,206,96,73,36,1
2021,Kingston upon Thames 018C,E01002942,1365,1262,103,56,31,14,2
2021,Kingston upon Thames 020B,E01002943,1432,1233,199,92,71,31,5
2021,Kingston upon Thames 019A,E01002944,1286,1165,121,68,35,14,4
2021,Kingston upon Thames 019B,E01002945,1514,1351,163,78,64,21,0
2021,Kingston upon Thames 019C,E01002946,1455,1342,113,62,37,12,2
2021,Kingston upon Thames 019D,E01002947,1593,1403,190,99,69,17,5
2021,Kingston upon Thames 020C,E01002948,2128,1862,266,119,94,46,7
2021,Kingston upon Thames 020D,E01002949,1795,1625,170,83,56,30,1
2021,Kingston upon Thames 020E,E01002950,1587,1427,160,81,49,29,1
2021,Kingston upon Thames 003C,E01002951,1462,1167,295,175,86,30,4
2021,Kingston upon Thames 002A,E01002952,1356,1124,232,138,65,24,5
2021,Kingston upon Thames 002B,E01002953,1315,1078,237,105,93,36,3
2021,Kingston upon Thames 003D,E01002954,1307,941,366,207,118,37,4
2021,Kingston upon Thames 002C,E01002955,1474,1140,334,168,115,48,3
2021,Kingston upon Thames 002D,E01002956,1373,1083,290,152,92,45,1
2021,Kingston upon Thames 003E,E01002957,1532,1116,416,217,141,46,12
2021,Kingston upon Thames 008C,E01002958,1673,1490,183,91,65,24,3
2021,Kingston upon Thames 002E,E01002959,1365,1185,180,103,54,23,0
2021,Kingston upon Thames 006B,E01002960,1547,1273,274,159,78,28,9
2021,Kingston upon Thames 008D,E01002961,1704,1443,261,135,76,45,5
2021,Kingston upon Thames 006C,E01002962,1559,1204,355,177,128,47,3
2021,Kingston upon Thames 007D,E01002963,1768,1305,463,190,162,94,17
2021,Kingston upon Thames 005A,E01002964,2429,1964,465,249,164,48,4
2021,Kingston upon Thames 009A,E01002965,2442,1910,532,281,179,61,11
2021,Kingston upon Thames 010C,E01002966,1905,1709,196,108,66,18,4
2021,Kingston upon Thames 009B,E01002967,1787,1506,281,182,84,13,2
2021,Kingston upon Thames 009C,E01002968,2838,2182,656,362,219,67,8
2021,Kingston upon Thames 005B,E01002969,1798,1275,523,200,214,93,16
2021,Kingston upon Thames 006D,E01002970,1735,1248,487,238,171,72,6
2021,Kingston upon Thames 005C,E01002971,1733,1443,290,144,99,44,3
2021,Kingston upon Thames 005D,E01002972,1952,1478,474,260,143,63,8
2021,Kingston upon Thames 006E,E01002973,1536,1148,388,149,185,49,5
2021,Kingston upon Thames 005E,E01002974,1988,1589,399,207,131,55,6
2021,Kingston upon Thames 012A,E01002975,1456,1112,344,154,126,54,10
2021,Kingston upon Thames 015A,E01002976,1645,1496,149,79,52,16,2
2021,Kingston upon Thames 012B,E01002977,1639,1316,323,126,128,61,8
2021,Kingston upon Thames 015B,E01002978,1784,1519,265,122,98,39,6
2021,Kingston upon Thames 015C,E01002979,1489,1320,169,84,61,21,3
2021,Kingston upon Thames 012C,E01002980,1380,1099,281,135,107,36,3
2021,Kingston upon Thames 012D,E01002981,1562,1268,294,131,113,46,4
2021,Kingston upon Thames 015D,E01002982,1460,1169,291,128,111,48,4
2021,Kingston upon Thames 015E,E01002983,1620,1392,228,118,91,18,1
2021,Kingston upon Thames 012E,E01002984,1390,1058,332,124,125,74,9
2021,Kingston upon Thames 007E,E01002985,1661,1092,569,219,224,115,11
2021,Kingston upon Thames 008E,E01002986,1333,1065,268,130,90,41,7
2021,Kingston upon Thames 011B,E01002987,1837,1474,363,215,90,53,5
2021,Kingston upon Thames 011C,E01002988,1627,1419,208,137,58,13,0
2021,Kingston upon Thames 011D,E01002989,1810,1595,215,141,54,19,1
2021,Kingston upon Thames 009D,E01002990,1636,1367,269,145,83,35,6
2021,Kingston upon Thames 009E,E01002991,1513,1316,197,124,47,23,3
2021,Kingston upon Thames 010D,E01002992,1520,1290,230,137,74,18,1
2021,Kingston upon Thames 013C,E01002993,1500,1265,235,142,64,26,3
2021,Kingston upon Thames 016A,E01002994,1438,1279,159,91,46,20,2
2021,Kingston upon Thames 013D,E01002995,1550,1374,176,116,40,15,5
2021,Kingston upon Thames 016B,E01002996,1489,1303,186,79,67,35,5
2021,Kingston upon Thames 016C,E01002997,1471,1353,118,65,37,15,1
2021,Kingston upon Thames 016D,E01002998,1520,1286,234,108,89,30,7
2021,Kingston upon Thames 013E,E01002999,1464,1169,295,153,101,36,5
2021,Kingston upon Thames 017C,E01003000,1800,1443,357,192,125,35,5
2021,Kingston upon Thames 017D,E01003001,1859,1429,430,226,140,56,8
2021,Kingston upon Thames 016E,E01003002,1847,1542,305,150,103,46,6
2021,Kingston upon Thames 017E,E01003003,1678,1207,471,169,198,83,21
2021,Kingston upon Thames 018D,E01003004,1576,1293,283,127,99,48,9
2021,Kingston upon Thames 018E,E01003005,1506,1341,165,76,58,27,4
2021,Kingston upon Thames 001A,E01003006,1484,1220,264,164,59,40,1
2021,Kingston upon Thames 001B,E01003007,1599,1340,259,156,81,21,1
2021,Kingston upon Thames 001C,E01003008,1413,1245,168,116,35,15,2
2021,Kingston upon Thames 001D,E01003009,2006,1738,268,173,72,19,4
2021,Kingston upon Thames 001E,E01003010,1407,1256,151,106,41,4,0
2021,Kingston upon Thames 004E,E01003011,1656,1453,203,119,68,16,0
2021,Lambeth 036A,E01003013,1925,1217,708,416,249,37,6
2021,Lambeth 036B,E01003014,1473,1130,343,146,125,68,4
2021,Lambeth 002A,E01003015,1677,1395,282,123,102,50,7
2021,Lambeth 036C,E01003016,1186,955,231,164,49,18,0
2021,Lambeth 036D,E01003017,1599,1360,239,155,55,24,5
2021,Lambeth 020A,E01003018,1974,1694,280,163,68,42,7
2021,Lambeth 015A,E01003019,1988,1800,188,114,48,23,3
2021,Lambeth 016A,E01003020,1789,1544,245,126,81,33,5
2021,Lambeth 021A,E01003021,2117,1871,246,101,85,46,14
2021,Lambeth 021B,E01003022,1575,1382,193,106,71,14,2
2021,Lambeth 021C,E01003023,2504,1955,549,224,185,118,22
2021,Lambeth 021D,E01003024,1770,1404,366,147,128,78,13
2021,Lambeth 021E,E01003025,1988,1671,317,147,112,50,8
2021,Lambeth 019A,E01003026,1448,1309,139,85,33,21,0
2021,Lambeth 019B,E01003027,1346,1251,95,73,17,3,2
2021,Lambeth 019C,E01003028,1422,1250,172,111,44,16,1
2021,Lambeth 017A,E01003029,1777,1557,220,142,60,16,2
2021,Lambeth 019D,E01003030,1682,1488,194,138,34,20,2
2021,Lambeth 023A,E01003031,1532,1344,188,107,50,24,7
2021,Lambeth 017B,E01003032,1685,1426,259,136,82,34,7
2021,Lambeth 019E,E01003033,1568,1400,168,87,46,34,1
2021,Lambeth 012A,E01003034,1599,1351,248,125,88,29,6
2021,Lambeth 012B,E01003035,1649,1417,232,128,51,42,11
2021,Lambeth 012C,E01003036,1722,1492,230,172,40,17,1
2021,Lambeth 013A,E01003037,1418,1208,210,100,62,36,12
2021,Lambeth 013B,E01003038,1648,1509,139,97,26,16,0
2021,Lambeth 013C,E01003039,1990,1785,205,149,39,15,2
2021,Lambeth 013D,E01003040,1216,1084,132,89,27,13,3
2021,Lambeth 017C,E01003041,1492,1266,226,90,94,37,5
2021,Lambeth 013E,E01003042,1091,921,170,90,59,17,4
2021,Lambeth 018A,E01003043,1588,1452,136,74,40,10,12
2021,Lambeth 018B,E01003044,1369,1179,190,95,49,44,2
2021,Lambeth 011A,E01003045,1937,1469,468,242,138,74,14
2021,Lambeth 009A,E01003046,1636,1297,339,133,111,92,3
2021,Lambeth 011B,E01003047,1756,1432,324,126,110,72,16
2021,Lambeth 009B,E01003048,1863,1454,409,143,161,84,21
2021,Lambeth 011C,E01003049,1716,1339,377,142,143,74,18
2021,Lambeth 016B,E01003050,1551,1391,160,83,44,31,2
2021,Lambeth 018C,E01003051,2061,1720,341,146,134,54,7
2021,Lambeth 016C,E01003052,2155,1722,433,190,134,94,15
2021,Lambeth 015B,E01003053,1653,1396,257,132,81,36,8
2021,Lambeth 015C,E01003054,2159,1920,239,152,58,21,8
2021,Lambeth 016D,E01003055,1562,1350,212,106,60,38,8
2021,Lambeth 015D,E01003056,1688,1531,157,83,38,31,5
2021,Lambeth 017D,E01003057,1659,1405,254,97,110,43,4
2021,Lambeth 015E,E01003058,1936,1716,220,114,55,45,6
2021,Lambeth 011D,E01003059,2153,1508,645,259,222,136,28
2021,Lambeth 011E,E01003060,1656,1241,415,166,149,86,14
2021,Lambeth 011F,E01003061,1308,971,337,119,104,95,19
2021,Lambeth 033A,E01003062,1779,1536,243,131,82,21,9
2021,Lambeth 033B,E01003063,1310,1081,229,104,78,37,10
2021,Lambeth 028A,E01003064,1402,1268,134,79,27,25,3
2021,Lambeth 031A,E01003065,1587,1392,195,99,53,29,14
2021,Lambeth 028B,E01003066,1804,1449,355,108,149,84,14
2021,Lambeth 033C,E01003067,1465,1277,188,80,74,31,3
2021,Lambeth 031B,E01003068,1514,1338,176,85,55,31,5
2021,Lambeth 033D,E01003069,1323,1199,124,58,44,18,4
2021,Lambeth 033E,E01003070,1479,1268,211,90,82,29,10
2021,Lambeth 018D,E01003071,2263,2065,198,112,64,17,5
2021,Lambeth 014A,E01003072,1697,1547,150,88,41,20,1
2021,Lambeth 014B,E01003073,1552,1413,139,67,46,23,3
2021,Lambeth 018E,E01003074,2289,2051,238,134,81,20,3
2021,Lambeth 009C,E01003075,1662,1352,310,127,109,67,7
2021,Lambeth 014C,E01003076,2594,2062,532,216,199,96,21
2021,Lambeth 014D,E01003077,1803,1439,364,178,80,89,17
2021,Lambeth 014E,E01003078,1570,1421,149,80,46,15,8
2021,Lambeth 027A,E01003079,1619,1279,340,139,104,79,18
2021,Lambeth 027B,E01003080,1620,1387,233,114,70,36,13
2021,Lambeth 028C,E01003081,1773,1447,326,147,134,38,7
2021,Lambeth 031C,E01003082,1337,1196,141,62,54,24,1
2021,Lambeth 030A,E01003083,1479,1297,182,78,60,38,6
2021,Lambeth 030B,E01003084,1435,1252,183,87,64,26,6
2021,Lambeth 030C,E01003085,1707,1506,201,91,65,37,8
2021,Lambeth 031D,E01003086,1506,1297,209,91,79,26,13
2021,Lambeth 031E,E01003087,1580,1252,328,127,130,56,15
2021,Lambeth 010A,E01003088,1529,1242,287,133,109,38,7
2021,Lambeth 008A,E01003089,1882,1339,543,259,200,70,14
2021,Lambeth 012D,E01003090,2343,2010,333,195,91,30,17
2021,Lambeth 008B,E01003091,1668,1326,342,154,121,55,12
2021,Lambeth 008C,E01003092,2272,1766,506,217,178,82,29
2021,Lambeth 010B,E01003093,2244,1761,483,200,169,94,20
2021,Lambeth 010C,E01003094,1446,1247,199,92,56,44,7
2021,Lambeth 012E,E01003095,1602,1429,173,98,56,16,3
2021,Lambeth 010D,E01003096,2054,1720,334,154,106,58,16
2021,Lambeth 006A,E01003097,1526,1218,308,131,108,54,15
2021,Lambeth 005A,E01003098,1432,1187,245,118,68,48,11
2021,Lambeth 005B,E01003099,1658,1315,343,157,95,69,22
2021,Lambeth 005C,E01003100,1976,1603,373,221,108,35,9
2021,Lambeth 003A,E01003101,1404,1110,294,132,101,52,9
2021,Lambeth 004A,E01003102,1676,1344,332,190,100,37,5
2021,Lambeth 004C,E01003104,1689,1293,396,201,110,60,25
2021,Lambeth 003B,E01003105,1661,1325,336,157,105,63,11
2021,Lambeth 003C,E01003106,2084,1802,282,174,70,29,9
2021,Lambeth 003D,E01003107,1815,1575,240,128,60,44,8
2021,Lambeth 002B,E01003108,1506,1195,311,147,105,55,4
2021,Lambeth 002C,E01003110,2000,1712,288,184,73,31,0
2021,Lambeth 002D,E01003111,1896,1462,434,171,144,99,20
2021,Lambeth 002E,E01003112,1733,1384,349,178,107,45,19
2021,Lambeth 032A,E01003113,1731,1322,409,160,146,95,8
2021,Lambeth 032B,E01003114,2311,1853,458,236,151,61,10
2021,Lambeth 034A,E01003115,1543,1249,294,133,95,61,5
2021,Lambeth 029A,E01003116,1712,1505,207,101,68,33,5
2021,Lambeth 029B,E01003117,1790,1426,364,161,122,64,17
2021,Lambeth 029C,E01003118,1791,1427,364,165,96,87,16
2021,Lambeth 032C,E01003119,2011,1479,532,183,197,134,18
2021,Lambeth 032D,E01003120,2320,1519,801,267,337,170,27
2021,Lambeth 006B,E01003121,1540,1205,335,143,135,49,8
2021,Lambeth 004D,E01003122,1866,1549,317,180,93,42,2
2021,Lambeth 006C,E01003123,1567,1244,323,153,97,68,5
2021,Lambeth 006D,E01003124,1327,973,354,146,133,62,13
2021,Lambeth 006E,E01003125,1746,1210,536,186,197,103,50
2021,Lambeth 008D,E01003126,1621,1162,459,197,158,94,10
2021,Lambeth 010E,E01003127,2021,1580,441,159,189,81,12
2021,Lambeth 008E,E01003128,1597,1183,414,166,152,83,13
2021,Lambeth 004E,E01003129,1751,1341,410,167,148,87,8
2021,Lambeth 026A,E01003130,1805,1399,406,159,140,88,19
2021,Lambeth 026B,E01003131,2096,1714,382,199,125,49,9
2021,Lambeth 024A,E01003132,1413,1143,270,115,95,48,12
2021,Lambeth 027C,E01003133,1602,1276,326,125,105,85,11
2021,Lambeth 027D,E01003134,1550,1330,220,136,56,26,2
2021,Lambeth 026C,E01003135,1888,1603,285,159,65,46,15
2021,Lambeth 022A,E01003136,1614,1260,354,161,122,54,17
2021,Lambeth 022B,E01003137,1540,1128,412,171,151,78,12
2021,Lambeth 026D,E01003138,1417,1276,141,84,32,23,2
2021,Lambeth 035A,E01003139,1474,984,490,164,186,129,11
2021,Lambeth 035B,E01003140,1458,1093,365,154,109,92,10
2021,Lambeth 034B,E01003141,1748,1343,405,138,147,110,10
2021,Lambeth 035C,E01003142,1335,953,382,165,137,72,8
2021,Lambeth 035D,E01003143,1460,1058,402,140,166,81,15
2021,Lambeth 034C,E01003144,1509,1328,181,79,62,37,3
2021,Lambeth 034D,E01003145,1605,1159,446,178,139,116,13
2021,Lambeth 035E,E01003146,1573,1196,377,149,117,97,14
2021,Lambeth 034E,E01003147,1987,1490,497,166,192,127,12
2021,Lambeth 032E,E01003148,1764,1472,292,143,106,35,8
2021,Lambeth 030D,E01003149,1700,1429,271,134,100,35,2
2021,Lambeth 032F,E01003150,1874,1443,431,157,182,76,16
2021,Lambeth 026E,E01003151,1900,1531,369,158,132,61,18
2021,Lambeth 027E,E01003152,1800,1463,337,162,116,48,11
2021,Lambeth 029D,E01003153,2116,1555,561,264,203,84,10
2021,Lambeth 030E,E01003154,1890,1608,282,120,107,43,12
2021,Lambeth 029E,E01003155,1782,1422,360,165,123,66,6
2021,Lambeth 023B,E01003156,1539,1397,142,76,46,16,4
2021,Lambeth 023C,E01003157,1512,1397,115,68,37,7,3
2021,Lambeth 023D,E01003158,1548,1433,115,82,24,9,0
2021,Lambeth 022C,E01003159,1737,1420,317,174,96,34,13
2021,Lambeth 022D,E01003160,1427,1077,350,168,120,52,10
2021,Lambeth 023E,E01003161,1273,1127,146,78,52,15,1
2021,Lambeth 022E,E01003162,1809,1322,487,159,198,114,16
2021,Lambeth 023F,E01003163,1565,1370,195,115,55,25,0
2021,Lambeth 025A,E01003164,2183,1775,408,154,138,98,18
2021,Lambeth 025B,E01003165,1584,1406,178,74,53,40,11
2021,Lambeth 028D,E01003166,2481,1979,502,180,193,107,22
2021,Lambeth 028E,E01003167,1675,1538,137,94,23,16,4
2021,Lambeth 025C,E01003168,1626,1459,167,61,69,33,4
2021,Lambeth 025D,E01003169,2257,1998,259,144,78,30,7
2021,Lambeth 025E,E01003170,1829,1704,125,71,31,18,5
2021,Lambeth 020B,E01003171,1579,1373,206,107,57,39,3
2021,Lambeth 024B,E01003172,1866,1602,264,108,115,38,3
2021,Lambeth 020C,E01003173,1587,1294,293,126,71,65,31
2021,Lambeth 024C,E01003174,1974,1543,431,189,155,76,11
2021,Lambeth 024D,E01003175,1528,1327,201,77,84,34,6
2021,Lambeth 016E,E01003176,1883,1455,428,211,134,68,15
2021,Lambeth 020D,E01003177,1541,1273,268,123,77,53,15
2021,Lambeth 020E,E01003178,1461,1327,134,66,38,26,4
2021,Lambeth 024E,E01003179,1564,1148,416,147,153,103,13
2021,Lambeth 005D,E01003180,1566,1348,218,98,77,37,6
2021,Lambeth 007A,E01003181,1486,1230,256,114,93,43,6
2021,Lambeth 009D,E01003182,1741,1442,299,115,120,55,9
2021,Lambeth 005E,E01003183,1563,1344,219,91,72,46,10
2021,Lambeth 007B,E01003184,1373,1052,321,123,92,90,16
2021,Lambeth 007C,E01003185,1866,1414,452,135,86,97,134
2021,Lambeth 007D,E01003186,2400,2044,356,224,85,40,7
2021,Lambeth 007E,E01003187,2243,1892,351,167,110,59,15
2021,Lambeth 009E,E01003188,1228,1014,214,83,76,50,5
2021,Lewisham 034A,E01003189,1715,1526,189,101,58,27,3
2021,Lewisham 034B,E01003190,2226,1732,494,185,213,83,13
2021,Lewisham 034C,E01003191,1589,1331,258,126,95,34,3
2021,Lewisham 034D,E01003192,1726,1415,311,121,114,68,8
2021,Lewisham 029A,E01003193,1653,1472,181,88,62,28,3
2021,Lewisham 029B,E01003194,1705,1382,323,126,109,75,13
2021,Lewisham 029C,E01003195,1433,1256,177,80,61,32,4
2021,Lewisham 029D,E01003196,1710,1378,332,164,108,53,7
2021,Lewisham 029E,E01003197,1617,1401,216,96,67,43,10
2021,Lewisham 009A,E01003198,1434,1276,158,111,31,15,1
2021,Lewisham 007A,E01003199,1910,1634,276,149,82,30,15
2021,Lewisham 009B,E01003200,1435,1291,144,90,34,14,6
2021,Lewisham 007B,E01003201,1629,1416,213,104,52,46,11
2021,Lewisham 009C,E01003202,1520,1377,143,101,30,10,2
2021,Lewisham 009D,E01003203,1872,1493,379,185,111,69,14
2021,Lewisham 007C,E01003204,1564,1315,249,119,90,33,7
2021,Lewisham 007D,E01003205,1340,1098,242,122,61,50,9
2021,Lewisham 007E,E01003206,1370,1239,131,86,27,17,1
2021,Lewisham 005A,E01003207,2267,1768,499,227,113,116,43
2021,Lewisham 005B,E01003209,1838,1579,259,127,75,45,12
2021,Lewisham 005C,E01003210,1711,1437,274,130,89,42,13
2021,Lewisham 008B,E01003211,1508,1303,205,117,47,35,6
2021,Lewisham 005D,E01003212,1951,1711,240,129,70,34,7
2021,Lewisham 008C,E01003213,1890,1664,226,147,66,13,0
2021,Lewisham 008D,E01003214,1723,1525,198,107,53,30,8
2021,Lewisham 005E,E01003215,1849,1470,379,167,120,77,15
2021,Lewisham 025A,E01003216,1609,1381,228,85,98,39,6
2021,Lewisham 022A,E01003217,1843,1492,351,123,137,68,23
2021,Lewisham 022B,E01003218,1490,1335,155,74,53,24,4
2021,Lewisham 025B,E01003219,1655,1414,241,88,103,47,3
2021,Lewisham 022C,E01003220,1596,1377,219,94,93,29,3
2021,Lewisham 025C,E01003221,2020,1706,314,114,117,71,12
2021,Lewisham 022D,E01003222,1495,1333,162,77,58,23,4
2021,Lewisham 025D,E01003223,1619,1365,254,112,96,36,10
2021,Lewisham 022E,E01003224,1629,1394,235,111,90,29,5
2021,Lewisham 015A,E01003225,1521,1407,114,70,25,14,5
2021,Lewisham 019A,E01003226,1742,1495,247,112,75,52,8
2021,Lewisham 019B,E01003227,1580,1476,104,46,41,14,3
2021,Lewisham 019C,E01003228,1493,1395,98,63,22,9,4
2021,Lewisham 019D,E01003229,1610,1396,214,95,71,40,8
2021,Lewisham 019E,E01003230,1885,1635,250,131,86,27,6
2021,Lewisham 015B,E01003231,1494,1311,183,95,56,30,2
2021,Lewisham 015C,E01003232,1630,1473,157,82,54,19,2
2021,Lewisham 015D,E01003233,1774,1602,172,82,55,35,0
2021,Lewisham 038A,E01003235,1367,1169,198,86,74,28,10
2021,Lewisham 037A,E01003236,1635,1304,331,132,116,58,25
2021,Lewisham 037B,E01003237,1612,1313,299,113,118,60,8
2021,Lewisham 037C,E01003238,1429,1206,223,77,101,42,3
2021,Lewisham 037D,E01003239,1547,1282,265,100,85,58,22
2021,Lewisham 038B,E01003240,1946,1566,380,134,144,87,15
2021,Lewisham 038C,E01003241,1560,1309,251,95,92,49,15
2021,Lewisham 038D,E01003243,1449,1171,278,111,102,55,10
2021,Lewisham 001A,E01003244,1839,1428,411,184,152,64,11
2021,Lewisham 001B,E01003245,1937,1558,379,148,150,77,4
2021,Lewisham 002A,E01003246,2339,1963,376,210,91,62,13
2021,Lewisham 001C,E01003247,2039,1465,574,336,169,63,6
2021,Lewisham 002B,E01003248,1600,1230,370,170,134,59,7
2021,Lewisham 001D,E01003249,1990,1496,494,268,123,94,9
2021,Lewisham 002C,E01003251,1684,1334,350,104,142,91,13
2021,Lewisham 002D,E01003252,1519,1189,330,109,101,106,14
2021,Lewisham 002E,E01003253,1378,1126,252,102,86,57,7
2021,Lewisham 021A,E01003254,1395,1278,117,77,25,13,2
2021,Lewisham 021B,E01003255,1900,1643,257,136,66,44,11
2021,Lewisham 028A,E01003256,2050,1761,289,142,89,52,6
2021,Lewisham 028B,E01003257,1556,1400,156,81,48,23,4
2021,Lewisham 028C,E01003258,1493,1242,251,114,66,60,11
2021,Lewisham 028D,E01003259,1652,1372,280,141,81,53,5
2021,Lewisham 021C,E01003260,1614,1453,161,87,49,24,1
2021,Lewisham 021D,E01003261,1478,1393,85,50,23,10,2
2021,Lewisham 021E,E01003262,1471,1318,153,84,44,21,4
2021,Lewisham 023A,E01003263,1714,1443,271,119,105,44,3
2021,Lewisham 031A,E01003264,1585,1333,252,124,74,44,10
2021,Lewisham 031B,E01003265,1567,1260,307,116,113,61,17
2021,Lewisham 031C,E01003266,1654,1416,238,93,95,36,14
2021,Lewisham 031D,E01003267,1706,1502,204,73,93,32,6
2021,Lewisham 023B,E01003268,1766,1513,253,116,87,42,8
2021,Lewisham 023C,E01003269,1538,1336,202,94,68,37,3
2021,Lewisham 023D,E01003270,1587,1348,239,130,70,33,6
2021,Lewisham 023E,E01003271,1576,1408,168,88,59,19,2
2021,Lewisham 014A,E01003272,1918,1716,202,115,55,30,2
2021,Lewisham 011A,E01003273,1455,1262,193,89,68,31,5
2021,Lewisham 014B,E01003274,1536,1326,210,89,85,30,6
2021,Lewisham 014C,E01003275,1630,1456,174,78,53,33,10
2021,Lewisham 014D,E01003276,1832,1660,172,85,58,27,2
2021,Lewisham 011B,E01003277,1624,1435,189,115,50,19,5
2021,Lewisham 011C,E01003278,2018,1578,440,232,124,74,10
2021,Lewisham 011D,E01003279,1464,1293,171,88,49,27,7
2021,Lewisham 016A,E01003280,1568,1273,295,114,110,63,8
2021,Lewisham 016B,E01003281,1418,1297,121,63,32,18,8
2021,Lewisham 013A,E01003282,2325,1862,463,238,148,59,18
2021,Lewisham 013B,E01003283,2035,1820,215,116,75,21,3
2021,Lewisham 013C,E01003284,1799,1571,228,122,76,28,2
2021,Lewisham 016C,E01003285,1668,1355,313,170,99,40,4
2021,Lewisham 013D,E01003286,1675,1421,254,103,100,45,6
2021,Lewisham 016D,E01003287,1864,1696,168,108,37,22,1
2021,Lewisham 041A,E01003288,2077,1598,479,222,131,108,18
2021,Lewisham 041E,E01003290,1836,1463,373,153,144,66,10
2021,Lewisham 041D,E01003291,1494,1296,198,78,56,57,7
2021,Lewisham 017A,E01003292,1701,1351,350,141,93,83,33
2021,Lewisham 017B,E01003293,1479,1190,289,101,108,68,12
2021,Lewisham 017D,E01003295,1696,1416,280,134,109,33,4
2021,Lewisham 003A,E01003297,1625,1056,569,218,250,89,12
2021,Lewisham 039A,E01003298,1240,1012,228,91,63,60,14
2021,Lewisham 003B,E01003299,1727,1426,301,94,94,101,12
2021,Lewisham 039B,E01003300,1440,1149,291,109,116,52,14
2021,Lewisham 003C,E01003301,2560,1955,605,302,207,75,21
2021,Lewisham 003D,E01003302,1808,1326,482,164,167,128,23
2021,Lewisham 039C,E01003303,1658,1166,492,185,166,112,29
2021,Lewisham 039D,E01003304,2189,1665,524,255,139,103,27
2021,Lewisham 003E,E01003305,2203,1907,296,139,106,42,9
2021,Lewisham 024A,E01003307,1531,1404,127,64,43,20,0
2021,Lewisham 024B,E01003308,1713,1517,196,101,60,31,4
2021,Lewisham 027A,E01003309,1547,1288,259,123,81,40,15
2021,Lewisham 027B,E01003310,1534,1340,194,106,58,30,0
2021,Lewisham 027C,E01003311,1528,1403,125,63,46,15,1
2021,Lewisham 027D,E01003312,1684,1508,176,82,55,32,7
2021,Lewisham 027E,E01003313,1493,1290,203,75,86,37,5
2021,Lewisham 024C,E01003314,1537,1381,156,101,37,16,2
2021,Lewisham 024D,E01003315,1254,1117,137,77,35,24,1
2021,Lewisham 024E,E01003316,1403,1284,119,70,30,17,2
2021,Lewisham 020B,E01003318,1996,1507,489,197,204,75,13
2021,Lewisham 018A,E01003319,1732,1341,391,143,158,77,13
2021,Lewisham 018B,E01003320,1529,1246,283,126,111,38,8
2021,Lewisham 020C,E01003321,1670,1445,225,84,86,44,11
2021,Lewisham 020D,E01003322,1555,1230,325,130,121,63,11
2021,Lewisham 018C,E01003323,1442,1171,271,110,122,36,3
2021,Lewisham 020E,E01003324,1603,1157,446,155,151,108,32
2021,Lewisham 018D,E01003325,1711,1424,287,123,122,35,7
2021,Lewisham 035A,E01003326,1707,1510,197,75,69,47,6
2021,Lewisham 035B,E01003327,1571,1392,179,88,64,24,3
2021,Lewisham 035C,E01003328,1710,1500,210,122,60,25,3
2021,Lewisham 033A,E01003329,1571,1408,163,97,46,19,1
2021,Lewisham 033B,E01003330,1538,1376,162,79,54,27,2
2021,Lewisham 033C,E01003331,1474,1280,194,93,63,34,4
2021,Lewisham 033D,E01003332,1529,1327,202,84,66,43,9
2021,Lewisham 035D,E01003333,1452,1290,162,76,50,28,8
2021,Lewisham 033E,E01003334,1720,1396,324,171,102,41,10
2021,Lewisham 035E,E01003335,1464,1314,150,55,60,29,6
2021,Lewisham 010A,E01003336,1479,1233,246,83,97,55,11
2021,Lewisham 010B,E01003337,1385,1205,180,81,51,44,4
2021,Lewisham 006A,E01003338,1973,1518,455,164,141,125,25
2021,Lewisham 006B,E01003339,1649,1389,260,99,104,51,6
2021,Lewisham 006C,E01003340,2020,1650,370,177,82,101,10
2021,Lewisham 006D,E01003341,1354,1259,95,48,30,16,1
2021,Lewisham 010C,E01003342,1587,1336,251,128,75,37,11
2021,Lewisham 006E,E01003343,1401,1254,147,75,41,24,7
2021,Lewisham 010D,E01003344,1631,1466,165,88,43,31,3
2021,Lewisham 010E,E01003345,1893,1635,258,140,76,35,7
2021,Lewisham 026A,E01003346,1620,1432,188,70,71,44,3
2021,Lewisham 030A,E01003347,1672,1434,238,82,92,55,9
2021,Lewisham 030B,E01003348,1737,1421,316,127,126,50,13
2021,Lewisham 026B,E01003349,1473,1233,240,96,90,49,5
2021,Lewisham 030C,E01003350,1286,1104,182,65,81,33,3
2021,Lewisham 026C,E01003351,1609,1388,221,95,85,34,7
2021,Lewisham 030D,E01003352,2191,1827,364,133,161,64,6
2021,Lewisham 030E,E01003353,1739,1434,305,139,108,43,15
2021,Lewisham 026D,E01003354,1932,1580,352,155,121,66,10
2021,Merton 009A,E01003355,1690,1320,370,211,117,37,5
2021,Merton 009B,E01003356,1751,1458,293,169,82,38,4
2021,Merton 012A,E01003357,1791,1345,446,176,197,72,1
2021,Merton 009C,E01003358,1712,1363,349,223,109,17,0
2021,Merton 006A,E01003359,1663,1352,311,160,103,43,5
2021,Merton 006B,E01003360,1690,1398,292,195,65,30,2
2021,Merton 015A,E01003361,1611,1299,312,141,118,46,7
2021,Merton 021A,E01003362,1329,1176,153,87,45,19,2
2021,Merton 021B,E01003363,1635,1393,242,130,83,24,5
2021,Merton 021C,E01003364,1763,1512,251,137,75,33,6
2021,Merton 021D,E01003365,1447,1214,233,104,93,31,5
2021,Merton 016A,E01003366,1671,1273,398,203,124,64,7
2021,Merton 008A,E01003368,1601,1152,449,191,175,77,6
2021,Merton 005B,E01003369,1564,1212,352,164,133,45,10
2021,Merton 005C,E01003370,1907,1425,482,213,177,77,15
2021,Merton 005D,E01003371,1499,1234,265,136,77,48,4
2021,Merton 008B,E01003372,1638,1231,407,165,159,74,9
2021,Merton 018A,E01003373,1474,1152,322,114,139,62,7
2021,Merton 022A,E01003374,1724,1289,435,198,142,73,22
2021,Merton 022B,E01003375,1720,1357,363,150,151,55,7
2021,Merton 012B,E01003376,1511,1127,384,145,165,73,1
2021,Merton 012C,E01003377,1580,1198,382,140,145,86,11
2021,Merton 018B,E01003378,2123,1559,564,215,239,100,10
2021,Merton 018C,E01003379,1944,1330,614,235,232,128,19
2021,Merton 011A,E01003380,1671,1389,282,170,87,22,3
2021,Merton 016B,E01003381,1468,1239,229,133,66,28,2
2021,Merton 011B,E01003382,1696,1468,228,144,54,28,2
2021,Merton 009D,E01003383,1561,1254,307,201,84,20,2
2021,Merton 009E,E01003384,1605,1314,291,187,82,21,1
2021,Merton 011C,E01003385,1568,1340,228,143,57,23,5
2021,Merton 013A,E01003386,2174,1351,823,296,365,150,12
2021,Merton 014A,E01003387,2009,1556,453,174,201,67,11
2021,Merton 013B,E01003388,1680,1256,424,162,179,74,9
2021,Merton 013C,E01003389,1732,1180,552,193,233,102,24
2021,Merton 018D,E01003390,1712,1172,540,192,233,107,8
2021,Merton 014B,E01003391,1267,1011,256,96,109,49,2
2021,Merton 013D,E01003392,1365,923,442,186,172,72,12
2021,Merton 008C,E01003393,1545,1021,524,202,207,102,13
2021,Merton 007A,E01003394,1983,1214,769,269,326,147,27
2021,Merton 007B,E01003395,1584,1142,442,145,185,108,4
2021,Merton 007C,E01003396,1440,1078,362,144,143,69,6
2021,Merton 007D,E01003397,1466,1090,376,138,165,67,6
2021,Merton 007E,E01003398,1836,1326,510,161,219,119,11
2021,Merton 011D,E01003399,1360,1099,261,164,74,21,2
2021,Merton 003A,E01003400,1406,1144,262,169,61,26,6
2021,Merton 004A,E01003401,1359,1065,294,198,72,22,2
2021,Merton 004B,E01003402,1441,1133,308,176,89,39,4
2021,Merton 004C,E01003403,1444,1259,185,130,36,18,1
2021,Merton 004D,E01003404,1772,1427,345,228,85,28,4
2021,Merton 018E,E01003405,2332,1658,674,304,260,96,14
2021,Merton 008D,E01003406,1642,1237,405,171,143,81,10
2021,Merton 008E,E01003407,1871,1191,680,298,253,108,21
2021,Merton 012D,E01003408,1867,1320,547,273,192,78,4
2021,Merton 013E,E01003409,1741,1196,545,199,239,100,7
2021,Merton 012E,E01003410,1578,1116,462,202,168,83,9
2021,Merton 014C,E01003411,1916,1404,512,222,190,89,11
2021,Merton 014D,E01003412,1684,1258,426,179,168,72,7
2021,Merton 017A,E01003413,2002,1400,602,233,211,126,32
2021,Merton 017B,E01003414,1673,1237,436,178,179,66,13
2021,Merton 017C,E01003415,2298,1640,658,279,247,117,15
2021,Merton 017D,E01003416,1542,1124,418,143,205,55,15
2021,Merton 025A,E01003417,1524,1355,169,77,65,23,4
2021,Merton 025B,E01003418,1404,1292,112,54,38,20,0
2021,Merton 025C,E01003419,1743,1448,295,147,122,18,8
2021,Merton 025D,E01003420,1430,1210,220,108,76,28,8
2021,Merton 021E,E01003421,1537,1253,284,127,110,37,10
2021,Merton 025E,E01003422,1420,1230,190,75,77,36,2
2021,Merton 011E,E01003423,1582,1285,297,181,76,37,3
2021,Merton 015B,E01003424,1505,1359,146,91,35,18,2
2021,Merton 015C,E01003425,1453,1288,165,106,44,10,5
2021,Merton 015D,E01003426,1716,1333,383,190,130,54,9
2021,Merton 023A,E01003427,1891,1214,677,270,247,143,17
2021,Merton 015E,E01003428,1463,1262,201,112,63,20,6
2021,Merton 019A,E01003429,1575,1233,342,146,128,58,10
2021,Merton 019B,E01003430,1598,1272,326,143,121,57,5
2021,Merton 019C,E01003431,1644,1352,292,125,96,62,9
2021,Merton 019D,E01003432,1653,1371,282,110,123,45,4
2021,Merton 019E,E01003433,1541,1188,353,148,146,52,7
2021,Merton 017E,E01003434,1510,1128,382,150,156,65,11
2021,Merton 014E,E01003435,2034,1611,423,196,168,51,8
2021,Merton 023B,E01003436,1674,1292,382,166,144,58,14
2021,Merton 022C,E01003437,1970,1470,500,239,177,75,9
2021,Merton 024A,E01003438,1763,1323,440,214,167,48,11
2021,Merton 023C,E01003439,1532,1019,513,209,169,120,15
2021,Merton 022D,E01003440,1600,1194,406,171,160,57,18
2021,Merton 022E,E01003441,1821,1406,415,162,157,84,12
2021,Merton 010A,E01003442,1652,1453,199,127,54,18,0
2021,Merton 010B,E01003443,1561,1397,164,121,27,15,1
2021,Merton 010C,E01003444,1560,1323,237,146,53,33,5
2021,Merton 010D,E01003445,1758,1515,243,137,77,21,8
2021,Merton 016C,E01003446,1898,1522,376,219,101,50,6
2021,Merton 016D,E01003447,1547,1195,352,166,118,60,8
2021,Merton 023D,E01003448,2211,1624,587,273,217,80,17
2021,Merton 024B,E01003449,1800,1255,545,218,223,89,15
2021,Merton 024C,E01003450,1739,1348,391,161,150,67,13
2021,Merton 024D,E01003451,1875,1540,335,146,127,53,9
2021,Merton 024E,E01003452,2142,1619,523,237,207,65,14
2021,Merton 023E,E01003453,1766,1243,523,200,209,98,16
2021,Merton 003B,E01003454,1315,1125,190,114,54,19,3
2021,Merton 005E,E01003455,1596,1268,328,173,112,37,6
2021,Merton 003C,E01003456,1542,1231,311,181,99,28,3
2021,Merton 006C,E01003457,1543,1325,218,157,47,11,3
2021,Merton 006D,E01003458,1666,1406,260,168,65,24,3
2021,Merton 006E,E01003459,2077,1720,357,200,104,47,6
2021,Merton 002A,E01003460,1378,1253,125,85,33,6,1
2021,Merton 004E,E01003461,1413,1277,136,90,39,6,1
2021,Merton 002B,E01003462,1380,1229,151,88,32,27,4
2021,Merton 010E,E01003463,1468,1262,206,108,73,24,1
2021,Merton 002C,E01003464,1360,1178,182,110,51,20,1
2021,Merton 002D,E01003465,1286,1131,155,82,50,22,1
2021,Merton 020A,E01003466,1643,1403,240,119,76,41,4
2021,Merton 020B,E01003467,1694,1488,206,143,39,23,1
2021,Merton 020C,E01003468,1681,1475,206,108,66,25,7
2021,Merton 020D,E01003469,1590,1074,516,189,229,82,16
2021,Merton 020E,E01003470,1935,1433,502,226,192,77,7
2021,Merton 016E,E01003471,1654,1378,276,156,77,41,2
2021,Merton 001A,E01003472,1265,1149,116,86,19,10,1
2021,Merton 001B,E01003473,1417,1202,215,144,61,10,0
2021,Merton 001C,E01003474,1320,1188,132,90,30,9,3
2021,Merton 003D,E01003476,1296,1088,208,129,60,18,1
2021,Merton 003E,E01003477,1533,1326,207,122,60,22,3
2021,Merton 001E,E01003478,1806,1538,268,165,82,18,3
2021,Newham 035A,E01003479,1486,930,556,207,233,106,10
2021,Newham 033A,E01003480,1961,1369,592,233,230,111,18
2021,Newham 035B,E01003481,1433,955,478,207,190,69,12
2021,Newham 032A,E01003483,1607,1148,459,142,184,116,17
2021,Newham 032B,E01003484,1721,920,801,278,356,153,14
2021,Newham 035C,E01003485,1643,994,649,243,260,134,12
2021,Newham 033C,E01003486,1169,957,212,69,80,51,12
2021,Newham 033D,E01003487,1305,991,314,103,122,72,17
2021,Newham 019A,E01003488,1892,1353,539,188,205,129,17
2021,Newham 019B,E01003489,2858,1898,960,340,379,211,30
2021,Newham 019C,E01003490,1924,1166,758,224,327,183,24
2021,Newham 022A,E01003491,1881,1017,864,287,343,190,44
2021,Newham 025A,E01003492,1960,1242,718,251,285,160,22
2021,Newham 025C,E01003494,2023,1326,697,248,307,133,9
2021,Newham 025D,E01003495,1993,1402,591,235,232,111,13
2021,Newham 027A,E01003496,1289,881,408,158,162,73,15
2021,Newham 034A,E01003497,1598,1181,417,149,163,90,15
2021,Newham 027B,E01003498,1780,1267,513,210,202,88,13
2021,Newham 030A,E01003499,2292,1636,656,235,259,143,19
2021,Newham 027C,E01003500,1990,1445,545,202,219,102,22
2021,Newham 030B,E01003501,2283,1573,710,221,286,168,35
2021,Newham 030C,E01003502,2558,1698,860,330,344,166,20
2021,Newham 030D,E01003503,2803,1929,874,456,279,132,7
2021,Newham 034D,E01003506,1386,991,395,154,144,82,15
2021,Newham 031A,E01003507,2179,1401,778,285,311,147,35
2021,Newham 031B,E01003508,2431,1670,761,322,265,157,17
2021,Newham 031C,E01003509,1955,1374,581,172,267,125,17
2021,Newham 036A,E01003511,1835,1342,493,230,173,81,9
2021,Newham 036B,E01003512,1915,1310,605,213,258,120,14
2021,Newham 035D,E01003513,1514,914,600,210,254,117,19
2021,Newham 036C,E01003514,1601,1195,406,151,181,63,11
2021,Newham 036D,E01003515,2031,1404,627,247,241,126,13
2021,Newham 032C,E01003516,1825,1358,467,149,198,102,18
2021,Newham 036E,E01003517,1822,1402,420,147,171,83,19
2021,Newham 032D,E01003518,1567,1047,520,198,214,93,15
2021,Newham 032E,E01003519,1560,943,617,167,300,133,17
2021,Newham 018A,E01003520,1905,1005,900,317,352,198,33
2021,Newham 018B,E01003521,2080,991,1089,397,403,267,22
2021,Newham 018C,E01003522,1778,980,798,279,308,188,23
2021,Newham 024A,E01003523,2345,1347,998,333,414,213,38
2021,Newham 019D,E01003524,1857,1050,807,208,345,226,28
2021,Newham 018D,E01003525,2007,1231,776,233,336,182,25
2021,Newham 018E,E01003526,1784,1179,605,199,248,144,14
2021,Newham 024B,E01003527,1760,1226,534,201,201,118,14
2021,Newham 005A,E01003528,1307,832,475,172,180,109,14
2021,Newham 010A,E01003529,2309,1278,1031,304,417,270,40
2021,Newham 010B,E01003530,1828,966,862,287,361,189,25
2021,Newham 010C,E01003531,2124,1283,841,294,335,182,30
2021,Newham 010D,E01003532,2202,1182,1020,372,399,222,27
2021,Newham 011A,E01003533,2221,1419,802,322,288,172,20
2021,Newham 010E,E01003534,2236,1342,894,288,335,237,34
2021,Newham 023A,E01003535,1792,1328,464,145,205,100,14
2021,Newham 023B,E01003536,2028,1298,730,281,286,144,19
2021,Newham 024C,E01003537,2071,1322,749,269,296,161,23
2021,Newham 029A,E01003538,2054,1300,754,258,299,175,22
2021,Newham 029B,E01003539,2423,1500,923,320,371,202,30
2021,Newham 029C,E01003540,1923,1360,563,190,269,91,13
2021,Newham 029D,E01003541,1954,1367,587,214,251,105,17
2021,Newham 024D,E01003542,2171,1580,591,189,249,132,21
2021,Newham 001A,E01003543,2234,1603,631,253,244,110,24
2021,Newham 001B,E01003544,1733,1194,539,215,200,108,16
2021,Newham 006A,E01003545,1693,1167,526,204,204,98,20
2021,Newham 001C,E01003546,1690,1182,508,151,220,122,15
2021,Newham 007A,E01003547,1883,1393,490,131,212,116,31
2021,Newham 006B,E01003548,2173,1435,738,269,296,157,16
2021,Newham 006C,E01003549,2035,1365,670,243,278,131,18
2021,Newham 001D,E01003550,1690,1196,494,122,178,177,17
2021,Newham 009A,E01003551,1764,1032,732,256,257,175,44
2021,Newham 016A,E01003552,1537,1005,532,166,208,139,19
2021,Newham 009B,E01003553,1946,1299,647,219,280,131,17
2021,Newham 009C,E01003554,1837,1147,690,267,279,125,19
2021,Newham 007B,E01003555,1798,1351,447,140,173,106,28
2021,Newham 008A,E01003556,1890,1232,658,226,224,184,24
2021,Newham 006D,E01003557,1862,1248,614,213,243,128,30
2021,Newham 008B,E01003558,1632,995,637,182,256,169,30
2021,Newham 009D,E01003559,2312,1509,803,325,319,144,15
2021,Newham 011B,E01003560,1610,973,637,230,230,147,30
2021,Newham 007C,E01003561,1636,935,701,219,284,173,25
2021,Newham 014A,E01003562,2000,1026,974,341,390,204,39
2021,Newham 011C,E01003563,2387,1374,1013,296,485,201,31
2021,Newham 014B,E01003564,2291,1311,980,369,373,218,20
2021,Newham 014C,E01003565,1987,1121,866,300,355,192,19
2021,Newham 014D,E01003566,1877,981,896,274,376,220,26
2021,Newham 007D,E01003567,1828,1054,774,234,334,181,25
2021,Newham 017A,E01003568,2480,1392,1088,398,451,190,49
2021,Newham 017B,E01003569,2249,1078,1171,394,474,265,38
2021,Newham 008C,E01003570,1821,1124,697,183,316,167,31
2021,Newham 008D,E01003571,2170,1296,874,279,356,215,24
2021,Newham 008E,E01003572,1602,1058,544,182,214,126,22
2021,Newham 017C,E01003573,2167,1194,973,353,364,215,41
2021,Newham 017D,E01003574,2430,1534,896,319,350,188,39
2021,Newham 005B,E01003575,1596,1044,552,167,238,128,19
2021,Newham 002A,E01003576,1705,1120,585,197,223,140,25
2021,Newham 005C,E01003577,2258,1564,694,265,252,154,23
2021,Newham 003A,E01003578,1901,1052,849,258,361,199,31
2021,Newham 004A,E01003579,1891,1152,739,214,301,197,27
2021,Newham 005D,E01003580,1936,1281,655,208,286,136,25
2021,Newham 002B,E01003581,1736,1068,668,188,291,165,24
2021,Newham 002C,E01003582,1525,1019,506,151,217,124,14
2021,Newham 002D,E01003583,1995,1165,830,262,360,168,40
2021,Newham 003B,E01003584,1838,1374,464,177,160,110,17
2021,Newham 004B,E01003585,1574,964,610,179,255,147,29
2021,Newham 003C,E01003586,1764,1085,679,198,279,176,26
2021,Newham 004C,E01003587,2371,1450,921,271,361,244,45
2021,Newham 011D,E01003588,1501,873,628,204,264,132,28
2021,Newham 011E,E01003589,1782,1039,743,223,338,159,23
2021,Newham 003D,E01003590,1520,1117,403,149,166,72,16
2021,Newham 004D,E01003591,2157,1256,901,277,374,211,39
2021,Newham 022B,E01003592,1817,1258,559,166,249,131,13
2021,Newham 027D,E01003593,1457,1026,431,154,182,87,8
2021,Newham 026A,E01003594,1760,1158,602,204,263,117,18
2021,Newham 026B,E01003595,1735,1131,604,228,228,124,24
2021,Newham 016B,E01003596,1641,1083,558,185,236,119,18
2021,Newham 016C,E01003597,2043,1445,598,151,246,179,22
2021,Newham 021A,E01003598,1812,1256,556,209,217,111,19
2021,Newham 022C,E01003599,1584,1043,541,181,212,129,19
2021,Newham 021B,E01003600,1585,1064,521,193,192,116,20
2021,Newham 028A,E01003601,2126,1540,586,203,248,128,7
2021,Newham 026C,E01003602,2102,1320,782,222,343,182,35
2021,Newham 028B,E01003603,1855,1246,609,226,246,125,12
2021,Newham 031D,E01003604,2219,1458,761,306,289,150,16
2021,Newham 028C,E01003605,1993,1311,682,197,288,176,21
2021,Newham 026D,E01003607,1790,1118,672,258,278,114,22
2021,Newham 028D,E01003608,1947,1255,692,227,269,180,16
2021,Newham 041C,E01003611,1886,1434,452,159,187,98,8
2021,Newham 039A,E01003615,1633,1057,576,205,217,132,22
2021,Newham 012A,E01003616,1790,1149,641,251,239,139,12
2021,Newham 012C,E01003618,2194,1337,857,294,371,147,45
2021,Newham 012D,E01003619,2347,1633,714,292,293,113,16
2021,Newham 023C,E01003621,1592,828,764,277,301,166,20
2021,Newham 023D,E01003622,1748,1055,693,226,308,142,17
2021,Newham 023E,E01003623,1698,1087,611,210,236,142,23
2021,Newham 024E,E01003624,1632,1071,561,201,228,118,14
2021,Newham 015A,E01003625,1605,893,712,257,297,144,14
2021,Newham 015B,E01003626,1638,743,895,339,384,155,17
2021,Newham 015C,E01003627,1476,761,715,294,247,160,14
2021,Newham 015D,E01003628,1639,837,802,237,329,183,53
2021,Newham 015E,E01003629,1859,913,946,265,383,248,50
2021,Newham 021C,E01003630,1821,1250,571,194,233,129,15
2021,Newham 020A,E01003631,1819,1248,571,230,223,106,12
2021,Newham 020B,E01003632,2356,1521,835,319,345,153,18
2021,Newham 020C,E01003633,1784,1308,476,169,207,89,11
2021,Newham 020D,E01003634,1695,1187,508,188,201,105,14
2021,Newham 016D,E01003635,1761,1082,679,217,309,139,14
2021,Newham 020E,E01003636,2080,1451,629,204,247,159,19
2021,Newham 021D,E01003637,1813,1058,755,218,322,204,11
2021,Redbridge 017A,E01003638,1848,1376,472,218,161,85,8
2021,Redbridge 013A,E01003639,2177,1411,766,353,281,107,25
2021,Redbridge 013B,E01003640,1882,1399,483,240,175,61,7
2021,Redbridge 013C,E01003641,1955,1386,569,265,199,97,8
2021,Redbridge 013D,E01003642,1715,1180,535,218,225,74,18
2021,Redbridge 017B,E01003643,2177,1477,700,313,261,109,17
2021,Redbridge 017C,E01003644,1617,1156,461,213,167,73,8
2021,Redbridge 017D,E01003645,2655,1657,998,481,372,132,13
2021,Redbridge 012A,E01003646,1861,1229,632,285,247,85,15
2021,Redbridge 015A,E01003647,1885,1237,648,279,272,89,8
2021,Redbridge 012B,E01003648,1467,1168,299,141,110,47,1
2021,Redbridge 012C,E01003649,1625,1203,422,184,166,59,13
2021,Redbridge 015B,E01003650,1726,1263,463,213,176,67,7
2021,Redbridge 012D,E01003651,1466,1117,349,180,128,37,4
2021,Redbridge 015C,E01003652,1567,1158,409,181,166,52,10
2021,Redbridge 015D,E01003653,2031,1197,834,320,325,163,26
2021,Redbridge 004A,E01003654,1633,1330,303,150,95,52,6
2021,Redbridge 004B,E01003655,1505,1278,227,107,80,35,5
2021,Redbridge 005A,E01003656,1510,1295,215,75,107,29,4
2021,Redbridge 005B,E01003657,2107,1815,292,133,106,47,6
2021,Redbridge 004C,E01003658,1670,1324,346,140,135,64,7
2021,Redbridge 005C,E01003659,1673,1421,252,115,97,38,2
2021,Redbridge 004D,E01003660,1698,1522,176,92,65,14,5
2021,Redbridge 038A,E01003661,2145,1611,534,241,176,95,22
2021,Redbridge 038C,E01003662,2038,1410,628,245,269,101,13
2021,Redbridge 037A,E01003663,1914,1551,363,166,129,55,13
2021,Redbridge 037B,E01003664,1839,1544,295,120,111,54,10
2021,Redbridge 037E,E01003665,1666,1282,384,182,147,50,5
2021,Redbridge 038B,E01003666,2708,1979,729,337,252,122,18
2021,Redbridge 007A,E01003668,1665,1396,269,119,99,41,10
2021,Redbridge 007B,E01003669,1491,1347,144,94,33,15,2
2021,Redbridge 007C,E01003670,1489,1322,167,104,46,16,1
2021,Redbridge 007D,E01003671,1509,1421,88,48,30,10,0
2021,Redbridge 007E,E01003672,1618,1310,308,153,106,37,12
2021,Redbridge 007F,E01003673,1830,1602,228,115,72,37,4
2021,Redbridge 007G,E01003674,2296,1833,463,234,157,60,12
2021,Redbridge 036A,E01003675,1655,1097,558,243,202,92,21
2021,Redbridge 036B,E01003676,1875,1331,544,232,204,96,12
2021,Redbridge 036C,E01003677,1763,1340,423,201,143,72,7
2021,Redbridge 036D,E01003678,1608,1214,394,183,155,45,11
2021,Redbridge 036E,E01003679,1717,1328,389,184,131,63,11
2021,Redbridge 036F,E01003680,1623,1203,420,207,145,63,5
2021,Redbridge 036G,E01003681,1967,1444,523,199,214,93,17
2021,Redbridge 036H,E01003682,1818,1296,522,231,219,58,14
2021,Redbridge 040C,E01003683,2076,1302,774,251,333,175,15
2021,Redbridge 040E,E01003684,1803,1185,618,241,255,98,24
2021,Redbridge 040D,E01003685,1836,1076,760,250,357,134,19
2021,Redbridge 040A,E01003686,1908,1185,723,273,272,158,20
2021,Redbridge 040B,E01003688,1737,1148,589,213,206,148,22
2021,Redbridge 039C,E01003689,2143,1255,888,363,301,189,35
2021,Redbridge 035A,E01003690,2061,1393,668,298,240,113,17
2021,Redbridge 035B,E01003691,1550,1190,360,159,119,73,9
2021,Redbridge 035C,E01003692,1583,1184,399,138,169,82,10
2021,Redbridge 035D,E01003693,1634,1240,394,167,154,60,13
2021,Redbridge 035E,E01003694,1433,1056,377,165,129,72,11
2021,Redbridge 035F,E01003695,1456,961,495,192,188,102,13
2021,Redbridge 035G,E01003696,1738,1251,487,146,212,115,14
2021,Redbridge 035H,E01003697,1674,1210,464,203,183,68,10
2021,Redbridge 006A,E01003698,1462,1195,267,113,106,46,2
2021,Redbridge 006B,E01003699,1485,1091,394,156,163,70,5
2021,Redbridge 006C,E01003700,2429,1849,580,205,252,109,14
2021,Redbridge 006D,E01003701,1970,1311,659,273,255,115,16
2021,Redbridge 006E,E01003702,2140,1488,652,278,261,105,8
2021,Redbridge 006F,E01003703,2566,2180,386,172,143,62,9
2021,Redbridge 006G,E01003704,1945,1373,572,202,264,99,7
2021,Redbridge 010A,E01003705,2326,1696,630,233,271,110,16
2021,Redbridge 010B,E01003706,1641,1247,394,171,146,71,6
2021,Redbridge 008A,E01003707,1485,1203,282,110,113,56,3
2021,Redbridge 008B,E01003708,1988,1529,459,199,169,76,15
2021,Redbridge 008C,E01003709,1709,1353,356,160,127,62,7
2021,Redbridge 008D,E01003710,1473,1177,296,145,104,38,9
2021,Redbridge 010C,E01003711,1849,1409,440,197,172,64,7
2021,Redbridge 010D,E01003712,1443,1130,313,105,131,63,14
2021,Redbridge 034A,E01003713,1822,1179,643,233,245,140,25
2021,Redbridge 034B,E01003714,2285,1377,908,300,408,174,26
2021,Redbridge 034C,E01003715,2119,1425,694,261,264,159,10
2021,Redbridge 034D,E01003716,1756,1271,485,204,186,79,16
2021,Redbridge 034E,E01003718,1887,1183,704,291,257,139,17
2021,Redbridge 034F,E01003719,2282,1524,758,308,293,135,22
2021,Redbridge 002A,E01003720,1864,1411,453,144,177,118,14
2021,Redbridge 003A,E01003721,1810,1298,512,168,222,106,16
2021,Redbridge 002B,E01003722,2296,1758,538,222,215,90,11
2021,Redbridge 002C,E01003723,1844,1485,359,177,130,46,6
2021,Redbridge 003B,E01003724,1421,1135,286,127,98,56,5
2021,Redbridge 003C,E01003725,1652,1319,333,135,116,70,12
2021,Redbridge 002D,E01003726,2386,1963,423,183,182,50,8
2021,Redbridge 003D,E01003727,1730,1381,349,134,134,68,13
2021,Redbridge 032B,E01003729,1703,951,752,287,296,145,24
2021,Redbridge 032C,E01003730,1777,1111,666,220,272,153,21
2021,Redbridge 033A,E01003731,1365,906,459,198,163,82,16
2021,Redbridge 032D,E01003732,1713,1173,540,183,228,112,17
2021,Redbridge 032E,E01003733,1752,1118,634,215,279,123,17
2021,Redbridge 033B,E01003734,1746,1082,664,199,293,149,23
2021,Redbridge 033C,E01003735,2012,1362,650,229,239,146,36
2021,Redbridge 033D,E01003736,1914,1137,777,249,349,160,19
2021,Redbridge 031A,E01003737,2850,2150,700,332,223,116,29
2021,Redbridge 031B,E01003738,2287,1735,552,230,217,100,5
2021,Redbridge 031C,E01003739,2311,1687,624,277,219,90,38
2021,Redbridge 031D,E01003740,2155,1526,629,270,230,117,12
2021,Redbridge 031E,E01003741,1925,1486,439,174,173,79,13
2021,Redbridge 031F,E01003742,2284,1426,858,291,392,152,23
2021,Redbridge 031G,E01003743,1830,1240,590,184,261,131,14
2021,Redbridge 001A,E01003744,1421,1297,124,76,26,18,4
2021,Redbridge 001B,E01003745,1380,1266,114,57,35,22,0
2021,Redbridge 001C,E01003746,1571,1417,154,90,41,23,0
2021,Redbridge 001D,E01003747,1324,1237,87,57,20,10,0
2021,Redbridge 001E,E01003748,1603,1423,180,91,50,26,13
2021,Redbridge 001F,E01003749,1713,1392,321,146,126,45,4
2021,Redbridge 001G,E01003750,1841,1585,256,140,76,31,9
2021,Redbridge 020A,E01003751,2188,1413,775,330,310,116,19
2021,Redbridge 023A,E01003752,2659,1911,748,389,216,132,11
2021,Redbridge 020B,E01003753,1909,1184,725,330,287,91,17
2021,Redbridge 020C,E01003754,1673,1123,550,237,193,104,16
2021,Redbridge 023B,E01003755,2314,1434,880,401,337,119,23
2021,Redbridge 023C,E01003756,2370,1658,712,303,272,120,17
2021,Redbridge 020D,E01003757,2057,1384,673,245,276,130,22
2021,Redbridge 009A,E01003759,1533,1394,139,83,44,10,2
2021,Redbridge 009B,E01003760,1825,1447,378,165,144,62,7
2021,Redbridge 009C,E01003761,1743,1281,462,163,197,91,11
2021,Redbridge 009D,E01003762,1667,1469,198,105,67,23,3
2021,Redbridge 009E,E01003763,1943,1566,377,157,146,65,9
2021,Redbridge 009F,E01003764,2017,1651,366,190,124,46,6
2021,Redbridge 009G,E01003765,1828,1537,291,128,104,52,7
2021,Redbridge 024A,E01003766,2057,1258,799,331,304,137,27
2021,Redbridge 024B,E01003767,2074,1235,839,288,346,191,14
2021,Redbridge 024C,E01003768,1814,1088,726,280,273,150,23
2021,Redbridge 022A,E01003769,1785,1041,744,263,310,159,12
2021,Redbridge 022B,E01003770,2797,1968,829,346,312,151,20
2021,Redbridge 022C,E01003771,1739,1149,590,224,240,101,25
2021,Redbridge 024D,E01003772,1751,1220,531,211,214,89,17
2021,Redbridge 022D,E01003773,1761,1327,434,188,153,79,14
2021,Redbridge 014A,E01003774,1840,1648,192,112,55,24,1
2021,Redbridge 014B,E01003775,1613,1344,269,140,88,34,7
2021,Redbridge 014C,E01003776,1693,1433,260,120,99,37,4
2021,Redbridge 014D,E01003777,1761,1541,220,132,66,22,0
2021,Redbridge 014E,E01003778,1851,1541,310,180,106,22,2
2021,Redbridge 014F,E01003779,1586,1384,202,99,73,29,1
2021,Redbridge 014G,E01003780,1528,1339,189,120,37,29,3
2021,Redbridge 026A,E01003781,1943,1268,675,289,250,113,23
2021,Redbridge 026B,E01003782,1659,1070,589,204,239,127,19
2021,Redbridge 029A,E01003783,2384,1408,976,361,406,182,27
2021,Redbridge 029B,E01003784,1925,1274,651,245,257,128,21
2021,Redbridge 029C,E01003785,1928,1090,838,322,331,157,28
2021,Redbridge 026C,E01003786,1576,1175,401,157,155,80,9
2021,Redbridge 026D,E01003787,1580,1135,445,171,172,88,14
2021,Redbridge 029D,E01003788,1719,1070,649,236,259,136,18
2021,Redbridge 018A,E01003789,1366,1223,143,76,45,18,4
2021,Redbridge 027A,E01003790,1445,1258,187,82,61,40,4
2021,Redbridge 027B,E01003791,1446,1324,122,47,52,20,3
2021,Redbridge 027C,E01003792,1368,1233,135,83,34,17,1
2021,Redbridge 027D,E01003793,1507,1266,241,107,91,39,4
2021,Redbridge 018B,E01003794,1494,1358,136,66,49,19,2
2021,Redbridge 018C,E01003795,1187,1091,96,60,22,13,1
2021,Redbridge 018D,E01003796,1537,1352,185,92,56,33,4
2021,Richmond upon Thames 001A,E01003797,1403,1276,127,99,22,5,1
2021,Richmond upon Thames 001B,E01003798,1362,1250,112,83,19,6,4
2021,Richmond upon Thames 001C,E01003799,1527,1387,140,107,28,5,0
2021,Richmond upon Thames 001D,E01003800,1470,1300,170,105,45,19,1
2021,Richmond upon Thames 001E,E01003801,1243,1059,184,142,35,6,1
2021,Richmond upon Thames 001F,E01003802,1336,1125,211,152,45,12,2
2021,Richmond upon Thames 001G,E01003803,1512,1290,222,136,61,25,0
2021,Richmond upon Thames 005A,E01003804,1835,1575,260,170,68,19,3
2021,Richmond upon Thames 012A,E01003805,1672,1567,105,76,22,6,1
2021,Richmond upon Thames 012B,E01003806,1432,1322,110,81,16,9,4
2021,Richmond upon Thames 005B,E01003807,1889,1582,307,183,79,37,8
2021,Richmond upon Thames 005C,E01003808,1782,1637,145,84,41,20,0
2021,Richmond upon Thames 005D,E01003809,1668,1538,130,79,29,19,3
2021,Richmond upon Thames 019A,E01003810,1580,1508,72,49,19,3,1
2021,Richmond upon Thames 018A,E01003811,1756,1654,102,61,26,12,3
2021,Richmond upon Thames 018B,E01003812,1794,1614,180,115,42,16,7
2021,Richmond upon Thames 019B,E01003813,1588,1513,75,43,24,8,0
2021,Richmond upon Thames 019C,E01003814,1752,1586,166,93,54,18,1
2021,Richmond upon Thames 019D,E01003815,1918,1733,185,111,58,16,0
2021,Richmond upon Thames 012C,E01003816,1703,1435,268,201,46,20,1
2021,Richmond upon Thames 012D,E01003817,1920,1614,306,170,97,32,7
2021,Richmond upon Thames 017A,E01003818,1558,1333,225,139,55,27,4
2021,Richmond upon Thames 017B,E01003819,1726,1470,256,143,78,31,4
2021,Richmond upon Thames 017C,E01003820,1969,1710,259,177,54,27,1
2021,Richmond upon Thames 008A,E01003821,1623,1238,385,246,90,43,6
2021,Richmond upon Thames 023A,E01003822,1447,1366,81,59,16,6,0
2021,Richmond upon Thames 023B,E01003823,1678,1562,116,81,24,10,1
2021,Richmond upon Thames 023C,E01003824,1579,1502,77,54,15,8,0
2021,Richmond upon Thames 023D,E01003825,1712,1646,66,50,14,2,0
2021,Richmond upon Thames 023E,E01003826,1714,1548,166,97,49,18,2
2021,Richmond upon Thames 023F,E01003827,1865,1673,192,118,53,15,6
2021,Richmond upon Thames 020A,E01003828,1486,1395,91,59,25,5,2
2021,Richmond upon Thames 020B,E01003829,1640,1426,214,83,70,44,17
2021,Richmond upon Thames 020C,E01003830,1799,1618,181,100,56,21,4
2021,Richmond upon Thames 020D,E01003831,1625,1444,181,94,64,19,4
2021,Richmond upon Thames 020E,E01003832,1447,1308,139,63,41,30,5
2021,Richmond upon Thames 020F,E01003833,1415,1228,187,88,76,22,1
2021,Richmond upon Thames 022A,E01003834,1565,1377,188,114,51,19,4
2021,Richmond upon Thames 022B,E01003835,1599,1509,90,71,12,6,1
2021,Richmond upon Thames 022C,E01003836,1348,1280,68,37,23,8,0
2021,Richmond upon Thames 022D,E01003837,2018,1852,166,103,39,18,6
2021,Richmond upon Thames 022E,E01003838,1732,1577,155,108,34,11,2
2021,Richmond upon Thames 022F,E01003839,2195,1942,253,155,76,20,2
2021,Richmond upon Thames 013A,E01003840,1759,1233,526,246,192,73,15
2021,Richmond upon Thames 013B,E01003841,2070,1543,527,208,193,114,12
2021,Richmond upon Thames 013C,E01003842,1664,1499,165,88,54,20,3
2021,Richmond upon Thames 013D,E01003843,2147,1752,395,181,129,65,20
2021,Richmond upon Thames 013E,E01003844,1431,1332,99,56,31,7,5
2021,Richmond upon Thames 013F,E01003845,1661,1471,190,128,42,18,2
2021,Richmond upon Thames 002A,E01003846,1668,1537,131,92,34,2,3
2021,Richmond upon Thames 002B,E01003847,1645,1364,281,188,77,14,2
2021,Richmond upon Thames 004A,E01003848,1828,1577,251,159,62,25,5
2021,Richmond upon Thames 002C,E01003849,1482,1328,154,102,43,8,1
2021,Richmond upon Thames 002D,E01003851,1567,1454,113,85,21,7,0
2021,Richmond upon Thames 003A,E01003852,1323,1117,206,126,56,23,1
2021,Richmond upon Thames 003B,E01003853,1392,1256,136,80,37,13,6
2021,Richmond upon Thames 003C,E01003854,1353,1236,117,86,22,8,1
2021,Richmond upon Thames 003D,E01003855,1857,1641,216,133,59,21,3
2021,Richmond upon Thames 003E,E01003856,1580,1419,161,111,40,9,1
2021,Richmond upon Thames 003F,E01003857,1770,1574,196,144,39,10,3
2021,Richmond upon Thames 003G,E01003858,1558,1438,120,85,19,14,2
2021,Richmond upon Thames 005E,E01003859,1569,1436,133,77,40,15,1
2021,Richmond upon Thames 002E,E01003860,1642,1470,172,121,42,8,1
2021,Richmond upon Thames 004C,E01003861,1874,1547,327,212,83,28,4
2021,Richmond upon Thames 004D,E01003862,1850,1568,282,162,94,22,4
2021,Richmond upon Thames 004E,E01003863,1392,1223,169,104,41,17,7
2021,Richmond upon Thames 002F,E01003864,1418,1203,215,168,32,10,5
2021,Richmond upon Thames 004F,E01003865,1394,1218,176,105,52,17,2
2021,Richmond upon Thames 007A,E01003866,1613,1523,90,73,12,4,1
2021,Richmond upon Thames 011A,E01003867,1546,1365,181,100,61,16,4
2021,Richmond upon Thames 007B,E01003868,1509,1369,140,103,25,10,2
2021,Richmond upon Thames 011B,E01003869,1609,1400,209,130,56,21,2
2021,Richmond upon Thames 011C,E01003870,2005,1765,240,151,69,18,2
2021,Richmond upon Thames 007C,E01003871,1689,1556,133,95,31,5,2
2021,Richmond upon Thames 007D,E01003872,1515,1304,211,129,62,19,1
2021,Richmond upon Thames 006A,E01003873,1585,1380,205,138,48,19,0
2021,Richmond upon Thames 006B,E01003874,1461,1263,198,139,51,6,2
2021,Richmond upon Thames 006C,E01003875,1629,1373,256,163,67,25,1
2021,Richmond upon Thames 008B,E01003876,1813,1551,262,189,60,12,1
2021,Richmond upon Thames 008C,E01003877,1447,1258,189,148,29,7,5
2021,Richmond upon Thames 006D,E01003878,1447,1265,182,116,52,9,5
2021,Richmond upon Thames 008D,E01003879,1365,1180,185,134,38,13,0
2021,Richmond upon Thames 016A,E01003880,1517,1434,83,48,26,9,0
2021,Richmond upon Thames 016B,E01003881,1745,1602,143,93,37,11,2
2021,Richmond upon Thames 014A,E01003882,1944,1751,193,132,42,19,0
2021,Richmond upon Thames 014B,E01003883,1920,1807,113,76,25,10,2
2021,Richmond upon Thames 016C,E01003884,1691,1584,107,61,36,8,2
2021,Richmond upon Thames 016D,E01003885,1503,1368,135,81,34,20,0
2021,Richmond upon Thames 021A,E01003886,1584,1451,133,86,31,13,3
2021,Richmond upon Thames 021B,E01003887,1736,1604,132,71,48,12,1
2021,Richmond upon Thames 021C,E01003888,1967,1795,172,96,50,21,5
2021,Richmond upon Thames 021D,E01003889,1615,1481,134,82,33,14,5
2021,Richmond upon Thames 018C,E01003890,1607,1474,133,87,31,15,0
2021,Richmond upon Thames 018D,E01003891,1701,1563,138,97,30,10,1
2021,Richmond upon Thames 009A,E01003892,2024,1722,302,208,69,20,5
2021,Richmond upon Thames 009B,E01003893,1592,1339,253,194,45,11,3
2021,Richmond upon Thames 009C,E01003894,1615,1458,157,118,28,11,0
2021,Richmond upon Thames 009D,E01003895,1724,1536,188,115,44,26,3
2021,Richmond upon Thames 014C,E01003896,1834,1536,298,188,84,21,5
2021,Richmond upon Thames 014D,E01003897,1891,1627,264,146,86,25,7
2021,Richmond upon Thames 015A,E01003898,1623,1523,100,66,25,8,1
2021,Richmond upon Thames 015B,E01003899,1443,1274,169,100,49,18,2
2021,Richmond upon Thames 015C,E01003900,1649,1465,184,98,65,19,2
2021,Richmond upon Thames 015D,E01003901,1711,1619,92,50,26,11,5
2021,Richmond upon Thames 015E,E01003902,1342,1210,132,76,43,12,1
2021,Richmond upon Thames 015F,E01003903,1602,1397,205,104,83,13,5
2021,Richmond upon Thames 015G,E01003904,1557,1377,180,113,45,17,5
2021,Richmond upon Thames 010A,E01003905,1235,1064,171,92,51,24,4
2021,Richmond upon Thames 010B,E01003906,1644,1449,195,85,72,33,5
2021,Richmond upon Thames 010C,E01003907,1633,1421,212,117,55,36,4
2021,Richmond upon Thames 010D,E01003908,1768,1487,281,144,91,42,4
2021,Richmond upon Thames 010E,E01003909,1595,1378,217,90,85,34,8
2021,Richmond upon Thames 011D,E01003910,1600,1476,124,78,34,11,1
2021,Southwark 020A,E01003911,2030,1624,406,210,129,57,10
2021,Southwark 019A,E01003912,1889,1477,412,138,170,88,16
2021,Southwark 024A,E01003913,1994,1600,394,173,136,60,25
2021,Southwark 024B,E01003914,1792,1552,240,110,81,46,3
2021,Southwark 024C,E01003915,1804,1500,304,150,92,54,8
2021,Southwark 020B,E01003916,2339,1825,514,179,201,123,11
2021,Southwark 020C,E01003917,1807,1434,373,154,127,72,20
2021,Southwark 020D,E01003918,1413,1173,240,97,85,37,21
2021,Southwark 021A,E01003919,1515,1231,284,136,98,44,6
2021,Southwark 021B,E01003920,2052,1676,376,158,124,80,14
2021,Southwark 021C,E01003921,1858,1452,406,176,131,82,17
2021,Southwark 021D,E01003922,2168,1724,444,179,153,100,12
2021,Southwark 017A,E01003923,1609,1368,241,93,83,60,5
2021,Southwark 021E,E01003924,1985,1403,582,203,209,151,19
2021,Southwark 020E,E01003925,1967,1584,383,160,108,89,26
2021,Southwark 021F,E01003926,1372,1111,261,91,102,55,13
2021,Southwark 002B,E01003929,1950,1625,325,249,50,21,5
2021,Southwark 034A,E01003930,1932,1572,360,219,94,38,9
2021,Southwark 034B,E01003932,1495,1202,293,135,108,45,5
2021,Southwark 034C,E01003933,2325,1797,528,290,162,68,8
2021,Southwark 002C,E01003934,1932,1499,433,281,118,29,5
2021,Southwark 002D,E01003935,1253,1033,220,119,75,19,7
2021,Southwark 009A,E01003936,1608,1355,253,220,26,7,0
2021,Southwark 009B,E01003937,1513,1068,445,266,103,67,9
2021,Southwark 006A,E01003938,1784,1454,330,205,87,33,5
2021,Southwark 002E,E01003939,1938,1470,468,297,140,25,6
2021,Southwark 006B,E01003940,1553,1207,346,160,121,54,11
2021,Southwark 006C,E01003941,1924,1555,369,228,84,52,5
2021,Southwark 006D,E01003942,1831,1439,392,233,103,43,13
2021,Southwark 009C,E01003943,1464,1099,365,161,114,83,7
2021,Southwark 033A,E01003945,1651,1489,162,97,48,16,1
2021,Southwark 033B,E01003946,1840,1585,255,161,72,19,3
2021,Southwark 033C,E01003947,1556,1344,212,94,84,31,3
2021,Southwark 033D,E01003948,1674,1481,193,117,51,20,5
2021,Southwark 032A,E01003949,1803,1585,218,131,57,22,8
2021,Southwark 032B,E01003950,1927,1687,240,89,89,59,3
2021,Southwark 033E,E01003951,1463,1271,192,111,69,10,2
2021,Southwark 030A,E01003952,1592,1428,164,90,39,33,2
2021,Southwark 028A,E01003953,1945,1766,179,118,43,15,3
2021,Southwark 030B,E01003954,1505,1414,91,64,19,6,2
2021,Southwark 028B,E01003955,1799,1647,152,92,39,20,1
2021,Southwark 030C,E01003956,1737,1615,122,74,19,29,0
2021,Southwark 032C,E01003957,1706,1574,132,85,30,16,1
2021,Southwark 032D,E01003958,1858,1594,264,81,83,81,19
2021,Southwark 012A,E01003960,1744,1462,282,145,90,44,3
2021,Southwark 012B,E01003961,2021,1552,469,185,159,106,19
2021,Southwark 016A,E01003963,1670,1305,365,137,147,65,16
2021,Southwark 015B,E01003966,2074,1354,720,217,228,231,44
2021,Southwark 017B,E01003969,2403,1682,721,280,215,201,25
2021,Southwark 015D,E01003971,1362,1096,266,124,87,46,9
2021,Southwark 016D,E01003972,1402,1088,314,151,87,67,9
2021,Southwark 016E,E01003973,1607,1248,359,149,133,66,11
2021,Southwark 004A,E01003975,1732,1448,284,163,81,33,7
2021,Southwark 036D,E01003976,2311,1898,413,279,93,37,4
2021,Southwark 010A,E01003977,1800,1382,418,234,116,58,10
2021,Southwark 006E,E01003979,1927,1540,387,191,99,64,33
2021,Southwark 013A,E01003980,1958,1523,435,198,129,88,20
2021,Southwark 006F,E01003981,1482,1231,251,161,66,24,0
2021,Southwark 018A,E01003983,1768,1458,310,105,112,84,9
2021,Southwark 023A,E01003984,2218,1888,330,134,126,63,7
2021,Southwark 011A,E01003986,1534,1238,296,134,102,49,11
2021,Southwark 011B,E01003987,1796,1564,232,107,74,42,9
2021,Southwark 018B,E01003988,1979,1533,446,165,164,102,15
2021,Southwark 018C,E01003989,2183,1709,474,181,167,102,24
2021,Southwark 018D,E01003990,2253,1815,438,161,163,98,16
2021,Southwark 017C,E01003991,1237,970,267,113,90,52,12
2021,Southwark 014A,E01003992,1546,1253,293,117,112,56,8
2021,Southwark 017D,E01003993,1966,1600,366,170,128,60,8
2021,Southwark 012E,E01003994,1791,1408,383,182,133,55,13
2021,Southwark 014B,E01003995,1333,1139,194,87,68,30,9
2021,Southwark 017E,E01003997,1260,1048,212,104,60,33,15
2021,Southwark 014D,E01003998,1395,1184,211,122,59,23,7
2021,Southwark 014E,E01003999,1464,1254,210,105,71,29,5
2021,Southwark 026A,E01004000,1861,1651,210,93,74,36,7
2021,Southwark 026B,E01004001,1705,1547,158,72,49,27,10
2021,Southwark 029A,E01004002,1624,1526,98,48,28,18,4
2021,Southwark 023B,E01004003,1779,1480,299,96,118,68,17
2021,Southwark 023C,E01004004,2531,2207,324,153,80,78,13
2021,Southwark 023D,E01004005,2244,1939,305,126,103,65,11
2021,Southwark 023E,E01004006,1769,1560,209,91,53,55,10
2021,Southwark 018E,E01004007,1403,1182,221,83,76,58,4
2021,Southwark 022B,E01004008,2034,1682,352,142,102,83,25
2021,Southwark 022D,E01004010,1442,1059,383,111,151,107,14
2021,Southwark 019B,E01004011,2057,1676,381,176,115,77,13
2021,Southwark 019C,E01004012,2287,1787,500,226,158,92,24
2021,Southwark 019D,E01004013,1654,1376,278,85,115,69,9
2021,Southwark 019E,E01004014,2029,1663,366,131,147,75,13
2021,Southwark 028C,E01004015,1733,1609,124,76,31,10,7
2021,Southwark 029B,E01004016,2438,2262,176,90,49,29,8
2021,Southwark 029C,E01004017,1579,1413,166,94,47,25,0
2021,Southwark 032E,E01004018,1816,1646,170,104,39,21,6
2021,Southwark 026C,E01004019,2008,1829,179,95,55,23,6
2021,Southwark 029D,E01004020,1673,1494,179,75,65,30,9
2021,Southwark 028D,E01004021,2030,1854,176,135,24,16,1
2021,Southwark 004D,E01004023,1606,1233,373,205,112,50,6
2021,Southwark 011C,E01004024,1917,1523,394,212,123,56,3
2021,Southwark 004E,E01004028,2342,1893,449,253,128,50,18
2021,Southwark 001A,E01004029,1926,1459,467,340,94,29,4
2021,Southwark 007A,E01004030,1447,1239,208,126,60,19,3
2021,Southwark 007B,E01004031,2545,1884,661,427,165,60,9
2021,Southwark 001B,E01004032,1448,1061,387,291,61,32,3
2021,Southwark 007C,E01004033,2342,1821,521,327,123,61,10
2021,Southwark 007D,E01004034,1561,1235,326,167,109,46,4
2021,Southwark 011D,E01004035,1362,1075,287,150,81,50,6
2021,Southwark 007E,E01004036,2037,1505,532,259,162,100,11
2021,Southwark 010B,E01004037,1939,1460,479,228,160,75,16
2021,Southwark 010C,E01004038,2328,1771,557,260,190,91,16
2021,Southwark 013B,E01004039,1488,1077,411,199,121,69,22
2021,Southwark 013C,E01004040,1802,1428,374,164,131,71,8
2021,Southwark 013D,E01004041,1541,1124,417,163,150,85,19
2021,Southwark 010D,E01004042,1899,1516,383,214,101,62,6
2021,Southwark 010E,E01004043,1318,1110,208,125,58,22,3
2021,Southwark 013E,E01004044,1395,1156,239,106,94,33,6
2021,Southwark 027A,E01004045,1532,1314,218,87,71,45,15
2021,Southwark 028E,E01004046,1498,1407,91,58,22,10,1
2021,Southwark 027B,E01004047,1597,1300,297,110,103,72,12
2021,Southwark 027C,E01004048,1555,1308,247,155,67,25,0
2021,Southwark 027D,E01004049,1295,1102,193,91,78,20,4
2021,Southwark 024D,E01004050,1351,1190,161,94,47,18,2
2021,Southwark 027E,E01004051,1243,1085,158,93,43,18,4
2021,Southwark 024E,E01004052,1687,1536,151,98,36,16,1
2021,Southwark 001C,E01004053,1808,1407,401,303,75,23,0
2021,Southwark 001D,E01004054,1468,1146,322,238,65,19,0
2021,Southwark 001E,E01004055,1286,1147,139,81,31,22,5
2021,Southwark 008A,E01004056,2226,1756,470,309,100,53,8
2021,Southwark 008B,E01004057,2141,1589,552,393,114,35,10
2021,Southwark 008C,E01004058,1651,1181,470,334,111,19,6
2021,Southwark 008D,E01004059,1992,1481,511,403,79,26,3
2021,Southwark 008E,E01004060,1921,1497,424,240,141,37,6
2021,Southwark 025A,E01004061,1584,1422,162,99,40,19,4
2021,Southwark 025B,E01004062,2129,1820,309,146,80,59,24
2021,Southwark 025C,E01004063,1812,1686,126,79,29,13,5
2021,Southwark 026D,E01004064,1872,1632,240,112,65,55,8
2021,Southwark 025D,E01004065,1458,1348,110,60,31,17,2
2021,Southwark 025E,E01004066,2016,1767,249,91,82,68,8
2021,Southwark 022E,E01004067,2146,1625,521,183,190,122,26
2021,Southwark 026E,E01004068,1847,1696,151,70,42,33,6
2021,Southwark 031A,E01004069,1258,1194,64,40,16,8,0
2021,Southwark 031B,E01004070,1885,1735,150,96,37,16,1
2021,Southwark 030D,E01004071,1468,1322,146,76,41,23,6
2021,Southwark 030E,E01004072,1618,1522,96,55,20,18,3
2021,Southwark 031C,E01004073,1825,1687,138,93,29,15,1
2021,Southwark 031D,E01004074,1664,1578,86,61,11,10,4
2021,Southwark 031E,E01004075,1665,1566,99,66,23,10,0
2021,Sutton 011A,E01004076,1576,1361,215,94,81,33,7
2021,Sutton 011B,E01004077,1573,1415,158,90,47,17,4
2021,Sutton 011C,E01004078,1696,1512,184,85,72,25,2
2021,Sutton 011D,E01004079,1351,1234,117,76,35,5,1
2021,Sutton 011E,E01004080,1355,1176,179,104,51,21,3
2021,Sutton 011F,E01004081,1585,1383,202,105,73,22,2
2021,Sutton 011G,E01004082,1356,1147,209,107,62,33,7
2021,Sutton 019A,E01004083,1453,1308,145,52,66,22,5
2021,Sutton 024A,E01004084,1429,1251,178,122,43,9,4
2021,Sutton 024B,E01004085,1577,1412,165,91,45,21,8
2021,Sutton 019B,E01004086,1926,1523,403,233,115,45,10
2021,Sutton 017A,E01004087,1541,1350,191,121,56,12,2
2021,Sutton 019C,E01004088,1886,1678,208,85,77,44,2
2021,Sutton 019D,E01004089,1291,1094,197,97,70,25,5
2021,Sutton 021A,E01004090,1278,1029,249,96,99,46,8
2021,Sutton 022A,E01004091,1265,1166,99,74,17,6,2
2021,Sutton 022B,E01004092,1461,1279,182,99,50,31,2
2021,Sutton 025A,E01004093,1651,1383,268,181,55,25,7
2021,Sutton 025B,E01004094,1804,1582,222,144,55,21,2
2021,Sutton 025C,E01004095,1519,1281,238,159,57,20,2
2021,Sutton 021B,E01004096,1497,1155,342,189,111,35,7
2021,Sutton 015A,E01004097,1599,1499,100,59,27,14,0
2021,Sutton 015B,E01004098,1258,1179,79,37,28,12,2
2021,Sutton 015C,E01004099,1536,1403,133,75,45,11,2
2021,Sutton 015D,E01004100,1464,1324,140,83,42,12,3
2021,Sutton 013A,E01004101,1377,1224,153,101,42,10,0
2021,Sutton 015E,E01004102,1460,1330,130,82,35,13,0
2021,Sutton 013B,E01004103,1704,1423,281,151,93,30,7
2021,Sutton 020A,E01004104,1529,1432,97,61,23,13,0
2021,Sutton 022C,E01004105,1823,1675,148,105,30,11,2
2021,Sutton 022D,E01004106,1603,1508,95,72,18,4,1
2021,Sutton 020B,E01004107,1578,1408,170,91,49,24,6
2021,Sutton 024C,E01004108,1903,1737,166,96,51,15,4
2021,Sutton 024D,E01004109,1657,1566,91,46,32,11,2
2021,Sutton 016A,E01004110,1980,1778,202,100,75,26,1
2021,Sutton 016B,E01004111,1641,1487,154,89,50,15,0
2021,Sutton 016C,E01004112,1619,1515,104,81,19,2,2
2021,Sutton 025D,E01004114,1755,1603,152,99,33,18,2
2021,Sutton 009A,E01004115,1772,1568,204,103,78,20,3
2021,Sutton 008A,E01004116,1527,1392,135,71,47,14,3
2021,Sutton 006A,E01004117,1385,1261,124,64,44,14,2
2021,Sutton 009B,E01004118,1768,1512,256,138,78,32,8
2021,Sutton 009C,E01004119,1402,1243,159,85,60,13,1
2021,Sutton 016D,E01004120,1482,1376,106,47,36,19,4
2021,Sutton 006B,E01004121,1530,1334,196,88,69,34,5
2021,Sutton 008B,E01004122,1346,1246,100,51,28,19,2
2021,Sutton 002A,E01004123,2194,1685,509,236,202,61,10
2021,Sutton 002B,E01004124,1932,1558,374,145,159,58,12
2021,Sutton 001A,E01004125,1553,1286,267,123,107,28,9
2021,Sutton 002C,E01004126,1516,1284,232,104,96,28,4
2021,Sutton 005A,E01004127,1777,1518,259,122,89,41,7
2021,Sutton 002D,E01004128,1408,1205,203,115,66,21,1
2021,Sutton 002E,E01004129,1811,1494,317,123,142,45,7
2021,Sutton 003A,E01004130,1716,1495,221,128,61,25,7
2021,Sutton 003B,E01004131,1821,1532,289,145,102,38,4
2021,Sutton 009D,E01004132,1442,1331,111,68,34,6,3
2021,Sutton 009E,E01004133,1528,1329,199,109,64,23,3
2021,Sutton 003C,E01004134,1565,1276,289,148,101,36,4
2021,Sutton 003D,E01004135,1406,1157,249,127,94,25,3
2021,Sutton 003E,E01004136,1522,1322,200,108,71,21,0
2021,Sutton 012A,E01004137,2457,1804,653,323,232,93,5
2021,Sutton 013C,E01004138,1716,1402,314,161,116,33,4
2021,Sutton 013D,E01004139,1483,1186,297,137,112,45,3
2021,Sutton 012B,E01004140,1798,1313,485,202,199,75,9
2021,Sutton 012C,E01004141,1720,1373,347,177,128,39,3
2021,Sutton 014A,E01004143,1486,1210,276,140,95,32,9
2021,Sutton 007A,E01004144,1719,1403,316,176,105,29,6
2021,Sutton 007B,E01004145,2200,1822,378,212,122,37,7
2021,Sutton 007C,E01004146,1913,1494,419,200,149,65,5
2021,Sutton 007D,E01004147,1549,1408,141,91,32,15,3
2021,Sutton 014B,E01004148,1754,1415,339,157,119,56,7
2021,Sutton 012E,E01004149,1800,1498,302,179,76,37,10
2021,Sutton 021C,E01004150,1907,1411,496,258,176,59,3
2021,Sutton 021D,E01004151,1894,1540,354,182,122,38,12
2021,Sutton 018A,E01004152,1712,1380,332,187,99,41,5
2021,Sutton 021E,E01004153,1836,1364,472,279,144,43,6
2021,Sutton 022E,E01004154,1446,1300,146,93,40,13,0
2021,Sutton 018B,E01004155,1827,1454,373,209,124,35,5
2021,Sutton 018C,E01004156,1939,1399,540,290,195,49,6
2021,Sutton 016E,E01004157,1257,1142,115,77,19,15,4
2021,Sutton 018D,E01004158,1555,1319,236,121,81,29,5
2021,Sutton 014C,E01004159,1599,1385,214,113,67,29,5
2021,Sutton 014D,E01004160,1593,1310,283,152,96,32,3
2021,Sutton 014E,E01004161,1457,1260,197,123,63,11,0
2021,Sutton 018E,E01004162,1626,1221,405,213,150,38,4
2021,Sutton 005B,E01004163,1666,1496,170,95,55,17,3
2021,Sutton 004A,E01004164,1391,1305,86,48,25,11,2
2021,Sutton 005C,E01004165,1710,1502,208,119,61,23,5
2021,Sutton 004B,E01004166,1500,1384,116,68,38,10,0
2021,Sutton 005D,E01004167,1571,1368,203,84,91,24,4
2021,Sutton 013E,E01004168,1551,1403,148,72,59,16,1
2021,Sutton 004C,E01004169,1701,1438,263,147,92,20,4
2021,Sutton 017B,E01004170,2114,1770,344,194,101,44,5
2021,Sutton 010A,E01004171,1568,1413,155,86,47,22,0
2021,Sutton 010B,E01004172,1835,1576,259,133,83,38,5
2021,Sutton 010C,E01004173,1332,1246,86,51,27,4,4
2021,Sutton 017C,E01004174,1532,1336,196,114,63,17,2
2021,Sutton 010D,E01004175,1662,1497,165,88,58,15,4
2021,Sutton 010E,E01004176,1462,1320,142,71,47,20,4
2021,Sutton 020C,E01004177,1745,1533,212,104,78,22,8
2021,Sutton 017D,E01004178,2257,1897,360,179,120,53,8
2021,Sutton 017E,E01004179,1579,1418,161,88,58,11,4
2021,Sutton 020D,E01004180,1733,1591,142,94,35,11,2
2021,Sutton 020E,E01004181,1667,1459,208,110,74,21,3
2021,Sutton 019E,E01004182,1698,1515,183,89,74,19,1
2021,Sutton 001B,E01004183,1708,1419,289,132,108,43,6
2021,Sutton 001C,E01004184,1646,1428,218,117,81,17,3
2021,Sutton 001D,E01004185,2001,1699,302,165,104,33,0
2021,Sutton 004D,E01004186,1632,1377,255,121,98,32,4
2021,Sutton 005E,E01004187,1613,1397,216,109,69,33,5
2021,Sutton 001E,E01004189,2049,1679,370,157,140,57,16
2021,Sutton 008C,E01004190,1348,1232,116,60,42,13,1
2021,Sutton 008D,E01004191,1811,1497,314,161,99,47,7
2021,Sutton 006C,E01004192,1792,1559,233,149,63,18,3
2021,Sutton 006D,E01004193,2704,2386,318,181,89,44,4
2021,Sutton 008E,E01004194,1537,1317,220,121,80,16,3
2021,Sutton 006E,E01004195,1628,1335,293,135,111,42,5
2021,Sutton 008F,E01004196,1529,1351,178,97,68,12,1
2021,Tower Hamlets 002B,E01004198,1432,1068,364,126,115,102,21
2021,Tower Hamlets 002C,E01004199,1626,1201,425,135,149,114,27
2021,Tower Hamlets 005A,E01004200,1473,1176,297,164,68,55,10
2021,Tower Hamlets 002D,E01004201,1651,1401,250,102,63,66,19
2021,Tower Hamlets 005B,E01004202,1936,1493,443,251,111,68,13
2021,Tower Hamlets 005C,E01004203,1770,1326,444,197,163,73,11
2021,Tower Hamlets 005D,E01004204,1809,1364,445,174,144,104,23
2021,Tower Hamlets 013A,E01004205,2106,1400,706,212,256,200,38
2021,Tower Hamlets 013B,E01004206,1418,865,553,153,209,162,29
2021,Tower Hamlets 011A,E01004207,1382,1050,332,140,103,73,16
2021,Tower Hamlets 013C,E01004208,1900,1278,622,248,235,121,18
2021,Tower Hamlets 011B,E01004209,1331,922,409,128,139,114,28
2021,Tower Hamlets 013D,E01004211,1576,1186,390,192,112,76,10
2021,Tower Hamlets 011D,E01004212,2161,1451,710,309,262,125,14
2021,Tower Hamlets 030A,E01004214,1549,1143,406,169,120,101,16
2021,Tower Hamlets 030B,E01004216,1723,1220,503,289,146,60,8
2021,Tower Hamlets 030C,E01004217,1987,1443,544,302,157,79,6
2021,Tower Hamlets 030D,E01004218,1859,1397,462,274,126,50,12
2021,Tower Hamlets 035B,E01004219,2604,1821,783,351,264,136,32
2021,Tower Hamlets 036A,E01004221,1897,1375,522,299,150,62,11
2021,Tower Hamlets 001A,E01004222,2635,2136,499,209,143,136,11
2021,Tower Hamlets 001B,E01004223,2140,1837,303,110,116,65,12
2021,Tower Hamlets 001D,E01004226,2303,1870,433,176,152,92,13
2021,Tower Hamlets 003A,E01004228,1891,1669,222,138,57,21,6
2021,Tower Hamlets 004C,E01004229,1361,1037,324,117,111,79,17
2021,Tower Hamlets 003B,E01004230,2072,1717,355,147,125,68,15
2021,Tower Hamlets 004D,E01004231,1589,1160,429,125,188,99,17
2021,Tower Hamlets 003C,E01004232,1726,1478,248,108,67,63,10
2021,Tower Hamlets 003D,E01004233,2148,1623,525,231,134,131,29
2021,Tower Hamlets 003E,E01004234,2388,2044,344,173,79,86,6
2021,Tower Hamlets 008A,E01004235,1242,895,347,79,142,110,16
2021,Tower Hamlets 008B,E01004236,1505,1104,401,92,170,110,29
2021,Tower Hamlets 008C,E01004237,1463,1111,352,148,124,63,17
2021,Tower Hamlets 008E,E01004239,1712,1239,473,107,135,162,69
2021,Tower Hamlets 012A,E01004240,1630,1198,432,119,153,136,24
2021,Tower Hamlets 012B,E01004241,1609,1178,431,123,151,135,22
2021,Tower Hamlets 020A,E01004243,1497,975,522,201,194,122,5
2021,Tower Hamlets 020B,E01004244,1985,1475,510,218,154,117,21
2021,Tower Hamlets 018A,E01004245,2835,2012,823,391,281,136,15
2021,Tower Hamlets 020C,E01004247,2522,1711,811,305,283,181,42
2021,Tower Hamlets 018C,E01004248,1801,1376,425,143,151,108,23
2021,Tower Hamlets 018D,E01004249,2327,1701,626,204,235,153,34
2021,Tower Hamlets 023A,E01004251,2445,1782,663,255,229,163,16
2021,Tower Hamlets 023C,E01004255,1519,1040,479,168,169,119,23
2021,Tower Hamlets 024C,E01004256,1630,1103,527,192,187,119,29
2021,Tower Hamlets 024D,E01004257,2149,1533,616,193,238,152,33
2021,Tower Hamlets 023D,E01004258,1418,1098,320,185,72,50,13
2021,Tower Hamlets 007A,E01004259,1693,1301,392,206,114,64,8
2021,Tower Hamlets 007B,E01004260,1710,1274,436,171,145,103,17
2021,Tower Hamlets 007C,E01004263,1346,1047,299,108,112,62,17
2021,Tower Hamlets 010C,E01004264,1390,876,514,134,200,151,29
2021,Tower Hamlets 007D,E01004266,1411,1207,204,88,56,53,7
2021,Tower Hamlets 012D,E01004267,2114,1708,406,170,134,82,20
2021,Tower Hamlets 012E,E01004268,1706,1192,514,180,202,120,12
2021,Tower Hamlets 014B,E01004270,2342,1799,543,256,145,127,15
2021,Tower Hamlets 014C,E01004271,2361,1773,588,276,179,120,13
2021,Tower Hamlets 014D,E01004272,2544,1716,828,297,297,187,47
2021,Tower Hamlets 031A,E01004274,1874,1304,570,242,189,119,20
2021,Tower Hamlets 031B,E01004275,2411,1824,587,315,176,77,19
2021,Tower Hamlets 031C,E01004276,1970,1461,509,358,116,31,4
2021,Tower Hamlets 033A,E01004277,1538,1056,482,344,107,30,1
2021,Tower Hamlets 032A,E01004280,1872,1338,534,288,123,101,22
2021,Tower Hamlets 031D,E01004281,1898,1309,589,378,164,42,5
2021,Tower Hamlets 016A,E01004283,2098,1504,594,209,195,165,25
2021,Tower Hamlets 019C,E01004286,2371,1771,600,200,201,151,48
2021,Tower Hamlets 016B,E01004287,2162,1457,705,198,269,198,40
2021,Tower Hamlets 019D,E01004288,1766,1300,466,137,171,128,30
2021,Tower Hamlets 016C,E01004289,1879,1363,516,168,178,123,47
2021,Tower Hamlets 016D,E01004290,1900,1393,507,204,178,109,16
2021,Tower Hamlets 027A,E01004291,1861,1538,323,220,75,24,4
2021,Tower Hamlets 026A,E01004292,1613,1275,338,247,68,17,6
2021,Tower Hamlets 027B,E01004293,1928,1505,423,322,61,36,4
2021,Tower Hamlets 026C,E01004295,1925,1343,582,219,198,130,35
2021,Tower Hamlets 026D,E01004296,2353,1737,616,306,180,113,17
2021,Tower Hamlets 027C,E01004297,1814,1465,349,211,92,40,6
2021,Tower Hamlets 022A,E01004298,1535,1062,473,157,146,139,31
2021,Tower Hamlets 022B,E01004300,1402,1019,383,124,138,102,19
2021,Tower Hamlets 025B,E01004301,1363,937,426,128,136,131,31
2021,Tower Hamlets 025C,E01004302,1583,995,588,176,228,158,26
2021,Tower Hamlets 025D,E01004303,2774,1990,784,333,251,162,38
2021,Tower Hamlets 022C,E01004304,2064,1326,738,205,295,197,41
2021,Tower Hamlets 022D,E01004305,1801,1235,566,187,217,137,25
2021,Tower Hamlets 015A,E01004306,1774,1243,531,237,128,117,49
2021,Tower Hamlets 015B,E01004307,2313,1633,680,449,166,50,15
2021,Tower Hamlets 015C,E01004308,1396,938,458,174,137,119,28
2021,Tower Hamlets 015D,E01004309,2683,1755,928,398,277,203,50
2021,Tower Hamlets 015E,E01004310,1964,1293,671,307,205,129,30
2021,Tower Hamlets 006A,E01004311,1797,1420,377,187,94,78,18
2021,Tower Hamlets 009A,E01004312,1470,1056,414,142,126,112,34
2021,Tower Hamlets 009B,E01004313,2039,1415,624,249,210,146,19
2021,Tower Hamlets 006C,E01004315,1523,1177,346,154,108,72,12
2021,Tower Hamlets 009C,E01004316,1008,737,271,138,63,55,15
2021,Tower Hamlets 021A,E01004319,2409,1536,873,271,276,262,64
2021,Tower Hamlets 021C,E01004321,2045,1367,678,271,210,161,36
2021,Tower Hamlets 017A,E01004322,1352,918,434,166,151,101,16
2021,Tower Hamlets 017B,E01004323,1545,1120,425,128,133,134,30
2021,Tower Hamlets 017C,E01004324,1531,1023,508,153,184,145,26
2021,Tower Hamlets 017D,E01004326,1802,1190,612,241,199,136,36
2021,Waltham Forest 028A,E01004327,1478,1002,476,169,197,71,39
2021,Waltham Forest 028B,E01004328,1777,1191,586,212,238,117,19
2021,Waltham Forest 028C,E01004329,1724,1230,494,148,233,101,12
2021,Waltham Forest 028D,E01004330,1592,1200,392,138,175,67,12
2021,Waltham Forest 028E,E01004331,1583,1172,411,167,144,91,9
2021,Waltham Forest 028F,E01004332,1882,1297,585,200,267,103,15
2021,Waltham Forest 024A,E01004333,1595,1225,370,144,145,74,7
2021,Waltham Forest 024B,E01004334,1787,1104,683,152,362,159,10
2021,Waltham Forest 027A,E01004335,1682,1345,337,101,159,65,12
2021,Waltham Forest 026A,E01004336,1511,929,582,224,243,100,15
2021,Waltham Forest 027B,E01004337,1689,1214,475,182,175,106,12
2021,Waltham Forest 027C,E01004338,1949,1209,740,250,345,132,13
2021,Waltham Forest 027D,E01004339,1723,1341,382,143,164,68,7
2021,Waltham Forest 027E,E01004340,1832,1399,433,155,181,85,12
2021,Waltham Forest 027F,E01004341,1887,1474,413,148,171,82,12
2021,Waltham Forest 011A,E01004342,2006,1574,432,150,194,78,10
2021,Waltham Forest 008A,E01004343,1786,1519,267,112,108,43,4
2021,Waltham Forest 008B,E01004344,1811,1373,438,162,203,63,10
2021,Waltham Forest 010A,E01004345,1723,1305,418,142,189,78,9
2021,Waltham Forest 011B,E01004346,1714,1405,309,128,121,55,5
2021,Waltham Forest 011C,E01004347,2055,1651,404,161,169,62,12
2021,Waltham Forest 010B,E01004348,2821,2162,659,263,274,104,18
2021,Waltham Forest 001A,E01004349,1495,1330,165,60,61,41,3
2021,Waltham Forest 001B,E01004350,1847,1650,197,63,84,39,11
2021,Waltham Forest 001C,E01004351,1593,1470,123,58,43,18,4
2021,Waltham Forest 002A,E01004352,1837,1697,140,80,46,13,1
2021,Waltham Forest 002B,E01004353,1757,1629,128,65,40,18,5
2021,Waltham Forest 002C,E01004354,1879,1644,235,110,80,38,7
2021,Waltham Forest 004A,E01004355,1618,1420,198,86,75,29,8
2021,Waltham Forest 001D,E01004356,1645,1378,267,97,106,56,8
2021,Waltham Forest 001E,E01004357,1540,1370,170,64,72,29,5
2021,Waltham Forest 002D,E01004358,1872,1664,208,96,78,31,3
2021,Waltham Forest 002E,E01004359,1641,1498,143,70,54,17,2
2021,Waltham Forest 004B,E01004360,1305,1186,119,53,51,15,0
2021,Waltham Forest 005A,E01004361,1349,1190,159,78,47,30,4
2021,Waltham Forest 021A,E01004362,1532,1274,258,131,86,35,6
2021,Waltham Forest 019A,E01004363,1599,1226,373,139,157,67,10
2021,Waltham Forest 019B,E01004364,1908,1444,464,170,164,109,21
2021,Waltham Forest 020A,E01004365,2395,1538,857,232,349,240,36
2021,Waltham Forest 019C,E01004366,1871,1510,361,125,154,71,11
2021,Waltham Forest 019D,E01004367,1515,1088,427,144,176,98,9
2021,Waltham Forest 019E,E01004368,2339,1798,541,208,208,113,12
2021,Waltham Forest 023A,E01004369,1668,1144,524,186,215,93,30
2021,Waltham Forest 023B,E01004370,1987,1480,507,169,219,110,9
2021,Waltham Forest 025A,E01004371,1559,1152,407,180,154,66,7
2021,Waltham Forest 023C,E01004372,1566,1153,413,174,176,57,6
2021,Waltham Forest 025B,E01004373,1713,1195,518,183,219,102,14
2021,Waltham Forest 025C,E01004374,1864,1276,588,203,250,117,18
2021,Waltham Forest 025D,E01004375,1837,1223,614,243,220,112,39
2021,Waltham Forest 025E,E01004376,1838,1202,636,217,272,123,24
2021,Waltham Forest 010C,E01004377,1772,1509,263,101,127,30,5
2021,Waltham Forest 010D,E01004378,1772,1515,257,93,124,40,0
2021,Waltham Forest 007A,E01004379,1829,1580,249,128,92,26,3
2021,Waltham Forest 007B,E01004380,1736,1455,281,177,74,27,3
2021,Waltham Forest 007C,E01004381,1908,1697,211,103,70,30,8
2021,Waltham Forest 008C,E01004382,1677,1410,267,99,110,48,10
2021,Waltham Forest 007D,E01004383,1630,1489,141,56,53,26,6
2021,Waltham Forest 003A,E01004384,1932,1681,251,101,109,36,5
2021,Waltham Forest 003B,E01004385,1474,1302,172,83,45,36,8
2021,Waltham Forest 003C,E01004386,1645,1489,156,72,54,25,5
2021,Waltham Forest 007E,E01004387,1393,1328,65,31,21,13,0
2021,Waltham Forest 007F,E01004388,1590,1382,208,88,83,32,5
2021,Waltham Forest 003D,E01004389,1671,1445,226,89,89,41,7
2021,Waltham Forest 003E,E01004390,1558,1351,207,86,78,37,6
2021,Waltham Forest 014A,E01004391,2223,1704,519,219,219,74,7
2021,Waltham Forest 017A,E01004392,2441,1710,731,281,304,131,15
2021,Waltham Forest 014B,E01004393,1633,1196,437,175,151,101,10
2021,Waltham Forest 017B,E01004394,1927,1471,456,165,162,109,20
2021,Waltham Forest 018A,E01004395,1619,1334,285,111,108,54,12
2021,Waltham Forest 012A,E01004396,1899,1347,552,199,239,101,13
2021,Waltham Forest 017C,E01004397,2794,2020,774,294,337,119,24
2021,Waltham Forest 009A,E01004398,1973,1528,445,139,189,101,16
2021,Waltham Forest 009B,E01004399,1826,1455,371,135,152,77,7
2021,Waltham Forest 009C,E01004400,1824,1370,454,213,169,68,4
2021,Waltham Forest 014C,E01004401,2258,1669,589,258,208,103,20
2021,Waltham Forest 009D,E01004402,1788,1434,354,143,131,67,13
2021,Waltham Forest 009E,E01004403,2449,1914,535,219,199,101,16
2021,Waltham Forest 014D,E01004404,2718,2061,657,269,261,115,12
2021,Waltham Forest 020B,E01004405,1646,1311,335,120,129,75,11
2021,Waltham Forest 016A,E01004406,1747,1206,541,193,226,109,13
2021,Waltham Forest 013A,E01004407,1575,1092,483,168,200,95,20
2021,Waltham Forest 016B,E01004408,1676,1354,322,139,122,51,10
2021,Waltham Forest 016C,E01004409,1687,1309,378,146,143,80,9
2021,Waltham Forest 013B,E01004410,1764,1457,307,104,120,67,16
2021,Waltham Forest 016D,E01004411,1865,1335,530,212,197,102,19
2021,Waltham Forest 015A,E01004412,1713,1438,275,135,93,41,6
2021,Waltham Forest 004C,E01004413,1503,1340,163,53,59,46,5
2021,Waltham Forest 005B,E01004414,1752,1369,383,110,176,86,11
2021,Waltham Forest 004D,E01004415,1569,1354,215,74,86,46,9
2021,Waltham Forest 004E,E01004416,1750,1543,207,85,84,33,5
2021,Waltham Forest 005C,E01004417,1807,1417,390,148,147,86,9
2021,Waltham Forest 008D,E01004418,1707,1380,327,125,121,72,9
2021,Waltham Forest 008E,E01004419,2503,1999,504,211,210,79,4
2021,Waltham Forest 020C,E01004420,2185,1381,804,252,337,195,20
2021,Waltham Forest 018B,E01004421,2058,1419,639,226,227,160,26
2021,Waltham Forest 022A,E01004422,2512,1836,676,252,253,154,17
2021,Waltham Forest 020D,E01004423,2006,1376,630,201,228,171,30
2021,Waltham Forest 022B,E01004424,2032,1446,586,208,236,123,19
2021,Waltham Forest 022C,E01004425,1893,1428,465,172,178,99,16
2021,Waltham Forest 022D,E01004426,1753,1358,395,132,168,82,13
2021,Waltham Forest 022E,E01004427,1878,1261,617,263,218,117,19
2021,Waltham Forest 026B,E01004428,2014,1635,379,117,151,94,17
2021,Waltham Forest 026C,E01004429,1745,1349,396,128,173,82,13
2021,Waltham Forest 026D,E01004430,2581,1715,866,378,319,153,16
2021,Waltham Forest 023D,E01004432,1844,1314,530,193,225,102,10
2021,Waltham Forest 026E,E01004434,2053,1485,568,230,204,113,21
2021,Waltham Forest 023E,E01004435,2021,1392,629,223,258,129,19
2021,Waltham Forest 021B,E01004436,1477,1211,266,109,95,58,4
2021,Waltham Forest 021C,E01004437,1704,1243,461,196,184,75,6
2021,Waltham Forest 024C,E01004438,2061,1545,516,244,190,71,11
2021,Waltham Forest 021D,E01004439,1567,1202,365,163,134,63,5
2021,Waltham Forest 024D,E01004440,1988,1490,498,228,197,62,11
2021,Waltham Forest 024E,E01004441,1465,1204,261,122,86,44,9
2021,Waltham Forest 021E,E01004442,1488,1249,239,102,88,44,5
2021,Waltham Forest 016E,E01004443,2151,1573,578,205,222,138,13
2021,Waltham Forest 017D,E01004444,2710,2041,669,262,276,112,19
2021,Waltham Forest 018C,E01004445,1932,1334,598,180,281,131,6
2021,Waltham Forest 017E,E01004446,2526,1735,791,255,331,183,22
2021,Waltham Forest 016F,E01004447,1777,1365,412,127,161,112,12
2021,Waltham Forest 018D,E01004448,1835,1473,362,144,134,73,11
2021,Waltham Forest 018E,E01004449,1837,1439,398,119,166,96,17
2021,Waltham Forest 006A,E01004450,1662,1409,253,81,120,44,8
2021,Waltham Forest 005D,E01004451,1790,1515,275,100,128,41,6
2021,Waltham Forest 005E,E01004452,1821,1437,384,127,165,83,9
2021,Waltham Forest 006B,E01004453,1733,1347,386,115,172,87,12
2021,Waltham Forest 006C,E01004454,1886,1499,387,122,179,75,11
2021,Waltham Forest 006D,E01004455,1715,1286,429,158,187,73,11
2021,Waltham Forest 006E,E01004456,1627,1345,282,94,116,64,8
2021,Waltham Forest 012B,E01004457,1834,1471,363,152,154,47,10
2021,Waltham Forest 012C,E01004458,1951,1390,561,198,226,123,14
2021,Waltham Forest 012D,E01004459,1614,1208,406,125,157,109,15
2021,Waltham Forest 011D,E01004460,1964,1362,602,233,259,101,9
2021,Waltham Forest 011E,E01004462,2120,1531,589,214,278,79,18
2021,Waltham Forest 012E,E01004463,1936,1667,269,122,105,40,2
2021,Waltham Forest 013C,E01004464,1654,1289,365,150,129,78,8
2021,Waltham Forest 015B,E01004465,1523,1295,228,102,73,41,12
2021,Waltham Forest 015C,E01004466,1643,1429,214,91,78,33,12
2021,Waltham Forest 015D,E01004467,2263,1685,578,204,241,122,11
2021,Waltham Forest 015E,E01004468,1706,1436,270,118,108,36,8
2021,Waltham Forest 013D,E01004469,1847,1460,387,139,148,76,24
2021,Waltham Forest 013E,E01004470,1583,1159,424,170,145,95,14
2021,Waltham Forest 013F,E01004471,1689,1306,383,142,161,71,9
2021,Wandsworth 021A,E01004472,1733,1534,199,137,39,21,2
2021,Wandsworth 026A,E01004473,1704,1502,202,125,54,19,4
2021,Wandsworth 021B,E01004474,1949,1681,268,147,78,37,6
2021,Wandsworth 026B,E01004475,1435,1295,140,86,37,16,1
2021,Wandsworth 021C,E01004476,1769,1526,243,154,62,20,7
2021,Wandsworth 017A,E01004477,1582,1437,145,111,23,8,3
2021,Wandsworth 017B,E01004478,1482,1327,155,114,34,5,2
2021,Wandsworth 017C,E01004479,1473,1340,133,92,32,9,0
2021,Wandsworth 026C,E01004480,1679,1547,132,99,18,15,0
2021,Wandsworth 029A,E01004481,1593,1384,209,105,63,34,7
2021,Wandsworth 030A,E01004482,1526,1282,244,141,75,24,4
2021,Wandsworth 026D,E01004483,2038,1724,314,164,105,37,8
2021,Wandsworth 026E,E01004484,1449,1304,145,84,51,10,0
2021,Wandsworth 030B,E01004485,1684,1430,254,114,69,65,6
2021,Wandsworth 026F,E01004486,1392,1270,122,68,39,11,4
2021,Wandsworth 030C,E01004487,1450,1289,161,93,50,17,1
2021,Wandsworth 029B,E01004488,1286,1189,97,60,29,8,0
2021,Wandsworth 030D,E01004489,1289,1185,104,52,31,19,2
2021,Wandsworth 031A,E01004490,1460,1342,118,73,27,17,1
2021,Wandsworth 031B,E01004491,2427,1939,488,276,172,37,3
2021,Wandsworth 031C,E01004492,1640,1396,244,123,78,39,4
2021,Wandsworth 019A,E01004493,1845,1573,272,158,84,26,4
2021,Wandsworth 018A,E01004494,1718,1449,269,147,88,29,5
2021,Wandsworth 024A,E01004495,1535,1162,373,181,126,51,15
2021,Wandsworth 024B,E01004496,1860,1662,198,128,53,15,2
2021,Wandsworth 024C,E01004497,1393,1292,101,70,23,8,0
2021,Wandsworth 031D,E01004498,1591,1477,114,91,19,3,1
2021,Wandsworth 020A,E01004499,1562,1298,264,191,59,12,2
2021,Wandsworth 014A,E01004500,1880,1523,357,218,100,33,6
2021,Wandsworth 014B,E01004501,1499,1186,313,177,101,31,4
2021,Wandsworth 020B,E01004502,1585,1376,209,125,62,17,5
2021,Wandsworth 014C,E01004503,1650,1381,269,179,66,22,2
2021,Wandsworth 020C,E01004504,1470,1247,223,121,65,26,11
2021,Wandsworth 014D,E01004505,1569,1241,328,204,84,34,6
2021,Wandsworth 011A,E01004506,2158,1741,417,293,85,34,5
2021,Wandsworth 014E,E01004507,2501,1966,535,375,115,37,8
2021,Wandsworth 012A,E01004508,1952,1748,204,134,47,21,2
2021,Wandsworth 012B,E01004510,1788,1566,222,136,54,23,9
2021,Wandsworth 010B,E01004511,1537,1364,173,125,39,9,0
2021,Wandsworth 019B,E01004512,1402,1295,107,59,31,17,0
2021,Wandsworth 018B,E01004513,1865,1448,417,246,120,44,7
2021,Wandsworth 012C,E01004514,1712,1526,186,123,47,15,1
2021,Wandsworth 012D,E01004515,1642,1368,274,184,76,12,2
2021,Wandsworth 036A,E01004516,1700,1502,198,100,50,38,10
2021,Wandsworth 037A,E01004517,2154,1572,582,259,213,84,26
2021,Wandsworth 036B,E01004518,1681,1437,244,109,74,52,9
2021,Wandsworth 036C,E01004519,1690,1327,363,152,130,64,17
2021,Wandsworth 036D,E01004520,1364,1101,263,113,90,59,1
2021,Wandsworth 037B,E01004521,1926,1594,332,178,98,47,9
2021,Wandsworth 037C,E01004522,1664,1286,378,136,151,47,44
2021,Wandsworth 036E,E01004523,1580,1332,248,116,86,39,7
2021,Wandsworth 037D,E01004524,1781,1316,465,179,191,80,15
2021,Wandsworth 035A,E01004525,1855,1305,550,231,209,87,23
2021,Wandsworth 035B,E01004526,1694,1386,308,118,127,56,7
2021,Wandsworth 035C,E01004527,1588,1302,286,128,97,52,9
2021,Wandsworth 035D,E01004528,1608,1271,337,159,122,47,9
2021,Wandsworth 035E,E01004529,2018,1632,386,173,138,64,11
2021,Wandsworth 035F,E01004530,1694,1383,311,121,111,63,16
2021,Wandsworth 033A,E01004531,1675,1430,245,119,74,46,6
2021,Wandsworth 032A,E01004532,1370,1226,144,68,52,21,3
2021,Wandsworth 033B,E01004533,1407,1246,161,66,59,34,2
2021,Wandsworth 008A,E01004534,1846,1667,179,121,41,15,2
2021,Wandsworth 007A,E01004535,1753,1247,506,222,199,70,15
2021,Wandsworth 008B,E01004536,2282,1587,695,366,256,64,9
2021,Wandsworth 007B,E01004537,2017,1546,471,265,153,45,8
2021,Wandsworth 007C,E01004538,2360,1785,575,321,178,53,23
2021,Wandsworth 003A,E01004539,2001,1496,505,299,154,44,8
2021,Wandsworth 003B,E01004540,2166,1776,390,221,127,31,11
2021,Wandsworth 007D,E01004541,1651,1287,364,180,127,52,5
2021,Wandsworth 021D,E01004542,1517,1410,107,77,19,8,3
2021,Wandsworth 027A,E01004543,1702,1575,127,73,33,19,2
2021,Wandsworth 021E,E01004544,1467,1315,152,96,41,15,0
2021,Wandsworth 027B,E01004545,1878,1660,218,145,57,11,5
2021,Wandsworth 027C,E01004546,1449,1370,79,49,18,11,1
2021,Wandsworth 029C,E01004547,1379,1267,112,45,40,17,10
2021,Wandsworth 029D,E01004548,1972,1686,286,156,89,34,7
2021,Wandsworth 027D,E01004549,1626,1476,150,85,44,16,5
2021,Wandsworth 017D,E01004550,1303,1180,123,61,42,17,3
2021,Wandsworth 012E,E01004551,1534,1272,262,182,67,11,2
2021,Wandsworth 008C,E01004552,1894,1635,259,190,50,14,5
2021,Wandsworth 015A,E01004553,1705,1530,175,135,31,8,1
2021,Wandsworth 009A,E01004554,1592,1426,166,136,19,7,4
2021,Wandsworth 017E,E01004555,1664,1496,168,138,22,7,1
2021,Wandsworth 009B,E01004556,1560,1363,197,161,29,7,0
2021,Wandsworth 015B,E01004557,1653,1429,224,130,77,15,2
2021,Wandsworth 015C,E01004558,1755,1487,268,211,42,14,1
2021,Wandsworth 015D,E01004559,1419,1255,164,117,25,21,1
2021,Wandsworth 001A,E01004560,1871,1437,434,272,112,45,5
2021,Wandsworth 039E,E01004563,2116,1478,638,321,223,83,11
2021,Wandsworth 039D,E01004564,1826,1584,242,142,67,31,2
2021,Wandsworth 005A,E01004565,1617,1407,210,135,55,15,5
2021,Wandsworth 001B,E01004566,1602,1382,220,153,49,15,3
2021,Wandsworth 039A,E01004567,2262,1679,583,300,183,85,15
2021,Wandsworth 013A,E01004568,1698,1305,393,194,137,56,6
2021,Wandsworth 023A,E01004569,2308,1735,573,242,216,92,23
2021,Wandsworth 023B,E01004570,1853,1214,639,230,264,135,10
2021,Wandsworth 023C,E01004571,1786,1252,534,216,219,87,12
2021,Wandsworth 016A,E01004572,1622,1221,401,201,143,52,5
2021,Wandsworth 023D,E01004573,1628,1161,467,189,179,76,23
2021,Wandsworth 013B,E01004574,2044,1550,494,203,183,95,13
2021,Wandsworth 013C,E01004575,1841,1410,431,199,141,82,9
2021,Wandsworth 013D,E01004576,1528,1161,367,187,126,50,4
2021,Wandsworth 003C,E01004577,1781,1449,332,216,89,24,3
2021,Wandsworth 004B,E01004579,1808,1556,252,151,71,25,5
2021,Wandsworth 004C,E01004580,2043,1582,461,315,114,31,1
2021,Wandsworth 004D,E01004581,1731,1356,375,225,107,38,5
2021,Wandsworth 001C,E01004582,2144,1690,454,303,112,38,1
2021,Wandsworth 001D,E01004583,1670,1308,362,201,105,50,6
2021,Wandsworth 003D,E01004584,1678,1336,342,153,128,49,12
2021,Wandsworth 008D,E01004585,1776,1610,166,129,31,6,0
2021,Wandsworth 009C,E01004586,1840,1658,182,141,36,5,0
2021,Wandsworth 009D,E01004587,1747,1490,257,190,51,15,1
2021,Wandsworth 008E,E01004588,1962,1764,198,154,38,3,3
2021,Wandsworth 009E,E01004589,1725,1509,216,160,38,15,3
2021,Wandsworth 005B,E01004590,1791,1569,222,116,77,26,3
2021,Wandsworth 005C,E01004591,1836,1534,302,194,71,30,7
2021,Wandsworth 005D,E01004592,1623,1485,138,86,38,13,1
2021,Wandsworth 025A,E01004593,1835,1529,306,191,85,26,4
2021,Wandsworth 020D,E01004594,1615,1426,189,131,42,16,0
2021,Wandsworth 025B,E01004595,1715,1448,267,152,83,25,7
2021,Wandsworth 020E,E01004596,1532,1350,182,121,39,20,2
2021,Wandsworth 025C,E01004597,1785,1555,230,130,53,39,8
2021,Wandsworth 025D,E01004598,2023,1752,271,192,51,20,8
2021,Wandsworth 025E,E01004599,1473,1372,101,87,9,5,0
2021,Wandsworth 018D,E01004601,2393,1940,453,228,134,71,20
2021,Wandsworth 010C,E01004602,1602,1413,189,122,37,18,12
2021,Wandsworth 006A,E01004604,1514,1435,79,63,15,1,0
2021,Wandsworth 006B,E01004605,1739,1557,182,124,44,14,0
2021,Wandsworth 006C,E01004606,1601,1480,121,92,26,3,0
2021,Wandsworth 006D,E01004607,1589,1432,157,108,38,9,2
2021,Wandsworth 006E,E01004608,1642,1392,250,167,60,16,7
2021,Wandsworth 010E,E01004609,2084,1738,346,251,70,21,4
2021,Wandsworth 033C,E01004610,1938,1543,395,195,132,54,14
2021,Wandsworth 032B,E01004611,1496,1240,256,125,81,44,6
2021,Wandsworth 032C,E01004612,1545,1159,386,152,136,86,12
2021,Wandsworth 033D,E01004613,1656,1229,427,161,165,86,15
2021,Wandsworth 034A,E01004614,1909,1528,381,162,158,48,13
2021,Wandsworth 034B,E01004615,1583,1300,283,115,96,65,7
2021,Wandsworth 034C,E01004616,1836,1386,450,187,176,81,6
2021,Wandsworth 034D,E01004617,1857,1464,393,182,139,64,8
2021,Wandsworth 032D,E01004618,1461,1278,183,101,52,25,5
2021,Wandsworth 015E,E01004619,1318,1250,68,36,23,9,0
2021,Wandsworth 019C,E01004620,1590,1375,215,123,76,14,2
2021,Wandsworth 019D,E01004621,1659,1509,150,97,33,20,0
2021,Wandsworth 024D,E01004622,1810,1516,294,163,95,34,2
2021,Wandsworth 019E,E01004623,1683,1513,170,100,46,23,1
2021,Wandsworth 024E,E01004624,1504,1344,160,115,24,15,6
2021,Wandsworth 027E,E01004625,1289,1238,51,36,11,3,1
2021,Wandsworth 027F,E01004626,1751,1610,141,85,51,5,0
2021,Wandsworth 019F,E01004627,1525,1397,128,76,33,14,5
2021,Wandsworth 022A,E01004628,2265,1766,499,293,146,56,4
2021,Wandsworth 020F,E01004629,1552,1330,222,135,60,25,2
2021,Wandsworth 022B,E01004630,1697,1264,433,192,178,55,8
2021,Wandsworth 022C,E01004631,1817,1228,589,307,190,81,11
2021,Wandsworth 028A,E01004632,1459,1107,352,189,117,42,4
2021,Wandsworth 022D,E01004633,1576,1092,484,215,174,85,10
2021,Wandsworth 028B,E01004634,1439,1153,286,168,95,19,4
2021,Wandsworth 028C,E01004635,1614,1162,452,240,132,65,15
2021,Wandsworth 028D,E01004636,1421,1026,395,202,138,50,5
2021,Wandsworth 028E,E01004637,1425,1031,394,220,121,43,10
2021,Wandsworth 011B,E01004638,1338,1239,99,67,22,8,2
2021,Wandsworth 011C,E01004639,1661,1328,333,193,112,27,1
2021,Wandsworth 011D,E01004640,1629,1461,168,122,36,9,1
2021,Wandsworth 011E,E01004641,1835,1595,240,148,59,30,3
2021,Wandsworth 016B,E01004642,2058,1684,374,228,106,32,8
2021,Wandsworth 016C,E01004643,2239,1669,570,285,188,79,18
2021,Wandsworth 016D,E01004644,2442,1993,449,262,140,41,6
2021,Wandsworth 016E,E01004645,2045,1521,524,280,166,70,8
2021,Westminster 002A,E01004646,1693,1419,274,132,102,36,4
2021,Westminster 001A,E01004647,1359,1046,313,180,93,34,6
2021,Westminster 002B,E01004648,2236,1718,518,326,128,56,8
2021,Westminster 001B,E01004649,1366,1035,331,167,125,38,1
2021,Westminster 002C,E01004650,1765,1404,361,251,86,23,1
2021,Westminster 003A,E01004651,1728,1196,532,330,138,53,11
2021,Westminster 017A,E01004652,1567,1002,565,355,135,60,15
2021,Westminster 014A,E01004653,1910,1580,330,211,89,24,6
2021,Westminster 014B,E01004654,2343,1725,618,435,155,25,3
2021,Westminster 014D,E01004656,1905,1408,497,322,123,50,2
2021,Westminster 012A,E01004657,1183,800,383,273,92,17,1
2021,Westminster 012B,E01004658,1465,961,504,300,150,48,6
2021,Westminster 008A,E01004659,1606,1205,401,295,80,25,1
2021,Westminster 008B,E01004660,1394,1064,330,243,65,22,0
2021,Westminster 012C,E01004661,1974,1332,642,427,142,70,3
2021,Westminster 012D,E01004662,1291,961,330,254,56,20,0
2021,Westminster 012E,E01004663,1389,1072,317,225,56,33,3
2021,Westminster 024A,E01004665,1417,1043,374,156,129,74,15
2021,Westminster 023D,E01004668,1387,1065,322,157,118,41,6
2021,Westminster 024B,E01004669,1675,1218,457,200,176,71,10
2021,Westminster 009A,E01004670,2662,1870,792,196,304,230,62
2021,Westminster 005A,E01004674,1857,1559,298,137,96,57,8
2021,Westminster 005B,E01004675,2295,1717,578,259,187,108,24
2021,Westminster 006A,E01004676,1442,1076,366,202,123,34,7
2021,Westminster 005C,E01004677,1639,1210,429,225,143,53,8
2021,Westminster 005D,E01004678,1900,1502,398,205,122,65,6
2021,Westminster 005E,E01004679,1926,1441,485,219,175,75,16
2021,Westminster 015A,E01004680,1218,944,274,186,63,23,2
2021,Westminster 016A,E01004681,1804,1260,544,345,140,50,9
2021,Westminster 016B,E01004682,1259,814,445,299,123,21,2
2021,Westminster 015B,E01004683,1443,1023,420,233,162,22,3
2021,Westminster 015C,E01004684,1307,904,403,214,124,54,11
2021,Westminster 015E,E01004686,1365,775,590,318,146,109,17
2021,Westminster 019A,E01004687,1299,1022,277,206,57,11,3
2021,Westminster 019D,E01004690,1047,738,309,166,86,47,10
2021,Westminster 019E,E01004691,1117,748,369,239,96,34,0
2021,Westminster 019F,E01004692,970,665,305,141,141,20,3
2021,Westminster 017B,E01004693,1175,903,272,188,71,12,1
2021,Westminster 016C,E01004694,1441,964,477,337,110,25,5
2021,Westminster 017C,E01004695,1052,665,387,224,143,18,2
2021,Westminster 017D,E01004696,1411,985,426,199,155,63,9
2021,Westminster 016D,E01004697,1296,895,401,260,107,27,7
2021,Westminster 017E,E01004698,1300,862,438,280,97,52,9
2021,Westminster 017F,E01004699,1701,1128,573,398,124,49,2
2021,Westminster 016E,E01004700,1435,1014,421,269,112,35,5
2021,Westminster 007A,E01004701,1481,1055,426,316,68,37,5
2021,Westminster 009E,E01004702,2715,1789,926,370,280,230,46
2021,Westminster 007B,E01004703,1928,1497,431,265,97,52,17
2021,Westminster 007D,E01004705,1211,975,236,168,50,18,0
2021,Westminster 006B,E01004706,1415,1119,296,246,40,8,2
2021,Westminster 006C,E01004707,1763,1403,360,292,51,15,2
2021,Westminster 006D,E01004708,1496,1122,374,208,121,39,6
2021,Westminster 007E,E01004709,1661,1190,471,254,137,77,3
2021,Westminster 002D,E01004710,1890,1230,660,368,183,83,26
2021,Westminster 002E,E01004711,1912,1438,474,226,161,84,3
2021,Westminster 008C,E01004712,1420,1006,414,289,86,32,7
2021,Westminster 011A,E01004713,1281,954,327,261,35,31,0
2021,Westminster 011B,E01004714,1632,1210,422,295,107,17,3
2021,Westminster 013A,E01004715,1779,1223,556,362,129,59,6
2021,Westminster 011C,E01004716,1010,794,216,170,43,1,2
2021,Westminster 011D,E01004717,1243,885,358,273,66,18,1
2021,Westminster 004A,E01004718,1810,1453,357,159,120,61,17
2021,Westminster 004B,E01004719,1765,1391,374,154,156,59,5
2021,Westminster 004C,E01004720,2185,1808,377,163,132,75,7
2021,Westminster 004D,E01004721,1810,1376,434,162,169,93,10
2021,Westminster 004E,E01004722,2630,1902,728,280,280,148,20
2021,Westminster 005F,E01004723,2158,1646,512,228,189,87,8
2021,Westminster 001C,E01004724,1868,1409,459,318,102,36,3
2021,Westminster 003B,E01004725,1265,965,300,160,102,33,5
2021,Westminster 003C,E01004726,1648,1243,405,251,99,51,4
2021,Westminster 008D,E01004727,1505,994,511,306,149,53,3
2021,Westminster 003D,E01004728,1426,1031,395,210,103,74,8
2021,Westminster 003E,E01004729,1456,1029,427,199,133,82,13
2021,Westminster 001D,E01004730,1420,1092,328,207,88,28,5
2021,Westminster 020A,E01004731,1950,1375,575,397,127,48,3
2021,Westminster 020B,E01004732,1282,1004,278,122,92,59,5
2021,Westminster 020C,E01004733,2070,1548,522,350,119,50,3
2021,Westminster 018A,E01004734,1673,1191,482,260,137,66,19
2021,Westminster 018B,E01004735,1980,1503,477,267,156,50,4
2021,Westminster 018C,E01004736,1444,1116,328,209,101,16,2
2021,Westminster 024C,E01004737,1193,972,221,132,71,18,0
2021,Westminster 021A,E01004740,1279,997,282,138,103,33,8
2021,Westminster 024F,E01004741,1255,958,297,191,84,21,1
2021,Westminster 022A,E01004742,1241,969,272,188,72,10,2
2021,Westminster 021B,E01004743,1469,1056,413,217,134,56,6
2021,Westminster 020D,E01004744,1420,1115,305,192,78,29,6
2021,Westminster 021D,E01004746,1230,930,300,145,95,56,4
2021,Westminster 021E,E01004747,2123,1587,536,288,152,75,21
2021,Westminster 020E,E01004748,1196,906,290,211,54,24,1
2021,Westminster 022B,E01004749,2153,1655,498,330,115,49,4
2021,Westminster 023E,E01004750,1553,1153,400,205,127,56,12
2021,Westminster 022C,E01004751,1687,1429,258,194,50,14,0
2021,Westminster 022D,E01004752,1337,1108,229,127,61,38,3
2021,Westminster 022E,E01004753,1724,1398,326,243,63,18,2
2021,Westminster 010A,E01004754,1828,1241,587,260,195,107,25
2021,Westminster 010B,E01004755,2392,1696,696,351,227,103,15
2021,Westminster 006E,E01004756,1484,1112,372,248,68,53,3
2021,Westminster 010C,E01004757,1605,1170,435,182,168,78,7
2021,Westminster 014E,E01004760,1647,1331,316,176,106,28,6
2021,Westminster 018D,E01004761,1175,865,310,195,91,24,0
2021,Westminster 011E,E01004762,1513,1109,404,225,119,56,4
2021,Westminster 013B,E01004763,1999,1419,580,408,125,34,13
2021,Westminster 013D,E01004765,1825,1279,546,408,82,52,4
2021,Bolton 005A,E01004766,1596,1472,124,44,45,28,7
2021,Bolton 005B,E01004767,1829,1646,183,72,69,36,6
2021,Bolton 001A,E01004768,1557,1532,25,15,7,2,1
2021,Bolton 003A,E01004769,1473,1445,28,17,6,3,2
2021,Bolton 003B,E01004770,1476,1398,78,23,38,13,4
2021,Bolton 003C,E01004771,1629,1577,52,31,17,4,0
2021,Bolton 005C,E01004772,1781,1691,90,31,33,21,5
2021,Bolton 003D,E01004773,1890,1754,136,63,49,22,2
2021,Bolton 005D,E01004774,1705,1606,99,31,47,19,2
2021,Bolton 014A,E01004775,2230,2156,74,36,28,7,3
2021,Bolton 031A,E01004776,1770,1722,48,23,22,2,1
2021,Bolton 004A,E01004777,1668,1637,31,12,7,12,0
2021,Bolton 009A,E01004778,1164,1156,8,3,3,1,1
2021,Bolton 007A,E01004779,1565,1536,29,8,14,7,0
2021,Bolton 009B,E01004780,2214,2182,32,7,16,8,1
2021,Bolton 007B,E01004781,2071,1978,93,43,35,14,1
2021,Bolton 009C,E01004782,1306,1287,19,8,8,3,0
2021,Bolton 009D,E01004783,1442,1433,9,4,3,1,1
2021,Bolton 006A,E01004784,1168,1162,6,2,2,2,0
2021,Bolton 006B,E01004785,1483,1451,32,11,13,8,0
2021,Bolton 006C,E01004786,1417,1403,14,2,7,4,1
2021,Bolton 013A,E01004787,1629,1540,89,26,39,15,9
2021,Bolton 002A,E01004788,1337,1326,11,4,4,2,1
2021,Bolton 006D,E01004789,1420,1416,4,2,1,1,0
2021,Bolton 002B,E01004790,1380,1358,22,12,8,2,0
2021,Bolton 006E,E01004791,1289,1281,8,3,4,0,1
2021,Bolton 006F,E01004792,1385,1377,8,6,2,0,0
2021,Bolton 013B,E01004793,1711,1602,109,44,38,22,5
2021,Bolton 013C,E01004794,2023,1849,174,60,72,33,9
2021,Bolton 013D,E01004795,1462,1409,53,17,24,10,2
2021,Bolton 019A,E01004796,1538,1469,69,28,22,17,2
2021,Bolton 013E,E01004797,1440,1303,137,52,56,26,3
2021,Bolton 019B,E01004798,1554,1487,67,34,18,13,2
2021,Bolton 019C,E01004799,1253,1223,30,12,10,8,0
2021,Bolton 019D,E01004800,1254,1234,20,10,6,4,0
2021,Bolton 019E,E01004801,1608,1529,79,34,23,18,4
2021,Bolton 010A,E01004802,1901,1729,172,77,57,36,2
2021,Bolton 001B,E01004803,1578,1566,12,9,3,0,0
2021,Bolton 001C,E01004804,1430,1418,12,7,4,1,0
2021,Bolton 002C,E01004805,1538,1528,10,8,2,0,0
2021,Bolton 002D,E01004806,1470,1457,13,3,4,3,3
2021,Bolton 001D,E01004807,1338,1322,16,7,4,5,0
2021,Bolton 001E,E01004808,1583,1565,18,13,4,0,1
2021,Bolton 003E,E01004809,1692,1678,14,7,3,3,1
2021,Bolton 002E,E01004810,1532,1521,11,6,3,2,0
2021,Bolton 022A,E01004811,1726,1103,623,167,257,158,41
2021,Bolton 022B,E01004812,2240,1455,785,165,300,259,61
2021,Bolton 022C,E01004813,1629,1269,360,101,149,92,18
2021,Bolton 027A,E01004814,1530,1293,237,64,85,63,25
2021,Bolton 022D,E01004815,1699,1271,428,114,189,104,21
2021,Bolton 029A,E01004816,2605,1917,688,169,322,135,62
2021,Bolton 022E,E01004817,2003,1587,416,147,160,91,18
2021,Bolton 017A,E01004818,1632,1235,397,117,157,100,23
2021,Bolton 017B,E01004819,1477,1298,179,71,65,41,2
2021,Bolton 011A,E01004820,1706,1217,489,148,186,140,15
2021,Bolton 016B,E01004822,1788,1284,504,140,191,139,34
2021,Bolton 016C,E01004823,1972,1494,478,141,177,133,27
2021,Bolton 005E,E01004824,1817,1230,587,164,220,170,33
2021,Bolton 011B,E01004825,1853,1201,652,135,331,159,27
2021,Bolton 011C,E01004826,1580,1043,537,155,227,138,17
2021,Bolton 021A,E01004827,1887,1218,669,186,268,167,48
2021,Bolton 023A,E01004828,1923,1260,663,198,274,173,18
2021,Bolton 023B,E01004829,1390,890,500,107,207,160,26
2021,Bolton 026A,E01004830,1665,1300,365,91,159,95,20
2021,Bolton 026B,E01004831,1756,1468,288,92,96,78,22
2021,Bolton 023C,E01004832,1558,1322,236,83,91,51,11
2021,Bolton 026C,E01004833,1484,1383,101,40,39,15,7
2021,Bolton 018A,E01004834,1644,1283,361,103,148,89,21
2021,Bolton 020A,E01004835,1425,1255,170,66,67,33,4
2021,Bolton 020B,E01004836,1689,1481,208,76,70,50,12
2021,Bolton 020C,E01004837,1533,1429,104,50,33,16,5
2021,Bolton 018B,E01004838,1924,1426,498,139,233,92,34
2021,Bolton 026D,E01004839,2278,1903,375,135,150,75,15
2021,Bolton 012A,E01004840,1681,1629,52,17,15,19,1
2021,Bolton 012B,E01004841,1690,1562,128,48,47,32,1
2021,Bolton 012C,E01004842,1670,1629,41,17,13,11,0
2021,Bolton 018C,E01004843,1500,1433,67,31,19,15,2
2021,Bolton 020D,E01004844,1540,1449,91,56,24,11,0
2021,Bolton 018D,E01004845,1814,1611,203,112,53,32,6
2021,Bolton 025A,E01004846,1344,890,454,148,172,92,42
2021,Bolton 025B,E01004847,2187,1562,625,179,264,143,39
2021,Bolton 016D,E01004848,2017,1524,493,150,202,120,21
2021,Bolton 021B,E01004849,1715,1006,709,200,270,208,31
2021,Bolton 021C,E01004850,2146,1386,760,178,324,236,22
2021,Bolton 021D,E01004851,1625,991,634,174,255,168,37
2021,Bolton 025C,E01004852,1658,1136,522,143,222,132,25
2021,Bolton 021E,E01004853,1513,987,526,150,189,158,29
2021,Bolton 023D,E01004854,1574,1043,531,95,191,215,30
2021,Bolton 027B,E01004855,1410,1314,96,36,34,21,5
2021,Bolton 027C,E01004856,1455,1217,238,72,109,45,12
2021,Bolton 027D,E01004857,1821,1539,282,77,120,68,17
2021,Bolton 032A,E01004858,1528,1423,105,39,47,16,3
2021,Bolton 032B,E01004859,1453,1379,74,31,21,20,2
2021,Bolton 032C,E01004860,1405,1346,59,33,9,14,3
2021,Bolton 033A,E01004861,1869,1681,188,82,69,32,5
2021,Bolton 033B,E01004862,1377,1303,74,30,25,13,6
2021,Bolton 033C,E01004863,1505,1394,111,45,40,21,5
2021,Bolton 008A,E01004864,1414,1330,84,26,35,19,4
2021,Bolton 011D,E01004865,1507,1317,190,51,75,55,9
2021,Bolton 011E,E01004866,1957,1512,445,116,177,136,16
2021,Bolton 008B,E01004867,1481,1179,302,99,117,72,14
2021,Bolton 015A,E01004868,2052,1506,546,180,224,113,29
2021,Bolton 015B,E01004869,1978,1331,647,135,259,192,61
2021,Bolton 015C,E01004870,1938,1464,474,138,167,129,40
2021,Bolton 015D,E01004871,1729,1103,626,142,267,171,46
2021,Bolton 029B,E01004872,1642,1449,193,64,75,47,7
2021,Bolton 029C,E01004873,1949,1630,319,104,140,65,10
2021,Bolton 033D,E01004874,1703,1619,84,33,29,17,5
2021,Bolton 029D,E01004875,1592,1505,87,41,30,14,2
2021,Bolton 033E,E01004876,1900,1683,217,41,92,71,13
2021,Bolton 025D,E01004877,1984,1455,529,179,204,127,19
2021,Bolton 023E,E01004878,1630,1255,375,126,163,76,10
2021,Bolton 025E,E01004879,1591,1201,390,131,147,96,16
2021,Bolton 029E,E01004880,1426,1203,223,88,85,44,6
2021,Bolton 004B,E01004881,1448,1417,31,10,10,8,3
2021,Bolton 007C,E01004882,1310,1292,18,12,4,1,1
2021,Bolton 007D,E01004883,1715,1648,67,25,29,11,2
2021,Bolton 007E,E01004884,1446,1436,10,3,5,2,0
2021,Bolton 014B,E01004885,1392,1340,52,30,13,8,1
2021,Bolton 014C,E01004886,1352,1313,39,16,12,9,2
2021,Bolton 014D,E01004887,1300,1248,52,17,28,7,0
2021,Bolton 004C,E01004888,1246,1222,24,6,11,5,2
2021,Bolton 004D,E01004889,1397,1376,21,14,7,0,0
2021,Bolton 004E,E01004890,1348,1308,40,18,12,10,0
2021,Bolton 028A,E01004891,1497,1463,34,12,11,10,1
2021,Bolton 030A,E01004892,1538,1506,32,12,15,4,1
2021,Bolton 028B,E01004893,1486,1461,25,9,5,10,1
2021,Bolton 028C,E01004894,1859,1805,54,25,17,9,3
2021,Bolton 031B,E01004895,1300,1287,13,4,4,4,1
2021,Bolton 030B,E01004896,1286,1273,13,4,3,6,0
2021,Bolton 020E,E01004897,985,953,32,16,9,6,1
2021,Bolton 030C,E01004899,1549,1423,126,49,57,15,5
2021,Bolton 030D,E01004900,1554,1382,172,68,63,36,5
2021,Bolton 028E,E01004901,1737,1718,19,11,5,3,0
2021,Bolton 032D,E01004902,1797,1679,118,53,37,25,3
2021,Bolton 034A,E01004903,1406,1388,18,8,8,2,0
2021,Bolton 034B,E01004904,1620,1585,35,25,6,4,0
2021,Bolton 034C,E01004905,1536,1471,65,23,25,16,1
2021,Bolton 032E,E01004906,1737,1634,103,37,30,31,5
2021,Bolton 034D,E01004907,1262,1234,28,15,9,4,0
2021,Bolton 034E,E01004908,1265,1247,18,6,9,3,0
2021,Bolton 034F,E01004909,1357,1329,28,15,11,2,0
2021,Bolton 034G,E01004910,1957,1912,45,21,15,7,2
2021,Bolton 024A,E01004911,1492,1477,15,1,8,5,1
2021,Bolton 024B,E01004912,1410,1382,28,10,14,4,0
2021,Bolton 024C,E01004913,1902,1880,22,5,12,4,1
2021,Bolton 024D,E01004914,1154,1147,7,3,2,2,0
2021,Bolton 024E,E01004915,1248,1231,17,9,5,2,1
2021,Bolton 024F,E01004916,1424,1382,42,19,14,7,2
2021,Bolton 019F,E01004917,2214,2157,57,26,18,10,3
2021,Bolton 024G,E01004918,1205,1192,13,4,5,3,1
2021,Bolton 012D,E01004919,1469,1414,55,21,21,12,1
2021,Bolton 012E,E01004920,1582,1504,78,32,34,11,1
2021,Bolton 008C,E01004921,1562,1467,95,30,33,25,7
2021,Bolton 015E,E01004922,2165,1744,421,139,158,109,15
2021,Bolton 018E,E01004923,1606,1375,231,95,85,42,9
2021,Bolton 008D,E01004924,1519,1494,25,12,7,3,3
2021,Bolton 008E,E01004925,1526,1440,86,22,40,16,8
2021,Bolton 010B,E01004926,1374,1278,96,45,31,15,5
2021,Bolton 010C,E01004927,2199,2047,152,53,58,36,5
2021,Bolton 017C,E01004928,1318,1228,90,29,39,17,5
2021,Bolton 010D,E01004929,2585,2382,203,75,88,36,4
2021,Bolton 017D,E01004930,1458,1422,36,21,8,7,0
2021,Bolton 017E,E01004931,1518,1453,65,24,23,13,5
2021,Bolton 017F,E01004932,1430,1340,90,36,35,15,4
2021,Bolton 035A,E01004933,1278,1262,16,6,3,6,1
2021,Bolton 035B,E01004934,1399,1369,30,19,10,1,0
2021,Bolton 035C,E01004935,1773,1752,21,13,3,4,1
2021,Bolton 031C,E01004936,2090,2045,45,22,13,9,1
2021,Bolton 035D,E01004937,1581,1562,19,10,4,3,2
2021,Bolton 031D,E01004938,1524,1483,41,17,19,5,0
2021,Bolton 031E,E01004939,1549,1521,28,8,10,10,0
2021,Bolton 035E,E01004940,1388,1348,40,17,15,7,1
2021,Bury 021A,E01004941,1801,1678,123,49,45,27,2
2021,Bury 021B,E01004942,1623,1449,174,67,66,33,8
2021,Bury 021C,E01004943,1765,1568,197,88,78,28,3
2021,Bury 021D,E01004944,1478,1402,76,36,21,15,4
2021,Bury 017A,E01004945,1494,1462,32,16,10,6,0
2021,Bury 021E,E01004946,1602,1524,78,35,25,16,2
2021,Bury 009A,E01004947,1479,1388,91,27,33,24,7
2021,Bury 009B,E01004948,1808,1699,109,44,35,22,8
2021,Bury 010A,E01004949,1373,1361,12,4,3,5,0
2021,Bury 010B,E01004950,1462,1453,9,3,6,0,0
2021,Bury 010C,E01004951,1534,1504,30,9,14,6,1
2021,Bury 010D,E01004952,1324,1298,26,4,11,10,1
2021,Bury 010E,E01004953,1500,1471,29,10,6,12,1
2021,Bury 007A,E01004954,1409,1313,96,45,39,12,0
2021,Bury 007B,E01004955,1322,1230,92,35,44,12,1
2021,Bury 007C,E01004956,1712,1584,128,44,46,36,2
2021,Bury 007D,E01004957,1808,1495,313,104,124,69,16
2021,Bury 008A,E01004958,1435,1221,214,60,89,49,16
2021,Bury 008B,E01004959,1661,1416,245,75,95,58,17
2021,Bury 007E,E01004960,1570,1289,281,78,118,75,10
2021,Bury 005A,E01004961,1401,1371,30,13,8,8,1
2021,Bury 009C,E01004962,1929,1870,59,27,18,11,3
2021,Bury 006A,E01004963,1431,1397,34,16,11,7,0
2021,Bury 009D,E01004964,1782,1698,84,35,31,14,4
2021,Bury 005B,E01004965,1205,1185,20,11,6,3,0
2021,Bury 005C,E01004966,1766,1670,96,43,30,19,4
2021,Bury 005D,E01004967,1157,1118,39,17,13,7,2
2021,Bury 006B,E01004968,1439,1427,12,8,3,0,1
2021,Bury 022A,E01004969,1463,1361,102,30,50,20,2
2021,Bury 022B,E01004970,1555,1455,100,35,35,21,9
2021,Bury 022C,E01004971,1437,1347,90,44,34,10,2
2021,Bury 023A,E01004972,1454,1327,127,47,48,27,5
2021,Bury 023B,E01004973,1483,1390,93,48,30,15,0
2021,Bury 024A,E01004974,1362,1304,58,29,20,6,3
2021,Bury 023C,E01004975,1443,1360,83,33,34,13,3
2021,Bury 004A,E01004976,1485,1381,104,50,36,12,6
2021,Bury 004B,E01004977,1656,1608,48,20,17,11,0
2021,Bury 004C,E01004978,1785,1565,220,65,77,59,19
2021,Bury 008C,E01004979,1713,1339,374,102,142,112,18
2021,Bury 008D,E01004980,1375,1148,227,69,87,55,16
2021,Bury 004D,E01004981,1429,1404,25,11,7,5,2
2021,Bury 004E,E01004982,1453,1421,32,14,9,8,1
2021,Bury 020A,E01004983,1309,1152,157,70,53,32,2
2021,Bury 019A,E01004984,1352,1311,41,23,11,6,1
2021,Bury 019B,E01004985,1413,1367,46,29,9,8,0
2021,Bury 020B,E01004986,1571,1473,98,50,34,11,3
2021,Bury 020C,E01004987,1286,1208,78,23,28,20,7
2021,Bury 020D,E01004988,1344,1290,54,21,20,9,4
2021,Bury 019C,E01004989,1386,1334,52,30,14,8,0
2021,Bury 016A,E01004990,1532,1477,55,15,24,16,0
2021,Bury 015A,E01004991,1331,1267,64,31,25,6,2
2021,Bury 015B,E01004992,1376,1304,72,27,25,18,2
2021,Bury 015C,E01004993,1907,1794,113,54,40,17,2
2021,Bury 015D,E01004994,1302,1209,93,29,45,17,2
2021,Bury 018A,E01004995,1469,1438,31,12,12,6,1
2021,Bury 016B,E01004996,1453,1371,82,20,38,23,1
2021,Bury 014A,E01004997,1487,1425,62,20,22,18,2
2021,Bury 014B,E01004998,1615,1587,28,11,9,8,0
2021,Bury 014C,E01004999,1430,1390,40,19,11,10,0
2021,Bury 012A,E01005000,1447,1435,12,10,2,0,0
2021,Bury 012B,E01005001,1245,1218,27,9,9,8,1
2021,Bury 014D,E01005002,1471,1442,29,16,7,6,0
2021,Bury 014E,E01005003,1416,1345,71,11,39,18,3
2021,Bury 016C,E01005004,1521,1433,88,27,31,27,3
2021,Bury 012C,E01005005,1380,1374,6,3,2,1,0
2021,Bury 012D,E01005006,1949,1906,43,19,15,7,2
2021,Bury 019D,E01005007,1472,1423,49,25,20,4,0
2021,Bury 016D,E01005008,2073,1930,143,49,49,35,10
2021,Bury 016E,E01005009,1696,1535,161,61,62,34,4
2021,Bury 018B,E01005010,1557,1505,52,22,21,8,1
2021,Bury 019E,E01005011,1374,1341,33,20,8,4,1
2021,Bury 018C,E01005012,1688,1610,78,29,27,19,3
2021,Bury 018D,E01005013,2515,2340,175,81,55,33,6
2021,Bury 001A,E01005014,1429,1409,20,7,11,2,0
2021,Bury 001B,E01005015,1459,1424,35,8,11,13,3
2021,Bury 001C,E01005016,1454,1433,21,12,5,4,0
2021,Bury 001D,E01005017,1782,1757,25,14,4,6,1
2021,Bury 001E,E01005018,1483,1454,29,12,12,5,0
2021,Bury 002A,E01005019,1464,1451,13,9,4,0,0
2021,Bury 003A,E01005020,1335,1325,10,4,3,3,0
2021,Bury 001F,E01005021,1201,1100,101,47,52,2,0
2021,Bury 003B,E01005022,1457,1447,10,7,3,0,0
2021,Bury 002B,E01005023,1258,1243,15,8,6,1,0
2021,Bury 008E,E01005024,2527,1731,796,234,303,201,58
2021,Bury 011A,E01005025,1639,1471,168,53,71,39,5
2021,Bury 008F,E01005026,2071,1398,673,209,265,156,43
2021,Bury 011B,E01005027,1784,1433,351,102,112,112,25
2021,Bury 011C,E01005028,2140,1684,456,118,212,104,22
2021,Bury 011D,E01005029,1901,1528,373,102,165,86,20
2021,Bury 013A,E01005030,1716,1542,174,54,67,47,6
2021,Bury 025A,E01005031,1483,1369,114,51,40,19,4
2021,Bury 025B,E01005032,1282,1121,161,65,64,29,3
2021,Bury 024B,E01005033,1584,1469,115,45,41,21,8
2021,Bury 022D,E01005034,1722,1656,66,33,21,11,1
2021,Bury 025C,E01005035,1390,1346,44,23,11,9,1
2021,Bury 024C,E01005036,1935,1768,167,68,54,42,3
2021,Bury 024D,E01005037,1426,1340,86,44,28,8,6
2021,Bury 025D,E01005038,1312,1240,72,36,24,10,2
2021,Bury 023D,E01005039,1510,1415,95,45,32,16,2
2021,Bury 026A,E01005040,1770,1576,194,69,79,38,8
2021,Bury 026B,E01005041,1791,1621,170,66,58,32,14
2021,Bury 026C,E01005042,1850,1726,124,55,41,24,4
2021,Bury 026D,E01005043,1829,1701,128,70,37,17,4
2021,Bury 026E,E01005044,1850,1664,186,45,78,48,15
2021,Bury 023E,E01005045,1576,1488,88,46,24,17,1
2021,Bury 002C,E01005046,1458,1452,6,5,1,0,0
2021,Bury 003C,E01005047,1444,1436,8,4,2,1,1
2021,Bury 002D,E01005048,1620,1612,8,4,3,1,0
2021,Bury 003D,E01005049,1601,1586,15,9,3,2,1
2021,Bury 006C,E01005050,2071,2041,30,15,10,4,1
2021,Bury 003E,E01005051,1500,1475,25,13,8,4,0
2021,Bury 006D,E01005052,1407,1396,11,4,3,3,1
2021,Bury 006E,E01005053,1489,1473,16,6,5,5,0
2021,Bury 013B,E01005054,1535,1491,44,18,21,5,0
2021,Bury 017B,E01005055,1406,1352,54,27,20,6,1
2021,Bury 017C,E01005056,1245,1210,35,16,8,11,0
2021,Bury 017D,E01005057,1578,1544,34,17,8,9,0
2021,Bury 017E,E01005058,1306,1256,50,19,23,5,3
2021,Bury 013C,E01005059,1721,1537,184,71,68,36,9
2021,Bury 013D,E01005060,1682,1582,100,25,46,26,3
2021,Manchester 018A,E01005061,1720,1298,422,176,144,76,26
2021,Manchester 018C,E01005063,2033,1409,624,258,223,128,15
2021,Manchester 018D,E01005065,2081,1437,644,268,252,105,19
2021,Manchester 018E,E01005066,1011,696,315,128,142,35,10
2021,Manchester 020A,E01005067,1949,1378,571,214,232,110,15
2021,Manchester 051A,E01005068,1624,1475,149,78,54,15,2
2021,Manchester 047A,E01005069,1377,1304,73,37,25,6,5
2021,Manchester 051B,E01005070,1776,1572,204,110,71,18,5
2021,Manchester 048A,E01005071,1667,1520,147,65,65,13,4
2021,Manchester 048B,E01005072,1698,1505,193,98,67,25,3
2021,Manchester 048C,E01005073,1500,1390,110,54,34,18,4
2021,Manchester 051C,E01005074,1558,1423,135,65,38,25,7
2021,Manchester 051D,E01005075,1495,1379,116,48,44,20,4
2021,Manchester 039A,E01005076,1326,1230,96,75,13,8,0
2021,Manchester 042A,E01005077,1624,1428,196,83,71,30,12
2021,Manchester 042B,E01005078,1529,1277,252,103,61,69,19
2021,Manchester 042C,E01005079,1588,1437,151,74,40,29,8
2021,Manchester 039C,E01005081,1737,1454,283,117,118,37,11
2021,Manchester 037A,E01005082,1740,1563,177,107,40,25,5
2021,Manchester 039D,E01005083,1804,1621,183,111,53,17,2
2021,Manchester 042D,E01005084,1949,1804,145,79,50,14,2
2021,Manchester 049A,E01005085,1592,1395,197,90,67,29,11
2021,Manchester 049B,E01005086,1806,1598,208,92,85,28,3
2021,Manchester 050A,E01005087,2192,1890,302,122,125,48,7
2021,Manchester 050B,E01005088,1846,1684,162,68,64,26,4
2021,Manchester 049C,E01005089,1879,1648,231,104,85,36,6
2021,Manchester 050C,E01005090,1808,1639,169,60,76,27,6
2021,Manchester 050D,E01005091,2267,1845,422,175,176,53,18
2021,Manchester 015A,E01005092,1821,1449,372,130,155,62,25
2021,Manchester 012A,E01005093,1776,1488,288,105,125,47,11
2021,Manchester 012B,E01005094,1614,1321,293,115,101,67,10
2021,Manchester 012C,E01005097,1879,1556,323,152,127,37,7
2021,Manchester 001A,E01005098,1570,1438,132,62,42,23,5
2021,Manchester 001B,E01005099,1864,1620,244,106,81,53,4
2021,Manchester 001C,E01005100,1601,1450,151,56,63,24,8
2021,Manchester 002A,E01005101,1810,1663,147,58,46,36,7
2021,Manchester 001D,E01005102,1314,1221,93,27,37,25,4
2021,Manchester 001E,E01005103,1764,1633,131,54,49,23,5
2021,Manchester 004A,E01005104,1893,1507,386,175,139,66,6
2021,Manchester 015C,E01005105,2825,1897,928,386,294,210,38
2021,Manchester 015D,E01005106,2222,1739,483,161,190,111,21
2021,Manchester 015E,E01005107,1944,1567,377,166,129,69,13
2021,Manchester 047B,E01005111,1380,1301,79,38,31,10,0
2021,Manchester 048D,E01005112,1662,1530,132,69,42,18,3
2021,Manchester 047C,E01005113,1590,1460,130,50,48,29,3
2021,Manchester 047D,E01005114,1700,1546,154,87,46,19,2
2021,Manchester 044A,E01005115,1816,1645,171,84,66,19,2
2021,Manchester 047E,E01005116,1997,1787,210,123,63,21,3
2021,Manchester 048E,E01005117,2318,1994,324,142,118,57,7
2021,Manchester 034A,E01005118,1436,1191,245,84,106,43,12
2021,Manchester 041A,E01005119,1680,1459,221,82,91,41,7
2021,Manchester 034B,E01005120,1817,1510,307,126,110,65,6
2021,Manchester 041B,E01005121,1619,1363,256,71,99,75,11
2021,Manchester 041C,E01005122,1841,1536,305,127,118,50,10
2021,Manchester 041D,E01005123,1707,1463,244,90,99,43,12
2021,Manchester 041E,E01005124,1790,1549,241,103,93,38,7
2021,Manchester 040A,E01005125,1505,1322,183,74,66,39,4
2021,Manchester 045A,E01005126,1935,1703,232,95,88,45,4
2021,Manchester 055A,E01005128,2022,1102,920,380,485,53,2
2021,Manchester 061A,E01005129,1799,1504,295,135,103,48,9
2021,Manchester 054A,E01005130,1395,1178,217,94,72,43,8
2021,Manchester 061B,E01005132,2039,1695,344,140,123,63,18
2021,Manchester 002B,E01005135,1799,1504,295,120,115,51,9
2021,Manchester 002C,E01005136,1466,1327,139,66,43,26,4
2021,Manchester 002D,E01005138,2334,1991,343,170,117,52,4
2021,Manchester 003B,E01005139,1869,1642,227,93,88,44,2
2021,Manchester 003C,E01005141,1894,1701,193,77,85,23,8
2021,Manchester 058A,E01005142,2164,1448,716,236,253,195,32
2021,Manchester 056A,E01005143,2863,1880,983,272,365,293,53
2021,Manchester 008A,E01005145,2870,1644,1226,379,464,315,68
2021,Manchester 058B,E01005147,2653,1821,832,348,286,166,32
2021,Manchester 008C,E01005149,2043,1312,731,210,300,181,40
2021,Manchester 029A,E01005150,1654,1532,122,70,30,19,3
2021,Manchester 029B,E01005151,1440,1334,106,47,43,15,1
2021,Manchester 029C,E01005152,1355,1287,68,38,19,10,1
2021,Manchester 037B,E01005153,1505,1442,63,36,19,7,1
2021,Manchester 033A,E01005154,1394,1311,83,42,25,14,2
2021,Manchester 037C,E01005155,1373,1315,58,37,8,12,1
2021,Manchester 033B,E01005156,1419,1366,53,34,13,5,1
2021,Manchester 037D,E01005157,1484,1455,29,21,5,2,1
2021,Manchester 033C,E01005158,1437,1311,126,55,54,9,8
2021,Manchester 029D,E01005159,1572,1462,110,58,34,16,2
2021,Manchester 004B,E01005160,1888,1503,385,134,157,81,13
2021,Manchester 004C,E01005161,1735,1379,356,120,147,60,29
2021,Manchester 004D,E01005162,1809,1451,358,126,140,64,28
2021,Manchester 004E,E01005163,1690,1345,345,99,139,85,22
2021,Manchester 006A,E01005164,2194,1467,727,248,312,138,29
2021,Manchester 008D,E01005165,2208,1559,649,196,271,158,24
2021,Manchester 008E,E01005166,2041,1312,729,200,277,202,50
2021,Manchester 008F,E01005167,2210,1441,769,266,301,168,34
2021,Manchester 045B,E01005168,1356,1294,62,28,23,8,3
2021,Manchester 045C,E01005169,1327,1252,75,43,20,8,4
2021,Manchester 045D,E01005170,1461,1310,151,69,56,18,8
2021,Manchester 045E,E01005171,1675,1460,215,106,69,35,5
2021,Manchester 043A,E01005172,1508,1415,93,58,26,8,1
2021,Manchester 043B,E01005173,1569,1453,116,79,23,12,2
2021,Manchester 043C,E01005174,1510,1425,85,56,16,13,0
2021,Manchester 043D,E01005175,1533,1394,139,86,33,15,5
2021,Manchester 043E,E01005176,1635,1495,140,77,47,13,3
2021,Manchester 043F,E01005177,1254,1166,88,52,25,10,1
2021,Manchester 030A,E01005178,1943,1563,380,164,152,53,11
2021,Manchester 030B,E01005179,2165,1788,377,173,138,57,9
2021,Manchester 030C,E01005180,1819,1431,388,169,139,66,14
2021,Manchester 030D,E01005181,2135,1734,401,168,126,90,17
2021,Manchester 030E,E01005182,1571,1293,278,101,112,50,15
2021,Manchester 030F,E01005183,1755,1454,301,105,125,56,15
2021,Manchester 032A,E01005184,2224,1793,431,232,122,66,11
2021,Manchester 032B,E01005185,3246,3028,218,156,43,18,1
2021,Manchester 020B,E01005186,2755,2148,607,188,230,167,22
2021,Manchester 021A,E01005187,2108,1575,533,189,194,131,19
2021,Manchester 021B,E01005188,1836,1569,267,79,107,74,7
2021,Manchester 017D,E01005189,1611,1322,289,91,121,56,21
2021,Manchester 017E,E01005190,2349,1869,480,186,186,94,14
2021,Manchester 021C,E01005191,1721,1318,403,157,151,73,22
2021,Manchester 021D,E01005192,1656,1352,304,116,124,50,14
2021,Manchester 021E,E01005193,1671,1415,256,91,97,59,9
2021,Manchester 023A,E01005195,2325,1875,450,166,187,87,10
2021,Manchester 023C,E01005197,1669,1374,295,100,107,82,6
2021,Manchester 023D,E01005198,1964,1453,511,197,192,105,17
2021,Manchester 064C,E01005199,2401,1633,768,242,296,187,43
2021,Manchester 064A,E01005200,2331,1810,521,164,216,115,26
2021,Manchester 023E,E01005201,1978,1307,671,202,295,149,25
2021,Manchester 009A,E01005202,2238,1728,510,223,167,97,23
2021,Manchester 009B,E01005203,1919,1563,356,134,130,87,5
2021,Manchester 006B,E01005205,2089,1708,381,152,140,78,11
2021,Manchester 006C,E01005206,1793,1433,360,108,140,107,5
2021,Manchester 006D,E01005207,1920,1517,403,148,153,88,14
2021,Manchester 019A,E01005208,2693,2164,529,273,190,56,10
2021,Manchester 019C,E01005210,2620,2106,514,186,275,50,3
2021,Manchester 057A,E01005212,3066,2576,490,258,178,47,7
2021,Manchester 059A,E01005213,2298,1812,486,221,180,71,14
2021,Manchester 019D,E01005214,2311,1771,540,279,184,66,11
2021,Manchester 034C,E01005215,1955,1516,439,147,183,92,17
2021,Manchester 034D,E01005216,1466,1302,164,64,53,38,9
2021,Manchester 034E,E01005217,1982,1667,315,125,133,49,8
2021,Manchester 034F,E01005218,1628,1386,242,87,91,54,10
2021,Manchester 031A,E01005219,2186,1648,538,170,184,149,35
2021,Manchester 031B,E01005220,1974,1394,580,221,212,123,24
2021,Manchester 031C,E01005221,2456,1715,741,266,274,175,26
2021,Manchester 031D,E01005222,2077,1632,445,171,150,95,29
2021,Manchester 007A,E01005223,1546,1254,292,145,87,46,14
2021,Manchester 007B,E01005224,2021,1568,453,165,157,111,20
2021,Manchester 007C,E01005225,2005,1752,253,107,94,44,8
2021,Manchester 007D,E01005226,1826,1449,377,116,148,104,9
2021,Manchester 009D,E01005227,1945,1542,403,150,143,94,16
2021,Manchester 009E,E01005228,2132,1744,388,160,145,72,11
2021,Manchester 007E,E01005229,1463,1416,47,24,13,10,0
2021,Manchester 022B,E01005230,2032,1371,661,264,257,119,21
2021,Manchester 022C,E01005231,2476,1831,645,391,173,71,10
2021,Manchester 020C,E01005232,1826,1248,578,210,218,117,33
2021,Manchester 063B,E01005233,2738,1461,1277,342,513,336,86
2021,Manchester 063A,E01005234,2213,1372,841,232,295,255,59
2021,Manchester 020D,E01005235,1964,1357,607,194,222,148,43
2021,Manchester 022D,E01005236,2159,1424,735,266,255,171,43
2021,Manchester 022E,E01005237,1947,1177,770,187,302,223,58
2021,Manchester 063D,E01005238,2211,1441,770,222,303,197,48
2021,Manchester 020E,E01005239,1727,1283,444,146,176,95,27
2021,Manchester 024B,E01005243,2790,2098,692,256,257,146,33
2021,Manchester 025C,E01005244,2934,2164,770,362,261,119,28
2021,Manchester 024C,E01005245,2685,1977,708,267,262,139,40
2021,Manchester 024D,E01005246,2426,1661,765,273,305,155,32
2021,Manchester 005A,E01005247,1374,1331,43,12,22,8,1
2021,Manchester 005B,E01005248,1300,1218,82,22,39,16,5
2021,Manchester 005C,E01005249,2114,1885,229,89,94,43,3
2021,Manchester 005D,E01005250,2157,1924,233,90,100,32,11
2021,Manchester 003D,E01005251,1616,1441,175,83,65,21,6
2021,Manchester 003E,E01005252,1859,1732,127,63,37,24,3
2021,Manchester 005E,E01005253,1665,1477,188,60,92,34,2
2021,Manchester 005F,E01005254,1557,1508,49,23,25,1,0
2021,Manchester 012D,E01005255,1592,1394,198,79,74,37,8
2021,Manchester 011A,E01005256,2536,2164,372,142,147,71,12
2021,Manchester 011B,E01005257,1908,1612,296,107,145,36,8
2021,Manchester 011C,E01005258,1734,1536,198,89,66,32,11
2021,Manchester 011D,E01005259,1681,1436,245,89,93,55,8
2021,Manchester 011E,E01005260,1421,1356,65,29,20,14,2
2021,Manchester 012E,E01005261,1718,1492,226,95,70,53,8
2021,Manchester 044B,E01005262,1711,1529,182,95,61,22,4
2021,Manchester 046A,E01005263,1631,1505,126,50,52,20,4
2021,Manchester 044C,E01005264,1598,1428,170,83,65,19,3
2021,Manchester 044D,E01005265,1655,1483,172,82,64,24,2
2021,Manchester 044E,E01005266,1946,1753,193,98,69,22,4
2021,Manchester 046B,E01005267,1477,1423,54,27,18,8,1
2021,Manchester 046C,E01005268,2090,1908,182,92,50,27,13
2021,Manchester 046D,E01005269,1494,1372,122,61,41,17,3
2021,Manchester 035A,E01005270,1701,1452,249,97,94,52,6
2021,Manchester 032C,E01005271,1957,1735,222,108,77,34,3
2021,Manchester 035B,E01005272,1911,1654,257,106,95,44,12
2021,Manchester 035C,E01005273,1642,1511,131,72,46,13,0
2021,Manchester 038A,E01005274,1700,1536,164,71,51,36,6
2021,Manchester 038B,E01005275,1736,1555,181,129,36,15,1
2021,Manchester 038C,E01005276,1433,1339,94,61,22,9,2
2021,Manchester 038D,E01005277,1639,1510,129,81,27,21,0
2021,Manchester 035D,E01005278,1807,1488,319,139,111,55,14
2021,Manchester 035E,E01005279,2109,1751,358,174,131,39,14
2021,Manchester 026A,E01005280,2119,1494,625,195,211,155,64
2021,Manchester 026B,E01005281,2560,2224,336,231,70,27,8
2021,Manchester 026C,E01005284,2556,1638,918,404,326,148,40
2021,Manchester 025D,E01005285,1462,902,560,212,200,118,30
2021,Manchester 026D,E01005286,2254,1781,473,236,148,80,9
2021,Manchester 026E,E01005287,2259,1563,696,214,270,173,39
2021,Manchester 025E,E01005288,1759,1209,550,209,196,117,28
2021,Manchester 049D,E01005289,1620,1512,108,41,41,19,7
2021,Manchester 052A,E01005290,1596,1458,138,54,64,18,2
2021,Manchester 050E,E01005291,1421,1291,130,61,43,23,3
2021,Manchester 052B,E01005292,1472,1372,100,55,34,10,1
2021,Manchester 052C,E01005293,1141,1071,70,35,32,2,1
2021,Manchester 052D,E01005294,1567,1454,113,60,41,12,0
2021,Manchester 049E,E01005295,2518,2180,338,168,120,46,4
2021,Manchester 029E,E01005296,1521,1353,168,80,55,29,4
2021,Manchester 028A,E01005297,2369,1962,407,130,146,108,23
2021,Manchester 028B,E01005298,1721,1313,408,167,133,91,17
2021,Manchester 029F,E01005299,1525,1259,266,78,87,86,15
2021,Manchester 033D,E01005300,1479,1215,264,106,105,49,4
2021,Manchester 033E,E01005301,1448,1306,142,68,44,23,7
2021,Manchester 028C,E01005302,2023,1595,428,179,160,81,8
2021,Manchester 040B,E01005304,1923,1762,161,81,48,31,1
2021,Manchester 036A,E01005305,1644,1406,238,115,67,52,4
2021,Manchester 040C,E01005306,1535,1445,90,59,26,3,2
2021,Manchester 040D,E01005307,1758,1599,159,84,50,21,4
2021,Manchester 040E,E01005308,1637,1417,220,109,75,33,3
2021,Manchester 036B,E01005309,2204,1956,248,137,70,35,6
2021,Manchester 036C,E01005310,1948,1757,191,85,71,26,9
2021,Manchester 036D,E01005311,1774,1540,234,103,88,37,6
2021,Manchester 036E,E01005312,1970,1830,140,87,35,15,3
2021,Manchester 053A,E01005313,1462,1329,133,63,48,19,3
2021,Manchester 053B,E01005314,1621,1490,131,54,58,15,4
2021,Manchester 053C,E01005315,1655,1506,149,47,72,28,2
2021,Manchester 053D,E01005316,1567,1241,326,155,120,40,11
2021,Manchester 052E,E01005317,1958,1794,164,84,62,15,3
2021,Manchester 053E,E01005318,1910,1677,233,101,95,29,8
2021,Manchester 051E,E01005319,2231,1940,291,120,132,32,7
2021,Oldham 024A,E01005320,2554,1847,707,182,281,214,30
2021,Oldham 022A,E01005321,2161,1547,614,147,267,164,36
2021,Oldham 029A,E01005322,1423,1139,284,59,130,75,20
2021,Oldham 029B,E01005323,1484,1404,80,22,33,19,6
2021,Oldham 029C,E01005324,1552,1442,110,41,55,11,3
2021,Oldham 029D,E01005325,1428,1314,114,39,49,22,4
2021,Oldham 022B,E01005326,2883,2123,760,132,277,266,85
2021,Oldham 017A,E01005327,1900,1790,110,36,40,22,12
2021,Oldham 017B,E01005328,1723,1496,227,55,81,79,12
2021,Oldham 015A,E01005329,1467,1425,42,15,10,16,1
2021,Oldham 015B,E01005330,1682,1589,93,44,29,19,1
2021,Oldham 017C,E01005331,1658,1521,137,46,48,32,11
2021,Oldham 028A,E01005332,2231,2072,159,50,75,25,9
2021,Oldham 015C,E01005333,1213,1170,43,17,18,6,2
2021,Oldham 017D,E01005334,1386,1351,35,18,10,5,2
2021,Oldham 010A,E01005335,1251,1204,47,24,10,9,4
2021,Oldham 015D,E01005336,1499,1471,28,14,4,9,1
2021,Oldham 010B,E01005337,2411,1864,547,146,192,186,23
2021,Oldham 017E,E01005338,1870,1625,245,61,80,90,14
2021,Oldham 010C,E01005339,1439,1416,23,11,8,4,0
2021,Oldham 010D,E01005340,1545,1387,158,46,61,44,7
2021,Oldham 028B,E01005341,1351,1289,62,25,28,8,1
2021,Oldham 027A,E01005342,1550,1379,171,47,77,41,6
2021,Oldham 027B,E01005343,1360,1293,67,23,20,21,3
2021,Oldham 027C,E01005344,1803,1645,158,33,67,40,18
2021,Oldham 028C,E01005345,1454,1410,44,16,16,8,4
2021,Oldham 028D,E01005346,1357,1339,18,6,6,3,3
2021,Oldham 028E,E01005347,1269,1230,39,14,7,18,0
2021,Oldham 014A,E01005348,2299,1739,560,206,170,156,28
2021,Oldham 016A,E01005349,2394,1565,829,135,273,347,74
2021,Oldham 014B,E01005350,2311,1678,633,149,219,208,57
2021,Oldham 016B,E01005351,1994,1404,590,132,177,214,67
2021,Oldham 016C,E01005352,1466,1092,374,56,128,161,29
2021,Oldham 016D,E01005353,1448,1023,425,65,121,192,47
2021,Oldham 016E,E01005354,1709,1322,387,85,123,132,47
2021,Oldham 005A,E01005355,1403,1343,60,15,32,11,2
2021,Oldham 005B,E01005356,1218,1207,11,2,6,3,0
2021,Oldham 001A,E01005357,1408,1398,10,1,5,4,0
2021,Oldham 001B,E01005358,1525,1484,41,12,16,9,4
2021,Oldham 001C,E01005359,1543,1528,15,4,2,7,2
2021,Oldham 001D,E01005360,1348,1320,28,12,9,7,0
2021,Oldham 003A,E01005361,1637,1613,24,7,8,9,0
2021,Oldham 031A,E01005362,1311,1285,26,4,15,6,1
2021,Oldham 032A,E01005363,1718,1670,48,23,13,11,1
2021,Oldham 031B,E01005364,1555,1542,13,3,6,4,0
2021,Oldham 033A,E01005365,1343,1335,8,6,2,0,0
2021,Oldham 033B,E01005366,1518,1502,16,7,4,4,1
2021,Oldham 033C,E01005367,1392,1371,21,6,8,6,1
2021,Oldham 031C,E01005368,1457,1398,59,15,20,17,7
2021,Oldham 032B,E01005369,1880,1679,201,74,53,65,9
2021,Oldham 032C,E01005370,1523,1416,107,30,37,32,8
2021,Oldham 032D,E01005371,1399,1335,64,18,26,17,3
2021,Oldham 034A,E01005372,1222,1173,49,20,14,14,1
2021,Oldham 034B,E01005373,1165,1142,23,8,6,7,2
2021,Oldham 034C,E01005374,1443,1386,57,28,17,9,3
2021,Oldham 034D,E01005375,1452,1434,18,8,4,5,1
2021,Oldham 031D,E01005376,1381,1248,133,38,56,32,7
2021,Oldham 030A,E01005377,1654,1539,115,59,41,14,1
2021,Oldham 031E,E01005378,1491,1347,144,55,50,33,6
2021,Oldham 030B,E01005379,1246,1183,63,23,19,16,5
2021,Oldham 030C,E01005380,1455,1406,49,17,20,11,1
2021,Oldham 027D,E01005381,1869,1582,287,98,102,77,10
2021,Oldham 030D,E01005382,1555,1449,106,29,48,26,3
2021,Oldham 026A,E01005383,2083,1776,307,82,123,85,17
2021,Oldham 026D,E01005386,1471,1301,170,60,75,25,10
2021,Oldham 018A,E01005387,1399,1382,17,7,8,2,0
2021,Oldham 018B,E01005388,1297,1285,12,5,6,1,0
2021,Oldham 018C,E01005389,1673,1572,101,28,46,24,3
2021,Oldham 004A,E01005390,1328,1319,9,1,4,4,0
2021,Oldham 008A,E01005391,1519,1506,13,6,4,3,0
2021,Oldham 008B,E01005392,1535,1494,41,13,16,12,0
2021,Oldham 008C,E01005393,1187,1169,18,13,5,0,0
2021,Oldham 004B,E01005394,1421,1413,8,5,1,0,2
2021,Oldham 004C,E01005395,1388,1376,12,7,0,5,0
2021,Oldham 004D,E01005396,1399,1379,20,5,10,4,1
2021,Oldham 009A,E01005397,1289,1269,20,15,3,1,1
2021,Oldham 009B,E01005398,1492,1466,26,11,6,8,1
2021,Oldham 005C,E01005399,1537,1527,10,7,0,3,0
2021,Oldham 009C,E01005400,1481,1456,25,8,14,3,0
2021,Oldham 008D,E01005401,1555,1509,46,22,17,6,1
2021,Oldham 009D,E01005402,1543,1427,116,43,35,30,8
2021,Oldham 005D,E01005403,1683,1660,23,11,10,2,0
2021,Oldham 021A,E01005406,1373,1362,11,1,6,3,1
2021,Oldham 013A,E01005407,1689,1674,15,7,4,4,0
2021,Oldham 020C,E01005408,1961,1949,12,6,3,3,0
2021,Oldham 020D,E01005409,1539,1521,18,8,4,6,0
2021,Oldham 006A,E01005410,1473,1460,13,6,4,3,0
2021,Oldham 006B,E01005411,1534,1520,14,2,9,3,0
2021,Oldham 013B,E01005412,1645,1634,11,6,3,2,0
2021,Oldham 021B,E01005413,1554,1541,13,4,7,2,0
2021,Oldham 006C,E01005414,1298,1292,6,2,2,2,0
2021,Oldham 006D,E01005415,1084,1071,13,5,3,5,0
2021,Oldham 013C,E01005416,1486,1475,11,6,2,3,0
2021,Oldham 013D,E01005417,1494,1481,13,2,11,0,0
2021,Oldham 018D,E01005418,1381,1368,13,4,2,3,4
2021,Oldham 021C,E01005419,1414,1395,19,7,8,4,0
2021,Oldham 021D,E01005420,1566,1546,20,7,7,5,1
2021,Oldham 011A,E01005421,1749,1654,95,32,30,28,5
2021,Oldham 011B,E01005422,1466,1359,107,47,40,20,0
2021,Oldham 022C,E01005427,2082,1405,677,142,237,233,65
2021,Oldham 019A,E01005428,2189,1326,863,261,324,218,60
2021,Oldham 022D,E01005429,1825,1266,559,129,184,191,55
2021,Oldham 022E,E01005430,2699,1918,781,172,338,211,60
2021,Oldham 019B,E01005431,1745,1490,255,68,118,64,5
2021,Oldham 014C,E01005432,1753,1485,268,79,105,69,15
2021,Oldham 014D,E01005433,2348,1863,485,171,159,130,25
2021,Oldham 024B,E01005434,2053,1454,599,163,249,164,23
2021,Oldham 037B,E01005435,1912,1306,606,129,251,197,29
2021,Oldham 037D,E01005436,1758,1393,365,124,136,81,24
2021,Oldham 024C,E01005437,1968,1397,571,117,238,176,40
2021,Oldham 029E,E01005438,2812,2238,574,177,217,168,12
2021,Oldham 030E,E01005439,1529,1358,171,53,66,43,9
2021,Oldham 033D,E01005440,1409,1344,65,29,23,11,2
2021,Oldham 002A,E01005441,1473,1431,42,17,14,10,1
2021,Oldham 002B,E01005442,1301,1292,9,5,3,1,0
2021,Oldham 003B,E01005443,1285,1279,6,2,3,1,0
2021,Oldham 002C,E01005444,1355,1298,57,16,22,16,3
2021,Oldham 002D,E01005445,1369,1291,78,33,25,18,2
2021,Oldham 003C,E01005446,1363,1335,28,10,12,5,1
2021,Oldham 003D,E01005447,1600,1508,92,28,36,22,6
2021,Oldham 012A,E01005448,1559,1291,268,84,118,51,15
2021,Oldham 012B,E01005449,1508,1444,64,16,29,13,6
2021,Oldham 019C,E01005450,2022,1268,754,166,286,223,79
2021,Oldham 019D,E01005451,1491,1274,217,50,91,65,11
2021,Oldham 007C,E01005452,1254,1245,9,7,0,2,0
2021,Oldham 007D,E01005453,1495,1469,26,11,6,8,1
2021,Oldham 012C,E01005454,1338,1328,10,6,1,2,1
2021,Oldham 012D,E01005455,1422,1405,17,6,7,4,0
2021,Oldham 012E,E01005456,1583,1437,146,50,65,24,7
2021,Oldham 024D,E01005459,1646,1169,477,93,140,189,55
2021,Oldham 036C,E01005460,2568,1951,617,169,241,171,36
2021,Oldham 037A,E01005461,2305,1669,636,137,220,226,53
2021,Oldham 037C,E01005462,2105,1689,416,108,160,112,36
2021,Oldham 036D,E01005463,1603,1142,461,97,191,143,30
2021,Rochdale 016A,E01005464,1890,1597,293,81,138,62,12
2021,Rochdale 016B,E01005465,1739,1629,110,30,64,16,0
2021,Rochdale 016C,E01005466,2348,1947,401,139,179,68,15
2021,Rochdale 016D,E01005467,1886,1635,251,97,105,45,4
2021,Rochdale 016E,E01005468,2074,2041,33,15,9,8,1
2021,Rochdale 012A,E01005469,1738,1598,140,38,49,46,7
2021,Rochdale 015A,E01005470,1937,1291,646,146,237,219,44
2021,Rochdale 015B,E01005471,1609,1150,459,94,198,136,31
2021,Rochdale 010A,E01005472,1577,1365,212,67,93,51,1
2021,Rochdale 010B,E01005473,1615,1247,368,95,145,113,15
2021,Rochdale 011A,E01005474,1287,1148,139,44,51,35,9
2021,Rochdale 015C,E01005475,1700,1344,356,74,140,123,19
2021,Rochdale 017A,E01005476,1734,1637,97,36,39,19,3
2021,Rochdale 017B,E01005477,1665,1509,156,48,63,39,6
2021,Rochdale 017C,E01005478,1527,1434,93,27,34,29,3
2021,Rochdale 017D,E01005479,1912,1849,63,27,26,9,1
2021,Rochdale 017E,E01005480,1600,1458,142,44,67,27,4
2021,Rochdale 017F,E01005481,1632,1488,144,40,65,34,5
2021,Rochdale 010C,E01005482,1597,1181,416,122,152,121,21
2021,Rochdale 010D,E01005483,1436,1028,408,89,161,125,33
2021,Rochdale 010E,E01005484,1923,1311,612,168,237,171,36
2021,Rochdale 015D,E01005485,2287,1620,667,145,264,217,41
2021,Rochdale 010F,E01005486,1603,1155,448,128,191,112,17
2021,Rochdale 010G,E01005487,1722,1293,429,103,173,137,16
2021,Rochdale 006A,E01005488,1460,1421,39,13,14,11,1
2021,Rochdale 005A,E01005489,1200,1139,61,26,23,11,1
2021,Rochdale 005B,E01005490,1536,1433,103,38,36,26,3
2021,Rochdale 005C,E01005491,1385,1322,63,25,23,13,2
2021,Rochdale 006B,E01005492,1488,1413,75,30,31,10,4
2021,Rochdale 005D,E01005493,1709,1621,88,38,30,18,2
2021,Rochdale 005E,E01005494,1696,1552,144,59,52,27,6
2021,Rochdale 005F,E01005495,1703,1554,149,43,64,35,7
2021,Rochdale 009A,E01005496,1237,1112,125,56,51,15,3
2021,Rochdale 018A,E01005497,1792,1611,181,52,78,42,9
2021,Rochdale 020A,E01005498,1309,1271,38,13,15,9,1
2021,Rochdale 006C,E01005499,1466,1418,48,13,22,9,4
2021,Rochdale 020B,E01005500,1536,1496,40,11,17,9,3
2021,Rochdale 018B,E01005501,1722,1607,115,41,45,25,4
2021,Rochdale 018C,E01005502,1337,1313,24,8,12,4,0
2021,Rochdale 020C,E01005503,1291,1247,44,18,18,8,0
2021,Rochdale 018D,E01005504,1569,1482,87,34,41,10,2
2021,Rochdale 018E,E01005505,2082,1968,114,36,47,26,5
2021,Rochdale 020D,E01005506,1496,1424,72,24,30,16,2
2021,Rochdale 020E,E01005507,2149,2094,55,23,23,7,2
2021,Rochdale 020F,E01005508,1955,1929,26,11,6,8,1
2021,Rochdale 018F,E01005509,1392,1283,109,43,42,17,7
2021,Rochdale 019A,E01005510,1065,1039,26,9,12,4,1
2021,Rochdale 019B,E01005511,1209,1192,17,5,4,8,0
2021,Rochdale 019C,E01005512,1384,1310,74,30,33,8,3
2021,Rochdale 019D,E01005513,1471,1336,135,50,51,31,3
2021,Rochdale 019E,E01005514,1748,1646,102,42,41,12,7
2021,Rochdale 019F,E01005515,1684,1565,119,43,56,19,1
2021,Rochdale 003A,E01005516,1250,1235,15,6,7,2,0
2021,Rochdale 003B,E01005517,1394,1386,8,3,2,3,0
2021,Rochdale 001A,E01005518,1528,1507,21,8,8,5,0
2021,Rochdale 002A,E01005519,1518,1508,10,4,3,2,1
2021,Rochdale 001B,E01005520,1679,1653,26,7,15,4,0
2021,Rochdale 003C,E01005521,1426,1411,15,8,4,1,2
2021,Rochdale 001C,E01005522,1435,1416,19,13,4,2,0
2021,Rochdale 001D,E01005523,1790,1764,26,11,10,4,1
2021,Rochdale 021A,E01005524,1415,1359,56,16,29,11,0
2021,Rochdale 021B,E01005525,1768,1606,162,60,67,31,4
2021,Rochdale 021C,E01005526,1826,1695,131,50,59,18,4
2021,Rochdale 022A,E01005527,1973,1750,223,109,68,40,6
2021,Rochdale 021D,E01005528,1504,1405,99,40,43,15,1
2021,Rochdale 022B,E01005529,1596,1456,140,59,52,26,3
2021,Rochdale 025A,E01005530,1411,1382,29,8,15,5,1
2021,Rochdale 025B,E01005531,1126,1072,54,28,14,12,0
2021,Rochdale 025C,E01005532,1495,1331,164,63,67,32,2
2021,Rochdale 024A,E01005533,1566,1510,56,26,23,2,5
2021,Rochdale 023A,E01005534,1372,1333,39,15,15,8,1
2021,Rochdale 023B,E01005535,1410,1361,49,20,21,8,0
2021,Rochdale 021E,E01005536,1645,1539,106,44,39,19,4
2021,Rochdale 023C,E01005537,1249,1231,18,11,4,3,0
2021,Rochdale 023D,E01005538,1422,1355,67,30,18,18,1
2021,Rochdale 024B,E01005539,1257,1197,60,19,28,11,2
2021,Rochdale 023E,E01005540,1283,1249,34,18,12,2,2
2021,Rochdale 023F,E01005541,1472,1410,62,32,13,15,2
2021,Rochdale 023G,E01005542,1534,1461,73,25,32,14,2
2021,Rochdale 021F,E01005543,1213,1181,32,14,14,3,1
2021,Rochdale 025D,E01005544,1431,1404,27,12,9,4,2
2021,Rochdale 025E,E01005545,1220,1177,43,18,14,11,0
2021,Rochdale 024C,E01005546,1210,1149,61,24,28,9,0
2021,Rochdale 024D,E01005547,1677,1550,127,60,39,28,0
2021,Rochdale 024E,E01005548,1243,1155,88,37,35,14,2
2021,Rochdale 025F,E01005549,1501,1480,21,8,9,3,1
2021,Rochdale 025G,E01005550,1436,1405,31,13,13,5,0
2021,Rochdale 022C,E01005551,1938,1769,169,68,65,33,3
2021,Rochdale 022D,E01005552,2216,1975,241,86,95,52,8
2021,Rochdale 022E,E01005553,1942,1711,231,93,93,42,3
2021,Rochdale 022F,E01005554,2049,1804,245,118,88,32,7
2021,Rochdale 014A,E01005555,1348,1337,11,8,1,2,0
2021,Rochdale 013A,E01005556,1486,1463,23,7,6,8,2
2021,Rochdale 014B,E01005557,1113,1105,8,4,4,0,0
2021,Rochdale 014C,E01005558,1546,1522,24,10,8,6,0
2021,Rochdale 013B,E01005559,1433,1370,63,29,26,5,3
2021,Rochdale 013C,E01005560,1435,1420,15,7,6,1,1
2021,Rochdale 014D,E01005561,1378,1361,17,11,2,3,1
2021,Rochdale 014E,E01005562,1471,1444,27,16,5,5,1
2021,Rochdale 012B,E01005563,2043,1637,406,94,173,113,26
2021,Rochdale 015E,E01005564,2279,1551,728,175,293,218,42
2021,Rochdale 012C,E01005565,1530,1346,184,50,68,59,7
2021,Rochdale 012D,E01005566,2249,1991,258,73,103,71,11
2021,Rochdale 013D,E01005567,1795,1721,74,28,25,19,2
2021,Rochdale 012E,E01005568,1839,1340,499,128,196,143,32
2021,Rochdale 012F,E01005569,1730,1468,262,86,98,66,12
2021,Rochdale 007A,E01005570,1262,1243,19,8,10,0,1
2021,Rochdale 006D,E01005571,1606,1582,24,10,10,3,1
2021,Rochdale 007B,E01005572,1446,1408,38,17,11,10,0
2021,Rochdale 007C,E01005573,1406,1358,48,19,17,10,2
2021,Rochdale 007D,E01005574,1688,1582,106,46,38,20,2
2021,Rochdale 011B,E01005575,1666,1586,80,35,30,15,0
2021,Rochdale 011C,E01005576,1476,1375,101,36,37,24,4
2021,Rochdale 011D,E01005577,1426,1388,38,15,15,8,0
2021,Rochdale 004A,E01005578,1464,1217,247,56,88,84,19
2021,Rochdale 004B,E01005579,1793,1410,383,99,148,111,25
2021,Rochdale 008A,E01005580,1563,1282,281,78,92,91,20
2021,Rochdale 008B,E01005581,1843,1396,447,141,142,128,36
2021,Rochdale 008D,E01005583,1670,1086,584,113,172,248,51
2021,Rochdale 008F,E01005585,1479,1113,366,106,143,101,16
2021,Rochdale 004C,E01005586,1546,1295,251,63,104,66,18
2021,Rochdale 007E,E01005587,1315,1269,46,21,14,10,1
2021,Rochdale 007F,E01005588,1274,1227,47,14,20,9,4
2021,Rochdale 009B,E01005589,1620,1510,110,23,51,31,5
2021,Rochdale 009C,E01005590,1815,1381,434,139,160,118,17
2021,Rochdale 009D,E01005591,1539,1476,63,18,23,18,4
2021,Rochdale 009E,E01005592,1576,1329,247,97,87,55,8
2021,Rochdale 004D,E01005593,1965,1850,115,44,43,23,5
2021,Rochdale 002B,E01005594,1468,1424,44,13,18,9,4
2021,Rochdale 004E,E01005595,1260,1179,81,26,31,22,2
2021,Rochdale 003D,E01005596,2075,1996,79,23,36,16,4
2021,Rochdale 002C,E01005597,1922,1907,15,11,4,0,0
2021,Rochdale 002D,E01005598,1522,1497,25,12,9,2,2
2021,Salford 026A,E01005599,1824,1536,288,108,111,57,12
2021,Salford 026B,E01005600,1944,1726,218,96,80,33,9
2021,Salford 026C,E01005601,1654,1446,208,72,79,45,12
2021,Salford 026D,E01005602,1572,1362,210,93,75,40,2
2021,Salford 027A,E01005603,1701,1421,280,97,113,58,12
2021,Salford 027B,E01005604,1582,1459,123,47,52,23,1
2021,Salford 027C,E01005605,1584,1482,102,44,45,12,1
2021,Salford 034C,E01005610,2889,2595,294,152,106,35,1
2021,Salford 032C,E01005611,2403,1958,445,147,183,104,11
2021,Salford 031B,E01005612,2357,1735,622,198,256,142,26
2021,Salford 031A,E01005613,2547,1695,852,207,290,329,26
2021,Salford 031C,E01005614,2775,2167,608,142,238,195,33
2021,Salford 032D,E01005615,2184,1505,679,167,265,218,29
2021,Salford 030A,E01005616,1400,1370,30,12,13,4,1
2021,Salford 030B,E01005617,1430,1400,30,19,10,1,0
2021,Salford 030C,E01005618,1980,1908,72,32,22,15,3
2021,Salford 030D,E01005619,1194,1166,28,13,10,5,0
2021,Salford 030E,E01005620,2449,2323,126,68,37,19,2
2021,Salford 030F,E01005621,1686,1588,98,27,55,14,2
2021,Salford 018A,E01005622,1525,1390,135,60,34,39,2
2021,Salford 018B,E01005623,1226,1168,58,22,18,6,12
2021,Salford 017A,E01005624,1768,1455,313,104,142,56,11
2021,Salford 015A,E01005625,1332,1271,61,29,22,8,2
2021,Salford 018C,E01005626,1246,1211,35,12,11,8,4
2021,Salford 015B,E01005627,1135,1076,59,26,16,12,5
2021,Salford 018D,E01005628,1534,1390,144,55,66,23,0
2021,Salford 021A,E01005629,1418,1305,113,52,36,18,7
2021,Salford 021B,E01005630,1483,1387,96,52,31,10,3
2021,Salford 020A,E01005631,1542,1351,191,68,73,43,7
2021,Salford 020B,E01005632,2360,2056,304,94,119,80,11
2021,Salford 020C,E01005633,1472,1332,140,74,36,20,10
2021,Salford 020D,E01005634,1526,1500,26,18,6,2,0
2021,Salford 020E,E01005635,1507,1375,132,57,47,26,2
2021,Salford 020F,E01005636,1567,1502,65,37,19,8,1
2021,Salford 020G,E01005637,1403,1352,51,21,17,13,0
2021,Salford 027D,E01005638,2097,1737,360,149,115,76,20
2021,Salford 029A,E01005639,1445,1337,108,39,37,24,8
2021,Salford 029B,E01005640,1309,1236,73,35,30,7,1
2021,Salford 029C,E01005641,1333,1283,50,24,22,4,0
2021,Salford 029D,E01005642,1168,1119,49,15,16,14,4
2021,Salford 029E,E01005643,1344,1317,27,8,10,9,0
2021,Salford 029F,E01005644,1464,1426,38,18,10,10,0
2021,Salford 029G,E01005645,1331,1313,18,4,9,5,0
2021,Salford 010A,E01005646,2103,1853,250,79,96,66,9
2021,Salford 011A,E01005647,1423,1295,128,50,43,31,4
2021,Salford 011B,E01005648,2246,1803,443,192,165,74,12
2021,Salford 010B,E01005649,1607,1490,117,44,50,22,1
2021,Salford 010C,E01005650,1823,1389,434,110,134,157,33
2021,Salford 010D,E01005651,2154,1824,330,92,150,80,8
2021,Salford 011C,E01005652,1488,1281,207,83,83,35,6
2021,Salford 011D,E01005653,1490,1155,335,119,151,54,11
2021,Salford 023A,E01005654,1898,1525,373,190,109,67,7
2021,Salford 023B,E01005656,1643,1344,299,95,140,48,16
2021,Salford 023C,E01005657,1724,1486,238,109,92,33,4
2021,Salford 001A,E01005659,1490,1369,121,53,36,23,9
2021,Salford 001B,E01005660,1745,1555,190,102,42,37,9
2021,Salford 004A,E01005661,1800,1606,194,82,77,33,2
2021,Salford 004B,E01005662,1558,1304,254,79,118,55,2
2021,Salford 001C,E01005663,1470,1333,137,68,45,22,2
2021,Salford 001D,E01005664,1617,1412,205,75,80,45,5
2021,Salford 001E,E01005665,1990,1724,266,95,92,68,11
2021,Salford 035C,E01005667,2199,1845,354,155,133,54,12
2021,Salford 005A,E01005670,1696,1539,157,65,58,27,7
2021,Salford 012A,E01005671,1498,1334,164,90,50,16,8
2021,Salford 005B,E01005672,1234,1096,138,57,49,24,8
2021,Salford 008A,E01005673,1437,1342,95,41,33,18,3
2021,Salford 012B,E01005674,1503,1401,102,47,32,15,8
2021,Salford 005C,E01005676,1194,1178,16,6,7,1,2
2021,Salford 005D,E01005677,1544,1417,127,56,46,21,4
2021,Salford 008C,E01005678,1492,1341,151,59,62,27,3
2021,Salford 008D,E01005679,1477,1320,157,68,59,28,2
2021,Salford 017B,E01005680,1664,1470,194,63,79,49,3
2021,Salford 024C,E01005681,1446,1232,214,96,77,38,3
2021,Salford 024D,E01005682,1620,1217,403,105,208,65,25
2021,Salford 017C,E01005683,2045,1739,306,117,111,70,8
2021,Salford 006A,E01005686,1425,1307,118,45,51,18,4
2021,Salford 009A,E01005687,1742,1645,97,37,35,24,1
2021,Salford 006B,E01005688,1507,1406,101,45,34,19,3
2021,Salford 009B,E01005689,1314,1133,181,65,69,43,4
2021,Salford 009C,E01005690,1527,1461,66,28,23,12,3
2021,Salford 006C,E01005691,1381,1344,37,14,16,5,2
2021,Salford 006D,E01005692,1318,1186,132,44,51,36,1
2021,Salford 009D,E01005693,1384,1332,52,24,18,9,1
2021,Salford 012C,E01005694,1639,1583,56,29,15,12,0
2021,Salford 014A,E01005695,1515,1481,34,13,17,4,0
2021,Salford 012D,E01005696,1704,1627,77,34,24,14,5
2021,Salford 014B,E01005697,1477,1461,16,11,1,4,0
2021,Salford 012E,E01005698,1661,1488,173,65,71,29,8
2021,Salford 015C,E01005699,1732,1675,57,28,26,2,1
2021,Salford 012F,E01005700,1469,1351,118,36,51,28,3
2021,Salford 015D,E01005701,1771,1708,63,34,17,9,3
2021,Salford 003A,E01005702,2525,2346,179,73,61,37,8
2021,Salford 002A,E01005703,1668,1514,154,49,55,41,9
2021,Salford 002B,E01005704,1292,1221,71,18,39,9,5
2021,Salford 002C,E01005706,1473,1356,117,42,36,35,4
2021,Salford 003C,E01005707,1682,1539,143,49,46,32,16
2021,Salford 002D,E01005708,1385,1261,124,42,39,30,13
2021,Salford 004C,E01005709,1519,1366,153,69,52,26,6
2021,Salford 004D,E01005710,2037,1932,105,45,43,15,2
2021,Salford 007A,E01005711,1362,1334,28,11,9,7,1
2021,Salford 007B,E01005712,1769,1683,86,48,28,7,3
2021,Salford 007C,E01005713,1561,1527,34,19,14,1,0
2021,Salford 007D,E01005714,1634,1557,77,33,31,11,2
2021,Salford 007E,E01005715,1680,1620,60,32,17,10,1
2021,Salford 013A,E01005716,1596,1536,60,32,19,6,3
2021,Salford 013B,E01005717,1503,1409,94,51,26,15,2
2021,Salford 007F,E01005718,1537,1475,62,24,26,10,2
2021,Salford 021C,E01005719,1972,1585,387,176,151,54,6
2021,Salford 023D,E01005721,1515,1399,116,55,40,10,11
2021,Salford 021E,E01005722,1956,1646,310,137,112,47,14
2021,Salford 021F,E01005723,1618,1402,216,67,89,50,10
2021,Salford 021G,E01005724,1386,1322,64,38,19,6,1
2021,Salford 019A,E01005725,1403,1264,139,47,51,39,2
2021,Salford 019B,E01005726,1389,1312,77,32,27,18,0
2021,Salford 019C,E01005727,1312,1227,85,36,31,14,4
2021,Salford 019D,E01005728,1708,1653,55,15,19,16,5
2021,Salford 025A,E01005729,1449,1257,192,57,89,42,4
2021,Salford 025B,E01005730,1609,1464,145,68,50,21,6
2021,Salford 025C,E01005731,1514,1294,220,78,90,47,5
2021,Salford 025D,E01005732,1173,1048,125,60,46,19,0
2021,Salford 019E,E01005733,1419,1198,221,83,65,69,4
2021,Salford 013C,E01005734,1373,1309,64,32,21,9,2
2021,Salford 013D,E01005735,1373,1351,22,12,9,1,0
2021,Salford 013E,E01005736,1322,1303,19,9,8,1,1
2021,Salford 013F,E01005737,1473,1419,54,37,15,2,0
2021,Salford 014C,E01005738,1860,1811,49,23,16,7,3
2021,Salford 013G,E01005739,1910,1825,85,53,20,10,2
2021,Salford 014D,E01005740,1544,1506,38,8,22,8,0
2021,Salford 014E,E01005741,1615,1588,27,23,3,1,0
2021,Salford 014F,E01005742,1488,1471,17,7,6,3,1
2021,Stockport 009A,E01005743,1229,1216,13,8,3,2,0
2021,Stockport 009B,E01005744,1487,1453,34,17,9,7,1
2021,Stockport 005A,E01005745,1342,1320,22,10,8,2,2
2021,Stockport 005B,E01005746,1407,1376,31,19,8,4,0
2021,Stockport 005C,E01005747,1367,1353,14,8,4,2,0
2021,Stockport 005D,E01005748,1472,1466,6,4,2,0,0
2021,Stockport 009C,E01005749,1592,1574,18,6,5,5,2
2021,Stockport 009D,E01005750,1601,1559,42,18,14,10,0
2021,Stockport 009E,E01005751,1343,1316,27,13,7,4,3
2021,Stockport 012A,E01005752,1355,1339,16,5,6,2,3
2021,Stockport 004A,E01005753,1772,1651,121,49,47,23,2
2021,Stockport 004B,E01005754,1918,1830,88,27,33,23,5
2021,Stockport 004C,E01005755,1675,1589,86,26,32,24,4
2021,Stockport 004D,E01005756,2223,1994,229,114,75,34,6
2021,Stockport 014A,E01005757,1548,1462,86,47,27,12,0
2021,Stockport 023A,E01005759,1605,1533,72,31,23,18,0
2021,Stockport 023B,E01005760,1843,1645,198,63,84,46,5
2021,Stockport 026A,E01005761,1357,1236,121,58,43,16,4
2021,Stockport 026B,E01005762,1877,1781,96,35,44,15,2
2021,Stockport 026C,E01005763,1674,1583,91,42,31,16,2
2021,Stockport 016A,E01005764,1535,1479,56,24,25,6,1
2021,Stockport 018A,E01005765,1335,1317,18,6,10,2,0
2021,Stockport 014C,E01005766,1727,1490,237,73,106,48,10
2021,Stockport 028A,E01005767,1598,1434,164,91,48,21,4
2021,Stockport 025A,E01005768,1963,1811,152,82,45,18,7
2021,Stockport 022A,E01005769,1501,1439,62,32,16,13,1
2021,Stockport 025B,E01005770,1427,1334,93,40,30,21,2
2021,Stockport 025C,E01005771,1387,1317,70,38,14,17,1
2021,Stockport 028B,E01005772,1502,1375,127,67,41,18,1
2021,Stockport 028C,E01005773,1522,1439,83,43,27,10,3
2021,Stockport 028D,E01005774,1504,1426,78,38,23,15,2
2021,Stockport 025D,E01005775,1605,1527,78,46,19,9,4
2021,Stockport 028E,E01005776,1656,1478,178,86,59,30,3
2021,Stockport 034A,E01005777,1516,1429,87,35,39,9,4
2021,Stockport 022B,E01005778,1348,1322,26,11,9,6,0
2021,Stockport 022C,E01005779,1422,1386,36,16,11,7,2
2021,Stockport 022D,E01005780,1422,1371,51,26,13,8,4
2021,Stockport 022E,E01005781,1605,1531,74,35,30,7,2
2021,Stockport 030A,E01005782,1242,1206,36,11,16,8,1
2021,Stockport 030B,E01005783,1496,1431,65,27,21,13,4
2021,Stockport 030C,E01005784,1460,1359,101,50,32,15,4
2021,Stockport 030D,E01005785,1624,1580,44,18,19,7,0
2021,Stockport 030E,E01005786,1800,1730,70,29,27,13,1
2021,Stockport 034B,E01005787,1297,1274,23,13,8,2,0
2021,Stockport 034C,E01005788,1515,1457,58,17,32,8,1
2021,Stockport 039A,E01005789,1636,1597,39,22,8,9,0
2021,Stockport 034D,E01005790,1193,1098,95,54,34,5,2
2021,Stockport 039B,E01005791,1528,1482,46,27,11,6,2
2021,Stockport 041A,E01005792,1491,1462,29,10,16,3,0
2021,Stockport 039C,E01005793,1489,1417,72,30,23,16,3
2021,Stockport 041B,E01005794,1232,1170,62,28,23,9,2
2021,Stockport 039D,E01005795,1325,1277,48,26,13,3,6
2021,Stockport 039E,E01005796,1218,1186,32,21,5,2,4
2021,Stockport 023C,E01005797,1345,1271,74,32,22,13,7
2021,Stockport 027A,E01005798,1601,1517,84,27,29,24,4
2021,Stockport 026D,E01005799,1799,1669,130,59,42,24,5
2021,Stockport 023D,E01005800,1558,1510,48,36,8,3,1
2021,Stockport 027B,E01005801,2102,1945,157,78,64,11,4
2021,Stockport 027C,E01005802,1425,1408,17,8,5,3,1
2021,Stockport 027D,E01005803,1355,1336,19,6,6,6,1
2021,Stockport 023E,E01005804,1101,1073,28,10,12,6,0
2021,Stockport 035A,E01005805,1508,1495,13,6,2,5,0
2021,Stockport 033A,E01005806,1151,1137,14,9,5,0,0
2021,Stockport 035B,E01005807,1516,1495,21,6,12,3,0
2021,Stockport 037A,E01005808,1326,1288,38,24,11,3,0
2021,Stockport 037B,E01005809,1188,1133,55,29,18,8,0
2021,Stockport 037C,E01005810,1520,1419,101,42,36,22,1
2021,Stockport 037D,E01005811,1274,1251,23,10,7,6,0
2021,Stockport 037E,E01005812,1184,1146,38,23,9,6,0
2021,Stockport 033B,E01005813,1333,1290,43,13,19,9,2
2021,Stockport 033C,E01005814,1268,1249,19,13,5,1,0
2021,Stockport 033D,E01005815,1387,1358,29,16,7,4,2
2021,Stockport 016B,E01005816,1489,1401,88,39,33,13,3
2021,Stockport 016C,E01005817,1325,1227,98,65,19,12,2
2021,Stockport 018B,E01005818,1340,1297,43,17,19,7,0
2021,Stockport 018C,E01005819,1539,1476,63,27,29,6,1
2021,Stockport 018D,E01005820,1447,1401,46,22,13,6,5
2021,Stockport 018E,E01005821,1364,1320,44,18,15,10,1
2021,Stockport 016D,E01005822,1825,1593,232,85,95,44,8
2021,Stockport 018F,E01005823,1574,1487,87,44,29,11,3
2021,Stockport 024A,E01005824,1467,1436,31,6,15,8,2
2021,Stockport 019A,E01005825,1589,1490,99,44,22,29,4
2021,Stockport 024B,E01005826,1558,1472,86,27,41,14,4
2021,Stockport 024C,E01005827,1704,1648,56,32,14,7,3
2021,Stockport 024D,E01005828,1327,1291,36,18,14,4,0
2021,Stockport 024E,E01005829,1140,1096,44,25,10,7,2
2021,Stockport 027E,E01005830,1492,1433,59,29,23,4,3
2021,Stockport 027F,E01005831,1594,1490,104,61,29,10,4
2021,Stockport 021A,E01005832,1388,1364,24,7,10,7,0
2021,Stockport 021B,E01005833,1019,999,20,6,7,7,0
2021,Stockport 031A,E01005834,1483,1398,85,36,34,12,3
2021,Stockport 021C,E01005835,1363,1340,23,13,8,2,0
2021,Stockport 031B,E01005836,1797,1737,60,31,23,6,0
2021,Stockport 021D,E01005837,1487,1458,29,15,9,4,1
2021,Stockport 031C,E01005838,1704,1567,137,78,40,18,1
2021,Stockport 035C,E01005839,1272,1258,14,6,5,3,0
2021,Stockport 031D,E01005840,1553,1447,106,63,31,11,1
2021,Stockport 035D,E01005841,1436,1378,58,25,19,12,2
2021,Stockport 038A,E01005842,1558,1528,30,20,7,2,1
2021,Stockport 021E,E01005843,1404,1384,20,11,6,2,1
2021,Stockport 036A,E01005844,1515,1345,170,75,61,29,5
2021,Stockport 036B,E01005845,1611,1493,118,50,40,28,0
2021,Stockport 040A,E01005846,1667,1532,135,70,45,15,5
2021,Stockport 040B,E01005847,1524,1415,109,52,35,18,4
2021,Stockport 040C,E01005848,1998,1810,188,74,48,21,45
2021,Stockport 036C,E01005849,1594,1520,74,43,19,10,2
2021,Stockport 040D,E01005850,1722,1626,96,53,23,16,4
2021,Stockport 036D,E01005851,1578,1448,130,57,53,17,3
2021,Stockport 013A,E01005852,1440,1301,139,66,42,27,4
2021,Stockport 011A,E01005853,1565,1443,122,47,42,28,5
2021,Stockport 013B,E01005854,1660,1628,32,15,13,3,1
2021,Stockport 013C,E01005855,1448,1384,64,29,25,10,0
2021,Stockport 011B,E01005856,1551,1466,85,44,23,16,2
2021,Stockport 013D,E01005857,1568,1343,225,117,77,29,2
2021,Stockport 013E,E01005858,1532,1469,63,30,25,8,0
2021,Stockport 008A,E01005859,1382,1339,43,26,8,8,1
2021,Stockport 011C,E01005860,1476,1426,50,28,9,11,2
2021,Stockport 011D,E01005861,1494,1462,32,15,12,5,0
2021,Stockport 003A,E01005862,1432,1410,22,9,6,6,1
2021,Stockport 006A,E01005863,1656,1582,74,32,23,17,2
2021,Stockport 006B,E01005864,1535,1469,66,30,22,14,0
2021,Stockport 008B,E01005865,1881,1815,66,36,20,9,1
2021,Stockport 006C,E01005866,1617,1512,105,44,36,23,2
2021,Stockport 008C,E01005867,1445,1394,51,36,9,6,0
2021,Stockport 008D,E01005868,1486,1368,118,48,46,20,4
2021,Stockport 006D,E01005869,1539,1454,85,32,34,15,4
2021,Stockport 015A,E01005870,1325,1301,24,14,7,3,0
2021,Stockport 015B,E01005871,1328,1298,30,13,7,10,0
2021,Stockport 019B,E01005872,1586,1540,46,20,15,9,2
2021,Stockport 015C,E01005873,1421,1409,12,6,4,2,0
2021,Stockport 019C,E01005874,1808,1705,103,52,32,16,3
2021,Stockport 015D,E01005875,1507,1488,19,6,8,2,3
2021,Stockport 019D,E01005876,1445,1410,35,20,9,5,1
2021,Stockport 019E,E01005877,1623,1566,57,17,22,18,0
2021,Stockport 020A,E01005878,1695,1666,29,17,6,6,0
2021,Stockport 020B,E01005879,1268,1229,39,23,16,0,0
2021,Stockport 017A,E01005880,1439,1436,3,3,0,0,0
2021,Stockport 017B,E01005881,1178,1164,14,12,1,1,0
2021,Stockport 020C,E01005882,1249,1238,11,9,1,1,0
2021,Stockport 017C,E01005883,1486,1479,7,6,0,1,0
2021,Stockport 020D,E01005884,1411,1396,15,11,2,0,2
2021,Stockport 020E,E01005885,1444,1410,34,13,14,6,1
2021,Stockport 001A,E01005886,1418,1354,64,27,26,11,0
2021,Stockport 002A,E01005887,1649,1539,110,50,42,16,2
2021,Stockport 001B,E01005888,1474,1431,43,22,13,8,0
2021,Stockport 001C,E01005889,1369,1313,56,25,15,14,2
2021,Stockport 002B,E01005890,1468,1360,108,47,39,18,4
2021,Stockport 001D,E01005891,1197,1170,27,14,8,5,0
2021,Stockport 003B,E01005892,1226,1168,58,24,25,8,1
2021,Stockport 002C,E01005893,2095,2006,89,39,34,13,3
2021,Stockport 001E,E01005894,1319,1287,32,17,12,3,0
2021,Stockport 003C,E01005895,1132,1102,30,13,10,5,2
2021,Stockport 002D,E01005896,1595,1504,91,40,29,22,0
2021,Stockport 010A,E01005897,1484,1451,33,23,6,4,0
2021,Stockport 010B,E01005898,1645,1606,39,22,12,4,1
2021,Stockport 012B,E01005899,1579,1553,26,18,3,3,2
2021,Stockport 010C,E01005900,1546,1530,16,8,3,5,0
2021,Stockport 012C,E01005901,1344,1323,21,14,5,2,0
2021,Stockport 012D,E01005902,1571,1512,59,28,28,3,0
2021,Stockport 010D,E01005903,1440,1426,14,5,9,0,0
2021,Stockport 010E,E01005904,1491,1481,10,7,2,1,0
2021,Stockport 012E,E01005905,1425,1396,29,13,14,1,1
2021,Stockport 038B,E01005906,1418,1405,13,7,5,1,0
2021,Stockport 038C,E01005907,1330,1308,22,13,5,2,2
2021,Stockport 017D,E01005908,1592,1581,11,10,1,0,0
2021,Stockport 029A,E01005909,1501,1489,12,7,3,1,1
2021,Stockport 029B,E01005910,1563,1537,26,13,8,4,1
2021,Stockport 029C,E01005911,1305,1297,8,5,3,0,0
2021,Stockport 029D,E01005912,1462,1442,20,9,9,1,1
2021,Stockport 038D,E01005913,1392,1373,19,9,4,6,0
2021,Stockport 007A,E01005914,1369,1343,26,12,12,2,0
2021,Stockport 007B,E01005915,1493,1433,60,29,19,7,5
2021,Stockport 007C,E01005916,1554,1479,75,22,31,11,11
2021,Stockport 007D,E01005917,1769,1588,181,72,61,43,5
2021,Stockport 014D,E01005918,1540,1361,179,69,65,42,3
2021,Stockport 002E,E01005919,1481,1375,106,60,24,17,5
2021,Stockport 003D,E01005920,1544,1500,44,24,11,9,0
2021,Stockport 003E,E01005921,1424,1357,67,28,20,15,4
2021,Stockport 003F,E01005922,1269,1245,24,10,7,7,0
2021,Stockport 041C,E01005923,1451,1425,26,15,8,3,0
2021,Stockport 042A,E01005924,1279,1255,24,13,6,5,0
2021,Stockport 042B,E01005925,1401,1353,48,21,16,9,2
2021,Stockport 042C,E01005926,2136,2047,89,52,22,15,0
2021,Stockport 032A,E01005927,1256,1230,26,16,6,3,1
2021,Stockport 032B,E01005928,1550,1471,79,32,27,16,4
2021,Stockport 032C,E01005929,1390,1303,87,53,26,8,0
2021,Stockport 032D,E01005930,1645,1595,50,30,14,6,0
2021,Stockport 041D,E01005931,1351,1328,23,13,10,0,0
2021,Stockport 042D,E01005932,1240,1208,32,17,11,3,1
2021,Tameside 006A,E01005933,1515,1356,159,50,57,44,8
2021,Tameside 006B,E01005934,1465,1403,62,33,15,12,2
2021,Tameside 006C,E01005935,1398,1247,151,55,44,39,13
2021,Tameside 004A,E01005936,1480,1398,82,37,27,14,4
2021,Tameside 004B,E01005937,1629,1504,125,58,45,17,5
2021,Tameside 002A,E01005938,1515,1450,65,25,27,12,1
2021,Tameside 002B,E01005939,1247,1087,160,51,75,32,2
2021,Tameside 002C,E01005940,1371,1247,124,53,40,26,5
2021,Tameside 007A,E01005941,1786,1423,363,70,161,111,21
2021,Tameside 007B,E01005942,1601,1524,77,30,26,19,2
2021,Tameside 007C,E01005943,1706,1592,114,31,52,24,7
2021,Tameside 007D,E01005944,1776,1618,158,78,60,18,2
2021,Tameside 004C,E01005945,1962,1696,266,103,74,80,9
2021,Tameside 004D,E01005946,1517,1362,155,49,54,43,9
2021,Tameside 004E,E01005947,1706,1357,349,92,166,75,16
2021,Tameside 013A,E01005948,2233,1667,566,152,242,140,32
2021,Tameside 006D,E01005949,1579,1365,214,59,93,53,9
2021,Tameside 013B,E01005950,2075,1481,594,156,224,172,42
2021,Tameside 013C,E01005951,1725,1417,308,107,119,65,17
2021,Tameside 013E,E01005953,2199,1748,451,158,167,97,29
2021,Tameside 005A,E01005954,1457,1392,65,20,19,22,4
2021,Tameside 002D,E01005955,1587,1468,119,39,50,27,3
2021,Tameside 005B,E01005956,1350,1270,80,28,35,14,3
2021,Tameside 005C,E01005957,1516,1383,133,46,47,32,8
2021,Tameside 005D,E01005958,1541,1453,88,35,34,18,1
2021,Tameside 005E,E01005959,1877,1652,225,91,70,49,15
2021,Tameside 006E,E01005960,1661,1391,270,108,99,49,14
2021,Tameside 014A,E01005961,2829,2668,161,80,47,23,11
2021,Tameside 014B,E01005962,1389,1321,68,22,22,18,6
2021,Tameside 019A,E01005963,1122,1095,27,10,10,6,1
2021,Tameside 019B,E01005964,1469,1436,33,8,14,7,4
2021,Tameside 019C,E01005965,1663,1543,120,52,48,19,1
2021,Tameside 019D,E01005966,1514,1440,74,32,16,23,3
2021,Tameside 019E,E01005967,1382,1277,105,46,27,28,4
2021,Tameside 014C,E01005968,1341,1294,47,25,10,12,0
2021,Tameside 014D,E01005969,1269,1217,52,19,21,11,1
2021,Tameside 021A,E01005970,1385,1331,54,17,20,7,10
2021,Tameside 025A,E01005971,1311,1260,51,13,22,11,5
2021,Tameside 021B,E01005972,1645,1549,96,40,35,18,3
2021,Tameside 026A,E01005973,1344,1329,15,4,6,5,0
2021,Tameside 021C,E01005974,1631,1556,75,29,25,19,2
2021,Tameside 021D,E01005975,1472,1392,80,40,27,12,1
2021,Tameside 026B,E01005976,1426,1389,37,14,15,6,2
2021,Tameside 026C,E01005977,1406,1381,25,7,11,5,2
2021,Tameside 026D,E01005978,1281,1235,46,20,17,7,2
2021,Tameside 029A,E01005979,1544,1513,31,12,16,3,0
2021,Tameside 029B,E01005980,1392,1362,30,11,15,4,0
2021,Tameside 029C,E01005981,1607,1544,63,26,22,11,4
2021,Tameside 029D,E01005982,1301,1258,43,20,18,5,0
2021,Tameside 029E,E01005983,1476,1451,25,12,7,6,0
2021,Tameside 029F,E01005984,1540,1483,57,24,26,5,2
2021,Tameside 024A,E01005985,1508,1486,22,7,7,7,1
2021,Tameside 025B,E01005986,1208,1177,31,14,9,6,2
2021,Tameside 024B,E01005987,1485,1469,16,5,3,6,2
2021,Tameside 024C,E01005988,1556,1518,38,15,13,9,1
2021,Tameside 025C,E01005989,1184,1179,5,0,3,2,0
2021,Tameside 024D,E01005990,1338,1319,19,2,8,7,2
2021,Tameside 024E,E01005991,1462,1417,45,22,14,9,0
2021,Tameside 025D,E01005992,1171,1138,33,18,11,3,1
2021,Tameside 010A,E01005993,1313,1300,13,1,10,1,1
2021,Tameside 011A,E01005994,1449,1385,64,25,27,11,1
2021,Tameside 010B,E01005995,1338,1294,44,10,13,17,4
2021,Tameside 010C,E01005996,1885,1792,93,33,30,26,4
2021,Tameside 010D,E01005997,1504,1450,54,22,16,15,1
2021,Tameside 012A,E01005998,1807,1667,140,47,65,25,3
2021,Tameside 011B,E01005999,2117,1812,305,125,101,70,9
2021,Tameside 010E,E01006000,1727,1632,95,30,40,22,3
2021,Tameside 012B,E01006001,1501,1393,108,39,49,17,3
2021,Tameside 011C,E01006002,1335,1269,66,25,30,11,0
2021,Tameside 012C,E01006003,1493,1383,110,43,40,22,5
2021,Tameside 011D,E01006004,1487,1435,52,20,16,15,1
2021,Tameside 011E,E01006005,1334,1268,66,22,23,17,4
2021,Tameside 012D,E01006006,1392,1363,29,15,10,4,0
2021,Tameside 011F,E01006007,1500,1412,88,37,32,16,3
2021,Tameside 017A,E01006008,1337,1284,53,17,20,12,4
2021,Tameside 016A,E01006009,1295,1248,47,24,16,5,2
2021,Tameside 017B,E01006010,1341,1296,45,17,22,6,0
2021,Tameside 018A,E01006011,1655,1562,93,28,44,18,3
2021,Tameside 017C,E01006012,1878,1804,74,32,23,18,1
2021,Tameside 018B,E01006013,1268,1234,34,7,10,12,5
2021,Tameside 018C,E01006014,1229,1174,55,29,20,5,1
2021,Tameside 017D,E01006015,1318,1271,47,21,16,5,5
2021,Tameside 017E,E01006016,1865,1684,181,55,81,41,4
2021,Tameside 016B,E01006017,1364,1355,9,3,3,3,0
2021,Tameside 016C,E01006018,1297,1281,16,5,5,4,2
2021,Tameside 018D,E01006019,1457,1433,24,12,7,2,3
2021,Tameside 018E,E01006020,1594,1570,24,13,6,3,2
2021,Tameside 016D,E01006021,1333,1315,18,13,4,0,1
2021,Tameside 015A,E01006022,1882,1809,73,28,27,16,2
2021,Tameside 015B,E01006023,1525,1464,61,23,23,12,3
2021,Tameside 022A,E01006024,1725,1699,26,15,8,1,2
2021,Tameside 027A,E01006025,1794,1721,73,35,33,5,0
2021,Tameside 022B,E01006026,1481,1440,41,16,14,9,2
2021,Tameside 027B,E01006027,2226,2122,104,52,37,13,2
2021,Tameside 028A,E01006028,1701,1568,133,39,58,28,8
2021,Tameside 028B,E01006029,1857,1538,319,84,107,106,22
2021,Tameside 028C,E01006030,1803,1745,58,18,19,19,2
2021,Tameside 020A,E01006031,2144,1986,158,66,48,37,7
2021,Tameside 020B,E01006032,1444,1392,52,29,10,11,2
2021,Tameside 020C,E01006033,1687,1614,73,33,25,15,0
2021,Tameside 020D,E01006034,2057,1978,79,23,32,20,4
2021,Tameside 020E,E01006035,2074,1995,79,25,31,21,2
2021,Tameside 020F,E01006036,2073,1942,131,56,44,28,3
2021,Tameside 022C,E01006037,1560,1552,8,7,1,0,0
2021,Tameside 022D,E01006038,1544,1513,31,16,8,5,2
2021,Tameside 028D,E01006039,1318,1103,215,53,61,85,16
2021,Tameside 028E,E01006040,1819,1507,312,80,94,115,23
2021,Tameside 028F,E01006041,1618,1435,183,38,70,51,24
2021,Tameside 030A,E01006042,1641,1626,15,8,4,3,0
2021,Tameside 030B,E01006043,1391,1351,40,8,18,13,1
2021,Tameside 030C,E01006044,1479,1452,27,13,7,6,1
2021,Tameside 030D,E01006045,1221,1215,6,4,2,0,0
2021,Tameside 030E,E01006046,1489,1472,17,8,5,3,1
2021,Tameside 023A,E01006047,1283,1267,16,10,3,2,1
2021,Tameside 023B,E01006048,1545,1524,21,11,7,3,0
2021,Tameside 023C,E01006049,1509,1494,15,7,3,4,1
2021,Tameside 027C,E01006050,1756,1701,55,26,21,7,1
2021,Tameside 023D,E01006051,1588,1571,17,11,3,3,0
2021,Tameside 027D,E01006052,1513,1483,30,12,12,4,2
2021,Tameside 001A,E01006053,1902,1882,20,15,5,0,0
2021,Tameside 001B,E01006054,1728,1680,48,24,13,8,3
2021,Tameside 001C,E01006055,1439,1412,27,21,3,3,0
2021,Tameside 003A,E01006056,1193,1163,30,16,11,3,0
2021,Tameside 001D,E01006057,1480,1446,34,23,7,3,1
2021,Tameside 001E,E01006058,2022,1965,57,25,19,12,1
2021,Tameside 001F,E01006059,1402,1371,31,15,8,8,0
2021,Tameside 008A,E01006060,1442,1370,72,33,24,12,3
2021,Tameside 003B,E01006061,2373,2296,77,34,29,13,1
2021,Tameside 003C,E01006062,1947,1938,9,4,4,0,1
2021,Tameside 003D,E01006063,1350,1332,18,6,7,5,0
2021,Tameside 008B,E01006064,1646,1568,78,27,28,20,3
2021,Tameside 008C,E01006065,1404,1290,114,46,36,31,1
2021,Tameside 008D,E01006066,1351,1307,44,21,9,14,0
2021,Tameside 009A,E01006067,1823,1801,22,13,6,2,1
2021,Tameside 009B,E01006068,1506,1482,24,10,9,4,1
2021,Tameside 009C,E01006069,1681,1629,52,25,16,8,3
2021,Tameside 015C,E01006070,1358,1337,21,11,5,5,0
2021,Tameside 015D,E01006071,1667,1626,41,24,14,2,1
2021,Tameside 015E,E01006072,1584,1557,27,12,9,5,1
2021,Tameside 009D,E01006073,1980,1905,75,32,35,8,0
2021,Trafford 025A,E01006074,1594,1515,79,43,26,8,2
2021,Trafford 025B,E01006075,2109,1934,175,83,67,19,6
2021,Trafford 025C,E01006076,1645,1563,82,40,30,10,2
2021,Trafford 027A,E01006077,1586,1489,97,51,34,9,3
2021,Trafford 024A,E01006078,2038,1831,207,110,66,25,6
2021,Trafford 025D,E01006079,2493,2218,275,198,62,15,0
2021,Trafford 024B,E01006080,1901,1788,113,51,45,15,2
2021,Trafford 027B,E01006081,1362,1284,78,57,15,4,2
2021,Trafford 027C,E01006082,1476,1416,60,24,25,7,4
2021,Trafford 026A,E01006083,1255,1234,21,12,6,3,0
2021,Trafford 026B,E01006084,1693,1645,48,26,15,6,1
2021,Trafford 027D,E01006085,1511,1457,54,28,19,5,2
2021,Trafford 027E,E01006086,1658,1588,70,46,17,5,2
2021,Trafford 025E,E01006087,1418,1340,78,54,21,3,0
2021,Trafford 026C,E01006088,1558,1491,67,34,19,12,2
2021,Trafford 024C,E01006089,1914,1685,229,140,65,22,2
2021,Trafford 020A,E01006090,2219,2038,181,106,58,16,1
2021,Trafford 019A,E01006091,2874,2477,397,266,85,38,8
2021,Trafford 019B,E01006092,1270,1159,111,45,41,23,2
2021,Trafford 023A,E01006093,1478,1414,64,38,16,10,0
2021,Trafford 020B,E01006094,1544,1395,149,98,36,15,0
2021,Trafford 019C,E01006095,1622,1480,142,100,31,11,0
2021,Trafford 020C,E01006096,1569,1447,122,78,26,13,5
2021,Trafford 015A,E01006097,1739,1582,157,96,42,17,2
2021,Trafford 014A,E01006098,1298,1244,54,40,10,2,2
2021,Trafford 014B,E01006099,1276,1205,71,41,22,8,0
2021,Trafford 020D,E01006100,1454,1387,67,37,20,9,1
2021,Trafford 021A,E01006101,1453,1385,68,44,18,6,0
2021,Trafford 018A,E01006102,1359,1261,98,79,16,3,0
2021,Trafford 020E,E01006103,1636,1493,143,77,40,21,5
2021,Trafford 017A,E01006104,1629,1588,41,23,13,5,0
2021,Trafford 017B,E01006105,1698,1615,83,41,20,18,4
2021,Trafford 017C,E01006106,1423,1381,42,10,17,11,4
2021,Trafford 017D,E01006107,1549,1527,22,10,7,3,2
2021,Trafford 017E,E01006108,1589,1531,58,18,25,14,1
2021,Trafford 001A,E01006109,1103,895,208,73,88,41,6
2021,Trafford 001B,E01006110,1791,1465,326,101,118,90,17
2021,Trafford 001C,E01006111,1699,1310,389,123,143,109,14
2021,Trafford 001D,E01006112,1959,1515,444,137,165,121,21
2021,Trafford 004A,E01006113,1553,1284,269,108,93,62,6
2021,Trafford 004B,E01006114,1633,1359,274,92,106,60,16
2021,Trafford 004C,E01006115,1475,1276,199,61,83,47,8
2021,Trafford 002A,E01006116,1276,1255,21,9,6,6,0
2021,Trafford 002B,E01006117,1643,1606,37,20,13,3,1
2021,Trafford 002C,E01006118,1416,1372,44,19,15,9,1
2021,Trafford 002D,E01006119,1574,1523,51,25,22,4,0
2021,Trafford 010A,E01006120,1375,1350,25,16,8,1,0
2021,Trafford 002E,E01006121,1405,1360,45,27,9,8,1
2021,Trafford 005A,E01006122,1732,1701,31,15,11,4,1
2021,Trafford 005B,E01006123,1633,1571,62,43,11,7,1
2021,Trafford 005C,E01006124,1441,1422,19,9,5,4,1
2021,Trafford 007A,E01006125,1461,1442,19,10,5,4,0
2021,Trafford 007B,E01006126,1768,1731,37,20,11,6,0
2021,Trafford 007C,E01006127,1505,1478,27,13,9,5,0
2021,Trafford 005D,E01006128,1871,1833,38,17,15,6,0
2021,Trafford 010B,E01006129,1344,1304,40,28,7,4,1
2021,Trafford 007D,E01006130,1700,1657,43,31,9,3,0
2021,Trafford 005E,E01006131,1484,1451,33,25,4,3,1
2021,Trafford 007E,E01006132,1494,1477,17,6,10,1,0
2021,Trafford 010C,E01006133,1382,1375,7,3,4,0,0
2021,Trafford 028A,E01006134,1459,1390,69,32,25,9,3
2021,Trafford 028B,E01006135,1719,1605,114,70,29,13,2
2021,Trafford 028C,E01006136,1636,1518,118,84,21,12,1
2021,Trafford 028D,E01006137,1370,1215,155,90,47,16,2
2021,Trafford 028E,E01006138,1827,1660,167,111,37,17,2
2021,Trafford 026D,E01006139,1738,1647,91,51,34,6,0
2021,Trafford 026E,E01006140,1638,1531,107,67,29,10,1
2021,Trafford 003A,E01006141,1716,1515,201,98,66,32,5
2021,Trafford 011A,E01006142,1670,1547,123,44,54,22,3
2021,Trafford 011B,E01006143,1614,1508,106,54,42,9,1
2021,Trafford 011C,E01006144,1353,1250,103,54,35,13,1
2021,Trafford 004D,E01006145,1978,1644,334,158,109,55,12
2021,Trafford 004E,E01006146,1715,1522,193,75,67,47,4
2021,Trafford 012A,E01006147,1387,1319,68,46,17,4,1
2021,Trafford 016A,E01006148,1666,1569,97,59,26,12,0
2021,Trafford 012B,E01006149,1519,1435,84,55,15,13,1
2021,Trafford 012C,E01006150,1868,1742,126,61,44,15,6
2021,Trafford 016B,E01006151,1542,1440,102,77,21,3,1
2021,Trafford 016C,E01006152,1605,1417,188,128,47,12,1
2021,Trafford 016D,E01006153,1559,1374,185,89,66,28,2
2021,Trafford 012D,E01006154,1541,1453,88,55,24,8,1
2021,Trafford 006A,E01006155,1688,1607,81,46,28,6,1
2021,Trafford 008A,E01006156,1635,1553,82,42,22,17,1
2021,Trafford 006B,E01006157,1639,1506,133,60,50,17,6
2021,Trafford 008B,E01006158,1654,1501,153,79,44,23,7
2021,Trafford 006C,E01006159,1788,1634,154,72,54,22,6
2021,Trafford 015B,E01006160,2074,1686,388,202,104,74,8
2021,Trafford 015C,E01006161,2093,1894,199,103,66,29,1
2021,Trafford 015D,E01006162,1574,1494,80,48,25,7,0
2021,Trafford 015E,E01006163,1756,1634,122,63,37,19,3
2021,Trafford 014C,E01006164,1706,1645,61,39,14,7,1
2021,Trafford 012E,E01006165,1908,1711,197,116,58,22,1
2021,Trafford 013A,E01006166,1595,1465,130,67,39,22,2
2021,Trafford 019D,E01006167,1526,1438,88,44,25,18,1
2021,Trafford 019E,E01006168,1746,1643,103,39,36,24,4
2021,Trafford 013B,E01006169,1587,1556,31,20,7,4,0
2021,Trafford 013C,E01006170,1555,1533,22,13,5,3,1
2021,Trafford 013D,E01006171,1694,1618,76,34,31,9,2
2021,Trafford 016E,E01006172,1508,1450,58,27,23,8,0
2021,Trafford 018B,E01006173,1488,1434,54,41,10,2,1
2021,Trafford 014D,E01006174,1728,1659,69,50,14,5,0
2021,Trafford 018C,E01006175,1702,1565,137,83,29,22,3
2021,Trafford 018D,E01006176,1679,1553,126,75,41,10,0
2021,Trafford 018E,E01006177,1596,1441,155,74,32,37,12
2021,Trafford 014E,E01006178,1755,1670,85,53,20,11,1
2021,Trafford 008C,E01006179,1733,1630,103,52,36,12,3
2021,Trafford 011D,E01006180,1770,1650,120,60,34,24,2
2021,Trafford 011E,E01006181,1695,1519,176,89,56,29,2
2021,Trafford 006D,E01006182,1564,1426,138,81,47,7,3
2021,Trafford 006E,E01006183,1675,1530,145,55,54,27,9
2021,Trafford 008D,E01006184,1632,1571,61,32,17,11,1
2021,Trafford 003B,E01006186,2090,1812,278,163,78,34,3
2021,Trafford 003C,E01006187,2492,2220,272,141,92,32,7
2021,Trafford 001F,E01006188,1906,1491,415,165,155,83,12
2021,Trafford 003D,E01006189,2251,2069,182,104,49,25,4
2021,Trafford 021B,E01006190,1632,1564,68,50,12,6,0
2021,Trafford 023B,E01006191,1651,1589,62,34,14,13,1
2021,Trafford 023C,E01006192,1480,1446,34,17,12,4,1
2021,Trafford 024D,E01006193,1516,1451,65,31,26,7,1
2021,Trafford 024E,E01006194,2331,2103,228,129,81,18,0
2021,Trafford 021C,E01006195,1742,1659,83,53,21,7,2
2021,Trafford 021D,E01006196,1650,1560,90,66,21,3,0
2021,Trafford 010D,E01006197,1431,1395,36,11,18,4,3
2021,Trafford 009A,E01006198,1420,1359,61,38,14,8,1
2021,Trafford 009B,E01006199,1493,1454,39,25,7,6,1
2021,Trafford 009C,E01006200,1445,1401,44,24,13,6,1
2021,Trafford 009D,E01006201,1404,1379,25,11,7,7,0
2021,Trafford 009E,E01006202,1255,1209,46,24,13,8,1
2021,Trafford 010E,E01006203,1301,1287,14,6,8,0,0
2021,Trafford 022A,E01006204,1584,1515,69,40,21,5,3
2021,Trafford 023D,E01006205,1311,1259,52,25,21,6,0
2021,Trafford 022B,E01006206,1812,1629,183,114,48,19,2
2021,Trafford 022C,E01006207,1680,1576,104,42,36,25,1
2021,Trafford 022D,E01006208,1519,1383,136,92,29,13,2
2021,Trafford 023E,E01006209,1603,1560,43,29,6,6,2
2021,Trafford 021E,E01006210,1562,1479,83,60,14,8,1
2021,Trafford 022E,E01006211,1559,1480,79,60,18,1,0
2021,Wigan 026A,E01006212,1358,1345,13,7,3,3,0
2021,Wigan 024A,E01006213,1449,1352,97,34,46,17,0
2021,Wigan 026B,E01006214,1329,1287,42,17,18,5,2
2021,Wigan 024B,E01006215,1660,1570,90,25,41,20,4
2021,Wigan 026C,E01006216,2109,2063,46,19,20,7,0
2021,Wigan 024C,E01006217,2298,2240,58,22,27,9,0
2021,Wigan 024D,E01006218,2296,2097,199,64,99,35,1
2021,Wigan 024E,E01006219,1151,1130,21,7,9,5,0
2021,Wigan 035A,E01006220,1702,1658,44,12,20,11,1
2021,Wigan 035B,E01006221,1524,1493,31,14,7,10,0
2021,Wigan 035C,E01006222,1528,1509,19,10,6,3,0
2021,Wigan 036A,E01006223,1538,1493,45,10,20,14,1
2021,Wigan 035D,E01006224,1390,1381,9,4,5,0,0
2021,Wigan 036B,E01006225,1471,1459,12,5,3,4,0
2021,Wigan 035E,E01006226,1661,1640,21,10,9,2,0
2021,Wigan 038A,E01006227,1549,1513,36,15,20,1,0
2021,Wigan 038B,E01006228,1571,1502,69,26,25,17,1
2021,Wigan 002A,E01006229,1348,1311,37,18,12,7,0
2021,Wigan 002B,E01006230,2041,1992,49,27,15,6,1
2021,Wigan 004A,E01006231,1427,1414,13,3,5,5,0
2021,Wigan 004B,E01006232,1932,1908,24,15,5,4,0
2021,Wigan 002C,E01006233,1379,1357,22,14,6,2,0
2021,Wigan 004C,E01006234,1127,1112,15,5,4,3,3
2021,Wigan 004D,E01006235,1485,1439,46,19,16,6,5
2021,Wigan 007A,E01006236,1541,1525,16,8,3,4,1
2021,Wigan 002D,E01006237,1860,1836,24,9,8,5,2
2021,Wigan 002E,E01006238,1468,1402,66,21,29,16,0
2021,Wigan 017A,E01006239,2028,1943,85,31,39,14,1
2021,Wigan 017B,E01006240,1501,1399,102,36,39,27,0
2021,Wigan 017C,E01006241,2409,2309,100,50,34,13,3
2021,Wigan 023A,E01006242,1873,1815,58,28,25,4,1
2021,Wigan 023B,E01006243,2061,2029,32,14,8,10,0
2021,Wigan 023C,E01006244,1632,1565,67,36,18,12,1
2021,Wigan 023D,E01006245,2524,2465,59,27,23,9,0
2021,Wigan 034A,E01006246,1489,1448,41,20,12,6,3
2021,Wigan 034B,E01006247,1256,1228,28,18,7,3,0
2021,Wigan 031A,E01006248,2143,2010,133,56,50,24,3
2021,Wigan 031B,E01006249,1603,1511,92,31,41,17,3
2021,Wigan 029A,E01006250,2046,2013,33,13,15,5,0
2021,Wigan 029B,E01006251,1506,1489,17,10,7,0,0
2021,Wigan 034C,E01006252,1362,1346,16,8,5,2,1
2021,Wigan 005A,E01006253,1479,1412,67,20,31,13,3
2021,Wigan 005B,E01006254,1518,1453,65,28,20,16,1
2021,Wigan 005C,E01006255,1458,1422,36,16,8,12,0
2021,Wigan 005D,E01006256,1646,1541,105,56,32,13,4
2021,Wigan 008A,E01006257,1175,1127,48,26,18,3,1
2021,Wigan 008B,E01006258,1556,1525,31,12,12,5,2
2021,Wigan 003A,E01006259,1279,1242,37,16,12,8,1
2021,Wigan 005E,E01006260,1475,1411,64,21,20,18,5
2021,Wigan 036C,E01006261,1455,1442,13,11,2,0,0
2021,Wigan 032A,E01006262,1665,1621,44,13,20,9,2
2021,Wigan 032B,E01006263,1463,1460,3,1,1,1,0
2021,Wigan 036D,E01006264,1202,1201,1,1,0,0,0
2021,Wigan 036E,E01006265,1361,1341,20,9,7,3,1
2021,Wigan 032C,E01006266,1353,1337,16,6,8,2,0
2021,Wigan 032D,E01006267,1568,1547,21,1,15,5,0
2021,Wigan 032E,E01006268,1597,1580,17,6,6,5,0
2021,Wigan 013A,E01006269,1689,1654,35,5,9,13,8
2021,Wigan 016A,E01006270,1414,1393,21,11,6,4,0
2021,Wigan 013B,E01006271,1633,1606,27,5,15,6,1
2021,Wigan 013C,E01006272,1578,1538,40,16,17,7,0
2021,Wigan 013D,E01006273,1435,1409,26,12,10,3,1
2021,Wigan 016B,E01006274,1474,1432,42,14,18,10,0
2021,Wigan 016C,E01006275,1508,1469,39,18,13,7,1
2021,Wigan 013E,E01006276,2094,2066,28,13,3,7,5
2021,Wigan 016D,E01006277,1829,1795,34,14,14,5,1
2021,Wigan 019A,E01006278,1585,1557,28,11,13,2,2
2021,Wigan 019B,E01006279,1529,1506,23,10,6,7,0
2021,Wigan 019C,E01006280,1423,1396,27,12,11,4,0
2021,Wigan 019D,E01006281,1868,1811,57,27,23,7,0
2021,Wigan 027A,E01006282,1794,1720,74,24,35,15,0
2021,Wigan 027B,E01006283,1512,1404,108,37,38,28,5
2021,Wigan 027C,E01006284,1530,1459,71,29,27,14,1
2021,Wigan 019E,E01006285,1877,1846,31,11,15,5,0
2021,Wigan 016E,E01006286,1524,1512,12,6,5,1,0
2021,Wigan 017D,E01006287,1122,1109,13,5,4,4,0
2021,Wigan 025A,E01006288,1749,1685,64,25,25,13,1
2021,Wigan 017E,E01006289,1625,1534,91,36,45,6,4
2021,Wigan 022A,E01006290,1354,1329,25,12,12,1,0
2021,Wigan 022B,E01006291,1408,1368,40,15,21,4,0
2021,Wigan 022C,E01006292,1477,1450,27,12,9,6,0
2021,Wigan 022D,E01006293,1574,1532,42,19,14,9,0
2021,Wigan 025B,E01006294,1868,1768,100,29,36,31,4
2021,Wigan 025C,E01006295,1525,1481,44,12,15,17,0
2021,Wigan 037A,E01006296,1447,1351,96,38,45,10,3
2021,Wigan 034D,E01006297,1532,1470,62,24,25,13,0
2021,Wigan 037B,E01006298,1397,1344,53,16,20,9,8
2021,Wigan 037C,E01006299,1900,1847,53,25,19,8,1
2021,Wigan 037D,E01006300,1338,1324,14,4,9,1,0
2021,Wigan 037E,E01006301,1454,1440,14,8,6,0,0
2021,Wigan 040A,E01006302,1794,1754,40,21,10,9,0
2021,Wigan 040B,E01006303,1565,1556,9,7,1,1,0
2021,Wigan 040C,E01006304,1480,1469,11,6,4,1,0
2021,Wigan 012A,E01006305,1650,1485,165,59,71,32,3
2021,Wigan 009A,E01006306,1435,1210,225,48,106,59,12
2021,Wigan 009B,E01006307,1336,1234,102,31,55,16,0
2021,Wigan 012B,E01006308,1555,1361,194,57,84,48,5
2021,Wigan 012C,E01006309,1606,1534,72,27,35,9,1
2021,Wigan 012D,E01006310,1543,1442,101,39,43,18,1
2021,Wigan 012E,E01006311,1471,1391,80,37,29,12,2
2021,Wigan 003B,E01006312,1342,1330,12,7,4,1,0
2021,Wigan 003C,E01006313,1396,1384,12,7,5,0,0
2021,Wigan 003D,E01006314,1687,1677,10,7,3,0,0
2021,Wigan 001A,E01006315,1441,1422,19,10,6,3,0
2021,Wigan 001B,E01006316,1927,1902,25,12,9,4,0
2021,Wigan 001C,E01006317,1514,1484,30,21,7,2,0
2021,Wigan 003E,E01006318,1395,1384,11,9,0,2,0
2021,Wigan 001D,E01006319,1522,1465,57,29,22,4,2
2021,Wigan 003F,E01006320,1240,1236,4,1,2,1,0
2021,Wigan 003G,E01006321,1548,1542,6,5,1,0,0
2021,Wigan 026D,E01006322,1966,1845,121,44,42,35,0
2021,Wigan 033A,E01006323,1495,1421,74,28,31,13,2
2021,Wigan 033B,E01006324,1258,1221,37,17,14,6,0
2021,Wigan 033C,E01006325,1470,1423,47,21,20,6,0
2021,Wigan 033D,E01006326,1361,1249,112,33,51,26,2
2021,Wigan 033E,E01006327,2407,2300,107,55,41,10,1
2021,Wigan 030A,E01006328,1462,1256,206,72,78,48,8
2021,Wigan 026E,E01006329,1594,1540,54,29,10,11,4
2021,Wigan 031C,E01006330,1520,1486,34,16,10,6,2
2021,Wigan 031D,E01006331,1492,1477,15,6,3,4,2
2021,Wigan 031E,E01006332,1961,1896,65,30,21,6,8
2021,Wigan 030B,E01006333,2012,1777,235,82,103,46,4
2021,Wigan 030C,E01006334,1990,1665,325,116,133,70,6
2021,Wigan 034E,E01006335,1517,1434,83,31,33,15,4
2021,Wigan 027D,E01006336,1598,1461,137,60,37,37,3
2021,Wigan 027E,E01006337,1457,1397,60,28,19,12,1
2021,Wigan 030D,E01006338,1593,1509,84,21,36,25,2
2021,Wigan 039A,E01006339,1241,1233,8,4,3,0,1
2021,Wigan 039B,E01006340,1829,1774,55,25,22,5,3
2021,Wigan 040D,E01006341,1606,1562,44,17,18,6,3
2021,Wigan 038C,E01006342,1510,1477,33,9,13,9,2
2021,Wigan 039C,E01006343,1567,1547,20,8,11,1,0
2021,Wigan 038D,E01006344,1403,1382,21,11,4,6,0
2021,Wigan 039D,E01006345,1522,1507,15,6,6,2,1
2021,Wigan 038E,E01006346,2001,1947,54,22,22,9,1
2021,Wigan 040E,E01006347,1497,1484,13,7,2,1,3
2021,Wigan 039E,E01006348,2539,2505,34,24,5,5,0
2021,Wigan 015A,E01006349,1960,1817,143,50,62,30,1
2021,Wigan 010A,E01006350,1780,1633,147,57,63,20,7
2021,Wigan 010B,E01006351,1907,1714,193,74,87,27,5
2021,Wigan 015B,E01006352,1949,1809,140,50,60,22,8
2021,Wigan 014A,E01006353,1417,1369,48,28,8,9,3
2021,Wigan 014B,E01006354,1404,1341,63,26,26,7,4
2021,Wigan 014C,E01006355,1437,1399,38,10,14,12,2
2021,Wigan 011A,E01006356,1385,1327,58,22,19,14,3
2021,Wigan 010C,E01006357,1752,1653,99,39,41,16,3
2021,Wigan 014D,E01006358,2068,2019,49,23,21,3,2
2021,Wigan 014E,E01006359,1349,1293,56,26,22,6,2
2021,Wigan 010D,E01006360,1611,1423,188,59,95,31,3
2021,Wigan 010E,E01006361,1595,1476,119,41,53,21,4
2021,Wigan 018A,E01006362,1591,1577,14,4,5,5,0
2021,Wigan 018B,E01006363,1492,1481,11,3,4,3,1
2021,Wigan 018C,E01006364,1784,1758,26,13,10,3,0
2021,Wigan 018D,E01006365,2203,2176,27,13,6,7,1
2021,Wigan 018E,E01006366,1790,1775,15,5,3,7,0
2021,Wigan 018F,E01006367,1739,1722,17,5,8,4,0
2021,Wigan 018G,E01006368,1832,1811,21,14,3,1,3
2021,Wigan 008C,E01006369,1929,1712,217,66,103,40,8
2021,Wigan 006A,E01006370,1832,1518,314,127,127,52,8
2021,Wigan 008D,E01006371,1434,1362,72,23,31,17,1
2021,Wigan 006B,E01006372,1572,1541,31,21,6,3,1
2021,Wigan 006C,E01006373,1411,1386,25,16,9,0,0
2021,Wigan 006D,E01006374,1427,1411,16,7,6,3,0
2021,Wigan 008E,E01006375,1642,1544,98,45,33,20,0
2021,Wigan 028A,E01006376,1710,1664,46,19,18,7,2
2021,Wigan 025D,E01006377,1519,1481,38,27,9,2,0
2021,Wigan 025E,E01006378,1266,1252,14,9,3,1,1
2021,Wigan 029C,E01006379,1534,1489,45,23,14,8,0
2021,Wigan 029D,E01006380,2584,2440,144,72,41,26,5
2021,Wigan 028B,E01006381,1987,1936,51,25,16,10,0
2021,Wigan 028C,E01006382,1224,1211,13,5,5,2,1
2021,Wigan 028D,E01006383,1557,1524,33,22,7,4,0
2021,Wigan 028E,E01006384,1281,1252,29,13,9,5,2
2021,Wigan 029E,E01006385,1415,1397,18,6,5,7,0
2021,Wigan 009C,E01006386,1556,1400,156,35,79,34,8
2021,Wigan 009D,E01006387,1279,1229,50,22,21,5,2
2021,Wigan 007B,E01006388,1772,1731,41,10,27,4,0
2021,Wigan 007C,E01006389,1277,1214,63,24,33,6,0
2021,Wigan 006E,E01006390,1544,1477,67,24,33,9,1
2021,Wigan 007D,E01006391,1506,1473,33,16,11,5,1
2021,Wigan 009E,E01006392,1404,1242,162,42,81,37,2
2021,Wigan 021A,E01006393,1355,1338,17,4,6,3,4
2021,Wigan 021B,E01006394,1504,1498,6,6,0,0,0
2021,Wigan 021C,E01006395,2556,2539,17,6,9,1,1
2021,Wigan 011B,E01006396,1442,1420,22,17,3,1,1
2021,Wigan 011C,E01006397,1053,1026,27,10,10,5,2
2021,Wigan 011D,E01006398,974,939,35,10,17,8,0
2021,Wigan 011E,E01006399,1541,1483,58,24,25,9,0
2021,Wigan 021D,E01006400,1914,1887,27,11,6,9,1
2021,Wigan 021E,E01006401,1323,1316,7,4,3,0,0
2021,Wigan 021F,E01006402,1105,1093,12,2,7,3,0
2021,Wigan 021G,E01006403,1595,1573,22,9,7,5,1
2021,Wigan 015C,E01006404,1715,1644,71,24,35,9,3
2021,Wigan 015D,E01006405,1691,1644,47,17,17,13,0
2021,Wigan 020A,E01006406,1348,1324,24,8,8,8,0
2021,Wigan 020B,E01006407,1415,1396,19,9,7,3,0
2021,Wigan 020C,E01006408,1672,1627,45,12,22,9,2
2021,Wigan 020D,E01006409,1271,1268,3,3,0,0,0
2021,Wigan 020E,E01006410,1253,1245,8,4,4,0,0
2021,Wigan 015E,E01006411,1391,1291,100,39,42,19,0
2021,Knowsley 006A,E01006412,1523,1442,81,34,26,17,4
2021,Knowsley 006B,E01006413,1357,1202,155,32,72,46,5
2021,Knowsley 006C,E01006414,1321,1265,56,18,21,15,2
2021,Knowsley 003A,E01006415,1914,1860,54,19,20,14,1
2021,Knowsley 005A,E01006416,1454,1393,61,13,33,13,2
2021,Knowsley 003B,E01006417,1196,1137,59,23,24,11,1
2021,Knowsley 005B,E01006418,1271,1234,37,15,14,7,1
2021,Knowsley 019A,E01006419,1348,1331,17,8,5,4,0
2021,Knowsley 017A,E01006420,2324,2280,44,22,14,8,0
2021,Knowsley 018A,E01006421,1085,1079,6,1,4,1,0
2021,Knowsley 019B,E01006422,1217,1202,15,11,3,1,0
2021,Knowsley 019C,E01006423,1271,1257,14,8,5,0,1
2021,Knowsley 017B,E01006424,1886,1873,13,4,6,3,0
2021,Knowsley 018B,E01006425,1242,1229,13,4,6,3,0
2021,Knowsley 020A,E01006426,1310,1291,19,7,5,7,0
2021,Knowsley 019D,E01006427,1396,1371,25,12,12,1,0
2021,Knowsley 020B,E01006428,1496,1453,43,23,17,3,0
2021,Knowsley 020C,E01006429,1087,1076,11,9,1,1,0
2021,Knowsley 018C,E01006430,1479,1438,41,14,22,4,1
2021,Knowsley 020D,E01006431,1770,1722,48,16,26,5,1
2021,Knowsley 020E,E01006432,1513,1434,79,22,32,25,0
2021,Knowsley 018D,E01006433,1532,1497,35,19,9,6,1
2021,Knowsley 005C,E01006434,1469,1447,22,6,9,7,0
2021,Knowsley 005D,E01006435,1464,1430,34,10,18,6,0
2021,Knowsley 003C,E01006436,1410,1380,30,10,14,4,2
2021,Knowsley 003D,E01006437,1326,1285,41,16,18,6,1
2021,Knowsley 005E,E01006438,1125,1091,34,17,12,5,0
2021,Knowsley 005F,E01006439,1597,1580,17,9,3,2,3
2021,Knowsley 010A,E01006440,1339,1290,49,28,16,4,1
2021,Knowsley 010B,E01006442,1408,1330,78,30,32,14,2
2021,Knowsley 010C,E01006443,1403,1350,53,23,26,4,0
2021,Knowsley 010D,E01006444,1318,1227,91,39,36,13,3
2021,Knowsley 010E,E01006445,1210,1161,49,21,20,8,0
2021,Knowsley 005G,E01006446,1393,1343,50,20,18,10,2
2021,Knowsley 003E,E01006447,1344,1237,107,42,44,15,6
2021,Knowsley 001A,E01006448,2062,1945,117,44,42,25,6
2021,Knowsley 012A,E01006449,1545,1512,33,12,11,9,1
2021,Knowsley 012B,E01006450,1620,1560,60,40,15,2,3
2021,Knowsley 012C,E01006451,1370,1350,20,8,8,3,1
2021,Knowsley 012D,E01006452,1359,1348,11,8,3,0,0
2021,Knowsley 008A,E01006453,1133,1082,51,22,15,13,1
2021,Knowsley 002A,E01006454,1476,1456,20,8,9,3,0
2021,Knowsley 004A,E01006455,1666,1586,80,28,31,16,5
2021,Knowsley 002B,E01006456,1478,1464,14,8,2,4,0
2021,Knowsley 002C,E01006457,1214,1203,11,5,6,0,0
2021,Knowsley 002D,E01006458,1477,1452,25,12,9,3,1
2021,Knowsley 009A,E01006459,1584,1484,100,55,33,11,1
2021,Knowsley 007A,E01006460,1461,1407,54,15,23,14,2
2021,Knowsley 007B,E01006461,1392,1370,22,7,5,10,0
2021,Knowsley 009B,E01006462,1636,1594,42,25,17,0,0
2021,Knowsley 007D,E01006464,2530,2441,89,52,34,1,2
2021,Knowsley 011A,E01006465,1542,1502,40,26,8,4,2
2021,Knowsley 007E,E01006466,1452,1420,32,13,9,6,4
2021,Knowsley 008B,E01006467,1249,1176,73,25,36,12,0
2021,Knowsley 008E,E01006470,1375,1335,40,17,10,13,0
2021,Knowsley 016A,E01006471,1413,1405,8,6,1,1,0
2021,Knowsley 014A,E01006472,1463,1450,13,3,7,3,0
2021,Knowsley 016B,E01006473,1548,1526,22,10,7,2,3
2021,Knowsley 016C,E01006474,1856,1830,26,13,10,2,1
2021,Knowsley 016D,E01006475,1414,1391,23,11,5,5,2
2021,Knowsley 016E,E01006476,1369,1348,21,9,5,7,0
2021,Knowsley 015A,E01006477,1401,1381,20,12,3,1,4
2021,Knowsley 015B,E01006478,1764,1727,37,18,15,2,2
2021,Knowsley 015C,E01006479,1389,1370,19,10,2,6,1
2021,Knowsley 015D,E01006480,1351,1316,35,12,12,11,0
2021,Knowsley 015E,E01006481,1322,1316,6,4,2,0,0
2021,Knowsley 011B,E01006482,1452,1424,28,12,8,6,2
2021,Knowsley 011C,E01006483,1402,1358,44,17,14,13,0
2021,Knowsley 011D,E01006484,1249,1215,34,12,17,3,2
2021,Knowsley 014B,E01006485,1751,1722,29,13,10,6,0
2021,Knowsley 014C,E01006486,1105,1092,13,5,2,4,2
2021,Knowsley 014D,E01006487,1400,1386,14,6,5,2,1
2021,Knowsley 014E,E01006488,2368,2333,35,21,10,2,2
2021,Knowsley 014F,E01006489,1294,1292,2,1,1,0,0
2021,Knowsley 002E,E01006490,2547,2515,32,20,5,6,1
2021,Knowsley 002F,E01006491,1940,1904,36,15,16,3,2
2021,Knowsley 001B,E01006492,1249,1239,10,6,3,1,0
2021,Knowsley 001C,E01006493,1726,1611,115,53,48,11,3
2021,Knowsley 001D,E01006494,1687,1597,90,42,30,16,2
2021,Knowsley 001E,E01006495,2221,2095,126,62,31,24,9
2021,Knowsley 009C,E01006496,1369,1338,31,19,9,3,0
2021,Knowsley 013A,E01006497,1069,1043,26,13,8,3,2
2021,Knowsley 009D,E01006498,1544,1494,50,32,12,4,2
2021,Knowsley 009E,E01006499,1848,1743,105,64,32,8,1
2021,Knowsley 013B,E01006500,1019,1009,10,4,5,1,0
2021,Knowsley 013C,E01006501,1333,1313,20,8,10,2,0
2021,Knowsley 017C,E01006502,1603,1590,13,6,5,1,1
2021,Knowsley 017D,E01006503,1204,1193,11,8,3,0,0
2021,Knowsley 013D,E01006504,1126,1089,37,16,12,9,0
2021,Knowsley 013E,E01006505,1620,1599,21,6,8,4,3
2021,Knowsley 004B,E01006506,1256,1191,65,30,26,7,2
2021,Knowsley 004C,E01006507,1482,1432,50,24,16,10,0
2021,Knowsley 004D,E01006508,1339,1309,30,7,14,9,0
2021,Knowsley 004E,E01006509,1698,1625,73,26,26,20,1
2021,Knowsley 004F,E01006510,1297,1250,47,16,17,9,5
2021,Liverpool 031A,E01006512,2237,1868,369,149,176,43,1
2021,Liverpool 037A,E01006514,2528,2190,338,117,171,49,1
2021,Liverpool 044A,E01006518,1772,1524,248,88,94,52,14
2021,Liverpool 056A,E01006519,1284,1249,35,10,16,8,1
2021,Liverpool 043A,E01006520,1532,1442,90,62,13,8,7
2021,Liverpool 052A,E01006521,1530,1395,135,55,46,30,4
2021,Liverpool 048A,E01006522,1687,1562,125,61,29,32,3
2021,Liverpool 052B,E01006523,1433,1341,92,51,30,8,3
2021,Liverpool 048B,E01006524,1274,1218,56,41,7,7,1
2021,Liverpool 049A,E01006525,1148,1116,32,20,7,4,1
2021,Liverpool 048C,E01006526,1330,1307,23,16,6,0,1
2021,Liverpool 053A,E01006527,1342,1296,46,31,9,5,1
2021,Liverpool 052C,E01006528,1316,1228,88,45,30,11,2
2021,Liverpool 048D,E01006529,1301,1248,53,32,12,8,1
2021,Liverpool 055A,E01006530,1360,1350,10,6,2,2,0
2021,Liverpool 055B,E01006531,1383,1371,12,11,1,0,0
2021,Liverpool 047A,E01006532,1510,1477,33,20,11,1,1
2021,Liverpool 055C,E01006533,1309,1274,35,16,14,5,0
2021,Liverpool 054A,E01006534,1818,1705,113,62,33,15,3
2021,Liverpool 054B,E01006535,1604,1555,49,20,19,10,0
2021,Liverpool 054C,E01006536,1750,1684,66,23,24,17,2
2021,Liverpool 055D,E01006537,2409,2221,188,85,78,23,2
2021,Liverpool 055E,E01006538,1233,1208,25,12,4,2,7
2021,Liverpool 047B,E01006539,1340,1284,56,30,21,5,0
2021,Liverpool 024A,E01006540,1682,1359,323,93,122,91,17
2021,Liverpool 015A,E01006541,1430,1361,69,21,33,12,3
2021,Liverpool 018A,E01006542,1488,1269,219,93,62,53,11
2021,Liverpool 015B,E01006543,1108,1093,15,6,5,4,0
2021,Liverpool 015C,E01006544,1560,1465,95,32,44,18,1
2021,Liverpool 019A,E01006545,1309,1199,110,27,47,29,7
2021,Liverpool 019B,E01006546,1274,1059,215,76,89,45,5
2021,Liverpool 019C,E01006547,1572,1168,404,143,176,77,8
2021,Liverpool 019D,E01006548,1722,1283,439,118,159,140,22
2021,Liverpool 043B,E01006549,1419,1178,241,107,79,55,0
2021,Liverpool 038A,E01006550,1762,1670,92,40,40,12,0
2021,Liverpool 048E,E01006551,1218,1146,72,36,15,14,7
2021,Liverpool 039A,E01006552,1757,1268,489,164,174,135,16
2021,Liverpool 042A,E01006553,1441,1374,67,37,17,12,1
2021,Liverpool 048F,E01006554,1654,1515,139,80,32,25,2
2021,Liverpool 039B,E01006556,1973,1368,605,149,224,199,33
2021,Liverpool 038B,E01006557,1867,1738,129,66,42,19,2
2021,Liverpool 018B,E01006558,1224,1042,182,55,66,53,8
2021,Liverpool 023A,E01006560,1834,1661,173,48,73,40,12
2021,Liverpool 018E,E01006562,1427,1195,232,53,101,72,6
2021,Liverpool 024B,E01006563,1670,1417,253,105,90,50,8
2021,Liverpool 023B,E01006564,1567,1430,137,59,56,18,4
2021,Liverpool 029A,E01006565,1475,1424,51,14,22,14,1
2021,Liverpool 032A,E01006566,1331,1290,41,19,13,9,0
2021,Liverpool 026A,E01006567,1635,1480,155,42,49,45,19
2021,Liverpool 026B,E01006568,1490,1449,41,18,12,11,0
2021,Liverpool 029B,E01006569,1373,1363,10,4,3,1,2
2021,Liverpool 026C,E01006570,1384,1320,64,27,28,6,3
2021,Liverpool 026D,E01006571,1368,1339,29,7,8,11,3
2021,Liverpool 025A,E01006572,1208,1137,71,22,26,22,1
2021,Liverpool 029C,E01006573,1410,1321,89,24,30,29,6
2021,Liverpool 025B,E01006574,1469,1314,155,45,67,19,24
2021,Liverpool 034A,E01006575,1240,1201,39,18,12,9,0
2021,Liverpool 034B,E01006576,1690,1648,42,27,10,5,0
2021,Liverpool 034C,E01006577,1475,1450,25,16,8,0,1
2021,Liverpool 036A,E01006578,1292,1253,39,21,13,4,1
2021,Liverpool 034D,E01006579,1518,1478,40,21,9,10,0
2021,Liverpool 036B,E01006580,1255,1224,31,15,14,2,0
2021,Liverpool 036C,E01006581,1500,1466,34,20,13,1,0
2021,Liverpool 041A,E01006582,1670,1613,57,37,11,7,2
2021,Liverpool 047C,E01006583,1596,1574,22,16,4,1,1
2021,Liverpool 034E,E01006584,1368,1346,22,9,9,1,3
2021,Liverpool 032B,E01006585,1312,1242,70,22,25,22,1
2021,Liverpool 032C,E01006586,1682,1580,102,46,31,20,5
2021,Liverpool 032D,E01006587,1477,1392,85,34,40,11,0
2021,Liverpool 042C,E01006588,1515,1464,51,26,17,8,0
2021,Liverpool 041B,E01006589,1417,1370,47,16,18,11,2
2021,Liverpool 042D,E01006590,1530,1470,60,33,19,7,1
2021,Liverpool 041C,E01006591,1440,1381,59,38,15,4,2
2021,Liverpool 041D,E01006592,1503,1468,35,26,4,5,0
2021,Liverpool 042E,E01006593,1386,1319,67,39,14,13,1
2021,Liverpool 047D,E01006594,1291,1250,41,16,18,6,1
2021,Liverpool 049B,E01006595,1681,1623,58,27,22,9,0
2021,Liverpool 049C,E01006596,1372,1305,67,24,27,13,3
2021,Liverpool 041E,E01006597,1640,1600,40,28,7,5,0
2021,Liverpool 010A,E01006598,1623,1451,172,58,71,39,4
2021,Liverpool 010B,E01006599,1758,1447,311,117,121,68,5
2021,Liverpool 011A,E01006600,1387,1343,44,25,14,3,2
2021,Liverpool 011B,E01006603,1414,1362,52,19,20,11,2
2021,Liverpool 016A,E01006604,1505,1458,47,26,13,7,1
2021,Liverpool 016B,E01006605,1570,1501,69,30,27,9,3
2021,Liverpool 020A,E01006606,1469,1398,71,17,39,14,1
2021,Liverpool 008A,E01006607,1498,1432,66,21,27,15,3
2021,Liverpool 009A,E01006608,1100,1070,30,14,8,6,2
2021,Liverpool 009B,E01006609,1164,1098,66,15,23,22,6
2021,Liverpool 009C,E01006610,1400,1265,135,38,45,37,15
2021,Liverpool 012A,E01006611,1247,941,306,106,84,100,16
2021,Liverpool 008B,E01006612,1383,1326,57,17,22,17,1
2021,Liverpool 009D,E01006613,1231,1186,45,17,19,6,3
2021,Liverpool 012B,E01006614,1065,959,106,30,34,36,6
2021,Liverpool 012C,E01006615,1361,1213,148,41,60,42,5
2021,Liverpool 015D,E01006616,1257,1231,26,12,9,5,0
2021,Liverpool 021A,E01006617,1448,1410,38,22,10,6,0
2021,Liverpool 016C,E01006618,1565,1535,30,10,8,9,3
2021,Liverpool 021B,E01006619,1686,1663,23,10,6,4,3
2021,Liverpool 021C,E01006620,1372,1311,61,24,20,15,2
2021,Liverpool 021D,E01006621,1580,1527,53,27,18,8,0
2021,Liverpool 021E,E01006622,1498,1470,28,10,13,5,0
2021,Liverpool 013A,E01006623,1287,1214,73,18,27,23,5
2021,Liverpool 013B,E01006624,1502,1400,102,31,21,45,5
2021,Liverpool 016D,E01006625,1340,1310,30,15,9,5,1
2021,Liverpool 016E,E01006626,1381,1346,35,12,15,7,1
2021,Liverpool 013C,E01006627,1330,1308,22,6,8,8,0
2021,Liverpool 052D,E01006628,1715,1635,80,50,19,11,0
2021,Liverpool 052E,E01006629,1269,1230,39,26,10,3,0
2021,Liverpool 044B,E01006630,2096,1732,364,134,129,79,22
2021,Liverpool 044C,E01006632,1698,1529,169,82,53,29,5
2021,Liverpool 050B,E01006633,1332,1248,84,39,30,11,4
2021,Liverpool 017A,E01006637,1452,1298,154,67,68,19,0
2021,Liverpool 017B,E01006638,1232,1113,119,46,44,23,6
2021,Liverpool 017C,E01006639,1562,1491,71,25,34,8,4
2021,Liverpool 021F,E01006640,1859,1781,78,29,27,19,3
2021,Liverpool 025C,E01006641,1605,1462,143,64,46,28,5
2021,Liverpool 025D,E01006642,1337,1236,101,53,27,20,1
2021,Liverpool 025E,E01006643,1718,1553,165,59,56,34,16
2021,Liverpool 017D,E01006644,1888,1786,102,24,52,23,3
2021,Liverpool 017E,E01006645,1471,1335,136,57,41,33,5
2021,Liverpool 023C,E01006646,2087,1755,332,151,124,52,5
2021,Liverpool 024C,E01006647,2043,1695,348,132,169,42,5
2021,Liverpool 023D,E01006648,2322,2023,299,146,99,48,6
2021,Liverpool 001A,E01006651,1565,1537,28,14,5,5,4
2021,Liverpool 002A,E01006652,1396,1348,48,13,10,24,1
2021,Liverpool 001B,E01006653,1741,1691,50,24,18,6,2
2021,Liverpool 005A,E01006654,1339,1242,97,57,29,11,0
2021,Liverpool 001C,E01006655,1778,1661,117,81,23,8,5
2021,Liverpool 002B,E01006656,1358,1330,28,9,10,8,1
2021,Liverpool 002C,E01006657,1099,1064,35,18,13,4,0
2021,Liverpool 001D,E01006658,1299,1246,53,18,20,14,1
2021,Liverpool 005B,E01006659,1791,1628,163,63,58,33,9
2021,Liverpool 001E,E01006660,1346,1245,101,61,25,14,1
2021,Liverpool 004A,E01006661,1596,1488,108,32,43,24,9
2021,Liverpool 004B,E01006662,1855,1684,171,66,64,37,4
2021,Liverpool 004C,E01006663,1060,1025,35,17,11,6,1
2021,Liverpool 004D,E01006664,1863,1621,242,94,86,55,7
2021,Liverpool 007A,E01006665,1430,1387,43,12,21,9,1
2021,Liverpool 007B,E01006666,1337,1271,66,23,19,18,6
2021,Liverpool 007C,E01006667,1406,1335,71,25,24,16,6
2021,Liverpool 007D,E01006668,1438,1415,23,7,8,5,3
2021,Liverpool 004E,E01006669,1420,1327,93,22,37,28,6
2021,Liverpool 007E,E01006670,1429,1369,60,23,18,14,5
2021,Liverpool 013D,E01006671,1260,1215,45,9,22,11,3
2021,Liverpool 010E,E01006672,1811,1640,171,47,78,38,8
2021,Liverpool 037D,E01006673,2141,1573,568,176,216,141,35
2021,Liverpool 039C,E01006674,2297,1676,621,233,217,147,24
2021,Liverpool 043C,E01006675,1949,1590,359,147,127,79,6
2021,Liverpool 044D,E01006676,1866,1401,465,122,156,158,29
2021,Liverpool 043D,E01006677,1470,1175,295,99,107,69,20
2021,Liverpool 044E,E01006678,1891,1714,177,83,48,40,6
2021,Liverpool 039D,E01006679,2617,1836,781,249,304,201,27
2021,Liverpool 053B,E01006680,1452,1429,23,17,6,0,0
2021,Liverpool 054D,E01006681,1468,1376,92,44,30,12,6
2021,Liverpool 053C,E01006682,1222,1205,17,10,5,2,0
2021,Liverpool 053D,E01006683,1473,1456,17,9,2,6,0
2021,Liverpool 056B,E01006684,2138,2054,84,33,28,21,2
2021,Liverpool 056C,E01006685,1449,1417,32,15,9,8,0
2021,Liverpool 053E,E01006686,1300,1270,30,12,13,2,3
2021,Liverpool 056D,E01006687,2386,2245,141,68,39,28,6
2021,Liverpool 056E,E01006688,1540,1501,39,17,14,7,1
2021,Liverpool 049D,E01006689,1532,1482,50,24,11,13,2
2021,Liverpool 028A,E01006690,1736,1229,507,151,189,143,24
2021,Liverpool 030A,E01006691,1734,1335,399,117,177,90,15
2021,Liverpool 028B,E01006692,2408,1897,511,186,178,130,17
2021,Liverpool 024D,E01006693,1461,1262,199,70,85,34,10
2021,Liverpool 030B,E01006694,1888,1254,634,205,224,177,28
2021,Liverpool 028C,E01006695,1746,1278,468,143,184,125,16
2021,Liverpool 030C,E01006696,1922,1487,435,185,149,84,17
2021,Liverpool 030D,E01006697,1845,1337,508,149,185,154,20
2021,Liverpool 012D,E01006698,1505,1428,77,28,34,12,3
2021,Liverpool 014A,E01006699,1642,1420,222,69,94,52,7
2021,Liverpool 012E,E01006700,1506,1281,225,63,56,79,27
2021,Liverpool 014B,E01006701,1537,1336,201,72,51,66,12
2021,Liverpool 014C,E01006702,1590,1315,275,126,89,48,12
2021,Liverpool 014D,E01006703,1588,1409,179,61,65,51,2
2021,Liverpool 009E,E01006705,1231,1065,166,46,74,36,10
2021,Liverpool 045A,E01006706,1272,1244,28,4,13,6,5
2021,Liverpool 045B,E01006707,1358,1328,30,12,15,3,0
2021,Liverpool 045C,E01006708,1793,1738,55,18,24,13,0
2021,Liverpool 040A,E01006709,1451,1407,44,16,18,7,3
2021,Liverpool 045D,E01006710,1353,1336,17,8,3,6,0
2021,Liverpool 027A,E01006711,1510,1321,189,49,87,45,8
2021,Liverpool 029D,E01006712,1169,1098,71,22,30,16,3
2021,Liverpool 029E,E01006713,1250,1154,96,61,22,9,4
2021,Liverpool 032E,E01006716,1340,1222,118,42,25,45,6
2021,Liverpool 027D,E01006717,1352,1293,59,23,24,9,3
2021,Liverpool 027E,E01006718,1499,1439,60,16,30,11,3
2021,Liverpool 027F,E01006719,1340,1299,41,12,22,5,2
2021,Liverpool 038C,E01006721,1512,1229,283,114,89,65,15
2021,Liverpool 038D,E01006722,1978,1735,243,108,85,45,5
2021,Liverpool 038E,E01006723,1929,1743,186,73,64,41,8
2021,Liverpool 038F,E01006724,1552,1455,97,54,24,15,4
2021,Liverpool 035B,E01006725,1430,1300,130,50,39,32,9
2021,Liverpool 035C,E01006726,1675,1374,301,81,113,93,14
2021,Liverpool 035D,E01006727,1212,1119,93,43,30,18,2
2021,Liverpool 035E,E01006728,1495,1188,307,88,114,82,23
2021,Liverpool 008C,E01006729,1391,1241,150,53,51,43,3
2021,Liverpool 011C,E01006730,1358,1268,90,29,37,22,2
2021,Liverpool 011D,E01006731,1178,1100,78,33,30,14,1
2021,Liverpool 011E,E01006732,1661,1449,212,99,70,40,3
2021,Liverpool 005C,E01006734,1364,1214,150,45,59,39,7
2021,Liverpool 005D,E01006735,1404,1284,120,49,31,39,1
2021,Liverpool 005E,E01006736,1455,1345,110,46,39,22,3
2021,Liverpool 005F,E01006737,1351,1293,58,22,20,14,2
2021,Liverpool 058A,E01006738,1351,1321,30,20,10,0,0
2021,Liverpool 058B,E01006739,2443,2240,203,115,56,26,6
2021,Liverpool 057A,E01006740,1505,1391,114,45,29,31,9
2021,Liverpool 058C,E01006741,1811,1753,58,17,31,8,2
2021,Liverpool 057B,E01006742,1562,1523,39,19,7,13,0
2021,Liverpool 058D,E01006743,1936,1784,152,61,46,37,8
2021,Liverpool 057C,E01006744,1417,1367,50,25,13,10,2
2021,Liverpool 057D,E01006745,1716,1565,151,59,68,20,4
2021,Liverpool 030E,E01006746,1616,1357,259,134,77,40,8
2021,Liverpool 031B,E01006747,2708,1950,758,268,389,92,9
2021,Liverpool 031C,E01006748,2172,1836,336,136,149,49,2
2021,Liverpool 031F,E01006751,2661,2217,444,202,171,61,10
2021,Liverpool 059A,E01006753,1769,1639,130,57,59,8,6
2021,Liverpool 059B,E01006754,1705,1527,178,49,75,50,4
2021,Liverpool 059C,E01006755,1513,1352,161,44,62,46,9
2021,Liverpool 059D,E01006756,1679,1492,187,61,84,35,7
2021,Liverpool 059E,E01006757,1407,1327,80,28,35,16,1
2021,Liverpool 059F,E01006758,1384,1315,69,22,31,16,0
2021,Liverpool 028D,E01006759,1007,869,138,59,43,28,8
2021,Liverpool 028E,E01006760,1398,1145,253,114,94,38,7
2021,Liverpool 020B,E01006761,1397,1276,121,39,57,23,2
2021,Liverpool 015E,E01006762,1666,1496,170,73,60,33,4
2021,Liverpool 020C,E01006763,1391,1277,114,38,46,26,4
2021,Liverpool 020D,E01006764,1480,1248,232,79,67,73,13
2021,Liverpool 020E,E01006765,1445,1321,124,42,51,27,4
2021,Liverpool 019E,E01006766,1223,991,232,62,99,60,11
2021,Liverpool 019F,E01006767,1767,1380,387,118,150,105,14
2021,Liverpool 020F,E01006768,1288,1171,117,27,44,41,5
2021,Liverpool 040B,E01006769,1307,1269,38,9,8,6,15
2021,Liverpool 040C,E01006770,1114,1084,30,12,5,11,2
2021,Liverpool 040D,E01006771,1544,1503,41,14,14,10,3
2021,Liverpool 040E,E01006772,1079,1050,29,10,10,7,2
2021,Liverpool 036D,E01006773,1267,1246,21,15,3,2,1
2021,Liverpool 036E,E01006774,1371,1297,74,26,27,19,2
2021,Liverpool 040F,E01006775,1430,1379,51,22,19,8,2
2021,Liverpool 022B,E01006776,1795,1681,114,56,40,14,4
2021,Liverpool 014E,E01006778,2090,1796,294,102,85,98,9
2021,Liverpool 022D,E01006779,1967,1801,166,58,59,39,10
2021,Liverpool 002D,E01006780,1318,1293,25,12,5,8,0
2021,Liverpool 003A,E01006781,1299,1276,23,12,4,4,3
2021,Liverpool 003B,E01006782,1436,1402,34,13,15,6,0
2021,Liverpool 002E,E01006783,1293,1271,22,4,13,4,1
2021,Liverpool 003C,E01006784,1186,1159,27,8,9,10,0
2021,Liverpool 003D,E01006785,1661,1605,56,27,22,4,3
2021,Liverpool 003E,E01006786,2270,2222,48,22,14,11,1
2021,Liverpool 006A,E01006787,1285,1230,55,27,17,8,3
2021,Liverpool 006B,E01006788,1608,1555,53,22,18,8,5
2021,Liverpool 006C,E01006790,1722,1590,132,26,47,42,17
2021,Liverpool 006D,E01006791,1572,1466,106,38,40,25,3
2021,Liverpool 046A,E01006792,1336,1307,29,11,10,6,2
2021,Liverpool 051A,E01006793,1322,1250,72,32,23,13,4
2021,Liverpool 046B,E01006794,1559,1519,40,16,13,7,4
2021,Liverpool 051B,E01006795,1401,1362,39,23,13,3,0
2021,Liverpool 047E,E01006796,1577,1513,64,33,18,9,4
2021,Liverpool 051C,E01006797,1321,1294,27,11,9,5,2
2021,Liverpool 051D,E01006798,1267,1239,28,16,3,9,0
2021,Liverpool 051E,E01006799,1650,1590,60,15,33,10,2
2021,Liverpool 046C,E01006800,1399,1365,34,18,6,8,2
2021,Liverpool 046D,E01006801,1836,1783,53,35,11,6,1
2021,St. Helens 002A,E01006802,1567,1561,6,5,0,0,1
2021,St. Helens 003A,E01006803,1374,1370,4,0,2,0,2
2021,St. Helens 002B,E01006804,1488,1478,10,4,5,1,0
2021,St. Helens 003B,E01006805,1488,1479,9,7,2,0,0
2021,St. Helens 002C,E01006806,1387,1383,4,3,0,1,0
2021,St. Helens 002D,E01006807,1289,1282,7,2,2,3,0
2021,St. Helens 003C,E01006808,1152,1147,5,5,0,0,0
2021,St. Helens 003D,E01006809,1308,1294,14,3,6,4,1
2021,St. Helens 008A,E01006810,1131,1124,7,3,4,0,0
2021,St. Helens 008B,E01006811,1278,1255,23,11,8,4,0
2021,St. Helens 008C,E01006812,1412,1369,43,14,21,8,0
2021,St. Helens 008D,E01006813,1398,1356,42,9,16,16,1
2021,St. Helens 008E,E01006814,1397,1384,13,5,3,5,0
2021,St. Helens 008F,E01006815,1210,1202,8,4,1,3,0
2021,St. Helens 017A,E01006816,1681,1580,101,37,44,18,2
2021,St. Helens 017B,E01006817,1393,1334,59,22,26,9,2
2021,St. Helens 008G,E01006818,1189,1182,7,2,3,1,1
2021,St. Helens 011A,E01006819,1683,1595,88,19,38,27,4
2021,St. Helens 011B,E01006820,1410,1302,108,44,38,22,4
2021,St. Helens 011C,E01006821,1423,1343,80,23,40,15,2
2021,St. Helens 009A,E01006822,1479,1471,8,2,6,0,0
2021,St. Helens 009B,E01006823,1288,1279,9,6,2,0,1
2021,St. Helens 009C,E01006824,1209,1198,11,6,1,4,0
2021,St. Helens 009D,E01006825,1441,1433,8,2,5,1,0
2021,St. Helens 018A,E01006826,1169,1148,21,12,6,3,0
2021,St. Helens 018B,E01006827,1507,1470,37,20,13,2,2
2021,St. Helens 018C,E01006828,2077,2038,39,21,11,6,1
2021,St. Helens 018D,E01006829,1658,1623,35,14,13,6,2
2021,St. Helens 025A,E01006830,1546,1476,70,38,20,12,0
2021,St. Helens 016A,E01006831,1327,1281,46,10,21,9,6
2021,St. Helens 012A,E01006832,1638,1557,81,31,35,14,1
2021,St. Helens 016B,E01006833,2000,1953,47,12,26,6,3
2021,St. Helens 012B,E01006834,1228,1162,66,22,27,17,0
2021,St. Helens 016C,E01006835,1290,1279,11,5,5,1,0
2021,St. Helens 005A,E01006836,1389,1338,51,19,18,14,0
2021,St. Helens 006A,E01006837,1521,1481,40,15,13,9,3
2021,St. Helens 006B,E01006838,1402,1353,49,14,28,3,4
2021,St. Helens 005B,E01006839,1239,1223,16,8,5,3,0
2021,St. Helens 005C,E01006840,1382,1351,31,14,10,4,3
2021,St. Helens 006C,E01006841,1534,1528,6,2,4,0,0
2021,St. Helens 005D,E01006842,1583,1551,32,12,14,5,1
2021,St. Helens 006D,E01006843,1190,1168,22,6,12,4,0
2021,St. Helens 020A,E01006844,1545,1442,103,28,46,22,7
2021,St. Helens 014A,E01006845,1695,1589,106,38,46,21,1
2021,St. Helens 020B,E01006846,1392,1360,32,11,6,12,3
2021,St. Helens 020C,E01006847,1912,1810,102,39,42,20,1
2021,St. Helens 020D,E01006848,1255,1227,28,9,15,4,0
2021,St. Helens 004A,E01006849,1428,1395,33,10,10,9,4
2021,St. Helens 004B,E01006850,1544,1513,31,17,10,4,0
2021,St. Helens 004C,E01006851,1298,1275,23,3,16,4,0
2021,St. Helens 004D,E01006852,1219,1212,7,4,1,2,0
2021,St. Helens 004E,E01006853,1649,1626,23,10,11,1,1
2021,St. Helens 004F,E01006854,1378,1349,29,13,8,3,5
2021,St. Helens 004G,E01006855,1460,1422,38,10,15,7,6
2021,St. Helens 015A,E01006856,1468,1444,24,15,5,4,0
2021,St. Helens 015B,E01006857,1380,1372,8,7,1,0,0
2021,St. Helens 015C,E01006858,1464,1418,46,23,12,11,0
2021,St. Helens 015D,E01006859,1654,1636,18,9,8,1,0
2021,St. Helens 015E,E01006860,1488,1455,33,16,9,8,0
2021,St. Helens 015F,E01006861,1864,1817,47,16,20,7,4
2021,St. Helens 015G,E01006862,2116,2061,55,25,21,8,1
2021,St. Helens 013A,E01006863,1594,1512,82,29,29,20,4
2021,St. Helens 013B,E01006864,1868,1821,47,22,13,9,3
2021,St. Helens 010A,E01006866,1679,1635,44,15,24,4,1
2021,St. Helens 010B,E01006867,2042,1968,74,31,26,14,3
2021,St. Helens 010C,E01006868,1464,1435,29,16,8,5,0
2021,St. Helens 010D,E01006869,1532,1463,69,30,25,11,3
2021,St. Helens 014B,E01006870,1366,1216,150,42,68,32,8
2021,St. Helens 011D,E01006871,1640,1520,120,32,54,30,4
2021,St. Helens 014C,E01006872,1534,1310,224,78,88,47,11
2021,St. Helens 014D,E01006873,1419,1352,67,22,29,13,3
2021,St. Helens 014E,E01006874,1290,1164,126,27,68,30,1
2021,St. Helens 017C,E01006875,1273,1200,73,24,29,15,5
2021,St. Helens 016D,E01006876,1345,1294,51,17,18,13,3
2021,St. Helens 012C,E01006877,1532,1440,92,28,32,32,0
2021,St. Helens 016E,E01006878,1254,1233,21,4,7,10,0
2021,St. Helens 016F,E01006879,1405,1379,26,8,13,4,1
2021,St. Helens 012D,E01006880,1316,1266,50,17,20,11,2
2021,St. Helens 012E,E01006881,1389,1326,63,19,25,16,3
2021,St. Helens 001A,E01006882,1168,1159,9,4,5,0,0
2021,St. Helens 001B,E01006883,1351,1325,26,14,6,6,0
2021,St. Helens 001C,E01006884,1352,1351,1,1,0,0,0
2021,St. Helens 001D,E01006885,1275,1271,4,3,1,0,0
2021,St. Helens 001E,E01006886,1226,1216,10,6,0,2,2
2021,St. Helens 001F,E01006887,1318,1306,12,6,4,2,0
2021,St. Helens 023A,E01006888,1169,1146,23,7,10,3,3
2021,St. Helens 023B,E01006889,1352,1327,25,5,9,9,2
2021,St. Helens 021A,E01006890,1362,1337,25,11,9,5,0
2021,St. Helens 023C,E01006891,1548,1528,20,16,4,0,0
2021,St. Helens 021B,E01006892,1332,1318,14,6,5,3,0
2021,St. Helens 021C,E01006893,1280,1248,32,15,7,10,0
2021,St. Helens 021D,E01006894,1328,1308,20,11,3,6,0
2021,St. Helens 023D,E01006895,1378,1351,27,15,6,4,2
2021,St. Helens 020E,E01006896,1412,1399,13,7,5,1,0
2021,St. Helens 020F,E01006897,1431,1421,10,1,7,2,0
2021,St. Helens 022A,E01006898,1698,1669,29,12,10,7,0
2021,St. Helens 017D,E01006899,2080,1934,146,46,67,28,5
2021,St. Helens 020G,E01006901,1419,1388,31,17,13,0,1
2021,St. Helens 024A,E01006903,1399,1359,40,10,23,7,0
2021,St. Helens 016G,E01006904,1586,1555,31,17,10,3,1
2021,St. Helens 024B,E01006905,1280,1246,34,13,16,4,1
2021,St. Helens 025B,E01006906,1481,1448,33,14,17,1,1
2021,St. Helens 024C,E01006907,1518,1445,73,24,29,14,6
2021,St. Helens 022C,E01006908,1274,1243,31,11,8,11,1
2021,St. Helens 022D,E01006909,1257,1229,28,14,7,6,1
2021,St. Helens 022E,E01006910,1808,1759,49,18,22,7,2
2021,St. Helens 022F,E01006911,1429,1412,17,7,8,2,0
2021,St. Helens 024E,E01006912,1640,1548,92,33,37,19,3
2021,St. Helens 024D,E01006913,1387,1334,53,25,19,8,1
2021,St. Helens 007A,E01006914,1264,1254,10,9,0,1,0
2021,St. Helens 007B,E01006915,1446,1439,7,4,2,1,0
2021,St. Helens 007C,E01006916,1477,1454,23,4,9,10,0
2021,St. Helens 007D,E01006917,1664,1661,3,2,0,1,0
2021,St. Helens 007E,E01006918,1248,1207,41,9,29,3,0
2021,St. Helens 007F,E01006919,1711,1661,50,17,20,12,1
2021,Sefton 011A,E01006920,1566,1534,32,12,13,6,1
2021,Sefton 012A,E01006921,1296,1285,11,5,4,2,0
2021,Sefton 012B,E01006922,1423,1415,8,4,4,0,0
2021,Sefton 012C,E01006923,1496,1477,19,7,9,2,1
2021,Sefton 011B,E01006924,1419,1365,54,24,21,7,2
2021,Sefton 011C,E01006925,1771,1726,45,15,18,11,1
2021,Sefton 012D,E01006926,1703,1655,48,17,26,5,0
2021,Sefton 011D,E01006927,1665,1650,15,9,3,3,0
2021,Sefton 009A,E01006928,1411,1396,15,11,2,2,0
2021,Sefton 010A,E01006929,1441,1399,42,23,14,2,3
2021,Sefton 010B,E01006930,1381,1347,34,21,7,3,3
2021,Sefton 010C,E01006931,1474,1460,14,10,1,3,0
2021,Sefton 010D,E01006932,1368,1359,9,5,2,2,0
2021,Sefton 010E,E01006933,1337,1314,23,11,7,5,0
2021,Sefton 007A,E01006934,1424,1364,60,25,28,7,0
2021,Sefton 009B,E01006935,1611,1581,30,9,16,5,0
2021,Sefton 022A,E01006936,1416,1371,45,20,12,9,4
2021,Sefton 022B,E01006937,1328,1315,13,9,3,1,0
2021,Sefton 022C,E01006938,1344,1310,34,19,9,6,0
2021,Sefton 022D,E01006939,1440,1425,15,6,5,3,1
2021,Sefton 022E,E01006940,1401,1371,30,16,13,1,0
2021,Sefton 028A,E01006941,1505,1484,21,14,6,1,0
2021,Sefton 028B,E01006942,1401,1382,19,6,5,6,2
2021,Sefton 022F,E01006943,1268,1249,19,11,5,2,1
2021,Sefton 003A,E01006944,1722,1619,103,35,44,21,3
2021,Sefton 004A,E01006945,1796,1562,234,67,116,47,4
2021,Sefton 001A,E01006946,1364,1330,34,16,14,4,0
2021,Sefton 002A,E01006947,1346,1330,16,9,5,2,0
2021,Sefton 003B,E01006948,1374,1320,54,24,21,6,3
2021,Sefton 003C,E01006949,1480,1456,24,16,3,5,0
2021,Sefton 004B,E01006950,1655,1407,248,81,101,56,10
2021,Sefton 003D,E01006951,1533,1456,77,23,33,17,4
2021,Sefton 032A,E01006952,1282,1235,47,29,12,6,0
2021,Sefton 032B,E01006953,1415,1381,34,16,11,7,0
2021,Sefton 028C,E01006954,1499,1481,18,11,7,0,0
2021,Sefton 030A,E01006955,1540,1506,34,13,9,11,1
2021,Sefton 030B,E01006956,1538,1459,79,26,37,15,1
2021,Sefton 032C,E01006957,1548,1433,115,44,48,22,1
2021,Sefton 030C,E01006958,1488,1449,39,16,15,8,0
2021,Sefton 032D,E01006959,1451,1427,24,11,8,4,1
2021,Sefton 038A,E01006960,1122,1109,13,2,7,3,1
2021,Sefton 038B,E01006961,1522,1359,163,35,83,33,12
2021,Sefton 038C,E01006962,1360,1297,63,25,20,15,3
2021,Sefton 038D,E01006963,1647,1327,320,68,133,95,24
2021,Sefton 036A,E01006964,1587,1460,127,60,34,27,6
2021,Sefton 038E,E01006965,1465,1419,46,17,19,7,3
2021,Sefton 038F,E01006966,1591,1524,67,31,21,13,2
2021,Sefton 037A,E01006967,1686,1482,204,45,84,71,4
2021,Sefton 004D,E01006969,1448,1198,250,82,92,72,4
2021,Sefton 007B,E01006970,2146,1828,318,85,153,74,6
2021,Sefton 009C,E01006971,1573,1538,35,15,16,4,0
2021,Sefton 009D,E01006972,1508,1459,49,22,17,8,2
2021,Sefton 009E,E01006973,1541,1492,49,23,18,5,3
2021,Sefton 009F,E01006974,1489,1475,14,10,3,1,0
2021,Sefton 033A,E01006976,1348,1320,28,14,10,3,1
2021,Sefton 032E,E01006977,2001,1973,28,15,8,5,0
2021,Sefton 031A,E01006978,1281,1268,13,7,4,1,1
2021,Sefton 024A,E01006979,1273,1209,64,8,30,25,1
2021,Sefton 024B,E01006980,1244,1195,49,17,21,11,0
2021,Sefton 031B,E01006981,1349,1313,36,10,17,9,0
2021,Sefton 031C,E01006982,1242,1234,8,6,0,2,0
2021,Sefton 031D,E01006983,1551,1548,3,2,0,1,0
2021,Sefton 031E,E01006984,1227,1126,101,29,48,18,6
2021,Sefton 013A,E01006985,1348,1336,12,8,2,2,0
2021,Sefton 013B,E01006986,1317,1289,28,17,8,3,0
2021,Sefton 013C,E01006987,1177,1165,12,5,5,0,2
2021,Sefton 014A,E01006988,1461,1444,17,6,5,6,0
2021,Sefton 013D,E01006989,1236,1224,12,11,1,0,0
2021,Sefton 013E,E01006990,1143,1134,9,7,1,1,0
2021,Sefton 015A,E01006991,1417,1404,13,7,3,3,0
2021,Sefton 015B,E01006992,1231,1218,13,10,2,1,0
2021,Sefton 015C,E01006993,1394,1382,12,11,1,0,0
2021,Sefton 007C,E01006994,1711,1573,138,47,40,49,2
2021,Sefton 008A,E01006995,1316,1283,33,23,6,4,0
2021,Sefton 007D,E01006996,1785,1626,159,61,64,31,3
2021,Sefton 008B,E01006997,1459,1415,44,18,22,4,0
2021,Sefton 007E,E01006998,1517,1312,205,79,86,33,7
2021,Sefton 008C,E01006999,1537,1458,79,41,28,6,4
2021,Sefton 008D,E01007000,1460,1381,79,27,31,19,2
2021,Sefton 008E,E01007001,1629,1572,57,25,26,5,1
2021,Sefton 008F,E01007002,1969,1885,84,47,26,9,2
2021,Sefton 036B,E01007003,1151,1035,116,28,59,27,2
2021,Sefton 034A,E01007004,1329,1234,95,27,38,28,2
2021,Sefton 034B,E01007005,1334,1236,98,29,38,26,5
2021,Sefton 036C,E01007006,1361,1285,76,24,31,17,4
2021,Sefton 037B,E01007007,1244,1170,74,17,44,12,1
2021,Sefton 037C,E01007008,1233,1095,138,47,65,25,1
2021,Sefton 037D,E01007009,1742,1585,157,51,62,39,5
2021,Sefton 037E,E01007010,1516,1332,184,61,81,37,5
2021,Sefton 034C,E01007011,1440,1326,114,55,32,27,0
2021,Sefton 036D,E01007012,1309,1250,59,20,19,17,3
2021,Sefton 036E,E01007013,1383,1269,114,33,48,29,4
2021,Sefton 033B,E01007014,1462,1459,3,3,0,0,0
2021,Sefton 034D,E01007016,1733,1685,48,15,18,11,4
2021,Sefton 034E,E01007017,1490,1428,62,20,26,16,0
2021,Sefton 035A,E01007019,1377,1242,135,44,52,34,5
2021,Sefton 021A,E01007020,1326,1314,12,3,4,3,2
2021,Sefton 025A,E01007021,1224,1218,6,3,3,0,0
2021,Sefton 021B,E01007022,1319,1313,6,2,1,3,0
2021,Sefton 021C,E01007023,1327,1312,15,6,3,5,1
2021,Sefton 024C,E01007024,1019,1000,19,7,8,4,0
2021,Sefton 025B,E01007025,1272,1259,13,6,3,4,0
2021,Sefton 024D,E01007026,1152,1138,14,7,5,2,0
2021,Sefton 021D,E01007027,1971,1947,24,13,7,4,0
2021,Sefton 001B,E01007028,1371,1345,26,8,13,4,1
2021,Sefton 001C,E01007029,1146,1136,10,5,4,1,0
2021,Sefton 001D,E01007030,1496,1452,44,21,12,10,1
2021,Sefton 002B,E01007031,1341,1318,23,11,7,3,2
2021,Sefton 002C,E01007032,1333,1320,13,7,5,0,1
2021,Sefton 002D,E01007033,1334,1324,10,3,6,1,0
2021,Sefton 003E,E01007034,1259,1249,10,7,3,0,0
2021,Sefton 002E,E01007035,1367,1351,16,7,6,1,2
2021,Sefton 001E,E01007036,1139,1132,7,2,1,4,0
2021,Sefton 021E,E01007037,1534,1516,18,8,4,3,3
2021,Sefton 021F,E01007038,1564,1555,9,6,2,1,0
2021,Sefton 026A,E01007039,1245,1228,17,4,2,11,0
2021,Sefton 026B,E01007040,1999,1988,11,3,7,1,0
2021,Sefton 027A,E01007041,1339,1321,18,4,10,1,3
2021,Sefton 026C,E01007042,1269,1259,10,5,2,3,0
2021,Sefton 027B,E01007043,1325,1322,3,2,0,0,1
2021,Sefton 026D,E01007044,1413,1402,11,3,7,1,0
2021,Sefton 026E,E01007045,1153,1150,3,1,1,1,0
2021,Sefton 027C,E01007046,1714,1682,32,12,11,7,2
2021,Sefton 033E,E01007047,1511,1499,12,3,3,3,3
2021,Sefton 029A,E01007048,1605,1498,107,40,45,20,2
2021,Sefton 035B,E01007049,2081,2011,70,19,34,17,0
2021,Sefton 035C,E01007050,1203,1189,14,0,6,6,2
2021,Sefton 035D,E01007051,1247,1186,61,25,24,10,2
2021,Sefton 035E,E01007052,1265,1192,73,27,30,14,2
2021,Sefton 027D,E01007053,1284,1275,9,2,5,2,0
2021,Sefton 029B,E01007054,1279,1250,29,13,8,5,3
2021,Sefton 005A,E01007055,1335,1231,104,29,54,19,2
2021,Sefton 005B,E01007056,1583,1498,85,40,31,10,4
2021,Sefton 005C,E01007057,1433,1355,78,38,30,8,2
2021,Sefton 006A,E01007058,1475,1336,139,45,68,21,5
2021,Sefton 006B,E01007059,1511,1472,39,17,15,7,0
2021,Sefton 006C,E01007060,1446,1368,78,28,42,6,2
2021,Sefton 006D,E01007061,1436,1377,59,26,25,7,1
2021,Sefton 005D,E01007062,1393,1352,41,16,24,1,0
2021,Sefton 005E,E01007063,1468,1429,39,22,9,7,1
2021,Sefton 006E,E01007064,1285,1263,22,16,3,3,0
2021,Sefton 020A,E01007065,1246,1236,10,6,4,0,0
2021,Sefton 020B,E01007066,1392,1384,8,5,3,0,0
2021,Sefton 017A,E01007067,1395,1390,5,4,0,1,0
2021,Sefton 017B,E01007068,1118,1110,8,4,1,3,0
2021,Sefton 017C,E01007069,1411,1404,7,3,4,0,0
2021,Sefton 017D,E01007070,1384,1384,0,0,0,0,0
2021,Sefton 020C,E01007071,1374,1366,8,5,3,0,0
2021,Sefton 020D,E01007072,1353,1341,12,3,6,3,0
2021,Sefton 020E,E01007073,1213,1209,4,1,3,0,0
2021,Sefton 019A,E01007074,1368,1366,2,1,1,0,0
2021,Sefton 016A,E01007075,1283,1272,11,5,5,1,0
2021,Sefton 016B,E01007076,1516,1507,9,5,2,2,0
2021,Sefton 016C,E01007077,1395,1380,15,10,3,2,0
2021,Sefton 015D,E01007078,1477,1453,24,13,7,4,0
2021,Sefton 014B,E01007079,1499,1485,14,10,2,2,0
2021,Sefton 014C,E01007080,1408,1382,26,13,7,3,3
2021,Sefton 014D,E01007081,1548,1531,17,7,5,4,1
2021,Sefton 016D,E01007082,1264,1231,33,21,9,2,1
2021,Sefton 023A,E01007083,1093,1080,13,6,3,2,2
2021,Sefton 027E,E01007084,1216,1214,2,1,0,1,0
2021,Sefton 023B,E01007085,1299,1245,54,19,21,8,6
2021,Sefton 023C,E01007086,1143,1127,16,8,6,2,0
2021,Sefton 029C,E01007087,1287,1239,48,11,25,10,2
2021,Sefton 029D,E01007088,1193,1164,29,8,21,0,0
2021,Sefton 024E,E01007089,1406,1376,30,11,9,9,1
2021,Sefton 029E,E01007090,1220,1189,31,13,13,2,3
2021,Sefton 023D,E01007091,1167,1150,17,10,4,2,1
2021,Sefton 023E,E01007092,1101,1090,11,5,3,2,1
2021,Sefton 018C,E01007095,1522,1510,12,8,3,0,1
2021,Sefton 018D,E01007096,1244,1240,4,1,2,1,0
2021,Sefton 019B,E01007097,1454,1443,11,9,2,0,0
2021,Sefton 019C,E01007098,1594,1582,12,8,3,0,1
2021,Sefton 019D,E01007099,1507,1487,20,3,10,6,1
2021,Sefton 018E,E01007100,1294,1285,9,9,0,0,0
2021,Sefton 017E,E01007101,1380,1373,7,4,2,0,1
2021,Sefton 030D,E01007102,1438,1404,34,16,14,4,0
2021,Sefton 030E,E01007103,1428,1415,13,6,2,5,0
2021,Sefton 028D,E01007104,1347,1330,17,13,3,0,1
2021,Sefton 025C,E01007105,1538,1509,29,15,12,2,0
2021,Sefton 025D,E01007106,1712,1666,46,23,15,8,0
2021,Sefton 025E,E01007107,1312,1296,16,8,5,3,0
2021,Sefton 025F,E01007108,1498,1477,21,8,7,5,1
2021,Sefton 028E,E01007109,1440,1413,27,13,9,5,0
2021,Wirral 035A,E01007110,1554,1536,18,13,4,1,0
2021,Wirral 032A,E01007111,1446,1438,8,6,2,0,0
2021,Wirral 032B,E01007112,1469,1438,31,16,13,1,1
2021,Wirral 032C,E01007113,1280,1264,16,9,5,1,1
2021,Wirral 032D,E01007114,1434,1413,21,8,6,6,1
2021,Wirral 031A,E01007115,1513,1490,23,7,8,7,1
2021,Wirral 032E,E01007116,1422,1391,31,19,8,3,1
2021,Wirral 035B,E01007117,1574,1556,18,11,4,2,1
2021,Wirral 035C,E01007118,1449,1440,9,5,3,1,0
2021,Wirral 019A,E01007119,1548,1516,32,19,10,3,0
2021,Wirral 011A,E01007120,1327,1306,21,12,6,3,0
2021,Wirral 011B,E01007121,1411,1357,54,9,29,16,0
2021,Wirral 011C,E01007122,1466,1390,76,26,35,15,0
2021,Wirral 011D,E01007123,1527,1430,97,36,42,16,3
2021,Wirral 011E,E01007124,1605,1572,33,15,12,5,1
2021,Wirral 015A,E01007125,1539,1482,57,18,30,8,1
2021,Wirral 016B,E01007127,1534,1378,156,65,54,30,7
2021,Wirral 016C,E01007128,1645,1399,246,54,103,73,16
2021,Wirral 016D,E01007129,1410,1303,107,48,34,19,6
2021,Wirral 021A,E01007130,1703,1403,300,96,104,85,15
2021,Wirral 021B,E01007131,1616,1534,82,31,36,12,3
2021,Wirral 016E,E01007133,1160,1096,64,20,27,15,2
2021,Wirral 039A,E01007135,1522,1498,24,13,8,3,0
2021,Wirral 039B,E01007136,1574,1549,25,16,8,1,0
2021,Wirral 039C,E01007137,1608,1579,29,15,9,5,0
2021,Wirral 031B,E01007138,1669,1613,56,19,21,12,4
2021,Wirral 031C,E01007139,1543,1480,63,31,27,4,1
2021,Wirral 031D,E01007141,1584,1541,43,24,10,6,3
2021,Wirral 036B,E01007142,1864,1826,38,22,11,4,1
2021,Wirral 036C,E01007143,1903,1871,32,12,13,6,1
2021,Wirral 038A,E01007144,1270,1252,18,12,3,3,0
2021,Wirral 038B,E01007145,1159,1150,9,4,2,3,0
2021,Wirral 038C,E01007146,1413,1391,22,18,4,0,0
2021,Wirral 038D,E01007147,1372,1357,15,7,5,3,0
2021,Wirral 038E,E01007148,1615,1591,24,15,7,1,1
2021,Wirral 041A,E01007149,1435,1418,17,9,6,2,0
2021,Wirral 041B,E01007150,1303,1291,12,6,4,1,1
2021,Wirral 035D,E01007151,1486,1456,30,20,5,3,2
2021,Wirral 036D,E01007152,1560,1517,43,23,16,3,1
2021,Wirral 036E,E01007153,1449,1427,22,14,7,1,0
2021,Wirral 035E,E01007154,1456,1429,27,14,9,2,2
2021,Wirral 020A,E01007155,1666,1614,52,23,13,13,3
2021,Wirral 015B,E01007156,1488,1466,22,10,5,7,0
2021,Wirral 015C,E01007157,1450,1441,9,5,1,3,0
2021,Wirral 015D,E01007158,1495,1478,17,7,7,1,2
2021,Wirral 015E,E01007159,1904,1845,59,40,5,14,0
2021,Wirral 020B,E01007160,1577,1528,49,23,9,13,4
2021,Wirral 019B,E01007161,1506,1483,23,20,2,1,0
2021,Wirral 019C,E01007162,1386,1364,22,8,8,5,1
2021,Wirral 024A,E01007163,2209,2132,77,29,20,25,3
2021,Wirral 042A,E01007164,1779,1751,28,8,15,3,2
2021,Wirral 041C,E01007165,1175,1170,5,3,1,1,0
2021,Wirral 042B,E01007166,1348,1339,9,3,4,2,0
2021,Wirral 042C,E01007167,1500,1478,22,6,9,5,2
2021,Wirral 042D,E01007168,1602,1581,21,10,8,3,0
2021,Wirral 042E,E01007169,1635,1617,18,7,7,4,0
2021,Wirral 039D,E01007170,1584,1565,19,9,5,4,1
2021,Wirral 041D,E01007171,1503,1491,12,8,2,2,0
2021,Wirral 041E,E01007172,1403,1389,14,4,5,5,0
2021,Wirral 029A,E01007173,1487,1467,20,9,4,7,0
2021,Wirral 029B,E01007174,1632,1599,33,13,9,7,4
2021,Wirral 027A,E01007175,1910,1840,70,34,24,9,3
2021,Wirral 029C,E01007176,1596,1548,48,25,15,5,3
2021,Wirral 029D,E01007177,1475,1459,16,3,5,5,3
2021,Wirral 029E,E01007178,1544,1519,25,9,13,3,0
2021,Wirral 021C,E01007179,1243,1155,88,34,42,11,1
2021,Wirral 022A,E01007180,1466,1425,41,19,14,6,2
2021,Wirral 022B,E01007181,1458,1421,37,10,22,5,0
2021,Wirral 037A,E01007182,1505,1471,34,24,5,5,0
2021,Wirral 034A,E01007183,1222,1214,8,5,1,2,0
2021,Wirral 037B,E01007184,1417,1395,22,11,8,3,0
2021,Wirral 037C,E01007185,1552,1528,24,11,8,2,3
2021,Wirral 040A,E01007186,1455,1439,16,9,4,1,2
2021,Wirral 040B,E01007187,1427,1406,21,14,4,3,0
2021,Wirral 040C,E01007188,1448,1432,16,11,2,2,1
2021,Wirral 040D,E01007189,1531,1523,8,5,0,3,0
2021,Wirral 040E,E01007190,1496,1477,19,14,3,1,1
2021,Wirral 040F,E01007191,1327,1312,15,14,1,0,0
2021,Wirral 037D,E01007192,1300,1283,17,13,2,1,1
2021,Wirral 014A,E01007193,1621,1599,22,14,5,2,1
2021,Wirral 014B,E01007194,1454,1432,22,14,5,3,0
2021,Wirral 013A,E01007195,1549,1537,12,8,3,0,1
2021,Wirral 026A,E01007196,1555,1537,18,10,7,1,0
2021,Wirral 026B,E01007197,1603,1587,16,13,1,1,1
2021,Wirral 026C,E01007198,1555,1489,66,41,16,8,1
2021,Wirral 013B,E01007199,1478,1468,10,4,4,0,2
2021,Wirral 014C,E01007200,1589,1582,7,4,1,2,0
2021,Wirral 014D,E01007201,1434,1404,30,15,11,3,1
2021,Wirral 014E,E01007202,1344,1328,16,10,5,1,0
2021,Wirral 006A,E01007203,1878,1833,45,26,11,5,3
2021,Wirral 009A,E01007204,1644,1601,43,19,17,5,2
2021,Wirral 006B,E01007205,1578,1556,22,10,8,4,0
2021,Wirral 009B,E01007206,1783,1740,43,18,16,9,0
2021,Wirral 009C,E01007207,1372,1362,10,6,2,2,0
2021,Wirral 012A,E01007208,1629,1598,31,15,8,6,2
2021,Wirral 009D,E01007209,1386,1371,15,5,5,3,2
2021,Wirral 006C,E01007210,1924,1857,67,29,30,7,1
2021,Wirral 004A,E01007211,1128,1112,16,5,7,4,0
2021,Wirral 007A,E01007212,1395,1374,21,6,7,4,4
2021,Wirral 007B,E01007213,1443,1420,23,10,7,4,2
2021,Wirral 007C,E01007214,1469,1439,30,12,9,9,0
2021,Wirral 005A,E01007215,1438,1403,35,15,9,8,3
2021,Wirral 005B,E01007216,1496,1481,15,9,6,0,0
2021,Wirral 007D,E01007217,1617,1590,27,6,6,14,1
2021,Wirral 002A,E01007218,1465,1436,29,10,8,7,4
2021,Wirral 005C,E01007219,1461,1423,38,17,16,5,0
2021,Wirral 005D,E01007220,1353,1308,45,9,18,16,2
2021,Wirral 012B,E01007221,1422,1374,48,25,20,3,0
2021,Wirral 013C,E01007222,1490,1471,19,11,7,1,0
2021,Wirral 013D,E01007223,1366,1338,28,13,10,4,1
2021,Wirral 017A,E01007224,1400,1383,17,11,5,1,0
2021,Wirral 012C,E01007225,2043,1999,44,22,9,9,4
2021,Wirral 017B,E01007226,1546,1534,12,7,3,2,0
2021,Wirral 012D,E01007227,1478,1451,27,9,16,2,0
2021,Wirral 012E,E01007228,1358,1353,5,0,3,1,1
2021,Wirral 001A,E01007229,1601,1584,17,6,7,3,1
2021,Wirral 001B,E01007230,1212,1196,16,7,4,5,0
2021,Wirral 001C,E01007231,1524,1497,27,15,7,5,0
2021,Wirral 002B,E01007232,1527,1505,22,11,9,0,2
2021,Wirral 002C,E01007233,1650,1616,34,15,9,7,3
2021,Wirral 002D,E01007234,1458,1437,21,10,6,3,2
2021,Wirral 004B,E01007235,1456,1442,14,8,4,2,0
2021,Wirral 002E,E01007236,1283,1273,10,3,5,1,1
2021,Wirral 001D,E01007237,1572,1541,31,18,6,4,3
2021,Wirral 001E,E01007238,1515,1454,61,34,25,2,0
2021,Wirral 022C,E01007239,1596,1542,54,26,19,9,0
2021,Wirral 020C,E01007240,1582,1537,45,30,8,7,0
2021,Wirral 020D,E01007241,1348,1316,32,18,8,6,0
2021,Wirral 020E,E01007242,1637,1602,35,24,8,3,0
2021,Wirral 022D,E01007243,1505,1491,14,8,4,2,0
2021,Wirral 022E,E01007244,2053,1978,75,22,35,17,1
2021,Wirral 024B,E01007245,1390,1367,23,10,8,5,0
2021,Wirral 024C,E01007246,1360,1332,28,14,7,6,1
2021,Wirral 024D,E01007247,1602,1578,24,9,8,5,2
2021,Wirral 030A,E01007248,1461,1421,40,24,10,5,1
2021,Wirral 025A,E01007249,1260,1240,20,12,6,2,0
2021,Wirral 030B,E01007250,1337,1317,20,10,7,3,0
2021,Wirral 025B,E01007251,1054,1014,40,31,8,0,1
2021,Wirral 024E,E01007252,1432,1404,28,19,5,4,0
2021,Wirral 030C,E01007253,1523,1499,24,15,6,3,0
2021,Wirral 030D,E01007254,1581,1562,19,13,4,2,0
2021,Wirral 034B,E01007255,1474,1446,28,17,4,4,3
2021,Wirral 034C,E01007256,1502,1487,15,10,2,2,1
2021,Wirral 025C,E01007257,1240,1232,8,4,3,1,0
2021,Wirral 028A,E01007258,1361,1332,29,27,2,0,0
2021,Wirral 023A,E01007259,1159,1154,5,4,1,0,0
2021,Wirral 028B,E01007260,1527,1506,21,16,3,2,0
2021,Wirral 023B,E01007261,1296,1282,14,8,5,1,0
2021,Wirral 028C,E01007262,1461,1439,22,19,1,2,0
2021,Wirral 026D,E01007263,1397,1387,10,5,5,0,0
2021,Wirral 023C,E01007264,1317,1292,25,15,9,1,0
2021,Wirral 017C,E01007265,1308,1298,10,6,3,1,0
2021,Wirral 023D,E01007266,1471,1460,11,6,3,1,1
2021,Wirral 023E,E01007267,1377,1360,17,10,2,4,1
2021,Wirral 023F,E01007268,1271,1264,7,2,4,1,0
2021,Wirral 010C,E01007269,1654,1619,35,15,11,8,1
2021,Wirral 010D,E01007270,1662,1599,63,22,30,6,5
2021,Wirral 010E,E01007271,1522,1493,29,15,10,3,1
2021,Wirral 008A,E01007272,1362,1322,40,11,17,9,3
2021,Wirral 008B,E01007273,1235,1183,52,27,18,6,1
2021,Wirral 008C,E01007274,1308,1257,51,19,14,16,2
2021,Wirral 005E,E01007275,1373,1340,33,13,12,5,3
2021,Wirral 007E,E01007276,1431,1413,18,4,7,7,0
2021,Wirral 008D,E01007277,1354,1296,58,17,15,15,11
2021,Wirral 008E,E01007278,1400,1340,60,22,16,15,7
2021,Wirral 034D,E01007279,1526,1500,26,12,8,6,0
2021,Wirral 033A,E01007280,1658,1645,13,12,0,1,0
2021,Wirral 028D,E01007281,1318,1303,15,12,2,1,0
2021,Wirral 026E,E01007282,1297,1255,42,20,20,1,1
2021,Wirral 028E,E01007283,1207,1179,28,21,3,4,0
2021,Wirral 033B,E01007284,1596,1581,15,9,5,0,1
2021,Wirral 033C,E01007285,1409,1399,10,7,2,0,1
2021,Wirral 034E,E01007286,1406,1379,27,20,5,2,0
2021,Wirral 033D,E01007287,1796,1781,15,6,2,6,1
2021,Wirral 037E,E01007288,1589,1575,14,9,4,1,0
2021,Wirral 031E,E01007289,1543,1461,82,30,29,17,6
2021,Wirral 027B,E01007290,1906,1809,97,46,32,15,4
2021,Wirral 021D,E01007291,1540,1432,108,38,42,22,6
2021,Wirral 021E,E01007292,1478,1418,60,14,23,18,5
2021,Wirral 027C,E01007293,1554,1490,64,22,27,12,3
2021,Wirral 021F,E01007294,1366,1340,26,17,6,3,0
2021,Wirral 027D,E01007295,1619,1438,181,91,53,30,7
2021,Wirral 027E,E01007296,1616,1527,89,33,37,18,1
2021,Wirral 018A,E01007297,1425,1416,9,3,2,3,1
2021,Wirral 018B,E01007298,1484,1445,39,28,7,4,0
2021,Wirral 017D,E01007299,1247,1238,9,6,2,1,0
2021,Wirral 019D,E01007300,2153,2107,46,22,16,7,1
2021,Wirral 018C,E01007301,1528,1502,26,11,12,3,0
2021,Wirral 018D,E01007302,1837,1781,56,16,16,21,3
2021,Wirral 025D,E01007303,1436,1423,13,7,3,2,1
2021,Wirral 025E,E01007304,1512,1493,19,10,9,0,0
2021,Wirral 018E,E01007305,1533,1516,17,7,7,3,0
2021,Wirral 017E,E01007306,1511,1486,25,11,5,6,3
2021,Wirral 003A,E01007307,1654,1634,20,9,6,3,2
2021,Wirral 003B,E01007308,1388,1375,13,10,3,0,0
2021,Wirral 006D,E01007309,1449,1435,14,7,4,3,0
2021,Wirral 004C,E01007310,1288,1270,18,7,8,3,0
2021,Wirral 004D,E01007311,1364,1352,12,4,5,2,1
2021,Wirral 003C,E01007312,1437,1417,20,14,4,0,2
2021,Wirral 003D,E01007313,1529,1503,26,12,9,5,0
2021,Wirral 004E,E01007314,1380,1364,16,10,4,2,0
2021,Wirral 003E,E01007315,1442,1432,10,3,7,0,0
2021,Wirral 004F,E01007316,1452,1437,15,11,3,1,0
2021,Barnsley 018A,E01007317,1471,1415,56,16,27,9,4
2021,Barnsley 018B,E01007318,1533,1352,181,71,89,18,3
2021,Barnsley 015A,E01007319,1388,1377,11,4,0,6,1
2021,Barnsley 018C,E01007320,1653,1468,185,64,76,38,7
2021,Barnsley 015B,E01007321,1389,1361,28,11,11,5,1
2021,Barnsley 015C,E01007322,2051,1873,178,63,85,22,8
2021,Barnsley 007A,E01007323,1470,1401,69,36,22,10,1
2021,Barnsley 007B,E01007324,1590,1545,45,14,22,8,1
2021,Barnsley 007C,E01007325,1553,1483,70,22,29,16,3
2021,Barnsley 007D,E01007326,1617,1585,32,14,10,8,0
2021,Barnsley 007E,E01007327,1633,1601,32,12,10,10,0
2021,Barnsley 006A,E01007328,2011,1962,49,22,24,2,1
2021,Barnsley 003A,E01007329,1542,1531,11,9,1,1,0
2021,Barnsley 006B,E01007330,1704,1678,26,6,16,3,1
2021,Barnsley 003B,E01007331,1766,1738,28,5,14,8,1
2021,Barnsley 006C,E01007332,2303,2121,182,72,80,24,6
2021,Barnsley 006D,E01007333,1432,1328,104,45,46,11,2
2021,Barnsley 009A,E01007334,1258,1205,53,27,16,8,2
2021,Barnsley 009B,E01007335,1368,1343,25,12,10,2,1
2021,Barnsley 013A,E01007336,1465,1159,306,99,152,53,2
2021,Barnsley 015D,E01007337,1742,1397,345,93,180,66,6
2021,Barnsley 017A,E01007338,1546,1256,290,94,122,69,5
2021,Barnsley 017B,E01007339,1412,1054,358,107,171,72,8
2021,Barnsley 013B,E01007340,1805,1290,515,182,238,89,6
2021,Barnsley 008A,E01007341,1243,1206,37,12,16,7,2
2021,Barnsley 003C,E01007342,1234,1213,21,6,8,7,0
2021,Barnsley 003D,E01007343,1401,1358,43,23,15,3,2
2021,Barnsley 011A,E01007344,2526,2445,81,31,33,16,1
2021,Barnsley 008B,E01007345,1542,1488,54,22,20,6,6
2021,Barnsley 008C,E01007346,1537,1503,34,23,10,1,0
2021,Barnsley 008D,E01007347,1739,1709,30,14,15,1,0
2021,Barnsley 020A,E01007348,1452,1414,38,13,16,7,2
2021,Barnsley 020B,E01007349,1517,1479,38,15,13,7,3
2021,Barnsley 020C,E01007350,1084,1075,9,4,5,0,0
2021,Barnsley 020D,E01007351,1652,1551,101,33,44,22,2
2021,Barnsley 020E,E01007352,1409,1322,87,30,42,13,2
2021,Barnsley 020F,E01007353,1626,1525,101,30,53,16,2
2021,Barnsley 020G,E01007354,1596,1582,14,6,5,3,0
2021,Barnsley 005A,E01007355,1403,1396,7,3,3,1,0
2021,Barnsley 004A,E01007356,1413,1402,11,5,5,1,0
2021,Barnsley 004B,E01007357,1377,1333,44,14,14,10,6
2021,Barnsley 005B,E01007358,1365,1352,13,5,7,1,0
2021,Barnsley 005C,E01007359,1402,1364,38,24,9,4,1
2021,Barnsley 005D,E01007360,1459,1438,21,10,9,2,0
2021,Barnsley 004C,E01007361,1841,1798,43,15,15,13,0
2021,Barnsley 004D,E01007362,2044,2010,34,10,13,11,0
2021,Barnsley 004E,E01007363,1579,1547,32,9,9,12,2
2021,Barnsley 025A,E01007364,1369,1359,10,4,6,0,0
2021,Barnsley 025B,E01007365,1164,1142,22,10,9,2,1
2021,Barnsley 025C,E01007366,2177,2149,28,10,12,3,3
2021,Barnsley 025D,E01007367,1109,1082,27,11,14,2,0
2021,Barnsley 025E,E01007368,1671,1619,52,15,21,11,5
2021,Barnsley 022A,E01007369,1949,1830,119,42,50,22,5
2021,Barnsley 022B,E01007370,1697,1634,63,25,24,12,2
2021,Barnsley 022C,E01007371,1837,1785,52,21,23,6,2
2021,Barnsley 014A,E01007372,1623,1476,147,48,69,29,1
2021,Barnsley 014B,E01007373,1634,1532,102,38,42,21,1
2021,Barnsley 014C,E01007374,1289,1273,16,8,7,1,0
2021,Barnsley 014D,E01007375,1685,1661,24,14,8,1,1
2021,Barnsley 022D,E01007376,1398,1353,45,11,23,8,3
2021,Barnsley 014E,E01007377,1334,1256,78,33,29,15,1
2021,Barnsley 014F,E01007378,1549,1502,47,9,21,13,4
2021,Barnsley 012A,E01007379,1429,1418,11,3,5,2,1
2021,Barnsley 012B,E01007380,1796,1764,32,19,10,2,1
2021,Barnsley 012C,E01007381,2003,1956,47,24,14,7,2
2021,Barnsley 019A,E01007382,1553,1526,27,10,10,7,0
2021,Barnsley 019B,E01007383,1275,1257,18,7,10,1,0
2021,Barnsley 019C,E01007384,1642,1624,18,12,2,0,4
2021,Barnsley 019D,E01007385,1354,1321,33,18,11,4,0
2021,Barnsley 005E,E01007386,1753,1742,11,5,4,2,0
2021,Barnsley 012D,E01007387,1354,1347,7,1,3,3,0
2021,Barnsley 029A,E01007388,1675,1659,16,5,4,7,0
2021,Barnsley 030A,E01007389,1313,1300,13,7,5,1,0
2021,Barnsley 030B,E01007390,1438,1419,19,11,6,2,0
2021,Barnsley 030C,E01007391,1474,1452,22,7,8,4,3
2021,Barnsley 030D,E01007392,1449,1436,13,8,3,1,1
2021,Barnsley 029B,E01007393,1755,1706,49,15,31,3,0
2021,Barnsley 029C,E01007394,1324,1301,23,6,12,5,0
2021,Barnsley 030E,E01007395,2012,1983,29,12,9,7,1
2021,Barnsley 028A,E01007396,1513,1495,18,8,5,5,0
2021,Barnsley 028B,E01007397,1501,1484,17,3,8,5,1
2021,Barnsley 028C,E01007398,1599,1595,4,0,4,0,0
2021,Barnsley 028D,E01007399,1940,1917,23,17,6,0,0
2021,Barnsley 009C,E01007400,2225,2183,42,18,15,6,3
2021,Barnsley 011B,E01007402,1859,1747,112,45,46,19,2
2021,Barnsley 011C,E01007403,1400,1325,75,40,28,7,0
2021,Barnsley 009D,E01007404,1293,1283,10,3,6,1,0
2021,Barnsley 011D,E01007405,1866,1787,79,29,32,16,2
2021,Barnsley 009E,E01007406,1627,1601,26,9,10,3,4
2021,Barnsley 010C,E01007408,1397,1351,46,23,21,2,0
2021,Barnsley 010D,E01007409,1440,1344,96,30,35,31,0
2021,Barnsley 010E,E01007410,1703,1544,159,50,64,41,4
2021,Barnsley 007F,E01007411,1429,1314,115,50,46,16,3
2021,Barnsley 017C,E01007413,1411,1277,134,39,66,24,5
2021,Barnsley 017D,E01007414,2182,1918,264,87,132,38,7
2021,Barnsley 013C,E01007415,1455,1378,77,25,32,14,6
2021,Barnsley 018D,E01007416,1334,1220,114,35,55,22,2
2021,Barnsley 013D,E01007417,1776,1416,360,95,179,79,7
2021,Barnsley 016A,E01007418,1276,1265,11,8,1,2,0
2021,Barnsley 016B,E01007419,1547,1537,10,8,2,0,0
2021,Barnsley 016C,E01007420,1365,1355,10,5,3,2,0
2021,Barnsley 027A,E01007421,1355,1335,20,13,6,1,0
2021,Barnsley 027B,E01007422,1506,1501,5,4,1,0,0
2021,Barnsley 027C,E01007423,1616,1605,11,5,3,1,2
2021,Barnsley 028E,E01007424,1855,1828,27,14,11,2,0
2021,Barnsley 016D,E01007425,1803,1793,10,6,3,1,0
2021,Barnsley 027D,E01007426,1886,1868,18,4,7,6,1
2021,Barnsley 024A,E01007427,1640,1629,11,6,4,1,0
2021,Barnsley 024B,E01007428,1471,1459,12,2,7,3,0
2021,Barnsley 024C,E01007429,1405,1387,18,12,4,2,0
2021,Barnsley 024D,E01007430,2751,2730,21,16,1,2,2
2021,Barnsley 024E,E01007431,1347,1324,23,14,8,1,0
2021,Barnsley 024F,E01007432,1640,1627,13,4,8,0,1
2021,Barnsley 002A,E01007433,1600,1595,5,4,1,0,0
2021,Barnsley 001A,E01007434,2361,2304,57,29,18,9,1
2021,Barnsley 001B,E01007435,1577,1564,13,4,7,1,1
2021,Barnsley 002B,E01007436,1343,1331,12,5,6,1,0
2021,Barnsley 002C,E01007437,1358,1338,20,7,8,4,1
2021,Barnsley 001C,E01007438,1392,1379,13,5,5,2,1
2021,Barnsley 001D,E01007439,1410,1394,16,10,3,2,1
2021,Barnsley 002D,E01007440,1421,1381,40,15,11,13,1
2021,Barnsley 013E,E01007441,1475,1276,199,75,89,32,3
2021,Barnsley 012E,E01007442,1421,1394,27,14,6,7,0
2021,Barnsley 013F,E01007443,2179,1588,591,177,306,99,9
2021,Barnsley 012F,E01007444,2099,2008,91,29,36,25,1
2021,Barnsley 013G,E01007445,1520,1321,199,64,96,32,7
2021,Barnsley 012G,E01007446,1247,1206,41,20,18,3,0
2021,Barnsley 023A,E01007447,1670,1644,26,12,12,2,0
2021,Barnsley 023B,E01007448,2138,1864,274,93,124,50,7
2021,Barnsley 023C,E01007449,1668,1526,142,54,73,14,1
2021,Barnsley 023D,E01007450,1963,1850,113,44,44,19,6
2021,Barnsley 026A,E01007451,1789,1710,79,23,35,21,0
2021,Barnsley 026B,E01007452,1582,1543,39,16,13,7,3
2021,Barnsley 026C,E01007453,1624,1582,42,18,16,4,4
2021,Barnsley 026E,E01007455,1371,1349,22,8,10,4,0
2021,Barnsley 029D,E01007456,1710,1698,12,4,1,5,2
2021,Barnsley 029E,E01007457,1708,1675,33,12,11,8,2
2021,Barnsley 021A,E01007458,1423,1380,43,13,17,10,3
2021,Barnsley 021B,E01007459,1488,1472,16,6,7,3,0
2021,Barnsley 021C,E01007460,1398,1379,19,11,5,2,1
2021,Barnsley 021D,E01007461,1663,1566,97,43,38,11,5
2021,Barnsley 021E,E01007462,1516,1410,106,36,47,17,6
2021,Barnsley 021F,E01007463,1700,1657,43,11,16,11,5
2021,Doncaster 009A,E01007464,1417,1367,50,14,25,8,3
2021,Doncaster 009B,E01007465,1802,1730,72,42,19,9,2
2021,Doncaster 009C,E01007466,1886,1758,128,48,61,14,5
2021,Doncaster 009D,E01007467,1463,1361,102,32,58,12,0
2021,Doncaster 005A,E01007468,1187,1166,21,9,3,9,0
2021,Doncaster 005B,E01007469,1217,1203,14,5,8,0,1
2021,Doncaster 005C,E01007470,1290,1271,19,8,9,1,1
2021,Doncaster 009E,E01007471,1339,1314,25,13,9,3,0
2021,Doncaster 005D,E01007472,1319,1279,40,14,16,7,3
2021,Doncaster 005E,E01007473,1360,1314,46,14,26,5,1
2021,Doncaster 005F,E01007474,1158,1135,23,7,8,8,0
2021,Doncaster 011A,E01007475,1398,1361,37,20,13,4,0
2021,Doncaster 011B,E01007476,1759,1731,28,10,10,5,3
2021,Doncaster 011C,E01007477,1354,1329,25,10,10,4,1
2021,Doncaster 011D,E01007478,1582,1465,117,38,54,22,3
2021,Doncaster 014A,E01007479,1460,1374,86,22,43,19,2
2021,Doncaster 014B,E01007480,1432,1302,130,34,54,32,10
2021,Doncaster 014D,E01007482,1321,1220,101,27,42,28,4
2021,Doncaster 017A,E01007483,1274,1218,56,22,17,17,0
2021,Doncaster 017B,E01007484,1287,1214,73,23,34,14,2
2021,Doncaster 017C,E01007485,1347,1304,43,19,18,4,2
2021,Doncaster 017D,E01007486,1203,1139,64,24,21,14,5
2021,Doncaster 002A,E01007487,1522,1509,13,4,7,2,0
2021,Doncaster 002B,E01007488,1599,1576,23,17,2,0,4
2021,Doncaster 002C,E01007489,1998,1915,83,36,32,12,3
2021,Doncaster 002D,E01007490,1652,1624,28,16,7,3,2
2021,Doncaster 002E,E01007491,1604,1550,54,15,29,7,3
2021,Doncaster 002F,E01007492,1533,1505,28,17,8,3,0
2021,Doncaster 002G,E01007493,1682,1676,6,2,1,3,0
2021,Doncaster 023A,E01007494,1456,1236,220,60,121,28,11
2021,Doncaster 028A,E01007495,1664,1369,295,87,149,55,4
2021,Doncaster 029A,E01007496,1536,1321,215,59,94,54,8
2021,Doncaster 029B,E01007497,1287,1193,94,17,44,18,15
2021,Doncaster 029C,E01007498,1466,1315,151,37,80,31,3
2021,Doncaster 029D,E01007499,1344,1209,135,39,59,31,6
2021,Doncaster 028B,E01007500,1215,1061,154,58,64,21,11
2021,Doncaster 029E,E01007501,1273,1234,39,18,15,5,1
2021,Doncaster 029F,E01007503,1475,1430,45,18,17,9,1
2021,Doncaster 009F,E01007504,1348,1312,36,12,19,4,1
2021,Doncaster 013A,E01007505,1543,1513,30,10,14,5,1
2021,Doncaster 010A,E01007506,1687,1489,198,79,99,18,2
2021,Doncaster 009G,E01007507,1227,1111,116,50,54,10,2
2021,Doncaster 010B,E01007508,1468,1350,118,43,44,28,3
2021,Doncaster 010C,E01007509,1580,1467,113,33,45,29,6
2021,Doncaster 010D,E01007510,1418,1320,98,24,52,19,3
2021,Doncaster 010E,E01007511,1451,1400,51,17,28,5,1
2021,Doncaster 012A,E01007512,2024,1961,63,23,25,14,1
2021,Doncaster 012B,E01007513,1419,1360,59,23,25,9,2
2021,Doncaster 013B,E01007514,1447,1287,160,51,73,35,1
2021,Doncaster 012C,E01007515,1421,1369,52,24,21,6,1
2021,Doncaster 013C,E01007516,1354,1293,61,30,21,6,4
2021,Doncaster 013D,E01007517,1369,1200,169,60,82,21,6
2021,Doncaster 012D,E01007518,1406,1386,20,5,9,5,1
2021,Doncaster 012E,E01007519,1248,1198,50,14,29,7,0
2021,Doncaster 027A,E01007520,1281,1235,46,17,15,10,4
2021,Doncaster 025A,E01007521,1429,1363,66,31,25,10,0
2021,Doncaster 024A,E01007522,1484,1387,97,33,48,14,2
2021,Doncaster 025B,E01007523,1439,1340,99,34,40,22,3
2021,Doncaster 025C,E01007524,1543,1464,79,33,34,10,2
2021,Doncaster 024B,E01007525,1470,1365,105,33,49,22,1
2021,Doncaster 025D,E01007526,1974,1838,136,57,50,22,7
2021,Doncaster 024C,E01007528,1372,1247,125,42,52,31,0
2021,Doncaster 022A,E01007529,2238,1587,651,169,255,189,38
2021,Doncaster 022B,E01007530,1465,864,601,186,253,142,20
2021,Doncaster 022C,E01007531,1562,1171,391,117,178,90,6
2021,Doncaster 023B,E01007532,1711,1112,599,190,250,139,20
2021,Doncaster 023C,E01007533,1467,1266,201,61,99,35,6
2021,Doncaster 028D,E01007534,1870,1164,706,209,357,127,13
2021,Doncaster 023D,E01007535,1405,1074,331,93,162,67,9
2021,Doncaster 032A,E01007536,1765,1737,28,14,9,2,3
2021,Doncaster 035A,E01007537,1558,1533,25,9,12,4,0
2021,Doncaster 035B,E01007538,1478,1463,15,4,9,0,2
2021,Doncaster 035C,E01007539,1380,1359,21,8,10,3,0
2021,Doncaster 035D,E01007540,1564,1542,22,14,5,1,2
2021,Doncaster 035E,E01007541,1428,1407,21,7,12,1,1
2021,Doncaster 032B,E01007542,1973,1917,56,18,19,16,3
2021,Doncaster 032C,E01007543,1394,1380,14,5,5,4,0
2021,Doncaster 032D,E01007544,1602,1552,50,13,24,8,5
2021,Doncaster 034A,E01007545,1306,1208,98,36,41,18,3
2021,Doncaster 033A,E01007546,1267,1154,113,43,42,24,4
2021,Doncaster 034B,E01007547,1427,1306,121,44,47,28,2
2021,Doncaster 034C,E01007548,1749,1443,306,122,138,42,4
2021,Doncaster 034D,E01007549,1382,1325,57,22,30,4,1
2021,Doncaster 034E,E01007550,1625,1566,59,19,21,15,4
2021,Doncaster 033B,E01007551,1575,1547,28,22,1,4,1
2021,Doncaster 033C,E01007552,1306,1274,32,9,19,4,0
2021,Doncaster 008A,E01007553,1566,1550,16,6,9,1,0
2021,Doncaster 006A,E01007554,1481,1438,43,22,13,8,0
2021,Doncaster 006B,E01007555,1281,1268,13,7,2,2,2
2021,Doncaster 006C,E01007556,1279,1239,40,16,13,10,1
2021,Doncaster 008B,E01007557,2920,2835,85,37,26,16,6
2021,Doncaster 008C,E01007558,1406,1385,21,7,10,3,1
2021,Doncaster 008D,E01007559,1163,1155,8,5,1,1,1
2021,Doncaster 008E,E01007560,1612,1590,22,7,12,3,0
2021,Doncaster 006D,E01007561,1319,1301,18,9,5,4,0
2021,Doncaster 006E,E01007562,1313,1288,25,13,9,3,0
2021,Doncaster 006F,E01007563,1393,1330,63,17,28,17,1
2021,Doncaster 018A,E01007564,1481,1196,285,89,135,51,10
2021,Doncaster 018B,E01007565,1455,1306,149,68,54,23,4
2021,Doncaster 018C,E01007566,1571,1290,281,88,126,57,10
2021,Doncaster 018D,E01007567,1284,1073,211,69,80,50,12
2021,Doncaster 018E,E01007568,1491,1215,276,85,115,59,17
2021,Doncaster 018F,E01007569,1543,1217,326,122,119,65,20
2021,Doncaster 015A,E01007570,1403,1304,99,41,40,12,6
2021,Doncaster 031A,E01007571,1587,1522,65,32,25,8,0
2021,Doncaster 031B,E01007572,1282,1258,24,11,9,2,2
2021,Doncaster 031C,E01007573,1376,1310,66,21,19,20,6
2021,Doncaster 031D,E01007574,1378,1308,70,23,33,14,0
2021,Doncaster 030A,E01007575,1204,1132,72,21,28,22,1
2021,Doncaster 031E,E01007576,1368,1331,37,13,14,10,0
2021,Doncaster 031F,E01007577,1316,1215,101,23,55,22,1
2021,Doncaster 030B,E01007578,1494,1449,45,21,15,9,0
2021,Doncaster 030C,E01007579,2619,2530,89,33,31,21,4
2021,Doncaster 030D,E01007580,1232,1214,18,9,9,0,0
2021,Doncaster 016A,E01007581,1354,1327,27,6,13,8,0
2021,Doncaster 016B,E01007582,1352,1322,30,15,11,4,0
2021,Doncaster 020A,E01007583,1328,1315,13,7,6,0,0
2021,Doncaster 021A,E01007584,1490,1429,61,21,23,16,1
2021,Doncaster 021B,E01007585,1480,1462,18,7,7,4,0
2021,Doncaster 020B,E01007586,1406,1399,7,4,3,0,0
2021,Doncaster 020C,E01007587,1565,1544,21,6,8,3,4
2021,Doncaster 016C,E01007588,1577,1544,33,14,15,3,1
2021,Doncaster 016D,E01007589,1573,1550,23,7,11,4,1
2021,Doncaster 037A,E01007590,1172,1142,30,14,10,4,2
2021,Doncaster 036A,E01007591,1374,1324,50,20,18,9,3
2021,Doncaster 037B,E01007592,1648,1553,95,32,33,24,6
2021,Doncaster 037C,E01007593,1845,1783,62,21,27,9,5
2021,Doncaster 036B,E01007594,1905,1852,53,22,21,8,2
2021,Doncaster 037D,E01007595,1398,1349,49,14,30,4,1
2021,Doncaster 036C,E01007596,1161,1140,21,10,9,2,0
2021,Doncaster 037E,E01007597,1485,1422,63,25,23,15,0
2021,Doncaster 036D,E01007598,1430,1394,36,12,19,5,0
2021,Doncaster 026A,E01007599,1714,1713,1,1,0,0,0
2021,Doncaster 026B,E01007600,1311,1294,17,7,10,0,0
2021,Doncaster 026C,E01007601,1494,1473,21,7,12,1,1
2021,Doncaster 026D,E01007602,1935,1916,19,7,5,5,2
2021,Doncaster 026E,E01007603,1527,1482,45,24,15,3,3
2021,Doncaster 024D,E01007604,1295,1225,70,35,27,7,1
2021,Doncaster 027C,E01007605,1442,1344,98,52,23,19,4
2021,Doncaster 027D,E01007606,2134,2046,88,49,27,10,2
2021,Doncaster 025E,E01007607,1472,1390,82,40,31,11,0
2021,Doncaster 038B,E01007609,2163,2129,34,20,9,4,1
2021,Doncaster 038C,E01007610,1716,1694,22,15,3,4,0
2021,Doncaster 039A,E01007611,1248,1212,36,14,15,5,2
2021,Doncaster 039B,E01007612,1324,1319,5,3,1,1,0
2021,Doncaster 033D,E01007613,1600,1589,11,3,4,3,1
2021,Doncaster 039C,E01007614,1359,1346,13,4,5,4,0
2021,Doncaster 039D,E01007615,1235,1223,12,3,4,5,0
2021,Doncaster 039E,E01007616,1137,1134,3,2,1,0,0
2021,Doncaster 021C,E01007617,1438,1430,8,4,1,3,0
2021,Doncaster 021D,E01007618,1160,1141,19,10,4,5,0
2021,Doncaster 021E,E01007619,1794,1772,22,13,6,2,1
2021,Doncaster 020D,E01007620,1569,1557,12,5,4,1,2
2021,Doncaster 007A,E01007621,1353,1342,11,7,3,1,0
2021,Doncaster 007B,E01007622,1386,1360,26,17,3,5,1
2021,Doncaster 007C,E01007623,1186,1154,32,13,18,1,0
2021,Doncaster 007D,E01007624,1864,1823,41,18,13,10,0
2021,Doncaster 004A,E01007625,1381,1375,6,4,1,1,0
2021,Doncaster 004B,E01007626,1484,1417,67,24,20,19,4
2021,Doncaster 004C,E01007627,1537,1491,46,4,23,19,0
2021,Doncaster 004D,E01007628,1318,1270,48,11,31,5,1
2021,Doncaster 004E,E01007629,1447,1384,63,31,21,8,3
2021,Doncaster 007E,E01007630,1295,1277,18,4,9,5,0
2021,Doncaster 007F,E01007631,1147,1133,14,5,6,3,0
2021,Doncaster 001A,E01007632,1547,1472,75,28,33,14,0
2021,Doncaster 001B,E01007633,1346,1248,98,35,44,17,2
2021,Doncaster 001C,E01007634,1682,1510,172,45,89,33,5
2021,Doncaster 001D,E01007635,1895,1790,105,39,49,16,1
2021,Doncaster 003A,E01007636,1519,1436,83,24,45,13,1
2021,Doncaster 003B,E01007637,1509,1345,164,47,82,34,1
2021,Doncaster 003C,E01007638,1481,1402,79,20,50,7,2
2021,Doncaster 003D,E01007639,2096,1968,128,32,66,27,3
2021,Doncaster 003E,E01007640,1539,1520,19,6,12,1,0
2021,Doncaster 003F,E01007641,1374,1354,20,2,12,5,1
2021,Doncaster 003G,E01007642,1544,1454,90,36,42,12,0
2021,Doncaster 022D,E01007643,1580,1228,352,126,140,72,14
2021,Doncaster 019A,E01007644,1703,1485,218,82,82,44,10
2021,Doncaster 019B,E01007646,1552,1247,305,121,127,51,6
2021,Doncaster 019C,E01007647,1502,1302,200,66,90,36,8
2021,Doncaster 019E,E01007649,1434,1265,169,63,67,36,3
2021,Doncaster 015B,E01007650,1607,1498,109,30,44,24,11
2021,Doncaster 015C,E01007651,1746,1348,398,153,167,66,12
2021,Doncaster 015D,E01007652,1970,1618,352,134,150,56,12
2021,Doncaster 015E,E01007653,1518,1213,305,105,144,44,12
2021,Doncaster 019F,E01007654,1480,1059,421,119,169,115,18
2021,Doncaster 022F,E01007655,1926,1092,834,242,366,193,33
2021,Doncaster 015F,E01007656,1576,1413,163,63,69,28,3
2021,Rotherham 029A,E01007657,1343,1332,11,3,4,3,1
2021,Rotherham 032A,E01007658,1413,1400,13,8,4,1,0
2021,Rotherham 029B,E01007659,1050,1047,3,2,1,0,0
2021,Rotherham 032B,E01007660,1172,1160,12,3,4,5,0
2021,Rotherham 032C,E01007661,1432,1425,7,1,4,1,1
2021,Rotherham 032D,E01007662,1062,1056,6,1,4,1,0
2021,Rotherham 032E,E01007663,1429,1416,13,6,4,3,0
2021,Rotherham 032F,E01007664,1812,1805,7,0,6,1,0
2021,Rotherham 026A,E01007666,1240,1226,14,7,6,1,0
2021,Rotherham 030A,E01007667,1487,1460,27,14,12,1,0
2021,Rotherham 030B,E01007668,1514,1490,24,12,7,4,1
2021,Rotherham 030C,E01007669,1418,1409,9,2,5,2,0
2021,Rotherham 030D,E01007670,1386,1374,12,8,4,0,0
2021,Rotherham 031A,E01007671,1972,1933,39,22,10,7,0
2021,Rotherham 030E,E01007672,1340,1329,11,4,3,2,2
2021,Rotherham 030F,E01007673,1486,1462,24,11,11,2,0
2021,Rotherham 031B,E01007674,2040,2025,15,11,4,0,0
2021,Rotherham 023A,E01007675,1888,1597,291,90,110,73,18
2021,Rotherham 025A,E01007676,1562,1485,77,29,37,11,0
2021,Rotherham 017A,E01007677,1871,1676,195,80,74,37,4
2021,Rotherham 023B,E01007678,1555,1358,197,105,61,21,10
2021,Rotherham 023C,E01007679,1921,1639,282,102,104,70,6
2021,Rotherham 023D,E01007680,1842,1409,433,138,151,129,15
2021,Rotherham 012A,E01007681,1236,1223,13,8,3,1,1
2021,Rotherham 019A,E01007682,1260,1232,28,12,8,7,1
2021,Rotherham 019B,E01007683,1298,1290,8,4,4,0,0
2021,Rotherham 034A,E01007684,1748,1728,20,9,8,3,0
2021,Rotherham 018A,E01007685,1307,1288,19,11,8,0,0
2021,Rotherham 019C,E01007686,1409,1400,9,2,0,3,4
2021,Rotherham 034C,E01007687,1542,1522,20,15,3,2,0
2021,Rotherham 019D,E01007688,1450,1444,6,3,2,1,0
2021,Rotherham 034B,E01007689,1526,1501,25,13,10,2,0
2021,Rotherham 034E,E01007690,1684,1652,32,19,7,6,0
2021,Rotherham 012B,E01007691,1973,1966,7,3,2,2,0
2021,Rotherham 012C,E01007692,1484,1471,13,7,5,0,1
2021,Rotherham 001B,E01007694,1835,1780,55,20,24,8,3
2021,Rotherham 001C,E01007695,2691,2652,39,18,13,8,0
2021,Rotherham 007A,E01007696,1380,1366,14,7,5,1,1
2021,Rotherham 001D,E01007697,1619,1596,23,9,5,9,0
2021,Rotherham 001E,E01007698,1395,1386,9,6,3,0,0
2021,Rotherham 027B,E01007699,2593,2484,109,65,30,13,1
2021,Rotherham 027C,E01007700,1902,1860,42,22,14,6,0
2021,Rotherham 027D,E01007701,1558,1529,29,16,8,4,1
2021,Rotherham 025B,E01007702,1646,1549,97,32,40,25,0
2021,Rotherham 025C,E01007703,1188,1159,29,11,9,9,0
2021,Rotherham 025D,E01007704,1497,1471,26,12,6,8,0
2021,Rotherham 025E,E01007705,1439,1409,30,10,8,9,3
2021,Rotherham 027E,E01007706,1291,1259,32,14,10,4,4
2021,Rotherham 025F,E01007707,1429,1403,26,9,14,3,0
2021,Rotherham 021A,E01007708,1640,1557,83,21,36,23,3
2021,Rotherham 021B,E01007709,1436,1411,25,15,5,5,0
2021,Rotherham 021C,E01007710,1515,1485,30,19,7,3,1
2021,Rotherham 021D,E01007711,1717,1653,64,27,28,8,1
2021,Rotherham 023E,E01007712,1945,1769,176,77,53,34,12
2021,Rotherham 023F,E01007713,1590,1473,117,57,42,14,4
2021,Rotherham 017B,E01007714,2169,1544,625,187,263,140,35
2021,Rotherham 016A,E01007715,1819,1175,644,197,264,160,23
2021,Rotherham 016B,E01007716,1871,1448,423,124,167,113,19
2021,Rotherham 016C,E01007717,1729,1588,141,58,43,37,3
2021,Rotherham 016D,E01007718,1496,1325,171,50,78,40,3
2021,Rotherham 010A,E01007719,1195,1158,37,13,15,9,0
2021,Rotherham 010B,E01007720,1477,1457,20,11,7,0,2
2021,Rotherham 010C,E01007721,1578,1514,64,24,26,12,2
2021,Rotherham 013A,E01007723,1363,1314,49,28,17,4,0
2021,Rotherham 021E,E01007724,1363,1347,16,7,6,2,1
2021,Rotherham 019E,E01007725,1189,1177,12,7,5,0,0
2021,Rotherham 019F,E01007726,1476,1432,44,18,17,5,4
2021,Rotherham 010D,E01007727,1368,1344,24,4,14,3,3
2021,Rotherham 009A,E01007728,1123,1107,16,6,6,4,0
2021,Rotherham 009B,E01007729,1514,1478,36,15,10,10,1
2021,Rotherham 009C,E01007730,1339,1306,33,13,15,4,1
2021,Rotherham 009D,E01007731,1122,1103,19,9,8,2,0
2021,Rotherham 009E,E01007732,1267,1253,14,9,4,1,0
2021,Rotherham 009F,E01007733,1197,1185,12,8,3,0,1
2021,Rotherham 021F,E01007734,1670,1567,103,31,46,21,5
2021,Rotherham 013B,E01007735,1369,1309,60,17,31,10,2
2021,Rotherham 014A,E01007736,1559,1261,298,73,129,86,10
2021,Rotherham 013C,E01007737,1551,1447,104,47,47,9,1
2021,Rotherham 013D,E01007738,1444,1314,130,28,57,43,2
2021,Rotherham 013E,E01007739,1477,1369,108,29,47,32,0
2021,Rotherham 011A,E01007740,1489,1448,41,13,20,8,0
2021,Rotherham 015A,E01007741,1433,1398,35,12,19,4,0
2021,Rotherham 015B,E01007742,1378,1351,27,12,12,3,0
2021,Rotherham 015C,E01007743,1158,1143,15,3,6,4,2
2021,Rotherham 015D,E01007744,1396,1338,58,18,27,12,1
2021,Rotherham 015E,E01007745,1547,1469,78,38,20,18,2
2021,Rotherham 015F,E01007746,1397,1363,34,20,11,3,0
2021,Rotherham 031C,E01007747,1274,1252,22,7,12,3,0
2021,Rotherham 033A,E01007748,1387,1381,6,5,1,0,0
2021,Rotherham 033B,E01007749,1810,1792,18,10,8,0,0
2021,Rotherham 031D,E01007750,1558,1524,34,15,14,5,0
2021,Rotherham 033C,E01007751,2224,2183,41,22,12,5,2
2021,Rotherham 033D,E01007752,1442,1426,16,6,9,1,0
2021,Rotherham 033E,E01007753,1562,1548,14,9,1,4,0
2021,Rotherham 018B,E01007754,1287,1274,13,6,2,2,3
2021,Rotherham 018C,E01007755,1255,1242,13,8,5,0,0
2021,Rotherham 018D,E01007756,1349,1335,14,3,6,4,1
2021,Rotherham 020A,E01007757,1549,1540,9,4,5,0,0
2021,Rotherham 020B,E01007758,1454,1418,36,7,15,14,0
2021,Rotherham 020C,E01007759,1393,1384,9,4,1,2,2
2021,Rotherham 020D,E01007760,1542,1485,57,22,27,8,0
2021,Rotherham 018E,E01007761,1527,1514,13,3,7,3,0
2021,Rotherham 018F,E01007762,1369,1362,7,3,0,3,1
2021,Rotherham 020E,E01007763,1480,1433,47,14,18,12,3
2021,Rotherham 020F,E01007764,1734,1686,48,13,20,10,5
2021,Rotherham 014B,E01007765,1319,1154,165,48,72,41,4
2021,Rotherham 014C,E01007766,1401,1274,127,48,49,26,4
2021,Rotherham 017C,E01007767,1439,1243,196,54,88,46,8
2021,Rotherham 014D,E01007768,1913,1421,492,132,203,132,25
2021,Rotherham 017D,E01007769,1604,834,770,229,277,223,41
2021,Rotherham 014E,E01007770,1708,1475,233,73,94,54,12
2021,Rotherham 006A,E01007771,1302,1285,17,4,6,5,2
2021,Rotherham 006B,E01007772,1329,1291,38,8,21,7,2
2021,Rotherham 006C,E01007773,1365,1330,35,10,11,12,2
2021,Rotherham 006D,E01007774,1383,1350,33,19,11,3,0
2021,Rotherham 008A,E01007775,1278,1235,43,23,15,4,1
2021,Rotherham 008B,E01007776,1494,1440,54,22,22,9,1
2021,Rotherham 004A,E01007777,2089,2081,8,6,2,0,0
2021,Rotherham 005A,E01007778,1363,1354,9,3,4,2,0
2021,Rotherham 005B,E01007779,1882,1865,17,10,3,4,0
2021,Rotherham 005C,E01007780,1368,1352,16,4,8,1,3
2021,Rotherham 005D,E01007781,1440,1417,23,12,7,4,0
2021,Rotherham 005E,E01007782,1431,1417,14,5,9,0,0
2021,Rotherham 008C,E01007783,1637,1551,86,35,27,20,4
2021,Rotherham 008D,E01007784,1672,1576,96,30,42,24,0
2021,Rotherham 029C,E01007785,1321,1302,19,9,3,6,1
2021,Rotherham 029D,E01007786,1155,1145,10,2,7,1,0
2021,Rotherham 028B,E01007788,1455,1438,17,9,5,3,0
2021,Rotherham 028C,E01007789,1526,1502,24,10,11,3,0
2021,Rotherham 029E,E01007790,1589,1519,70,34,18,14,4
2021,Rotherham 029F,E01007791,1329,1307,22,10,10,2,0
2021,Rotherham 028D,E01007792,1209,1198,11,2,9,0,0
2021,Rotherham 004B,E01007793,1368,1346,22,8,8,6,0
2021,Rotherham 004C,E01007794,1276,1244,32,15,7,7,3
2021,Rotherham 004D,E01007795,1306,1300,6,2,2,2,0
2021,Rotherham 003A,E01007796,1116,1092,24,8,9,6,1
2021,Rotherham 003B,E01007797,1190,1175,15,11,3,1,0
2021,Rotherham 003C,E01007798,1507,1498,9,4,2,3,0
2021,Rotherham 003D,E01007799,1423,1416,7,2,2,3,0
2021,Rotherham 003E,E01007800,1511,1477,34,14,13,7,0
2021,Rotherham 007B,E01007801,1408,1383,25,14,7,4,0
2021,Rotherham 007C,E01007802,1210,1202,8,3,2,2,1
2021,Rotherham 007D,E01007803,1225,1223,2,2,0,0,0
2021,Rotherham 011B,E01007804,1360,1340,20,3,10,7,0
2021,Rotherham 011C,E01007805,1420,1372,48,22,22,3,1
2021,Rotherham 011D,E01007806,1322,1267,55,21,25,9,0
2021,Rotherham 011E,E01007807,1391,1340,51,23,17,3,8
2021,Rotherham 007E,E01007808,1308,1303,5,3,2,0,0
2021,Rotherham 026B,E01007809,1579,1556,23,8,8,4,3
2021,Rotherham 026C,E01007810,2820,2785,35,20,7,6,2
2021,Rotherham 034D,E01007811,1264,1218,46,18,14,12,2
2021,Rotherham 034F,E01007812,1211,1173,38,17,13,6,2
2021,Rotherham 026D,E01007815,1571,1518,53,18,24,11,0
2021,Rotherham 002A,E01007816,1649,1630,19,10,5,3,1
2021,Rotherham 002B,E01007817,1417,1405,12,7,3,2,0
2021,Rotherham 003F,E01007818,1557,1543,14,4,6,3,1
2021,Rotherham 002C,E01007819,1514,1499,15,8,4,3,0
2021,Rotherham 002D,E01007820,1675,1612,63,30,19,11,3
2021,Rotherham 002E,E01007821,1545,1533,12,4,3,2,3
2021,Rotherham 002F,E01007822,1862,1837,25,15,6,4,0
2021,Sheffield 069A,E01007823,1631,1590,41,26,12,3,0
2021,Sheffield 066A,E01007824,1290,1275,15,11,2,2,0
2021,Sheffield 066B,E01007825,1398,1375,23,11,4,8,0
2021,Sheffield 066C,E01007826,1458,1444,14,9,4,0,1
2021,Sheffield 064A,E01007827,1796,1765,31,20,10,1,0
2021,Sheffield 059A,E01007828,1681,1604,77,28,26,18,5
2021,Sheffield 059B,E01007829,1534,1425,109,60,24,23,2
2021,Sheffield 064B,E01007830,1426,1398,28,13,8,3,4
2021,Sheffield 059C,E01007831,1535,1487,48,24,15,9,0
2021,Sheffield 059D,E01007832,1455,1431,24,16,5,3,0
2021,Sheffield 064C,E01007833,1629,1583,46,17,13,13,3
2021,Sheffield 066D,E01007834,1581,1535,46,25,18,1,2
2021,Sheffield 062A,E01007835,1297,1278,19,10,6,3,0
2021,Sheffield 062B,E01007836,1543,1530,13,5,6,2,0
2021,Sheffield 076A,E01007838,1405,1393,12,8,3,1,0
2021,Sheffield 076B,E01007839,1550,1537,13,8,2,3,0
2021,Sheffield 076C,E01007841,1462,1451,11,5,6,0,0
2021,Sheffield 076D,E01007842,1518,1504,14,7,6,1,0
2021,Sheffield 062C,E01007843,1630,1561,69,14,52,2,1
2021,Sheffield 062D,E01007846,1345,1332,13,8,3,2,0
2021,Sheffield 014A,E01007847,1246,1140,106,30,46,25,5
2021,Sheffield 013A,E01007848,1743,1548,195,57,77,55,6
2021,Sheffield 010A,E01007849,2048,1773,275,90,115,56,14
2021,Sheffield 014B,E01007850,1348,1270,78,17,35,22,4
2021,Sheffield 013B,E01007851,1435,1175,260,83,97,66,14
2021,Sheffield 014C,E01007852,1449,1319,130,48,63,18,1
2021,Sheffield 014D,E01007853,1698,1566,132,55,56,16,5
2021,Sheffield 014E,E01007854,1381,1147,234,77,90,52,15
2021,Sheffield 014F,E01007855,1890,1484,406,131,176,84,15
2021,Sheffield 007A,E01007856,1254,1170,84,42,23,15,4
2021,Sheffield 010B,E01007857,1631,1523,108,44,48,13,3
2021,Sheffield 038A,E01007858,1336,1280,56,31,16,7,2
2021,Sheffield 038B,E01007861,1549,1511,38,27,7,3,1
2021,Sheffield 038C,E01007862,3523,3268,255,168,67,20,0
2021,Sheffield 036C,E01007863,1585,1531,54,38,12,4,0
2021,Sheffield 036D,E01007864,1598,1544,54,38,10,4,2
2021,Sheffield 038D,E01007865,1710,1638,72,41,24,5,2
2021,Sheffield 030A,E01007866,1706,1582,124,80,36,8,0
2021,Sheffield 030B,E01007867,1897,1779,118,56,28,32,2
2021,Sheffield 030C,E01007868,1266,1175,91,64,17,6,4
2021,Sheffield 020A,E01007869,1525,1167,358,115,134,87,22
2021,Sheffield 019A,E01007870,1705,1380,325,85,148,84,8
2021,Sheffield 019B,E01007871,1711,1394,317,153,90,67,7
2021,Sheffield 020B,E01007872,1733,1336,397,129,146,89,33
2021,Sheffield 020C,E01007873,2083,1467,616,199,252,138,27
2021,Sheffield 022A,E01007874,1808,1184,624,221,210,155,38
2021,Sheffield 022B,E01007875,1716,1146,570,188,206,148,28
2021,Sheffield 075A,E01007878,1245,1119,126,53,50,21,2
2021,Sheffield 075B,E01007879,1458,1252,206,61,77,61,7
2021,Sheffield 075C,E01007881,1493,1352,141,62,42,31,6
2021,Sheffield 075D,E01007882,1422,1241,181,56,73,40,12
2021,Sheffield 027A,E01007883,1829,1324,505,123,190,160,32
2021,Sheffield 075E,E01007885,1861,1502,359,129,115,97,18
2021,Sheffield 075F,E01007886,1508,1377,131,56,45,26,4
2021,Sheffield 004A,E01007887,1362,1352,10,6,3,1,0
2021,Sheffield 003A,E01007888,1309,1301,8,3,3,2,0
2021,Sheffield 004B,E01007889,2669,2626,43,22,14,7,0
2021,Sheffield 004C,E01007890,1321,1309,12,4,6,0,2
2021,Sheffield 004D,E01007891,1452,1448,4,4,0,0,0
2021,Sheffield 003B,E01007892,1399,1347,52,38,9,3,2
2021,Sheffield 003C,E01007893,1390,1378,12,3,7,1,1
2021,Sheffield 004E,E01007894,1362,1348,14,6,7,1,0
2021,Sheffield 004F,E01007895,1387,1364,23,12,6,4,1
2021,Sheffield 004G,E01007896,1207,1201,6,1,5,0,0
2021,Sheffield 005A,E01007897,1310,1297,13,7,6,0,0
2021,Sheffield 003D,E01007898,1414,1386,28,21,5,2,0
2021,Sheffield 003E,E01007899,1397,1381,16,7,6,3,0
2021,Sheffield 003F,E01007900,1628,1610,18,9,6,3,0
2021,Sheffield 003G,E01007901,1369,1314,55,25,19,9,2
2021,Sheffield 027B,E01007902,1630,1161,469,122,195,132,20
2021,Sheffield 018A,E01007903,1577,1271,306,76,130,82,18
2021,Sheffield 018B,E01007904,1642,1227,415,127,150,111,27
2021,Sheffield 027C,E01007905,1953,1259,694,232,225,201,36
2021,Sheffield 027D,E01007906,2723,1897,826,266,313,224,23
2021,Sheffield 032A,E01007907,1626,1346,280,56,131,80,13
2021,Sheffield 032B,E01007908,1322,1268,54,18,17,12,7
2021,Sheffield 032C,E01007909,2423,2297,126,32,78,15,1
2021,Sheffield 037A,E01007910,1748,1644,104,31,42,27,4
2021,Sheffield 032D,E01007911,1344,1321,23,12,6,2,3
2021,Sheffield 037B,E01007912,1405,1357,48,28,17,3,0
2021,Sheffield 018C,E01007913,1519,953,566,119,228,176,43
2021,Sheffield 018D,E01007914,1497,926,571,149,233,157,32
2021,Sheffield 071A,E01007915,1418,1395,23,16,5,2,0
2021,Sheffield 069B,E01007916,1468,1357,111,35,61,12,3
2021,Sheffield 071B,E01007917,1404,1361,43,19,12,12,0
2021,Sheffield 071C,E01007918,1661,1611,50,30,16,2,2
2021,Sheffield 069C,E01007919,1577,1453,124,45,44,30,5
2021,Sheffield 068A,E01007920,1672,1642,30,16,13,1,0
2021,Sheffield 068B,E01007921,1688,1650,38,25,12,1,0
2021,Sheffield 071D,E01007922,1343,1323,20,14,3,2,1
2021,Sheffield 068C,E01007923,1822,1780,42,20,18,4,0
2021,Sheffield 071E,E01007924,1591,1540,51,30,12,9,0
2021,Sheffield 068D,E01007925,1723,1662,61,41,15,5,0
2021,Sheffield 068E,E01007926,1682,1647,35,20,11,3,1
2021,Sheffield 055A,E01007927,1537,1481,56,32,17,7,0
2021,Sheffield 055B,E01007928,1708,1676,32,24,5,0,3
2021,Sheffield 055C,E01007929,1912,1808,104,55,38,11,0
2021,Sheffield 055D,E01007930,1403,1350,53,37,15,1,0
2021,Sheffield 047A,E01007931,1523,1485,38,29,6,2,1
2021,Sheffield 055E,E01007932,1438,1377,61,37,20,4,0
2021,Sheffield 068F,E01007933,1625,1583,42,31,10,1,0
2021,Sheffield 047B,E01007934,1446,1408,38,26,6,5,1
2021,Sheffield 047C,E01007935,1348,1293,55,39,13,2,1
2021,Sheffield 047D,E01007936,1580,1528,52,28,14,6,4
2021,Sheffield 047E,E01007937,1428,1392,36,21,12,2,1
2021,Sheffield 047F,E01007938,1465,1440,25,16,5,4,0
2021,Sheffield 055F,E01007939,1577,1541,36,23,6,6,1
2021,Sheffield 022E,E01007940,1716,1047,669,212,264,157,36
2021,Sheffield 015A,E01007941,1642,1508,134,63,44,23,4
2021,Sheffield 020D,E01007942,1817,1247,570,150,220,166,34
2021,Sheffield 019C,E01007943,1688,1512,176,57,72,38,9
2021,Sheffield 015B,E01007945,1642,1513,129,41,55,28,5
2021,Sheffield 015C,E01007946,1488,1401,87,34,37,12,4
2021,Sheffield 013C,E01007947,1477,1244,233,71,92,57,13
2021,Sheffield 013D,E01007948,1584,1156,428,133,163,108,24
2021,Sheffield 020E,E01007949,1673,1026,647,182,291,132,42
2021,Sheffield 015D,E01007950,1490,1405,85,44,27,10,4
2021,Sheffield 029A,E01007951,1565,1491,74,52,13,5,4
2021,Sheffield 033A,E01007952,1517,1436,81,51,19,11,0
2021,Sheffield 033B,E01007953,1492,1404,88,54,22,9,3
2021,Sheffield 033C,E01007954,1573,1518,55,32,18,3,2
2021,Sheffield 041A,E01007955,1387,1324,63,44,13,5,1
2021,Sheffield 041B,E01007956,2085,1991,94,67,20,6,1
2021,Sheffield 041C,E01007957,1600,1525,75,44,21,8,2
2021,Sheffield 041D,E01007958,1407,1349,58,40,14,3,1
2021,Sheffield 041E,E01007959,1413,1374,39,23,14,2,0
2021,Sheffield 029B,E01007960,1504,1435,69,47,14,6,2
2021,Sheffield 033D,E01007961,1474,1396,78,41,27,9,1
2021,Sheffield 029C,E01007962,1273,1201,72,39,22,9,2
2021,Sheffield 045A,E01007963,1387,1336,51,21,25,4,1
2021,Sheffield 049A,E01007964,1456,1428,28,11,8,7,2
2021,Sheffield 044A,E01007965,1820,1745,75,20,31,24,0
2021,Sheffield 049B,E01007966,1410,1372,38,20,10,6,2
2021,Sheffield 045B,E01007967,1704,1639,65,26,25,9,5
2021,Sheffield 049C,E01007968,1390,1297,93,30,37,26,0
2021,Sheffield 044B,E01007969,1596,1559,37,13,17,5,2
2021,Sheffield 049D,E01007970,1381,1332,49,16,17,14,2
2021,Sheffield 037C,E01007971,1416,1365,51,23,15,11,2
2021,Sheffield 044C,E01007972,1352,1330,22,10,10,2,0
2021,Sheffield 037D,E01007973,1478,1453,25,5,12,7,1
2021,Sheffield 044D,E01007974,1353,1332,21,13,6,2,0
2021,Sheffield 051A,E01007975,1483,1368,115,46,39,27,3
2021,Sheffield 051B,E01007976,1340,1242,98,45,26,24,3
2021,Sheffield 051C,E01007977,1420,1205,215,67,82,64,2
2021,Sheffield 053A,E01007978,1512,1439,73,30,32,11,0
2021,Sheffield 051D,E01007979,1696,1418,278,91,103,58,26
2021,Sheffield 053B,E01007980,1391,1325,66,21,26,16,3
2021,Sheffield 053C,E01007981,1428,1342,86,34,28,19,5
2021,Sheffield 054A,E01007982,1817,1623,194,81,52,46,15
2021,Sheffield 053D,E01007983,1341,1311,30,16,8,6,0
2021,Sheffield 064D,E01007984,1359,1336,23,16,5,2,0
2021,Sheffield 053E,E01007985,1431,1395,36,15,14,7,0
2021,Sheffield 059E,E01007986,1316,1261,55,21,21,10,3
2021,Sheffield 016A,E01007987,1379,1351,28,16,9,3,0
2021,Sheffield 016B,E01007988,1437,1416,21,9,5,6,1
2021,Sheffield 016C,E01007989,1357,1304,53,24,17,10,2
2021,Sheffield 021A,E01007990,1403,1388,15,11,3,1,0
2021,Sheffield 016D,E01007991,1472,1447,25,15,9,0,1
2021,Sheffield 021B,E01007992,1469,1437,32,21,7,4,0
2021,Sheffield 021C,E01007993,1575,1535,40,23,8,8,1
2021,Sheffield 021D,E01007994,1293,1267,26,13,10,3,0
2021,Sheffield 017A,E01007995,1457,1371,86,44,29,11,2
2021,Sheffield 021E,E01007996,1608,1569,39,22,12,5,0
2021,Sheffield 025A,E01007997,1530,1514,16,8,3,4,1
2021,Sheffield 025B,E01007998,1472,1411,61,24,24,9,4
2021,Sheffield 045C,E01007999,1200,1187,13,9,2,2,0
2021,Sheffield 052A,E01008000,1399,1371,28,13,12,3,0
2021,Sheffield 052B,E01008001,1453,1428,25,10,9,5,1
2021,Sheffield 054B,E01008002,1515,1459,56,27,21,6,2
2021,Sheffield 054C,E01008003,1314,1286,28,14,7,7,0
2021,Sheffield 052C,E01008004,1515,1471,44,20,17,7,0
2021,Sheffield 052D,E01008005,1481,1459,22,11,11,0,0
2021,Sheffield 054D,E01008006,1407,1375,32,14,16,2,0
2021,Sheffield 060A,E01008007,1595,1515,80,26,35,15,4
2021,Sheffield 045D,E01008008,1600,1493,107,27,40,38,2
2021,Sheffield 045E,E01008009,1454,1354,100,41,39,18,2
2021,Sheffield 052E,E01008010,1347,1290,57,30,21,4,2
2021,Sheffield 039A,E01008011,1798,1605,193,84,71,28,10
2021,Sheffield 039B,E01008012,2193,1825,368,154,131,72,11
2021,Sheffield 039C,E01008013,1939,1583,356,145,141,62,8
2021,Sheffield 032E,E01008014,1762,1467,295,87,135,60,13
2021,Sheffield 039D,E01008015,1499,1416,83,25,41,16,1
2021,Sheffield 032F,E01008016,1465,1315,150,54,57,31,8
2021,Sheffield 039E,E01008017,1590,1404,186,73,60,48,5
2021,Sheffield 039F,E01008018,1518,1354,164,52,66,43,3
2021,Sheffield 065A,E01008019,1729,1693,36,14,15,6,1
2021,Sheffield 065B,E01008020,1208,1189,19,9,8,2,0
2021,Sheffield 072A,E01008021,1343,1312,31,9,18,2,2
2021,Sheffield 065C,E01008022,1379,1310,69,28,22,12,7
2021,Sheffield 072B,E01008023,2341,2285,56,23,19,10,4
2021,Sheffield 072C,E01008024,2099,2080,19,14,5,0,0
2021,Sheffield 072D,E01008025,1927,1901,26,15,6,4,1
2021,Sheffield 065D,E01008027,1403,1377,26,10,8,4,4
2021,Sheffield 056A,E01008028,1482,1469,13,4,3,2,4
2021,Sheffield 056B,E01008029,1448,1405,43,21,19,2,1
2021,Sheffield 063A,E01008030,1372,1358,14,6,4,4,0
2021,Sheffield 061A,E01008031,1337,1288,49,23,13,13,0
2021,Sheffield 056C,E01008032,1308,1287,21,8,4,7,2
2021,Sheffield 061B,E01008033,1184,1155,29,10,11,7,1
2021,Sheffield 056D,E01008034,1503,1478,25,6,9,9,1
2021,Sheffield 063B,E01008035,1126,1118,8,5,3,0,0
2021,Sheffield 063C,E01008036,1292,1279,13,6,6,1,0
2021,Sheffield 065E,E01008037,1295,1273,22,10,9,3,0
2021,Sheffield 061C,E01008038,1419,1398,21,9,8,1,3
2021,Sheffield 065F,E01008039,1167,1156,11,6,2,3,0
2021,Sheffield 061D,E01008040,1555,1532,23,14,7,1,1
2021,Sheffield 063D,E01008041,1264,1251,13,7,5,1,0
2021,Sheffield 050A,E01008042,1753,1539,214,69,91,48,6
2021,Sheffield 046A,E01008043,1690,1611,79,44,22,10,3
2021,Sheffield 046B,E01008044,1603,1488,115,49,45,20,1
2021,Sheffield 050B,E01008045,1297,1207,90,28,28,28,6
2021,Sheffield 050C,E01008046,1549,1427,122,41,56,21,4
2021,Sheffield 046C,E01008047,1305,1248,57,38,15,4,0
2021,Sheffield 046D,E01008048,1530,1463,67,44,12,6,5
2021,Sheffield 050D,E01008049,1606,1553,53,31,10,11,1
2021,Sheffield 046E,E01008050,1421,1345,76,43,28,4,1
2021,Sheffield 050E,E01008051,1664,1445,219,68,88,50,13
2021,Sheffield 050F,E01008052,1647,1574,73,29,24,18,2
2021,Sheffield 006A,E01008053,1273,1256,17,6,10,1,0
2021,Sheffield 007B,E01008054,1327,1227,100,55,27,13,5
2021,Sheffield 007C,E01008055,1496,1402,94,48,29,15,2
2021,Sheffield 006B,E01008056,1385,1366,19,12,3,4,0
2021,Sheffield 007D,E01008057,1573,1465,108,45,39,19,5
2021,Sheffield 006C,E01008058,1696,1667,29,18,4,5,2
2021,Sheffield 010C,E01008059,1587,1465,122,56,46,12,8
2021,Sheffield 010D,E01008060,1476,1371,105,40,44,16,5
2021,Sheffield 011A,E01008061,1602,1431,171,63,73,29,6
2021,Sheffield 013E,E01008062,1645,1342,303,97,131,59,16
2021,Sheffield 011B,E01008063,1364,1272,92,37,35,19,1
2021,Sheffield 028A,E01008064,1471,1376,95,55,27,13,0
2021,Sheffield 026A,E01008065,2033,1384,649,205,253,163,28
2021,Sheffield 028B,E01008066,1410,1343,67,38,16,13,0
2021,Sheffield 030D,E01008067,1759,1634,125,78,40,7,0
2021,Sheffield 026B,E01008068,2226,1429,797,310,320,146,21
2021,Sheffield 028C,E01008069,1442,1367,75,47,20,7,1
2021,Sheffield 026C,E01008072,1617,1257,360,147,122,78,13
2021,Sheffield 030E,E01008073,1544,1420,124,45,48,28,3
2021,Sheffield 028D,E01008074,1266,1198,68,38,19,9,2
2021,Sheffield 060B,E01008075,1354,1129,225,74,91,43,17
2021,Sheffield 060C,E01008076,1341,1235,106,46,38,22,0
2021,Sheffield 060D,E01008077,1478,1420,58,20,23,12,3
2021,Sheffield 064E,E01008078,1436,1401,35,14,12,9,0
2021,Sheffield 064F,E01008079,1175,1156,19,8,5,3,3
2021,Sheffield 069D,E01008080,1375,1332,43,20,21,2,0
2021,Sheffield 070A,E01008081,1457,1373,84,31,29,18,6
2021,Sheffield 070B,E01008082,1509,1396,113,39,43,25,6
2021,Sheffield 070C,E01008083,1465,1347,118,41,39,32,6
2021,Sheffield 070D,E01008084,1572,1390,182,63,69,44,6
2021,Sheffield 009A,E01008085,1261,1225,36,13,10,8,5
2021,Sheffield 009B,E01008086,1395,1295,100,38,34,23,5
2021,Sheffield 012A,E01008087,1432,1392,40,18,16,5,1
2021,Sheffield 012B,E01008088,1327,1281,46,17,19,7,3
2021,Sheffield 017B,E01008089,1649,1386,263,83,107,62,11
2021,Sheffield 012C,E01008090,1557,1456,101,40,27,13,21
2021,Sheffield 017C,E01008091,1348,1278,70,36,22,10,2
2021,Sheffield 012D,E01008092,1407,1360,47,21,15,10,1
2021,Sheffield 017D,E01008093,1392,1307,85,42,33,9,1
2021,Sheffield 019D,E01008094,1166,1055,111,36,51,20,4
2021,Sheffield 043A,E01008095,1788,1507,281,131,98,48,4
2021,Sheffield 043B,E01008096,2248,1891,357,153,116,73,15
2021,Sheffield 043C,E01008097,1379,1233,146,53,53,30,10
2021,Sheffield 048A,E01008098,1398,1243,155,51,66,36,2
2021,Sheffield 051E,E01008099,1429,1319,110,45,37,22,6
2021,Sheffield 048B,E01008100,1258,1121,137,51,53,28,5
2021,Sheffield 043D,E01008101,1731,1515,216,83,82,42,9
2021,Sheffield 048C,E01008102,1298,1196,102,38,47,16,1
2021,Sheffield 048D,E01008103,1103,1017,86,23,38,22,3
2021,Sheffield 036E,E01008104,1365,1228,137,83,34,16,4
2021,Sheffield 040A,E01008105,2809,2420,389,127,162,81,19
2021,Sheffield 040C,E01008107,1473,1178,295,72,112,84,27
2021,Sheffield 042A,E01008108,1811,1435,376,129,161,74,12
2021,Sheffield 042B,E01008109,2849,2126,723,161,362,172,28
2021,Sheffield 040D,E01008111,1586,1493,93,36,34,19,4
2021,Sheffield 042D,E01008112,1685,1284,401,85,157,129,30
2021,Sheffield 042E,E01008113,1597,1392,205,58,79,60,8
2021,Sheffield 074A,E01008114,2633,1775,858,283,413,150,12
2021,Sheffield 074B,E01008115,1484,1275,209,103,71,28,7
2021,Sheffield 009C,E01008116,1242,1204,38,14,15,9,0
2021,Sheffield 009D,E01008117,1733,1626,107,38,41,23,5
2021,Sheffield 009E,E01008118,1340,1283,57,24,23,10,0
2021,Sheffield 009F,E01008119,1307,1235,72,33,28,10,1
2021,Sheffield 012E,E01008122,1569,1456,113,47,44,17,5
2021,Sheffield 015E,E01008123,1322,1243,79,38,24,14,3
2021,Sheffield 012F,E01008124,1393,1312,81,34,35,12,0
2021,Sheffield 009G,E01008125,1487,1442,45,20,25,0,0
2021,Sheffield 008A,E01008126,1511,1497,14,6,8,0,0
2021,Sheffield 008C,E01008128,1767,1749,18,13,5,0,0
2021,Sheffield 023A,E01008129,1594,1582,12,8,3,1,0
2021,Sheffield 023B,E01008130,1499,1471,28,19,5,4,0
2021,Sheffield 023C,E01008131,1549,1526,23,20,2,1,0
2021,Sheffield 023D,E01008132,1293,1280,13,6,3,4,0
2021,Sheffield 023E,E01008133,1477,1462,15,10,2,2,1
2021,Sheffield 005B,E01008134,1245,1235,10,9,0,1,0
2021,Sheffield 005C,E01008135,1618,1578,40,20,12,7,1
2021,Sheffield 008D,E01008136,1353,1338,15,9,4,1,1
2021,Sheffield 005D,E01008137,1325,1315,10,4,4,2,0
2021,Sheffield 006D,E01008138,1224,1188,36,13,18,5,0
2021,Sheffield 006E,E01008139,1475,1442,33,10,17,5,1
2021,Sheffield 008E,E01008140,1824,1781,43,21,13,1,8
2021,Sheffield 005E,E01008141,1486,1448,38,18,13,6,1
2021,Sheffield 002A,E01008142,1421,1402,19,8,7,2,2
2021,Sheffield 002B,E01008143,1529,1518,11,7,3,1,0
2021,Sheffield 001A,E01008144,1878,1849,29,10,15,4,0
2021,Sheffield 001B,E01008145,1347,1330,17,6,7,4,0
2021,Sheffield 002C,E01008146,1196,1193,3,2,0,1,0
2021,Sheffield 002D,E01008147,1339,1336,3,3,0,0,0
2021,Sheffield 001C,E01008148,1458,1450,8,4,4,0,0
2021,Sheffield 001D,E01008149,1384,1370,14,11,3,0,0
2021,Sheffield 001E,E01008150,1377,1370,7,6,0,0,1
2021,Sheffield 024A,E01008151,1461,1345,116,67,23,19,7
2021,Sheffield 025C,E01008152,1385,1360,25,13,6,5,1
2021,Sheffield 024B,E01008153,1571,1483,88,49,21,14,4
2021,Sheffield 024C,E01008154,1596,1534,62,39,20,3,0
2021,Sheffield 024D,E01008155,1373,1313,60,29,20,10,1
2021,Sheffield 024E,E01008156,1412,1378,34,30,1,3,0
2021,Sheffield 026D,E01008157,1580,1396,184,69,73,36,6
2021,Sheffield 025D,E01008158,1479,1453,26,17,8,1,0
2021,Sheffield 029D,E01008159,1457,1392,65,42,13,8,2
2021,Sheffield 024F,E01008160,1302,1260,42,27,11,2,2
2021,Sheffield 026E,E01008161,1628,1520,108,41,45,20,2
2021,Gateshead 027A,E01008162,2175,1854,321,131,127,58,5
2021,Gateshead 028A,E01008163,1959,1793,166,59,61,35,11
2021,Gateshead 027B,E01008164,1454,1251,203,62,77,47,17
2021,Gateshead 011A,E01008165,1433,1277,156,55,48,36,17
2021,Gateshead 027C,E01008166,1614,1423,191,94,62,25,10
2021,Gateshead 008A,E01008167,1478,1302,176,68,67,34,7
2021,Gateshead 008C,E01008170,1703,1440,263,80,94,79,10
2021,Gateshead 026A,E01008172,1691,1644,47,19,23,3,2
2021,Gateshead 026B,E01008173,1455,1389,66,19,22,17,8
2021,Gateshead 026C,E01008174,2083,2041,42,17,11,13,1
2021,Gateshead 026D,E01008175,1393,1303,90,31,31,23,5
2021,Gateshead 026E,E01008176,1439,1411,28,12,11,3,2
2021,Gateshead 005A,E01008177,1245,1230,15,11,3,1,0
2021,Gateshead 004A,E01008178,1523,1487,36,14,17,5,0
2021,Gateshead 005B,E01008179,1119,1103,16,5,4,7,0
2021,Gateshead 004B,E01008180,1307,1274,33,12,14,6,1
2021,Gateshead 005C,E01008181,1505,1482,23,6,12,3,2
2021,Gateshead 004C,E01008182,1650,1628,22,7,7,8,0
2021,Gateshead 029B,E01008183,1405,1365,40,21,9,5,5
2021,Gateshead 022A,E01008184,1313,1308,5,2,0,3,0
2021,Gateshead 022B,E01008185,1353,1293,60,22,21,10,7
2021,Gateshead 029C,E01008186,1718,1692,26,9,13,2,2
2021,Gateshead 022C,E01008188,1300,1286,14,7,5,2,0
2021,Gateshead 023A,E01008189,1183,1137,46,18,17,10,1
2021,Gateshead 023B,E01008190,1321,1295,26,6,16,4,0
2021,Gateshead 023C,E01008191,1349,1311,38,15,15,8,0
2021,Gateshead 023D,E01008192,1341,1315,26,7,14,4,1
2021,Gateshead 020A,E01008193,1257,1243,14,8,3,3,0
2021,Gateshead 020B,E01008194,1328,1314,14,4,4,5,1
2021,Gateshead 002A,E01008195,1930,1913,17,8,6,3,0
2021,Gateshead 029A,E01008196,2058,2044,14,10,4,0,0
2021,Gateshead 002B,E01008197,1648,1640,8,4,3,1,0
2021,Gateshead 002C,E01008198,1577,1567,10,1,9,0,0
2021,Gateshead 002D,E01008199,1276,1263,13,8,4,1,0
2021,Gateshead 002E,E01008200,1331,1324,7,6,1,0,0
2021,Gateshead 011B,E01008201,1548,1416,132,33,64,30,5
2021,Gateshead 011C,E01008202,1631,1551,80,32,27,17,4
2021,Gateshead 028B,E01008203,1543,1365,178,69,62,44,3
2021,Gateshead 011D,E01008204,1453,1358,95,44,27,17,7
2021,Gateshead 028C,E01008205,1430,1394,36,14,18,4,0
2021,Gateshead 013A,E01008206,1587,1542,45,26,12,7,0
2021,Gateshead 013B,E01008207,1292,1277,15,7,7,1,0
2021,Gateshead 013C,E01008208,1563,1521,42,13,22,6,1
2021,Gateshead 007A,E01008209,1864,1761,103,49,37,16,1
2021,Gateshead 007B,E01008210,1340,1277,63,24,19,16,4
2021,Gateshead 013D,E01008211,1596,1552,44,16,16,7,5
2021,Gateshead 012A,E01008212,1220,1119,101,41,30,20,10
2021,Gateshead 012B,E01008213,1444,1406,38,22,11,5,0
2021,Gateshead 003A,E01008214,1693,1424,269,96,110,56,7
2021,Gateshead 003B,E01008215,1489,1371,118,48,36,28,6
2021,Gateshead 012C,E01008216,1341,1300,41,17,9,15,0
2021,Gateshead 023E,E01008217,1415,1395,20,9,9,2,0
2021,Gateshead 021A,E01008218,1494,1434,60,22,21,9,8
2021,Gateshead 016A,E01008219,1586,1519,67,31,19,11,6
2021,Gateshead 021B,E01008220,1184,1100,84,24,32,20,8
2021,Gateshead 021C,E01008221,1769,1679,90,36,31,17,6
2021,Gateshead 025A,E01008222,1569,1516,53,26,16,11,0
2021,Gateshead 025B,E01008223,1772,1641,131,34,54,32,11
2021,Gateshead 025C,E01008224,2563,2508,55,34,14,5,2
2021,Gateshead 021D,E01008225,1515,1506,9,5,1,3,0
2021,Gateshead 025D,E01008226,1735,1694,41,18,11,9,3
2021,Gateshead 021E,E01008227,1643,1429,214,61,93,46,14
2021,Gateshead 012D,E01008228,1095,1069,26,17,6,3,0
2021,Gateshead 018A,E01008229,1221,1215,6,3,3,0,0
2021,Gateshead 018B,E01008230,1324,1264,60,31,17,10,2
2021,Gateshead 015A,E01008231,1456,1427,29,16,5,4,4
2021,Gateshead 018C,E01008232,1310,1268,42,17,13,11,1
2021,Gateshead 018D,E01008233,1187,1183,4,2,2,0,0
2021,Gateshead 020C,E01008234,2013,1986,27,10,5,9,3
2021,Gateshead 016B,E01008235,1311,1289,22,7,8,7,0
2021,Gateshead 016C,E01008236,1395,1353,42,20,14,7,1
2021,Gateshead 016D,E01008237,1509,1490,19,8,8,3,0
2021,Gateshead 016E,E01008238,1403,1385,18,7,5,2,4
2021,Gateshead 020D,E01008239,1489,1462,27,18,4,4,1
2021,Gateshead 015B,E01008240,1454,1429,25,11,6,7,1
2021,Gateshead 015C,E01008241,1529,1508,21,12,6,2,1
2021,Gateshead 015D,E01008242,1576,1537,39,15,14,9,1
2021,Gateshead 003C,E01008243,1479,1456,23,13,9,1,0
2021,Gateshead 003D,E01008244,1793,1731,62,21,32,7,2
2021,Gateshead 002F,E01008245,1297,1285,12,7,4,0,1
2021,Gateshead 001A,E01008246,1342,1327,15,8,6,0,1
2021,Gateshead 001B,E01008247,1507,1493,14,10,4,0,0
2021,Gateshead 001C,E01008248,2575,2531,44,23,9,7,5
2021,Gateshead 001D,E01008249,1464,1447,17,10,4,3,0
2021,Gateshead 001E,E01008250,1390,1364,26,13,7,5,1
2021,Gateshead 010A,E01008251,1669,1457,212,60,80,60,12
2021,Gateshead 010B,E01008252,1586,1375,211,79,74,51,7
2021,Gateshead 010C,E01008253,1399,1142,257,90,103,55,9
2021,Gateshead 010D,E01008254,1426,1212,214,77,81,46,10
2021,Gateshead 010E,E01008255,2049,1951,98,54,28,12,4
2021,Gateshead 019A,E01008256,1583,1543,40,19,9,10,2
2021,Gateshead 008E,E01008257,1419,1336,83,21,36,23,3
2021,Gateshead 007C,E01008258,2224,1966,258,137,90,25,6
2021,Gateshead 007D,E01008259,1945,1661,284,91,102,73,18
2021,Gateshead 019B,E01008260,1461,1413,48,13,22,8,5
2021,Gateshead 019C,E01008261,1330,1273,57,30,19,8,0
2021,Gateshead 009A,E01008262,1522,1448,74,36,27,10,1
2021,Gateshead 009B,E01008263,1346,1320,26,15,9,2,0
2021,Gateshead 009C,E01008264,1401,1384,17,9,7,1,0
2021,Gateshead 009D,E01008265,1296,1269,27,15,8,4,0
2021,Gateshead 009E,E01008266,1275,1268,7,1,1,4,1
2021,Gateshead 017A,E01008267,1468,1458,10,5,2,0,3
2021,Gateshead 019D,E01008268,1348,1337,11,10,1,0,0
2021,Gateshead 017B,E01008269,1427,1409,18,12,2,3,1
2021,Gateshead 017C,E01008270,1252,1236,16,11,4,1,0
2021,Gateshead 017D,E01008271,1306,1298,8,7,0,1,0
2021,Gateshead 019E,E01008272,1553,1534,19,10,7,2,0
2021,Gateshead 019F,E01008273,1363,1356,7,6,0,0,1
2021,Gateshead 019G,E01008274,1307,1295,12,4,4,1,3
2021,Gateshead 017E,E01008275,1372,1354,18,9,9,0,0
2021,Gateshead 005D,E01008276,1365,1350,15,8,3,2,2
2021,Gateshead 004D,E01008277,1491,1471,20,10,6,2,2
2021,Gateshead 022D,E01008278,1474,1469,5,5,0,0,0
2021,Gateshead 005E,E01008279,1337,1326,11,5,3,2,1
2021,Gateshead 004E,E01008280,1792,1772,20,11,7,2,0
2021,Gateshead 015E,E01008281,1521,1490,31,15,9,6,1
2021,Gateshead 015F,E01008282,1345,1287,58,6,20,23,9
2021,Gateshead 014A,E01008283,1195,1175,20,9,5,6,0
2021,Gateshead 014B,E01008284,1316,1296,20,13,5,2,0
2021,Gateshead 018E,E01008285,1326,1273,53,21,19,13,0
2021,Gateshead 014C,E01008286,1310,1284,26,13,12,0,1
2021,Gateshead 014D,E01008287,1832,1796,36,19,11,4,2
2021,Newcastle upon Tyne 027A,E01008288,1320,1211,109,55,34,19,1
2021,Newcastle upon Tyne 027B,E01008289,1674,1515,159,54,63,36,6
2021,Newcastle upon Tyne 027C,E01008290,1620,1330,290,120,84,71,15
2021,Newcastle upon Tyne 027D,E01008291,1974,1409,565,196,207,140,22
2021,Newcastle upon Tyne 027E,E01008292,1257,1226,31,17,9,5,0
2021,Newcastle upon Tyne 004A,E01008293,1341,1215,126,45,37,32,12
2021,Newcastle upon Tyne 033D,E01008294,1336,1263,73,29,30,12,2
2021,Newcastle upon Tyne 008A,E01008295,1733,1545,188,69,70,44,5
2021,Newcastle upon Tyne 011A,E01008296,1291,1275,16,7,6,2,1
2021,Newcastle upon Tyne 011B,E01008297,1868,1695,173,66,82,22,3
2021,Newcastle upon Tyne 011C,E01008298,1836,1720,116,53,38,22,3
2021,Newcastle upon Tyne 011D,E01008299,1348,1275,73,36,26,11,0
2021,Newcastle upon Tyne 016A,E01008300,1962,1736,226,100,84,33,9
2021,Newcastle upon Tyne 040D,E01008301,1582,1431,151,71,47,31,2
2021,Newcastle upon Tyne 035D,E01008302,1569,1370,199,76,86,33,4
2021,Newcastle upon Tyne 018A,E01008303,1721,1459,262,109,103,44,6
2021,Newcastle upon Tyne 040C,E01008305,2336,1897,439,135,197,92,15
2021,Newcastle upon Tyne 032A,E01008306,2275,2242,33,18,9,4,2
2021,Newcastle upon Tyne 032B,E01008307,1306,1285,21,10,6,5,0
2021,Newcastle upon Tyne 002A,E01008309,1732,1691,41,26,9,6,0
2021,Newcastle upon Tyne 033A,E01008311,2161,2032,129,72,42,14,1
2021,Newcastle upon Tyne 033B,E01008312,1126,1040,86,56,23,5,2
2021,Newcastle upon Tyne 033C,E01008313,1169,1108,61,30,22,8,1
2021,Newcastle upon Tyne 012A,E01008314,1044,995,49,31,15,2,1
2021,Newcastle upon Tyne 012B,E01008315,1471,1388,83,47,23,11,2
2021,Newcastle upon Tyne 012C,E01008316,1461,1398,63,34,18,9,2
2021,Newcastle upon Tyne 007A,E01008317,1367,1303,64,31,22,5,6
2021,Newcastle upon Tyne 012D,E01008318,1282,1181,101,32,39,26,4
2021,Newcastle upon Tyne 007B,E01008319,1748,1592,156,65,42,43,6
2021,Newcastle upon Tyne 007C,E01008320,1538,1429,109,76,21,10,2
2021,Newcastle upon Tyne 007D,E01008321,1663,1492,171,121,32,14,4
2021,Newcastle upon Tyne 007E,E01008322,1473,1378,95,46,33,14,2
2021,Newcastle upon Tyne 007F,E01008323,1591,1427,164,100,46,13,5
2021,Newcastle upon Tyne 015A,E01008324,1225,1190,35,11,14,10,0
2021,Newcastle upon Tyne 015B,E01008325,1439,1280,159,62,71,25,1
2021,Newcastle upon Tyne 015C,E01008326,1347,1340,7,1,0,5,1
2021,Newcastle upon Tyne 015D,E01008327,1199,1127,72,31,29,11,1
2021,Newcastle upon Tyne 015E,E01008328,1181,1173,8,6,1,1,0
2021,Newcastle upon Tyne 015F,E01008329,1413,1378,35,20,9,5,1
2021,Newcastle upon Tyne 015G,E01008330,1349,1311,38,20,11,6,1
2021,Newcastle upon Tyne 041A,E01008331,1811,1136,675,217,251,163,44
2021,Newcastle upon Tyne 038E,E01008333,1876,1428,448,134,180,109,25
2021,Newcastle upon Tyne 038A,E01008334,2185,1407,778,266,315,167,30
2021,Newcastle upon Tyne 038D,E01008335,2053,1274,779,266,273,208,32
2021,Newcastle upon Tyne 003A,E01008336,1304,1225,79,37,25,13,4
2021,Newcastle upon Tyne 003B,E01008337,1272,1193,79,31,32,12,4
2021,Newcastle upon Tyne 003C,E01008338,1104,1007,97,42,38,15,2
2021,Newcastle upon Tyne 003D,E01008339,1789,1622,167,76,48,40,3
2021,Newcastle upon Tyne 003E,E01008340,1692,1419,273,104,117,47,5
2021,Newcastle upon Tyne 003F,E01008341,1378,1313,65,26,23,16,0
2021,Newcastle upon Tyne 003G,E01008342,1303,1247,56,36,14,6,0
2021,Newcastle upon Tyne 019A,E01008343,1595,1457,138,75,45,13,5
2021,Newcastle upon Tyne 019B,E01008344,1457,1380,77,26,26,19,6
2021,Newcastle upon Tyne 019C,E01008345,1508,1412,96,35,34,22,5
2021,Newcastle upon Tyne 019D,E01008346,1014,867,147,68,48,30,1
2021,Newcastle upon Tyne 019E,E01008347,1443,1258,185,82,51,47,5
2021,Newcastle upon Tyne 019F,E01008348,1160,960,200,71,78,45,6
2021,Newcastle upon Tyne 019G,E01008349,1659,1151,508,184,196,111,17
2021,Newcastle upon Tyne 019H,E01008350,1576,1451,125,52,40,30,3
2021,Newcastle upon Tyne 005A,E01008351,1337,1272,65,40,13,10,2
2021,Newcastle upon Tyne 002C,E01008352,1412,1280,132,64,47,19,2
2021,Newcastle upon Tyne 006A,E01008353,1482,1367,115,68,30,15,2
2021,Newcastle upon Tyne 005B,E01008354,1566,1477,89,54,24,11,0
2021,Newcastle upon Tyne 006B,E01008355,1489,1417,72,53,13,5,1
2021,Newcastle upon Tyne 006C,E01008356,1284,1190,94,47,28,17,2
2021,Newcastle upon Tyne 002D,E01008357,1486,1407,79,39,23,15,2
2021,Newcastle upon Tyne 002E,E01008358,1667,1504,163,90,53,19,1
2021,Newcastle upon Tyne 018B,E01008359,1381,1221,160,105,38,15,2
2021,Newcastle upon Tyne 018C,E01008360,1488,1343,145,102,32,11,0
2021,Newcastle upon Tyne 018D,E01008361,1456,1283,173,88,62,22,1
2021,Newcastle upon Tyne 018E,E01008362,1510,1368,142,101,30,11,0
2021,Newcastle upon Tyne 012E,E01008363,1554,1486,68,40,18,9,1
2021,Newcastle upon Tyne 018F,E01008364,1434,1336,98,57,30,9,2
2021,Newcastle upon Tyne 012F,E01008365,1539,1459,80,44,19,15,2
2021,Newcastle upon Tyne 013A,E01008366,2096,2015,81,49,17,12,3
2021,Newcastle upon Tyne 017A,E01008367,2128,2050,78,56,18,4,0
2021,Newcastle upon Tyne 017B,E01008368,1720,1676,44,29,13,2,0
2021,Newcastle upon Tyne 013B,E01008369,1988,1923,65,43,14,4,4
2021,Newcastle upon Tyne 017C,E01008370,1842,1749,93,62,25,4,2
2021,Newcastle upon Tyne 013C,E01008371,1388,1311,77,49,19,8,1
2021,Newcastle upon Tyne 013D,E01008372,1793,1734,59,42,12,4,1
2021,Newcastle upon Tyne 013E,E01008373,2160,2106,54,33,14,6,1
2021,Newcastle upon Tyne 008B,E01008374,1458,1395,63,37,17,8,1
2021,Newcastle upon Tyne 008C,E01008375,1417,1349,68,33,22,13,0
2021,Newcastle upon Tyne 008D,E01008376,1121,1051,70,43,15,10,2
2021,Newcastle upon Tyne 008E,E01008377,2223,1941,282,128,89,56,9
2021,Newcastle upon Tyne 006D,E01008378,1364,1274,90,48,26,16,0
2021,Newcastle upon Tyne 008F,E01008379,1643,1554,89,36,38,14,1
2021,Newcastle upon Tyne 008G,E01008380,1776,1382,394,138,163,81,12
2021,Newcastle upon Tyne 021A,E01008381,1405,1396,9,4,2,3,0
2021,Newcastle upon Tyne 021B,E01008382,1235,1212,23,8,5,6,4
2021,Newcastle upon Tyne 021C,E01008383,1415,1393,22,14,7,1,0
2021,Newcastle upon Tyne 021D,E01008384,1318,1293,25,10,8,6,1
2021,Newcastle upon Tyne 021E,E01008385,1322,1264,58,21,24,10,3
2021,Newcastle upon Tyne 021F,E01008386,1252,1232,20,10,7,2,1
2021,Newcastle upon Tyne 021G,E01008387,1224,1199,25,14,11,0,0
2021,Newcastle upon Tyne 028A,E01008388,1733,1526,207,85,59,57,6
2021,Newcastle upon Tyne 028B,E01008389,1605,1479,126,43,46,33,4
2021,Newcastle upon Tyne 030A,E01008390,1876,1611,265,107,92,51,15
2021,Newcastle upon Tyne 035C,E01008391,1547,1486,61,21,29,11,0
2021,Newcastle upon Tyne 035A,E01008392,1754,1561,193,52,79,52,10
2021,Newcastle upon Tyne 022B,E01008396,2235,1560,675,227,239,161,48
2021,Newcastle upon Tyne 036B,E01008397,2789,1872,917,364,467,81,5
2021,Newcastle upon Tyne 022C,E01008398,1712,1040,672,186,277,174,35
2021,Newcastle upon Tyne 039A,E01008399,1974,1403,571,219,197,141,14
2021,Newcastle upon Tyne 014A,E01008400,1680,1613,67,28,19,14,6
2021,Newcastle upon Tyne 014B,E01008401,1464,1448,16,6,4,4,2
2021,Newcastle upon Tyne 014C,E01008402,1390,1379,11,3,5,3,0
2021,Newcastle upon Tyne 014D,E01008403,1535,1506,29,16,10,2,1
2021,Newcastle upon Tyne 014E,E01008404,1505,1469,36,19,8,9,0
2021,Newcastle upon Tyne 014F,E01008405,1453,1414,39,22,9,7,1
2021,Newcastle upon Tyne 037A,E01008406,3942,3333,609,335,201,65,8
2021,Newcastle upon Tyne 034D,E01008407,3240,2875,365,216,96,43,10
2021,Newcastle upon Tyne 017D,E01008409,1503,1418,85,59,19,6,1
2021,Newcastle upon Tyne 034B,E01008410,2498,2359,139,78,54,7,0
2021,Newcastle upon Tyne 017E,E01008411,1689,1527,162,109,20,26,7
2021,Newcastle upon Tyne 034A,E01008412,1481,1382,99,71,20,7,1
2021,Newcastle upon Tyne 034C,E01008413,1338,1239,99,48,39,12,0
2021,Newcastle upon Tyne 025B,E01008415,1234,1118,116,41,48,18,9
2021,Newcastle upon Tyne 025C,E01008416,1672,1606,66,37,18,11,0
2021,Newcastle upon Tyne 005C,E01008418,1899,1775,124,86,30,8,0
2021,Newcastle upon Tyne 006E,E01008419,1390,1335,55,40,14,1,0
2021,Newcastle upon Tyne 005D,E01008420,1264,1231,33,22,9,2,0
2021,Newcastle upon Tyne 006F,E01008421,1470,1421,49,37,9,3,0
2021,Newcastle upon Tyne 005E,E01008422,1501,1433,68,47,13,8,0
2021,Newcastle upon Tyne 006G,E01008423,1274,1243,31,19,8,3,1
2021,Newcastle upon Tyne 005F,E01008424,1441,1311,130,78,35,16,1
2021,Newcastle upon Tyne 030B,E01008425,1361,1283,78,20,32,25,1
2021,Newcastle upon Tyne 028C,E01008426,1545,1455,90,27,36,25,2
2021,Newcastle upon Tyne 030C,E01008427,1281,1135,146,36,53,54,3
2021,Newcastle upon Tyne 030D,E01008428,1435,1320,115,27,55,27,6
2021,Newcastle upon Tyne 028D,E01008429,1501,1400,101,38,36,26,1
2021,Newcastle upon Tyne 020A,E01008430,1230,1178,52,15,29,8,0
2021,Newcastle upon Tyne 020B,E01008431,1475,1435,40,13,23,4,0
2021,Newcastle upon Tyne 035B,E01008432,1390,1329,61,28,22,7,4
2021,Newcastle upon Tyne 020C,E01008433,1337,1285,52,22,24,5,1
2021,Newcastle upon Tyne 020D,E01008434,1387,1355,32,6,17,9,0
2021,Newcastle upon Tyne 020E,E01008435,1528,1453,75,32,25,15,3
2021,Newcastle upon Tyne 020F,E01008436,1517,1314,203,98,56,42,7
2021,Newcastle upon Tyne 041C,E01008437,1659,1369,290,98,130,53,9
2021,Newcastle upon Tyne 041B,E01008438,1859,1445,414,135,165,93,21
2021,Newcastle upon Tyne 039D,E01008439,1681,1239,442,146,171,110,15
2021,Newcastle upon Tyne 031A,E01008441,1723,1669,54,33,12,9,0
2021,Newcastle upon Tyne 031B,E01008442,1286,1269,17,8,4,5,0
2021,Newcastle upon Tyne 014G,E01008443,1355,1335,20,12,8,0,0
2021,Newcastle upon Tyne 031C,E01008444,1557,1529,28,8,10,6,4
2021,Newcastle upon Tyne 031D,E01008445,2041,2000,41,22,10,7,2
2021,Newcastle upon Tyne 031E,E01008446,1328,1311,17,6,10,1,0
2021,Newcastle upon Tyne 031F,E01008447,1280,1265,15,4,4,5,2
2021,Newcastle upon Tyne 031G,E01008448,1346,1339,7,6,0,1,0
2021,Newcastle upon Tyne 022D,E01008449,1783,1114,669,285,275,91,18
2021,Newcastle upon Tyne 016B,E01008450,1691,1435,256,116,95,42,3
2021,Newcastle upon Tyne 016C,E01008451,1805,1516,289,130,94,46,19
2021,Newcastle upon Tyne 016D,E01008452,1416,1276,140,52,49,32,7
2021,Newcastle upon Tyne 022E,E01008453,1801,1542,259,86,114,48,11
2021,Newcastle upon Tyne 022G,E01008455,1654,1122,532,183,204,119,26
2021,Newcastle upon Tyne 004B,E01008456,1470,1414,56,20,20,14,2
2021,Newcastle upon Tyne 004C,E01008457,1531,1455,76,26,23,17,10
2021,Newcastle upon Tyne 004D,E01008458,2059,1975,84,59,18,5,2
2021,Newcastle upon Tyne 004E,E01008459,1789,1681,108,43,39,20,6
2021,Newcastle upon Tyne 004F,E01008460,1362,1336,26,7,10,7,2
2021,North Tyneside 021A,E01008461,1359,1342,17,4,11,2,0
2021,North Tyneside 024A,E01008462,1504,1478,26,15,8,2,1
2021,North Tyneside 024B,E01008463,1253,1225,28,18,8,1,1
2021,North Tyneside 024C,E01008464,1268,1258,10,4,3,3,0
2021,North Tyneside 024D,E01008465,1346,1337,9,3,5,1,0
2021,North Tyneside 021B,E01008466,1341,1336,5,3,0,2,0
2021,North Tyneside 021C,E01008467,1318,1295,23,9,8,6,0
2021,North Tyneside 021D,E01008468,1416,1392,24,5,12,5,2
2021,North Tyneside 018A,E01008469,1785,1717,68,49,15,4,0
2021,North Tyneside 014A,E01008470,1394,1368,26,17,5,3,1
2021,North Tyneside 019A,E01008471,1506,1452,54,33,14,4,3
2021,North Tyneside 018B,E01008472,1401,1387,14,4,5,3,2
2021,North Tyneside 018C,E01008473,1229,1200,29,18,7,1,3
2021,North Tyneside 019B,E01008474,1493,1429,64,41,13,6,4
2021,North Tyneside 008A,E01008475,1550,1521,29,13,9,4,3
2021,North Tyneside 008B,E01008476,1717,1704,13,4,2,4,3
2021,North Tyneside 008C,E01008477,1731,1708,23,18,3,1,1
2021,North Tyneside 002A,E01008478,1432,1414,18,7,3,6,2
2021,North Tyneside 008D,E01008479,1484,1455,29,19,4,5,1
2021,North Tyneside 002B,E01008480,1462,1448,14,7,3,4,0
2021,North Tyneside 023A,E01008481,1384,1360,24,8,8,4,4
2021,North Tyneside 023B,E01008482,1601,1524,77,25,28,20,4
2021,North Tyneside 022A,E01008483,1409,1339,70,24,20,20,6
2021,North Tyneside 023C,E01008484,1385,1334,51,17,19,13,2
2021,North Tyneside 023D,E01008485,1401,1336,65,30,23,11,1
2021,North Tyneside 020A,E01008486,1334,1309,25,5,8,12,0
2021,North Tyneside 020B,E01008487,1432,1403,29,19,9,1,0
2021,North Tyneside 015A,E01008488,1402,1372,30,17,7,5,1
2021,North Tyneside 015B,E01008489,1803,1721,82,34,34,11,3
2021,North Tyneside 015C,E01008490,1506,1475,31,21,5,5,0
2021,North Tyneside 015D,E01008491,1494,1449,45,24,10,10,1
2021,North Tyneside 023E,E01008492,1659,1613,46,17,11,17,1
2021,North Tyneside 013A,E01008493,1459,1451,8,6,2,0,0
2021,North Tyneside 013B,E01008494,1569,1546,23,9,8,5,1
2021,North Tyneside 010A,E01008495,1705,1686,19,12,4,3,0
2021,North Tyneside 010B,E01008496,1451,1423,28,13,6,6,3
2021,North Tyneside 010C,E01008497,1421,1407,14,12,2,0,0
2021,North Tyneside 010D,E01008498,1486,1481,5,2,3,0,0
2021,North Tyneside 014B,E01008499,1604,1580,24,13,1,6,4
2021,North Tyneside 012A,E01008500,1483,1449,34,17,7,9,1
2021,North Tyneside 014C,E01008502,1502,1465,37,25,8,4,0
2021,North Tyneside 018E,E01008503,1924,1884,40,20,16,4,0
2021,North Tyneside 002C,E01008504,1477,1459,18,7,5,5,1
2021,North Tyneside 012B,E01008505,1718,1686,32,18,10,3,1
2021,North Tyneside 012C,E01008506,1331,1314,17,7,3,5,2
2021,North Tyneside 012D,E01008507,1644,1616,28,18,5,5,0
2021,North Tyneside 026A,E01008508,1528,1511,17,5,11,1,0
2021,North Tyneside 026B,E01008509,1627,1607,20,10,8,1,1
2021,North Tyneside 026C,E01008510,1478,1460,18,10,8,0,0
2021,North Tyneside 028A,E01008511,1597,1556,41,21,10,10,0
2021,North Tyneside 026D,E01008512,1564,1523,41,17,16,6,2
2021,North Tyneside 019C,E01008513,2136,1988,148,90,42,14,2
2021,North Tyneside 019D,E01008514,1765,1696,69,37,15,14,3
2021,North Tyneside 014D,E01008516,1935,1882,53,33,14,6,0
2021,North Tyneside 005A,E01008517,1539,1526,13,11,1,0,1
2021,North Tyneside 007A,E01008518,1527,1510,17,5,7,5,0
2021,North Tyneside 005B,E01008519,1196,1179,17,3,11,3,0
2021,North Tyneside 003A,E01008520,1369,1347,22,16,3,3,0
2021,North Tyneside 005C,E01008521,1403,1391,12,5,5,0,2
2021,North Tyneside 005D,E01008522,1503,1492,11,4,6,0,1
2021,North Tyneside 003B,E01008523,1276,1262,14,8,3,3,0
2021,North Tyneside 022B,E01008524,1809,1718,91,35,30,20,6
2021,North Tyneside 017A,E01008525,1469,1456,13,10,2,1,0
2021,North Tyneside 020C,E01008526,1410,1398,12,10,1,0,1
2021,North Tyneside 017B,E01008527,1348,1336,12,9,1,2,0
2021,North Tyneside 022C,E01008528,1299,1282,17,13,2,0,2
2021,North Tyneside 022D,E01008529,1463,1442,21,12,5,3,1
2021,North Tyneside 020D,E01008530,1498,1464,34,9,13,11,1
2021,North Tyneside 025A,E01008531,1288,1249,39,4,11,22,2
2021,North Tyneside 025B,E01008532,1602,1561,41,13,11,16,1
2021,North Tyneside 030A,E01008533,1439,1411,28,9,10,6,3
2021,North Tyneside 025C,E01008534,1211,1166,45,8,17,14,6
2021,North Tyneside 030B,E01008535,1424,1397,27,9,8,7,3
2021,North Tyneside 030C,E01008536,1384,1306,78,32,24,18,4
2021,North Tyneside 030D,E01008537,1126,1097,29,11,12,6,0
2021,North Tyneside 025D,E01008538,2397,2337,60,35,15,9,1
2021,North Tyneside 027A,E01008539,1515,1484,31,16,11,4,0
2021,North Tyneside 027B,E01008540,1649,1491,158,54,59,38,7
2021,North Tyneside 027C,E01008541,1444,1416,28,10,14,4,0
2021,North Tyneside 028B,E01008542,1598,1535,63,20,13,26,4
2021,North Tyneside 028C,E01008543,2435,2339,96,41,37,15,3
2021,North Tyneside 027D,E01008544,1486,1406,80,32,41,7,0
2021,North Tyneside 027E,E01008545,1215,1184,31,16,8,7,0
2021,North Tyneside 003C,E01008546,1553,1531,22,14,6,2,0
2021,North Tyneside 001A,E01008547,1375,1346,29,17,9,3,0
2021,North Tyneside 001B,E01008548,1750,1735,15,5,6,4,0
2021,North Tyneside 001C,E01008549,1509,1486,23,13,4,2,4
2021,North Tyneside 003D,E01008550,1560,1537,23,14,8,1,0
2021,North Tyneside 001D,E01008551,1408,1396,12,10,1,1,0
2021,North Tyneside 009A,E01008552,1544,1517,27,8,15,3,1
2021,North Tyneside 009B,E01008553,1689,1668,21,8,8,5,0
2021,North Tyneside 009C,E01008554,1613,1568,45,22,11,11,1
2021,North Tyneside 009D,E01008555,1656,1635,21,11,5,3,2
2021,North Tyneside 013C,E01008556,1988,1952,36,26,3,7,0
2021,North Tyneside 013D,E01008557,1592,1561,31,14,10,6,1
2021,North Tyneside 016A,E01008558,1431,1403,28,18,7,2,1
2021,North Tyneside 017C,E01008559,1448,1415,33,20,5,7,1
2021,North Tyneside 016B,E01008560,1561,1520,41,27,10,4,0
2021,North Tyneside 016C,E01008561,1594,1549,45,21,12,7,5
2021,North Tyneside 016D,E01008562,1436,1423,13,11,2,0,0
2021,North Tyneside 017D,E01008563,1372,1363,9,8,1,0,0
2021,North Tyneside 007B,E01008564,1396,1390,6,3,2,1,0
2021,North Tyneside 007D,E01008567,1440,1416,24,15,6,1,2
2021,North Tyneside 011B,E01008568,1444,1421,23,13,6,2,2
2021,North Tyneside 011C,E01008569,1413,1393,20,6,7,7,0
2021,North Tyneside 011D,E01008570,1242,1217,25,13,7,5,0
2021,North Tyneside 028D,E01008571,1742,1675,67,20,32,15,0
2021,North Tyneside 029A,E01008572,1539,1376,163,51,67,43,2
2021,North Tyneside 029B,E01008573,1559,1375,184,52,71,44,17
2021,North Tyneside 029C,E01008574,1888,1869,19,7,4,6,2
2021,North Tyneside 030E,E01008575,1286,1222,64,21,17,23,3
2021,North Tyneside 029D,E01008576,1988,1910,78,38,23,15,2
2021,North Tyneside 004A,E01008577,1826,1794,32,21,9,1,1
2021,North Tyneside 002D,E01008578,1290,1282,8,6,2,0,0
2021,North Tyneside 004B,E01008579,1349,1340,9,6,1,2,0
2021,North Tyneside 004C,E01008580,1254,1239,15,11,1,2,1
2021,North Tyneside 004D,E01008581,1765,1742,23,18,2,3,0
2021,North Tyneside 004E,E01008582,1306,1280,26,11,12,3,0
2021,North Tyneside 002E,E01008583,1403,1372,31,17,8,5,1
2021,North Tyneside 006A,E01008584,1565,1507,58,26,13,14,5
2021,North Tyneside 006B,E01008585,1485,1441,44,21,11,9,3
2021,North Tyneside 009E,E01008586,1469,1441,28,16,6,3,3
2021,North Tyneside 006C,E01008587,1347,1326,21,13,3,5,0
2021,North Tyneside 006D,E01008588,1553,1508,45,23,4,15,3
2021,North Tyneside 006E,E01008589,1410,1400,10,7,3,0,0
2021,South Tyneside 011A,E01008590,1355,1318,37,15,17,5,0
2021,South Tyneside 011B,E01008591,1190,1128,62,30,19,11,2
2021,South Tyneside 011C,E01008592,1172,1128,44,23,13,8,0
2021,South Tyneside 016A,E01008593,1292,1245,47,22,20,5,0
2021,South Tyneside 011D,E01008594,1726,1704,22,10,6,6,0
2021,South Tyneside 001A,E01008595,1366,1322,44,19,13,12,0
2021,South Tyneside 001B,E01008596,1377,1085,292,64,101,108,19
2021,South Tyneside 001C,E01008597,2292,2230,62,27,21,12,2
2021,South Tyneside 001D,E01008598,1427,1288,139,33,58,41,7
2021,South Tyneside 001E,E01008599,1405,1292,113,31,40,41,1
2021,South Tyneside 007A,E01008600,1180,1136,44,18,11,11,4
2021,South Tyneside 012A,E01008601,1496,1476,20,7,11,2,0
2021,South Tyneside 014A,E01008602,1375,1358,17,10,3,4,0
2021,South Tyneside 014B,E01008603,1294,1273,21,12,2,6,1
2021,South Tyneside 007B,E01008604,1552,1510,42,17,17,8,0
2021,South Tyneside 016B,E01008605,1083,1067,16,10,2,3,1
2021,South Tyneside 016C,E01008606,1660,1628,32,13,14,4,1
2021,South Tyneside 016D,E01008607,1387,1353,34,18,8,7,1
2021,South Tyneside 014C,E01008608,1091,1079,12,3,8,0,1
2021,South Tyneside 016E,E01008609,1434,1412,22,13,7,1,1
2021,South Tyneside 021A,E01008610,1429,1406,23,17,5,1,0
2021,South Tyneside 021B,E01008611,1320,1286,34,13,10,10,1
2021,South Tyneside 021C,E01008612,1417,1405,12,3,7,2,0
2021,South Tyneside 021D,E01008613,1438,1409,29,7,16,6,0
2021,South Tyneside 023A,E01008614,1630,1612,18,10,7,0,1
2021,South Tyneside 023B,E01008615,1351,1343,8,5,3,0,0
2021,South Tyneside 022A,E01008616,1428,1415,13,5,6,2,0
2021,South Tyneside 023C,E01008617,1354,1344,10,5,1,4,0
2021,South Tyneside 022B,E01008618,1275,1241,34,23,9,1,1
2021,South Tyneside 022C,E01008619,1548,1526,22,13,6,3,0
2021,South Tyneside 023D,E01008620,1406,1396,10,4,5,1,0
2021,South Tyneside 022D,E01008621,1398,1367,31,21,8,2,0
2021,South Tyneside 013A,E01008622,1638,1618,20,12,4,2,2
2021,South Tyneside 018A,E01008624,1279,1277,2,1,0,0,1
2021,South Tyneside 013C,E01008625,1325,1317,8,3,3,0,2
2021,South Tyneside 020A,E01008627,1175,1157,18,10,6,1,1
2021,South Tyneside 020B,E01008628,1339,1309,30,10,13,6,1
2021,South Tyneside 020C,E01008629,1320,1318,2,2,0,0,0
2021,South Tyneside 020D,E01008630,1386,1361,25,9,9,4,3
2021,South Tyneside 017A,E01008631,1301,1289,12,5,5,2,0
2021,South Tyneside 017B,E01008632,1192,1175,17,9,6,2,0
2021,South Tyneside 008A,E01008633,1376,1369,7,3,1,3,0
2021,South Tyneside 008B,E01008634,1191,1172,19,8,4,7,0
2021,South Tyneside 006A,E01008635,1320,1300,20,4,11,5,0
2021,South Tyneside 008C,E01008636,1351,1345,6,4,1,1,0
2021,South Tyneside 008D,E01008637,1369,1366,3,1,1,1,0
2021,South Tyneside 010A,E01008638,1210,1186,24,11,7,6,0
2021,South Tyneside 009A,E01008639,2302,2253,49,23,18,6,2
2021,South Tyneside 010B,E01008640,2540,2475,65,33,16,12,4
2021,South Tyneside 010C,E01008641,1010,980,30,11,12,7,0
2021,South Tyneside 010D,E01008642,1769,1753,16,9,3,2,2
2021,South Tyneside 015A,E01008643,1670,1657,13,5,6,2,0
2021,South Tyneside 015B,E01008644,1505,1477,28,6,15,4,3
2021,South Tyneside 015C,E01008645,2566,2536,30,15,9,4,2
2021,South Tyneside 015D,E01008646,1284,1275,9,5,2,2,0
2021,South Tyneside 004A,E01008647,1413,1407,6,3,2,1,0
2021,South Tyneside 004B,E01008648,1304,1302,2,0,2,0,0
2021,South Tyneside 004C,E01008649,1504,1486,18,7,8,3,0
2021,South Tyneside 006B,E01008650,1278,1275,3,3,0,0,0
2021,South Tyneside 004D,E01008651,1792,1742,50,16,21,10,3
2021,South Tyneside 009B,E01008652,1184,1157,27,11,10,6,0
2021,South Tyneside 009C,E01008653,1184,1168,16,9,5,1,1
2021,South Tyneside 009D,E01008654,1077,1044,33,10,16,6,1
2021,South Tyneside 009E,E01008655,1759,1746,13,7,3,1,2
2021,South Tyneside 015E,E01008656,1386,1376,10,4,2,3,1
2021,South Tyneside 009F,E01008657,1236,1226,10,7,3,0,0
2021,South Tyneside 015F,E01008658,1411,1374,37,15,8,10,4
2021,South Tyneside 017C,E01008659,1432,1414,18,11,5,1,1
2021,South Tyneside 007C,E01008660,1300,1292,8,6,2,0,0
2021,South Tyneside 007D,E01008661,1056,1025,31,10,15,2,4
2021,South Tyneside 017D,E01008662,1156,1152,4,1,1,0,2
2021,South Tyneside 017E,E01008663,1339,1333,6,2,2,1,1
2021,South Tyneside 002A,E01008664,1173,1045,128,48,40,34,6
2021,South Tyneside 002B,E01008665,1207,1124,83,31,27,18,7
2021,South Tyneside 002C,E01008666,1753,1569,184,59,77,38,10
2021,South Tyneside 002D,E01008667,1660,1554,106,38,32,29,7
2021,South Tyneside 002E,E01008668,1358,1265,93,28,45,17,3
2021,South Tyneside 012B,E01008669,1395,1364,31,16,10,5,0
2021,South Tyneside 014D,E01008670,1424,1416,8,5,1,1,1
2021,South Tyneside 012C,E01008671,1016,985,31,12,12,5,2
2021,South Tyneside 012D,E01008672,1287,1277,10,7,1,2,0
2021,South Tyneside 003A,E01008673,1104,1094,10,6,4,0,0
2021,South Tyneside 006C,E01008674,1169,1166,3,1,2,0,0
2021,South Tyneside 003B,E01008675,1208,1174,34,16,12,5,1
2021,South Tyneside 003C,E01008676,1139,1112,27,13,5,7,2
2021,South Tyneside 003D,E01008677,1284,1266,18,7,9,0,2
2021,South Tyneside 003E,E01008678,1083,1056,27,10,11,5,1
2021,South Tyneside 005A,E01008679,1189,1157,32,17,3,10,2
2021,South Tyneside 005B,E01008680,1391,1376,15,4,10,1,0
2021,South Tyneside 006D,E01008681,1375,1364,11,4,6,1,0
2021,South Tyneside 005C,E01008682,1112,1032,80,31,31,16,2
2021,South Tyneside 005D,E01008683,1187,1142,45,24,11,8,2
2021,South Tyneside 018B,E01008684,1006,997,9,3,2,2,2
2021,South Tyneside 018C,E01008685,1742,1731,11,7,2,2,0
2021,South Tyneside 018D,E01008686,1622,1613,9,3,2,2,2
2021,South Tyneside 018E,E01008687,1768,1758,10,8,0,2,0
2021,South Tyneside 019A,E01008688,1285,1278,7,5,1,1,0
2021,South Tyneside 019B,E01008689,1382,1361,21,7,7,6,1
2021,South Tyneside 019C,E01008690,1313,1297,16,9,5,1,1
2021,South Tyneside 019D,E01008691,1113,1107,6,3,2,0,1
2021,South Tyneside 019E,E01008692,1307,1296,11,6,2,1,2
2021,Sunderland 008A,E01008693,1364,1341,23,4,7,10,2
2021,Sunderland 008B,E01008694,1346,1320,26,12,11,2,1
2021,Sunderland 008C,E01008695,1365,1345,20,4,11,1,4
2021,Sunderland 008D,E01008696,1188,1181,7,2,3,2,0
2021,Sunderland 008E,E01008697,1360,1351,9,2,4,3,0
2021,Sunderland 003A,E01008698,1384,1365,19,6,10,2,1
2021,Sunderland 008F,E01008699,1338,1315,23,9,9,3,2
2021,Sunderland 013A,E01008700,1898,1759,139,77,47,13,2
2021,Sunderland 011A,E01008701,1572,1369,203,110,72,16,5
2021,Sunderland 016A,E01008702,1130,1101,29,17,9,2,1
2021,Sunderland 013B,E01008703,2156,1692,464,236,172,47,9
2021,Sunderland 011B,E01008704,1463,1231,232,122,79,26,5
2021,Sunderland 013C,E01008705,1029,895,134,50,49,29,6
2021,Sunderland 011C,E01008706,1400,1202,198,95,69,28,6
2021,Sunderland 011D,E01008707,1201,943,258,120,78,54,6
2021,Sunderland 005A,E01008708,1382,1358,24,11,10,3,0
2021,Sunderland 005B,E01008709,1144,1104,40,14,19,3,4
2021,Sunderland 005D,E01008711,1419,1399,20,11,7,2,0
2021,Sunderland 004A,E01008712,1754,1727,27,8,9,8,2
2021,Sunderland 001A,E01008713,1489,1466,23,8,10,2,3
2021,Sunderland 034A,E01008714,1473,1426,47,20,21,5,1
2021,Sunderland 034B,E01008715,1309,1280,29,14,11,3,1
2021,Sunderland 034C,E01008716,1433,1429,4,2,1,1,0
2021,Sunderland 034D,E01008717,1513,1500,13,5,1,6,1
2021,Sunderland 035A,E01008718,1677,1647,30,10,16,2,2
2021,Sunderland 035B,E01008719,1157,1151,6,0,3,2,1
2021,Sunderland 032A,E01008720,1290,1280,10,5,1,4,0
2021,Sunderland 032B,E01008721,1523,1500,23,11,6,4,2
2021,Sunderland 001B,E01008722,1365,1351,14,6,5,2,1
2021,Sunderland 002A,E01008723,1384,1374,10,6,2,2,0
2021,Sunderland 001C,E01008724,1103,1101,2,1,1,0,0
2021,Sunderland 002B,E01008725,1322,1314,8,4,1,3,0
2021,Sunderland 001D,E01008726,1371,1356,15,9,5,1,0
2021,Sunderland 002C,E01008727,1425,1420,5,3,1,1,0
2021,Sunderland 002D,E01008728,1317,1315,2,0,1,1,0
2021,Sunderland 021B,E01008730,1595,1561,34,14,8,7,5
2021,Sunderland 021D,E01008732,1877,1856,21,11,7,3,0
2021,Sunderland 021E,E01008733,1535,1525,10,4,2,2,2
2021,Sunderland 021F,E01008734,1280,1279,1,1,0,0,0
2021,Sunderland 016B,E01008735,1847,1707,140,51,43,38,8
2021,Sunderland 016C,E01008736,985,912,73,21,24,21,7
2021,Sunderland 016D,E01008737,1195,1121,74,27,29,17,1
2021,Sunderland 016E,E01008738,1020,976,44,17,17,7,3
2021,Sunderland 024A,E01008739,1448,1404,44,10,25,9,0
2021,Sunderland 022A,E01008740,1397,1370,27,16,7,3,1
2021,Sunderland 024B,E01008741,1377,1357,20,11,6,3,0
2021,Sunderland 035C,E01008742,1475,1462,13,5,6,1,1
2021,Sunderland 036A,E01008743,1516,1496,20,9,7,4,0
2021,Sunderland 036B,E01008744,1968,1948,20,7,5,8,0
2021,Sunderland 036C,E01008745,1569,1564,5,3,2,0,0
2021,Sunderland 036D,E01008746,2037,2011,26,8,11,6,1
2021,Sunderland 035D,E01008747,1678,1644,34,16,12,4,2
2021,Sunderland 035E,E01008748,1430,1421,9,4,2,1,2
2021,Sunderland 034E,E01008749,1248,1247,1,1,0,0,0
2021,Sunderland 033A,E01008750,1960,1952,8,6,1,1,0
2021,Sunderland 033B,E01008751,1413,1404,9,5,2,1,1
2021,Sunderland 033C,E01008752,1887,1866,21,14,4,3,0
2021,Sunderland 033D,E01008753,1254,1246,8,4,2,1,1
2021,Sunderland 034F,E01008754,1327,1311,16,6,7,3,0
2021,Sunderland 033E,E01008755,1228,1215,13,10,3,0,0
2021,Sunderland 012A,E01008756,1454,1407,47,36,8,1,2
2021,Sunderland 015A,E01008757,1274,1171,103,57,29,15,2
2021,Sunderland 015B,E01008758,1340,1333,7,2,4,1,0
2021,Sunderland 015C,E01008759,1383,1309,74,38,21,13,2
2021,Sunderland 018A,E01008760,1384,1358,26,12,12,1,1
2021,Sunderland 015D,E01008761,1343,1324,19,10,6,3,0
2021,Sunderland 012B,E01008762,1613,1566,47,24,12,9,2
2021,Sunderland 028A,E01008763,1386,1355,31,14,12,4,1
2021,Sunderland 028B,E01008764,1431,1406,25,7,11,7,0
2021,Sunderland 031A,E01008765,1495,1481,14,13,0,1,0
2021,Sunderland 028C,E01008766,2839,2801,38,21,7,10,0
2021,Sunderland 031B,E01008767,1319,1308,11,6,4,1,0
2021,Sunderland 028D,E01008768,1927,1913,14,1,8,3,2
2021,Sunderland 028E,E01008769,1613,1587,26,15,8,3,0
2021,Sunderland 031C,E01008770,1222,1214,8,2,1,2,3
2021,Sunderland 031D,E01008771,1433,1426,7,4,2,1,0
2021,Sunderland 029A,E01008772,1341,1337,4,3,1,0,0
2021,Sunderland 026A,E01008773,1236,1228,8,5,3,0,0
2021,Sunderland 029B,E01008774,1256,1249,7,3,2,2,0
2021,Sunderland 029C,E01008775,1346,1330,16,9,4,3,0
2021,Sunderland 026B,E01008776,1204,1187,17,3,3,8,3
2021,Sunderland 026C,E01008777,1373,1368,5,2,2,1,0
2021,Sunderland 026D,E01008778,1276,1254,22,10,6,5,1
2021,Sunderland 024C,E01008779,1299,1287,12,9,3,0,0
2021,Sunderland 024D,E01008780,1886,1834,52,21,14,15,2
2021,Sunderland 022B,E01008781,1407,1376,31,9,12,8,2
2021,Sunderland 022C,E01008782,1347,1337,10,7,3,0,0
2021,Sunderland 022D,E01008783,1352,1330,22,15,5,1,1
2021,Sunderland 022E,E01008784,1469,1460,9,8,1,0,0
2021,Sunderland 022F,E01008785,1300,1293,7,2,2,3,0
2021,Sunderland 006A,E01008786,1392,1387,5,3,2,0,0
2021,Sunderland 006B,E01008787,1384,1324,60,27,24,9,0
2021,Sunderland 006C,E01008788,1397,1375,22,8,6,6,2
2021,Sunderland 006D,E01008789,1275,1229,46,13,18,13,2
2021,Sunderland 006E,E01008790,1362,1330,32,21,7,4,0
2021,Sunderland 006F,E01008791,1559,1394,165,95,36,25,9
2021,Sunderland 002E,E01008792,1240,1235,5,0,3,0,2
2021,Sunderland 030A,E01008793,1557,1536,21,7,2,6,6
2021,Sunderland 030B,E01008795,1690,1671,19,7,7,5,0
2021,Sunderland 032D,E01008796,1828,1804,24,13,8,3,0
2021,Sunderland 025A,E01008799,1596,1578,18,8,4,6,0
2021,Sunderland 030D,E01008800,1469,1447,22,13,7,2,0
2021,Sunderland 030E,E01008801,1488,1483,5,3,2,0,0
2021,Sunderland 029D,E01008802,1328,1311,17,13,3,1,0
2021,Sunderland 027A,E01008803,1412,1398,14,4,5,2,3
2021,Sunderland 027B,E01008804,1571,1555,16,7,8,1,0
2021,Sunderland 027C,E01008805,1275,1253,22,14,6,2,0
2021,Sunderland 029E,E01008808,1474,1457,17,7,9,1,0
2021,Sunderland 026E,E01008809,1530,1525,5,4,0,1,0
2021,Sunderland 014A,E01008810,1542,1501,41,30,7,3,1
2021,Sunderland 014B,E01008811,1518,1503,15,6,8,1,0
2021,Sunderland 012C,E01008812,1640,1616,24,12,9,3,0
2021,Sunderland 014C,E01008813,1545,1511,34,10,17,2,5
2021,Sunderland 014D,E01008814,1435,1422,13,3,6,0,4
2021,Sunderland 004B,E01008817,1177,1162,15,8,7,0,0
2021,Sunderland 004C,E01008819,1349,1342,7,2,3,0,2
2021,Sunderland 004D,E01008821,1446,1419,27,10,9,8,0
2021,Sunderland 004E,E01008822,1475,1453,22,11,5,4,2
2021,Sunderland 023A,E01008823,1374,1370,4,2,1,1,0
2021,Sunderland 023B,E01008824,1346,1319,27,13,9,5,0
2021,Sunderland 023C,E01008825,1461,1448,13,5,6,2,0
2021,Sunderland 023D,E01008826,1343,1322,21,10,10,1,0
2021,Sunderland 023E,E01008827,1130,1109,21,13,4,4,0
2021,Sunderland 023F,E01008828,1462,1434,28,9,11,8,0
2021,Sunderland 023G,E01008829,1241,1216,25,4,13,7,1
2021,Sunderland 018B,E01008830,1310,1080,230,94,81,53,2
2021,Sunderland 013D,E01008831,1797,1452,345,127,134,63,21
2021,Sunderland 018C,E01008832,1403,1246,157,65,51,35,6
2021,Sunderland 018D,E01008833,1303,1170,133,64,40,24,5
2021,Sunderland 013E,E01008834,1434,1284,150,75,48,23,4
2021,Sunderland 022G,E01008835,1501,1382,119,42,44,26,7
2021,Sunderland 016F,E01008836,1272,1060,212,63,66,73,10
2021,Sunderland 003B,E01008837,1198,1191,7,6,1,0,0
2021,Sunderland 003C,E01008838,1428,1398,30,16,8,3,3
2021,Sunderland 003D,E01008839,1302,1286,16,5,5,4,2
2021,Sunderland 003E,E01008840,1330,1305,25,10,9,6,0
2021,Sunderland 003F,E01008841,1339,1321,18,9,5,4,0
2021,Sunderland 004F,E01008842,1350,1347,3,3,0,0,0
2021,Sunderland 019A,E01008843,1189,1175,14,8,6,0,0
2021,Sunderland 019B,E01008844,1414,1404,10,1,5,3,1
2021,Sunderland 017A,E01008845,1364,1355,9,2,2,3,2
2021,Sunderland 017B,E01008846,1187,1166,21,5,11,4,1
2021,Sunderland 017C,E01008847,1307,1288,19,4,12,3,0
2021,Sunderland 019C,E01008848,1282,1264,18,8,5,5,0
2021,Sunderland 019D,E01008849,1353,1319,34,5,20,7,2
2021,Sunderland 017E,E01008851,1503,1484,19,5,6,8,0
2021,Sunderland 019E,E01008852,1100,1096,4,2,2,0,0
2021,Sunderland 009A,E01008853,1332,1308,24,12,6,4,2
2021,Sunderland 009B,E01008854,1188,1098,90,43,41,6,0
2021,Sunderland 007A,E01008855,1359,1332,27,15,10,2,0
2021,Sunderland 007B,E01008856,1242,1231,11,4,6,1,0
2021,Sunderland 009C,E01008857,1294,1278,16,3,5,8,0
2021,Sunderland 009D,E01008858,1184,1170,14,7,4,3,0
2021,Sunderland 009E,E01008859,1323,1276,47,28,14,4,1
2021,Sunderland 009F,E01008860,1249,1222,27,11,14,2,0
2021,Sunderland 025B,E01008861,1408,1383,25,13,8,3,1
2021,Sunderland 025C,E01008862,1269,1254,15,10,2,2,1
2021,Sunderland 025D,E01008863,1510,1465,45,30,10,5,0
2021,Sunderland 025E,E01008864,1191,1170,21,10,11,0,0
2021,Sunderland 025F,E01008865,1300,1287,13,4,8,1,0
2021,Sunderland 025G,E01008866,1332,1317,15,9,4,1,1
2021,Sunderland 020A,E01008867,1489,1443,46,21,17,8,0
2021,Sunderland 020B,E01008868,1071,1063,8,3,3,0,2
2021,Sunderland 020C,E01008869,1192,1172,20,6,6,6,2
2021,Sunderland 020D,E01008870,1306,1298,8,4,1,2,1
2021,Sunderland 020E,E01008871,1342,1330,12,5,4,3,0
2021,Sunderland 020F,E01008872,1622,1609,13,4,8,0,1
2021,Sunderland 010A,E01008873,1177,1169,8,2,4,1,1
2021,Sunderland 010B,E01008874,1686,1652,34,9,16,8,1
2021,Sunderland 010C,E01008875,1394,1376,18,10,4,2,2
2021,Sunderland 007C,E01008876,1609,1581,28,16,9,2,1
2021,Sunderland 007D,E01008877,1534,1517,17,9,5,3,0
2021,Sunderland 009G,E01008878,1432,1430,2,2,0,0,0
2021,Sunderland 010D,E01008879,1236,1229,7,4,2,1,0
2021,Sunderland 010E,E01008880,1051,1042,9,3,4,1,1
2021,Birmingham 067A,E01008881,1678,1354,324,113,104,84,23
2021,Birmingham 066A,E01008882,1969,1504,465,129,173,144,19
2021,Birmingham 078A,E01008883,1915,1500,415,125,185,91,14
2021,Birmingham 078B,E01008884,2087,1496,591,168,196,194,33
2021,Birmingham 076A,E01008885,1294,1133,161,69,60,25,7
2021,Birmingham 076B,E01008886,1526,1342,184,64,83,29,8
2021,Birmingham 078C,E01008887,1635,1354,281,110,122,49,0
2021,Birmingham 076C,E01008888,1572,1459,113,46,39,23,5
2021,Birmingham 078D,E01008889,1713,1426,287,70,143,68,6
2021,Birmingham 089A,E01008890,1753,1511,242,81,97,54,10
2021,Birmingham 089B,E01008891,1521,1456,65,28,25,11,1
2021,Birmingham 089C,E01008892,1427,1157,270,79,109,72,10
2021,Birmingham 089D,E01008893,1657,1421,236,86,105,35,10
2021,Birmingham 089E,E01008894,1551,1326,225,87,77,52,9
2021,Birmingham 089F,E01008895,1831,1649,182,96,55,27,4
2021,Birmingham 066B,E01008896,1798,1490,308,123,101,68,16
2021,Birmingham 067B,E01008897,1893,1533,360,115,136,89,20
2021,Birmingham 066C,E01008898,1697,1320,377,107,133,121,16
2021,Birmingham 037A,E01008899,1234,862,372,88,150,115,19
2021,Birmingham 037C,E01008901,1747,1298,449,96,165,156,32
2021,Birmingham 040A,E01008905,1872,1248,624,114,198,262,50
2021,Birmingham 049A,E01008906,1906,1300,606,141,185,215,65
2021,Birmingham 040B,E01008907,1718,1295,423,95,144,155,29
2021,Birmingham 041D,E01008909,2040,1530,510,146,193,152,19
2021,Birmingham 050A,E01008910,1663,1189,474,102,167,163,42
2021,Birmingham 049B,E01008911,1818,1282,536,127,249,135,25
2021,Birmingham 050B,E01008913,2127,1543,584,180,259,126,19
2021,Birmingham 030A,E01008915,1665,1242,423,118,201,77,27
2021,Birmingham 037E,E01008916,1649,1144,505,107,205,154,39
2021,Birmingham 102A,E01008917,1207,1150,57,29,17,11,0
2021,Birmingham 094A,E01008918,1643,1456,187,66,83,32,6
2021,Birmingham 095A,E01008919,1587,1390,197,95,54,39,9
2021,Birmingham 094B,E01008920,1275,1225,50,24,15,7,4
2021,Birmingham 094C,E01008921,1395,1296,99,29,44,24,2
2021,Birmingham 102B,E01008923,1461,1344,117,31,66,20,0
2021,Birmingham 101A,E01008924,1444,1345,99,42,40,11,6
2021,Birmingham 102C,E01008925,1146,1108,38,16,18,4,0
2021,Birmingham 102D,E01008927,1254,1194,60,23,27,7,3
2021,Birmingham 102E,E01008928,1518,1362,156,42,60,41,13
2021,Birmingham 106C,E01008929,1530,1435,95,41,31,21,2
2021,Birmingham 106D,E01008930,1893,1712,181,97,48,32,4
2021,Birmingham 094D,E01008931,1384,1241,143,62,53,24,4
2021,Birmingham 111A,E01008932,1547,1333,214,80,82,42,10
2021,Birmingham 105A,E01008933,1563,1407,156,60,59,30,7
2021,Birmingham 105B,E01008934,1463,1296,167,95,45,24,3
2021,Birmingham 111B,E01008935,1711,1496,215,83,72,54,6
2021,Birmingham 111C,E01008936,1599,1427,172,76,62,29,5
2021,Birmingham 115A,E01008937,1524,1341,183,72,70,32,9
2021,Birmingham 111D,E01008938,1622,1420,202,70,89,37,6
2021,Birmingham 111E,E01008939,1583,1417,166,66,59,36,5
2021,Birmingham 115B,E01008940,1550,1402,148,59,50,37,2
2021,Birmingham 115C,E01008941,1518,1359,159,55,72,31,1
2021,Birmingham 117A,E01008942,1541,1456,85,29,42,13,1
2021,Birmingham 117B,E01008943,1398,1314,84,42,30,10,2
2021,Birmingham 115D,E01008944,1657,1532,125,41,61,19,4
2021,Birmingham 122A,E01008945,1759,1656,103,37,36,26,4
2021,Birmingham 122B,E01008946,1487,1406,81,22,29,29,1
2021,Birmingham 122C,E01008947,1302,1235,67,34,19,13,1
2021,Birmingham 122D,E01008948,1395,1357,38,17,15,4,2
2021,Birmingham 122E,E01008949,1158,1142,16,5,9,2,0
2021,Birmingham 113A,E01008950,1404,1348,56,32,17,3,4
2021,Birmingham 112A,E01008951,1364,1311,53,35,12,4,2
2021,Birmingham 112B,E01008952,1714,1580,134,64,52,16,2
2021,Birmingham 107A,E01008953,1506,1364,142,57,50,31,4
2021,Birmingham 113B,E01008954,1397,1333,64,40,15,7,2
2021,Birmingham 112C,E01008955,1609,1510,99,63,26,9,1
2021,Birmingham 112D,E01008956,1382,1333,49,21,19,8,1
2021,Birmingham 112E,E01008957,1540,1453,87,38,27,16,6
2021,Birmingham 113C,E01008958,1501,1434,67,29,31,7,0
2021,Birmingham 116A,E01008959,1691,1619,72,37,28,7,0
2021,Birmingham 116B,E01008960,1490,1434,56,30,18,6,2
2021,Birmingham 116C,E01008961,1369,1320,49,29,13,6,1
2021,Birmingham 116D,E01008962,1991,1836,155,58,71,25,1
2021,Birmingham 107B,E01008963,1421,1319,102,42,46,12,2
2021,Birmingham 107C,E01008964,1413,1316,97,43,37,16,1
2021,Birmingham 107D,E01008965,1404,1322,82,44,23,15,0
2021,Birmingham 107E,E01008966,1686,1493,193,69,77,40,7
2021,Birmingham 110A,E01008967,1534,1415,119,68,32,15,4
2021,Birmingham 110B,E01008968,1746,1660,86,41,30,13,2
2021,Birmingham 117C,E01008969,1614,1521,93,40,26,21,6
2021,Birmingham 110C,E01008970,1412,1264,148,67,57,21,3
2021,Birmingham 117D,E01008971,1677,1548,129,61,32,36,0
2021,Birmingham 118A,E01008972,1819,1675,144,50,62,23,9
2021,Birmingham 118B,E01008973,1856,1741,115,48,49,16,2
2021,Birmingham 118C,E01008974,2707,2519,188,114,50,22,2
2021,Birmingham 118D,E01008975,1430,1410,20,7,11,2,0
2021,Birmingham 121A,E01008976,1468,1357,111,36,49,24,2
2021,Birmingham 123A,E01008977,1491,1452,39,24,8,5,2
2021,Birmingham 121B,E01008978,1320,1118,202,39,102,52,9
2021,Birmingham 121C,E01008979,1513,1426,87,39,28,17,3
2021,Birmingham 121D,E01008980,1637,1518,119,30,57,26,6
2021,Birmingham 110D,E01008981,1501,1394,107,49,35,19,4
2021,Birmingham 079A,E01008982,1622,1279,343,166,118,50,9
2021,Birmingham 074A,E01008984,1645,1247,398,130,166,84,18
2021,Birmingham 064A,E01008986,1515,1166,349,168,119,56,6
2021,Birmingham 064B,E01008987,1561,1288,273,106,113,46,8
2021,Birmingham 064C,E01008988,2014,1508,506,226,184,85,11
2021,Birmingham 064D,E01008989,1648,1242,406,179,132,77,18
2021,Birmingham 064E,E01008990,1146,967,179,124,41,11,3
2021,Birmingham 064F,E01008991,1805,1403,402,188,103,86,25
2021,Birmingham 079C,E01008992,1657,1407,250,147,78,20,5
2021,Birmingham 074B,E01008994,1553,1250,303,158,106,30,9
2021,Birmingham 134A,E01008995,2295,1740,555,190,199,138,28
2021,Birmingham 074C,E01008996,1771,1261,510,154,181,140,35
2021,Birmingham 074D,E01008997,1504,1312,192,101,67,22,2
2021,Birmingham 031A,E01008998,1836,1526,310,95,133,71,11
2021,Birmingham 031B,E01008999,1526,1305,221,82,78,52,9
2021,Birmingham 031C,E01009000,1682,1359,323,116,137,58,12
2021,Birmingham 018A,E01009001,1611,1551,60,33,22,4,1
2021,Birmingham 023A,E01009002,1898,1653,245,97,105,39,4
2021,Birmingham 018B,E01009003,1710,1553,157,59,59,24,15
2021,Birmingham 025A,E01009005,1696,1529,167,65,76,20,6
2021,Birmingham 023C,E01009006,1496,1299,197,68,75,51,3
2021,Birmingham 023D,E01009007,1755,1391,364,129,151,81,3
2021,Birmingham 141A,E01009008,1397,1336,61,26,21,12,2
2021,Birmingham 025B,E01009009,1442,1338,104,36,51,15,2
2021,Birmingham 141B,E01009011,1690,1546,144,62,45,31,6
2021,Birmingham 141C,E01009012,1448,1286,162,68,65,27,2
2021,Birmingham 031D,E01009013,1940,1623,317,114,136,57,10
2021,Birmingham 090A,E01009014,2496,1905,591,195,217,149,30
2021,Birmingham 089G,E01009015,1780,1383,397,176,126,80,15
2021,Birmingham 098A,E01009016,1585,1342,243,99,79,59,6
2021,Birmingham 097A,E01009017,1738,1291,447,142,162,117,26
2021,Birmingham 090B,E01009018,1800,1503,297,91,101,90,15
2021,Birmingham 103A,E01009019,1725,1403,322,131,119,62,10
2021,Birmingham 103B,E01009020,1540,1329,211,65,85,49,12
2021,Birmingham 103C,E01009021,1630,1407,223,78,95,47,3
2021,Birmingham 098B,E01009022,1767,1515,252,98,103,46,5
2021,Birmingham 098C,E01009023,1637,1417,220,100,76,35,9
2021,Birmingham 103D,E01009024,1735,1480,255,109,94,52,0
2021,Birmingham 103E,E01009025,1531,1319,212,73,68,51,20
2021,Birmingham 090C,E01009026,1871,1512,359,118,147,71,23
2021,Birmingham 090D,E01009028,1776,1492,284,87,123,65,9
2021,Birmingham 090E,E01009029,1492,1215,277,104,102,58,13
2021,Birmingham 098D,E01009030,1795,1518,277,116,92,58,11
2021,Birmingham 105C,E01009031,1751,1534,217,92,72,42,11
2021,Birmingham 108A,E01009032,1835,1573,262,111,90,45,16
2021,Birmingham 103F,E01009033,1807,1549,258,84,99,62,13
2021,Birmingham 108B,E01009034,1697,1432,265,130,80,48,7
2021,Birmingham 108C,E01009035,1816,1537,279,127,99,36,17
2021,Birmingham 108D,E01009036,1541,1296,245,116,87,36,6
2021,Birmingham 105D,E01009037,1838,1694,144,67,42,29,6
2021,Birmingham 132A,E01009039,1736,1541,195,100,57,33,5
2021,Birmingham 132B,E01009040,1759,1651,108,48,39,17,4
2021,Birmingham 132C,E01009041,1647,1543,104,48,28,20,8
2021,Birmingham 132D,E01009042,1312,1250,62,31,22,7,2
2021,Birmingham 097B,E01009043,1935,1491,444,130,145,141,28
2021,Birmingham 097C,E01009044,1694,1228,466,108,188,132,38
2021,Birmingham 097D,E01009045,1970,1565,405,154,151,82,18
2021,Birmingham 097E,E01009046,1764,1523,241,82,79,65,15
2021,Birmingham 040C,E01009047,1739,1281,458,84,159,171,44
2021,Birmingham 040D,E01009048,1968,1492,476,89,211,152,24
2021,Birmingham 032A,E01009049,1590,1256,334,91,131,98,14
2021,Birmingham 035A,E01009050,2127,1564,563,187,215,141,20
2021,Birmingham 033A,E01009051,1736,1241,495,121,194,158,22
2021,Birmingham 033B,E01009053,1526,1054,472,99,172,158,43
2021,Birmingham 033C,E01009054,1590,1205,385,93,137,126,29
2021,Birmingham 032B,E01009056,2162,1711,451,130,153,140,28
2021,Birmingham 035D,E01009057,1895,1444,451,92,160,171,28
2021,Birmingham 033D,E01009058,1871,1318,553,127,213,172,41
2021,Birmingham 035E,E01009059,1732,1358,374,94,133,106,41
2021,Birmingham 035F,E01009060,1634,1186,448,94,140,184,30
2021,Birmingham 033E,E01009061,1802,1279,523,98,191,190,44
2021,Birmingham 040E,E01009062,1780,1234,546,124,162,209,51
2021,Birmingham 095B,E01009064,1441,1225,216,86,93,33,4
2021,Birmingham 075A,E01009065,1587,1441,146,88,39,18,1
2021,Birmingham 073A,E01009066,1892,1707,185,98,46,31,10
2021,Birmingham 075B,E01009067,1454,1360,94,61,23,8,2
2021,Birmingham 075C,E01009068,1535,1369,166,113,38,13,2
2021,Birmingham 075D,E01009069,1583,1418,165,111,34,20,0
2021,Birmingham 073B,E01009070,1547,1446,101,71,22,6,2
2021,Birmingham 087B,E01009071,1646,1467,179,102,51,25,1
2021,Birmingham 075E,E01009072,1709,1557,152,95,37,17,3
2021,Birmingham 085A,E01009073,1710,1430,280,89,89,94,8
2021,Birmingham 085B,E01009074,1705,1374,331,137,112,72,10
2021,Birmingham 087C,E01009075,1608,1292,316,127,125,54,10
2021,Birmingham 095C,E01009077,1543,1390,153,67,59,24,3
2021,Birmingham 087E,E01009078,1485,1224,261,157,77,24,3
2021,Birmingham 141G,E01009079,1321,1113,208,71,100,32,5
2021,Birmingham 141F,E01009080,1284,1083,201,82,77,32,10
2021,Birmingham 141H,E01009081,1304,1128,176,65,74,29,8
2021,Birmingham 044A,E01009082,1454,1263,191,77,79,28,7
2021,Birmingham 141I,E01009083,1547,1251,296,91,130,64,11
2021,Birmingham 042A,E01009084,1889,1566,323,91,121,80,31
2021,Birmingham 042B,E01009085,2035,1685,350,97,142,90,21
2021,Birmingham 044B,E01009086,2118,1747,371,120,147,88,16
2021,Birmingham 042C,E01009087,1691,1423,268,90,115,52,11
2021,Birmingham 045A,E01009088,1527,1420,107,38,41,26,2
2021,Birmingham 042D,E01009089,1725,1515,210,65,69,62,14
2021,Birmingham 042E,E01009090,2044,1660,384,101,144,115,24
2021,Birmingham 045B,E01009091,1607,1427,180,74,61,40,5
2021,Birmingham 054A,E01009092,1674,1481,193,71,68,45,9
2021,Birmingham 054B,E01009093,1623,1450,173,59,79,27,8
2021,Birmingham 054C,E01009094,1527,1312,215,59,99,48,9
2021,Birmingham 056A,E01009095,1743,1496,247,88,99,49,11
2021,Birmingham 029A,E01009096,1619,1570,49,21,20,7,1
2021,Birmingham 029B,E01009097,1972,1896,76,35,18,20,3
2021,Birmingham 025C,E01009098,2036,1892,144,47,57,32,8
2021,Birmingham 029C,E01009099,1681,1605,76,29,32,11,4
2021,Birmingham 025D,E01009100,1880,1684,196,74,67,47,8
2021,Birmingham 029D,E01009101,1469,1418,51,17,20,10,4
2021,Birmingham 141E,E01009102,1534,1308,226,73,99,53,1
2021,Birmingham 029E,E01009103,1520,1476,44,30,9,5,0
2021,Birmingham 141D,E01009104,1613,1367,246,80,118,41,7
2021,Birmingham 025E,E01009105,1725,1623,102,45,37,17,3
2021,Birmingham 029F,E01009106,1303,1256,47,18,20,6,3
2021,Birmingham 128A,E01009107,1596,1465,131,33,53,33,12
2021,Birmingham 127A,E01009108,994,944,50,29,15,6,0
2021,Birmingham 123B,E01009109,1340,1249,91,46,22,18,5
2021,Birmingham 128B,E01009110,1320,1260,60,19,25,13,3
2021,Birmingham 127B,E01009111,1490,1382,108,35,48,17,8
2021,Birmingham 127C,E01009112,1567,1516,51,17,20,11,3
2021,Birmingham 128C,E01009113,1626,1495,131,51,44,32,4
2021,Birmingham 128D,E01009114,1370,1294,76,36,25,10,5
2021,Birmingham 128E,E01009115,1375,1307,68,25,28,14,1
2021,Birmingham 127D,E01009116,1344,1301,43,24,8,5,6
2021,Birmingham 126A,E01009117,1977,1842,135,47,62,22,4
2021,Birmingham 127E,E01009118,1508,1428,80,46,22,9,3
2021,Birmingham 123C,E01009119,1387,1332,55,29,20,6,0
2021,Birmingham 123D,E01009120,1645,1552,93,52,31,10,0
2021,Birmingham 014B,E01009122,1577,1425,152,60,64,27,1
2021,Birmingham 022A,E01009123,1568,1289,279,102,114,55,8
2021,Birmingham 022B,E01009124,1974,1640,334,134,129,64,7
2021,Birmingham 022C,E01009125,1970,1672,298,86,132,67,13
2021,Birmingham 026A,E01009126,1437,1287,150,64,63,20,3
2021,Birmingham 011A,E01009127,1481,1335,146,44,53,44,5
2021,Birmingham 011B,E01009128,1318,1185,133,57,48,22,6
2021,Birmingham 014C,E01009129,1540,1366,174,54,86,32,2
2021,Birmingham 011C,E01009130,1435,1324,111,45,42,16,8
2021,Birmingham 011D,E01009131,1408,1268,140,38,67,31,4
2021,Birmingham 014D,E01009132,1473,1345,128,49,49,25,5
2021,Birmingham 011E,E01009133,1434,1313,121,41,41,27,12
2021,Birmingham 011F,E01009134,1602,1419,183,62,80,36,5
2021,Birmingham 010A,E01009135,1369,1227,142,76,40,24,2
2021,Birmingham 014E,E01009136,1690,1507,183,85,62,32,4
2021,Birmingham 011G,E01009137,1558,1385,173,83,47,41,2
2021,Birmingham 060A,E01009138,2126,1557,569,206,199,136,28
2021,Birmingham 060B,E01009139,1552,1160,392,138,154,84,16
2021,Birmingham 060C,E01009140,2137,1676,461,187,168,92,14
2021,Birmingham 137A,E01009141,1815,1386,429,147,172,89,21
2021,Birmingham 136A,E01009143,1764,1205,559,170,257,116,16
2021,Birmingham 060D,E01009145,1912,1443,469,197,160,99,13
2021,Birmingham 136B,E01009146,2249,1676,573,202,267,96,8
2021,Birmingham 060E,E01009147,1871,1502,369,134,149,77,9
2021,Birmingham 053A,E01009151,2037,1458,579,106,212,216,45
2021,Birmingham 053B,E01009152,1886,1441,445,120,152,134,39
2021,Birmingham 053C,E01009153,2021,1536,485,182,172,116,15
2021,Birmingham 125B,E01009155,1291,1254,37,20,9,7,1
2021,Birmingham 125D,E01009157,1407,1361,46,24,9,10,3
2021,Birmingham 129A,E01009158,2156,2070,86,34,30,20,2
2021,Birmingham 130A,E01009159,2201,2126,75,20,37,13,5
2021,Birmingham 125E,E01009160,1550,1472,78,35,31,12,0
2021,Birmingham 125F,E01009161,1391,1368,23,9,10,4,0
2021,Birmingham 124A,E01009162,1544,1415,129,56,33,35,5
2021,Birmingham 130B,E01009164,1377,1352,25,2,16,5,2
2021,Birmingham 129C,E01009165,1322,1257,65,39,16,8,2
2021,Birmingham 131A,E01009166,1269,1238,31,6,13,10,2
2021,Birmingham 130C,E01009167,1431,1386,45,23,15,6,1
2021,Birmingham 131B,E01009168,1402,1378,24,8,11,5,0
2021,Birmingham 129D,E01009169,1609,1569,40,18,15,7,0
2021,Birmingham 131C,E01009170,1439,1409,30,10,12,6,2
2021,Birmingham 130D,E01009171,1593,1567,26,8,10,7,1
2021,Birmingham 119A,E01009172,1415,1278,137,58,46,20,13
2021,Birmingham 119B,E01009173,1641,1488,153,58,57,28,10
2021,Birmingham 119C,E01009174,1177,1152,25,10,10,4,1
2021,Birmingham 104A,E01009175,1396,1281,115,58,31,22,4
2021,Birmingham 105E,E01009176,1674,1416,258,100,88,60,10
2021,Birmingham 104B,E01009177,1478,1370,108,33,42,29,4
2021,Birmingham 104C,E01009178,1593,1462,131,50,50,28,3
2021,Birmingham 104D,E01009179,1622,1493,129,65,43,19,2
2021,Birmingham 092A,E01009182,1560,1222,338,127,108,82,21
2021,Birmingham 088C,E01009183,1605,1429,176,109,35,26,6
2021,Birmingham 092B,E01009184,1487,1359,128,67,36,17,8
2021,Birmingham 093A,E01009185,1688,1548,140,61,42,32,5
2021,Birmingham 088D,E01009186,1712,1547,165,88,52,20,5
2021,Birmingham 092C,E01009187,1454,1362,92,39,33,16,4
2021,Birmingham 092D,E01009188,1439,1330,109,52,27,25,5
2021,Birmingham 104E,E01009189,1376,1289,87,43,23,19,2
2021,Birmingham 052B,E01009192,2649,1813,836,214,227,302,93
2021,Birmingham 058A,E01009195,2611,1875,736,176,262,231,67
2021,Birmingham 058C,E01009197,1813,1316,497,122,189,140,46
2021,Birmingham 052D,E01009199,1347,1011,336,128,120,76,12
2021,Birmingham 139A,E01009200,1732,1332,400,112,147,119,22
2021,Birmingham 043A,E01009201,1883,1477,406,90,171,113,32
2021,Birmingham 043B,E01009202,1684,1324,360,119,136,91,14
2021,Birmingham 052E,E01009204,2052,1526,526,140,211,144,31
2021,Birmingham 120A,E01009205,1493,1443,50,19,19,9,3
2021,Birmingham 120B,E01009206,1477,1389,88,44,29,14,1
2021,Birmingham 124B,E01009207,1567,1514,53,27,16,10,0
2021,Birmingham 124C,E01009208,1638,1579,59,33,20,5,1
2021,Birmingham 124D,E01009209,1977,1872,105,51,35,16,3
2021,Birmingham 126B,E01009210,1746,1662,84,29,31,17,7
2021,Birmingham 120C,E01009211,1396,1337,59,30,19,9,1
2021,Birmingham 126C,E01009212,1689,1552,137,53,48,23,13
2021,Birmingham 124E,E01009213,1548,1486,62,19,31,8,4
2021,Birmingham 126D,E01009214,1587,1485,102,34,39,29,0
2021,Birmingham 126E,E01009215,1721,1575,146,44,59,36,7
2021,Birmingham 131D,E01009216,1990,1848,142,68,50,19,5
2021,Birmingham 131E,E01009217,1507,1487,20,13,4,2,1
2021,Birmingham 120D,E01009218,1583,1503,80,37,24,15,4
2021,Birmingham 120E,E01009219,1424,1309,115,45,31,36,3
2021,Birmingham 008A,E01009220,1500,1409,91,38,28,20,5
2021,Birmingham 007A,E01009221,1467,1377,90,46,28,15,1
2021,Birmingham 008B,E01009222,1466,1372,94,40,38,11,5
2021,Birmingham 013A,E01009223,1527,1423,104,45,36,21,2
2021,Birmingham 008C,E01009224,1355,1296,59,23,29,5,2
2021,Birmingham 013B,E01009225,1576,1487,89,32,37,19,1
2021,Birmingham 017A,E01009226,1395,1309,86,25,39,17,5
2021,Birmingham 013C,E01009227,1598,1492,106,43,42,15,6
2021,Birmingham 013D,E01009228,1494,1381,113,49,40,20,4
2021,Birmingham 017B,E01009229,1529,1415,114,39,41,25,9
2021,Birmingham 017C,E01009230,1564,1460,104,49,36,18,1
2021,Birmingham 017D,E01009231,1868,1719,149,58,50,34,7
2021,Birmingham 022D,E01009232,1512,1359,153,56,63,30,4
2021,Birmingham 008D,E01009233,1560,1495,65,27,26,9,3
2021,Birmingham 019A,E01009234,1420,1321,99,44,32,20,3
2021,Birmingham 016A,E01009235,1578,1368,210,92,75,36,7
2021,Birmingham 019B,E01009236,1499,1343,156,64,61,25,6
2021,Birmingham 024A,E01009237,1406,1166,240,95,85,48,12
2021,Birmingham 024B,E01009238,1694,1484,210,78,73,48,11
2021,Birmingham 033F,E01009239,1410,1120,290,106,120,57,7
2021,Birmingham 024C,E01009240,1464,1220,244,89,81,62,12
2021,Birmingham 024D,E01009241,1704,1471,233,82,94,46,11
2021,Birmingham 024E,E01009242,1998,1584,414,112,157,113,32
2021,Birmingham 016B,E01009243,1728,1558,170,77,61,23,9
2021,Birmingham 019C,E01009244,1794,1644,150,64,65,19,2
2021,Birmingham 016C,E01009245,1416,1288,128,34,54,34,6
2021,Birmingham 016D,E01009246,1500,1394,106,48,31,22,5
2021,Birmingham 016E,E01009247,1504,1360,144,52,54,33,5
2021,Birmingham 019D,E01009248,1694,1568,126,50,61,11,4
2021,Birmingham 080A,E01009249,1548,1425,123,46,51,25,1
2021,Birmingham 080B,E01009250,1665,1568,97,45,35,15,2
2021,Birmingham 080C,E01009251,1439,1323,116,68,32,14,2
2021,Birmingham 073C,E01009252,1553,1377,176,105,48,19,4
2021,Birmingham 080D,E01009253,1557,1382,175,94,43,36,2
2021,Birmingham 085C,E01009254,1883,1631,252,111,85,48,8
2021,Birmingham 080E,E01009255,1479,1328,151,62,48,32,9
2021,Birmingham 085D,E01009256,1607,1405,202,68,88,40,6
2021,Birmingham 080F,E01009257,1547,1393,154,49,63,38,4
2021,Birmingham 085E,E01009258,1456,1276,180,74,60,44,2
2021,Birmingham 094E,E01009259,1637,1478,159,65,58,29,7
2021,Birmingham 073D,E01009260,1542,1277,265,135,76,49,5
2021,Birmingham 073E,E01009261,1693,1452,241,121,80,31,9
2021,Birmingham 133A,E01009262,1713,1378,335,143,96,83,13
2021,Birmingham 032C,E01009263,1578,1297,281,103,111,57,10
2021,Birmingham 032D,E01009264,1742,1371,371,157,140,66,8
2021,Birmingham 032E,E01009265,1724,1214,510,137,204,136,33
2021,Birmingham 034A,E01009266,1714,1093,621,129,251,195,46
2021,Birmingham 133B,E01009267,1751,1309,442,174,146,98,24
2021,Birmingham 036A,E01009268,1439,998,441,133,153,131,24
2021,Birmingham 034B,E01009269,1431,871,560,150,208,165,37
2021,Birmingham 034C,E01009270,1943,1437,506,116,193,175,22
2021,Birmingham 034D,E01009271,1550,950,600,146,219,198,37
2021,Birmingham 036B,E01009272,1365,1018,347,92,132,102,21
2021,Birmingham 034E,E01009273,1544,1019,525,156,192,152,25
2021,Birmingham 036C,E01009274,1986,1346,640,166,234,193,47
2021,Birmingham 039A,E01009275,1705,1135,570,143,203,178,46
2021,Birmingham 133C,E01009276,1613,1238,375,145,112,103,15
2021,Birmingham 133D,E01009278,1679,1338,341,129,129,66,17
2021,Birmingham 133E,E01009279,1536,1174,362,153,117,74,18
2021,Birmingham 100A,E01009280,1673,1559,114,59,27,20,8
2021,Birmingham 099A,E01009281,1505,1400,105,39,37,27,2
2021,Birmingham 100B,E01009282,1658,1522,136,45,65,24,2
2021,Birmingham 079E,E01009283,1701,1463,238,90,100,45,3
2021,Birmingham 096A,E01009284,4278,3637,641,285,281,69,6
2021,Birmingham 096C,E01009286,2386,2256,130,101,26,3,0
2021,Birmingham 100C,E01009288,1321,1120,201,95,71,28,7
2021,Birmingham 096E,E01009289,2514,2312,202,107,64,24,7
2021,Birmingham 096F,E01009290,2430,2291,139,83,40,11,5
2021,Birmingham 095D,E01009291,1414,1216,198,89,55,46,8
2021,Birmingham 099B,E01009292,1510,1227,283,138,93,42,10
2021,Birmingham 100D,E01009293,1497,1317,180,76,59,39,6
2021,Birmingham 099C,E01009294,1861,1667,194,104,56,30,4
2021,Birmingham 099D,E01009295,1668,1439,229,117,78,28,6
2021,Birmingham 100E,E01009296,1430,1173,257,120,98,34,5
2021,Birmingham 057A,E01009297,1747,1654,93,32,45,13,3
2021,Birmingham 054D,E01009298,1555,1376,179,80,65,28,6
2021,Birmingham 057B,E01009299,1525,1385,140,47,56,34,3
2021,Birmingham 057C,E01009300,1840,1609,231,82,90,47,12
2021,Birmingham 057D,E01009301,1581,1469,112,36,50,22,4
2021,Birmingham 069A,E01009302,1418,1386,32,12,14,5,1
2021,Birmingham 057E,E01009303,1456,1343,113,41,49,14,9
2021,Birmingham 046A,E01009304,1758,1680,78,37,30,9,2
2021,Birmingham 045C,E01009305,1596,1467,129,37,54,30,8
2021,Birmingham 046B,E01009306,1610,1521,89,46,31,10,2
2021,Birmingham 045D,E01009307,1487,1384,103,27,47,24,5
2021,Birmingham 046C,E01009308,1801,1720,81,36,35,9,1
2021,Birmingham 045E,E01009309,1759,1605,154,68,53,31,2
2021,Birmingham 046D,E01009310,1911,1813,98,37,43,16,2
2021,Birmingham 054E,E01009311,1559,1375,184,70,70,37,7
2021,Birmingham 072A,E01009312,1546,1460,86,31,31,16,8
2021,Birmingham 076D,E01009313,1602,1435,167,51,77,31,8
2021,Birmingham 069B,E01009314,1888,1718,170,74,59,29,8
2021,Birmingham 081A,E01009315,1686,1542,144,54,67,19,4
2021,Birmingham 081B,E01009316,1840,1649,191,79,74,32,6
2021,Birmingham 081C,E01009317,1957,1784,173,76,63,28,6
2021,Birmingham 081D,E01009318,1477,1408,69,24,30,13,2
2021,Birmingham 081E,E01009319,1507,1449,58,27,20,11,0
2021,Birmingham 081F,E01009320,1577,1477,100,42,31,20,7
2021,Birmingham 069C,E01009321,1880,1737,143,53,51,35,4
2021,Birmingham 069D,E01009322,1696,1552,144,40,62,32,10
2021,Birmingham 069E,E01009323,1759,1576,183,88,62,28,5
2021,Birmingham 072B,E01009324,1668,1588,80,23,36,20,1
2021,Birmingham 063A,E01009325,1914,1420,494,145,165,139,45
2021,Birmingham 066D,E01009326,2024,1511,513,154,174,157,28
2021,Birmingham 139B,E01009327,1582,1037,545,143,198,174,30
2021,Birmingham 139C,E01009328,2331,1642,689,162,224,226,77
2021,Birmingham 070A,E01009329,2547,1738,809,158,276,312,63
2021,Birmingham 139D,E01009331,2335,1606,729,163,277,231,58
2021,Birmingham 139E,E01009332,1845,1367,478,109,202,143,24
2021,Birmingham 139F,E01009333,1532,1026,506,136,174,163,33
2021,Birmingham 070B,E01009334,1761,1256,505,114,190,164,37
2021,Birmingham 139G,E01009335,1903,1285,618,154,218,207,39
2021,Birmingham 070C,E01009337,1868,1204,664,166,219,222,57
2021,Birmingham 070D,E01009338,1712,1162,550,112,193,194,51
2021,Birmingham 142A,E01009339,1575,1154,421,78,150,156,37
2021,Birmingham 066E,E01009341,1547,1128,419,108,164,124,23
2021,Birmingham 063D,E01009342,1778,1387,391,91,128,142,30
2021,Birmingham 063E,E01009343,1773,1145,628,161,220,203,44
2021,Birmingham 139H,E01009344,1733,1150,583,174,193,183,33
2021,Birmingham 053D,E01009345,2024,1623,401,87,178,109,27
2021,Birmingham 053E,E01009346,1620,1082,538,139,222,144,33
2021,Birmingham 049D,E01009347,1510,1223,287,96,116,67,8
2021,Birmingham 047A,E01009348,2006,1609,397,135,165,90,7
2021,Birmingham 036D,E01009349,1580,1037,543,141,192,179,31
2021,Birmingham 039B,E01009350,1572,1013,559,119,194,177,69
2021,Birmingham 036E,E01009351,1638,970,668,150,254,225,39
2021,Birmingham 039C,E01009352,1768,1195,573,100,249,190,34
2021,Birmingham 039D,E01009353,1658,1102,556,123,216,172,45
2021,Birmingham 036F,E01009354,1496,1020,476,96,176,169,35
2021,Birmingham 039E,E01009355,1376,996,380,81,155,114,30
2021,Birmingham 047B,E01009358,2149,1562,587,147,242,173,25
2021,Birmingham 047C,E01009359,1974,1304,670,155,276,208,31
2021,Birmingham 047D,E01009360,2631,1931,700,221,274,171,34
2021,Birmingham 047E,E01009361,2092,1425,667,154,261,206,46
2021,Birmingham 071A,E01009362,1345,958,387,89,164,119,15
2021,Birmingham 071B,E01009363,1692,1289,403,78,168,129,28
2021,Birmingham 071C,E01009364,1558,1095,463,123,194,125,21
2021,Birmingham 071D,E01009365,1783,1226,557,161,187,172,37
2021,Birmingham 084A,E01009366,1613,1145,468,113,159,167,29
2021,Birmingham 083A,E01009367,1689,1191,498,112,172,178,36
2021,Birmingham 077A,E01009368,1441,1070,371,78,125,137,31
2021,Birmingham 077D,E01009371,1852,1275,577,111,214,207,45
2021,Birmingham 082A,E01009372,1659,1132,527,122,166,195,44
2021,Birmingham 082B,E01009373,1671,1119,552,139,176,190,47
2021,Birmingham 084B,E01009374,1177,939,238,49,82,97,10
2021,Birmingham 083B,E01009375,1879,1345,534,136,192,160,46
2021,Birmingham 084C,E01009376,1517,1092,425,88,155,142,40
2021,Birmingham 083C,E01009377,1381,963,418,121,146,118,33
2021,Birmingham 071E,E01009379,1828,1310,518,154,178,147,39
2021,Birmingham 070E,E01009380,1754,1139,615,105,254,214,42
2021,Birmingham 142D,E01009382,1932,1402,530,115,224,152,39
2021,Birmingham 083D,E01009383,1341,1015,326,75,105,111,35
2021,Birmingham 092E,E01009384,1323,1150,173,60,60,49,4
2021,Birmingham 092F,E01009385,1160,1017,143,62,35,45,1
2021,Birmingham 093B,E01009389,1815,1395,420,97,149,141,33
2021,Birmingham 093C,E01009390,1529,1301,228,80,60,74,14
2021,Birmingham 143C,E01009391,1821,1170,651,183,229,192,47
2021,Birmingham 142E,E01009392,1644,1238,406,118,127,132,29
2021,Birmingham 143D,E01009393,1713,1134,579,175,196,175,33
2021,Birmingham 093D,E01009394,1679,1437,242,83,87,53,19
2021,Birmingham 097F,E01009395,1638,1287,351,92,135,95,29
2021,Birmingham 082D,E01009396,2035,1422,613,120,207,227,59
2021,Birmingham 077E,E01009397,1698,1191,507,82,192,202,31
2021,Birmingham 083E,E01009399,1574,1068,506,123,194,151,38
2021,Birmingham 031E,E01009400,1610,1352,258,71,118,45,24
2021,Birmingham 031F,E01009401,1771,1432,339,118,137,70,14
2021,Birmingham 020A,E01009403,1512,1321,191,69,88,32,2
2021,Birmingham 020B,E01009404,1529,1345,184,91,59,29,5
2021,Birmingham 020C,E01009405,1432,1235,197,82,73,36,6
2021,Birmingham 020D,E01009406,1672,1417,255,82,106,54,13
2021,Birmingham 020E,E01009407,1668,1397,271,95,95,71,10
2021,Birmingham 026B,E01009408,1700,1446,254,89,109,51,5
2021,Birmingham 026C,E01009409,1765,1372,393,122,172,83,16
2021,Birmingham 026D,E01009410,1847,1558,289,92,126,65,6
2021,Birmingham 030B,E01009411,1806,1508,298,115,125,49,9
2021,Birmingham 030C,E01009412,1721,1368,353,117,147,77,12
2021,Birmingham 030D,E01009413,1755,1376,379,111,167,85,16
2021,Birmingham 030E,E01009414,2256,1814,442,166,182,84,10
2021,Birmingham 002A,E01009415,1702,1639,63,39,10,8,6
2021,Birmingham 003A,E01009416,2696,2580,116,71,25,18,2
2021,Birmingham 001A,E01009417,1569,1503,66,45,15,5,1
2021,Birmingham 001B,E01009418,1547,1500,47,26,13,8,0
2021,Birmingham 001C,E01009419,1438,1372,66,26,27,12,1
2021,Birmingham 003B,E01009420,1650,1572,78,50,22,6,0
2021,Birmingham 004A,E01009421,1683,1617,66,36,18,12,0
2021,Birmingham 002B,E01009422,1952,1890,62,31,21,8,2
2021,Birmingham 002C,E01009423,1620,1561,59,25,18,11,5
2021,Birmingham 004B,E01009424,1528,1435,93,58,25,8,2
2021,Birmingham 002D,E01009425,1677,1625,52,31,12,8,1
2021,Birmingham 003C,E01009426,1445,1411,34,21,7,3,3
2021,Birmingham 004C,E01009427,1459,1381,78,43,19,14,2
2021,Birmingham 004D,E01009428,1645,1577,68,44,16,6,2
2021,Birmingham 003D,E01009429,1459,1397,62,42,16,4,0
2021,Birmingham 004E,E01009430,1693,1617,76,38,22,16,0
2021,Birmingham 003E,E01009431,1649,1579,70,33,19,16,2
2021,Birmingham 006A,E01009432,1445,1375,70,39,20,10,1
2021,Birmingham 001D,E01009433,1746,1661,85,46,29,9,1
2021,Birmingham 012A,E01009434,1600,1545,55,37,15,2,1
2021,Birmingham 006B,E01009435,1674,1622,52,24,18,10,0
2021,Birmingham 012B,E01009436,1358,1291,67,51,4,11,1
2021,Birmingham 006C,E01009437,1747,1674,73,37,25,8,3
2021,Birmingham 012C,E01009438,1314,1277,37,22,12,2,1
2021,Birmingham 021A,E01009439,1400,1357,43,27,13,0,3
2021,Birmingham 012D,E01009440,1531,1480,51,21,14,13,3
2021,Birmingham 021B,E01009441,1426,1385,41,21,17,3,0
2021,Birmingham 021C,E01009442,1416,1364,52,25,16,10,1
2021,Birmingham 021D,E01009443,1171,1094,77,47,26,4,0
2021,Birmingham 006D,E01009444,1457,1430,27,15,6,5,1
2021,Birmingham 005A,E01009445,1788,1716,72,26,33,10,3
2021,Birmingham 005B,E01009446,2395,2261,134,77,39,16,2
2021,Birmingham 005C,E01009447,1592,1506,86,43,35,8,0
2021,Birmingham 005D,E01009448,1600,1527,73,30,29,12,2
2021,Birmingham 009A,E01009449,2108,1975,133,69,41,17,6
2021,Birmingham 012E,E01009450,1550,1517,33,17,9,6,1
2021,Birmingham 009B,E01009451,1397,1330,67,42,16,8,1
2021,Birmingham 005E,E01009452,1653,1549,104,67,22,15,0
2021,Birmingham 009C,E01009453,1324,1276,48,22,14,6,6
2021,Birmingham 006E,E01009454,1395,1333,62,32,17,12,1
2021,Birmingham 005F,E01009455,1248,1210,38,20,12,6,0
2021,Birmingham 018C,E01009456,1665,1635,30,21,5,3,1
2021,Birmingham 015A,E01009457,1481,1433,48,23,13,10,2
2021,Birmingham 018D,E01009458,1357,1291,66,28,27,8,3
2021,Birmingham 015B,E01009459,1552,1491,61,26,20,15,0
2021,Birmingham 018E,E01009460,1551,1452,99,35,39,18,7
2021,Birmingham 015C,E01009461,1277,1207,70,43,16,8,3
2021,Birmingham 018F,E01009462,1529,1463,66,30,19,12,5
2021,Birmingham 015D,E01009463,1523,1429,94,55,30,7,2
2021,Birmingham 007B,E01009464,1374,1317,57,31,12,9,5
2021,Birmingham 007C,E01009465,1399,1349,50,19,16,14,1
2021,Birmingham 009D,E01009466,1649,1591,58,34,10,9,5
2021,Birmingham 007D,E01009467,1508,1434,74,33,29,9,3
2021,Birmingham 004F,E01009468,1465,1428,37,20,10,6,1
2021,Birmingham 010B,E01009469,1409,1304,105,46,37,21,1
2021,Birmingham 010C,E01009470,1390,1344,46,28,14,3,1
2021,Birmingham 009E,E01009471,1785,1709,76,43,21,10,2
2021,Birmingham 010D,E01009472,1618,1559,59,34,15,8,2
2021,Birmingham 010E,E01009473,1524,1404,120,62,38,17,3
2021,Birmingham 010F,E01009474,1520,1476,44,24,8,10,2
2021,Birmingham 055A,E01009475,2224,1727,497,121,197,152,27
2021,Birmingham 055B,E01009476,1998,1445,553,152,202,162,37
2021,Birmingham 055C,E01009477,1812,1403,409,128,123,130,28
2021,Birmingham 048A,E01009478,1996,1614,382,99,165,97,21
2021,Birmingham 048B,E01009479,2146,1589,557,109,189,204,55
2021,Birmingham 044C,E01009480,1993,1576,417,132,148,113,24
2021,Birmingham 044D,E01009481,2626,1934,692,226,211,205,50
2021,Birmingham 048C,E01009482,1654,1147,507,141,160,147,59
2021,Birmingham 051B,E01009483,1966,1269,697,177,223,227,70
2021,Birmingham 048D,E01009484,1730,1252,478,111,150,181,36
2021,Birmingham 048E,E01009485,1939,1382,557,147,167,200,43
2021,Birmingham 044E,E01009486,2120,1581,539,127,211,164,37
2021,Birmingham 044F,E01009487,2105,1571,534,130,193,159,52
2021,Birmingham 051C,E01009488,2449,1898,551,149,207,150,45
2021,Birmingham 051D,E01009489,2024,1414,610,133,212,220,45
2021,Birmingham 055D,E01009490,2052,1582,470,100,187,165,18
2021,Birmingham 051E,E01009491,2103,1515,588,141,196,193,58
2021,Birmingham 055E,E01009492,1926,1445,481,126,164,154,37
2021,Birmingham 113D,E01009493,1796,1559,237,91,85,59,2
2021,Birmingham 109A,E01009494,1645,1559,86,27,40,16,3
2021,Birmingham 106E,E01009495,1256,1181,75,29,24,18,4
2021,Birmingham 109B,E01009496,1416,1325,91,44,28,17,2
2021,Birmingham 109C,E01009497,1741,1583,158,59,71,24,4
2021,Birmingham 119D,E01009498,1651,1484,167,60,69,32,6
2021,Birmingham 119E,E01009499,1684,1560,124,61,50,8,5
2021,Birmingham 095E,E01009500,1460,1279,181,62,77,38,4
2021,Birmingham 101B,E01009501,1471,1290,181,61,90,25,5
2021,Birmingham 101C,E01009502,1392,1211,181,87,57,34,3
2021,Birmingham 101D,E01009503,1517,1379,138,43,55,37,3
2021,Birmingham 109D,E01009504,1570,1426,144,74,43,23,4
2021,Birmingham 101E,E01009505,1597,1438,159,66,59,23,11
2021,Birmingham 109E,E01009506,1454,1254,200,100,71,27,2
2021,Birmingham 056B,E01009507,1538,1290,248,94,94,53,7
2021,Birmingham 056C,E01009508,1579,1377,202,74,67,52,9
2021,Birmingham 056D,E01009509,1957,1562,395,135,148,91,21
2021,Birmingham 056E,E01009510,1654,1456,198,79,67,47,5
2021,Birmingham 054F,E01009511,1601,1363,238,68,94,62,14
2021,Birmingham 062A,E01009512,1919,1706,213,99,71,41,2
2021,Birmingham 066F,E01009513,1977,1604,373,148,134,68,23
2021,Birmingham 062B,E01009514,1664,1459,205,78,83,39,5
2021,Birmingham 067C,E01009515,1637,1435,202,99,60,36,7
2021,Birmingham 062C,E01009516,1382,1229,153,75,57,20,1
2021,Birmingham 062D,E01009517,1910,1726,184,72,71,30,11
2021,Birmingham 067D,E01009518,1673,1519,154,54,59,34,7
2021,Birmingham 072C,E01009519,1412,1365,47,22,23,2,0
2021,Birmingham 072D,E01009520,1713,1602,111,34,40,26,11
2021,Birmingham 067E,E01009521,1601,1445,156,54,58,36,8
2021,Coventry 014A,E01009522,1821,1581,240,111,85,38,6
2021,Coventry 010A,E01009523,1612,1580,32,21,8,3,0
2021,Coventry 006A,E01009524,1497,1411,86,33,33,18,2
2021,Coventry 006B,E01009525,1480,1241,239,113,86,32,8
2021,Coventry 010B,E01009526,1509,1460,49,24,16,7,2
2021,Coventry 006C,E01009527,1570,1453,117,64,31,18,4
2021,Coventry 010C,E01009528,2086,1987,99,49,43,7,0
2021,Coventry 014B,E01009529,1484,1390,94,49,31,14,0
2021,Coventry 014C,E01009530,1362,1318,44,16,19,9,0
2021,Coventry 010D,E01009531,1545,1464,81,36,31,13,1
2021,Coventry 033A,E01009532,1295,1214,81,41,29,9,2
2021,Coventry 033B,E01009535,1335,1226,109,59,40,10,0
2021,Coventry 033C,E01009536,1426,1298,128,61,51,14,2
2021,Coventry 035C,E01009537,1454,1328,126,67,42,16,1
2021,Coventry 035D,E01009538,1490,1386,104,54,35,14,1
2021,Coventry 039A,E01009539,1968,1641,327,147,127,45,8
2021,Coventry 039B,E01009540,1924,1521,403,176,166,55,6
2021,Coventry 039C,E01009541,1611,1416,195,85,89,16,5
2021,Coventry 039D,E01009542,1816,1519,297,135,110,35,17
2021,Coventry 033D,E01009543,1738,1570,168,92,44,29,3
2021,Coventry 038A,E01009544,1507,1243,264,150,76,31,7
2021,Coventry 031A,E01009548,2709,1994,715,369,265,75,6
2021,Coventry 037B,E01009549,1576,1355,221,134,63,23,1
2021,Coventry 037C,E01009550,1655,1320,335,171,111,51,2
2021,Coventry 037E,E01009552,1526,1282,244,134,76,34,0
2021,Coventry 031B,E01009553,1895,1378,517,291,165,54,7
2021,Coventry 034A,E01009554,1312,1212,100,51,42,7,0
2021,Coventry 034B,E01009555,1443,1368,75,45,20,8,2
2021,Coventry 034C,E01009556,1467,1329,138,108,21,8,1
2021,Coventry 034D,E01009557,1363,1292,71,45,18,5,3
2021,Coventry 034E,E01009558,1369,1288,81,55,18,7,1
2021,Coventry 034F,E01009559,1334,1243,91,53,23,13,2
2021,Coventry 040A,E01009560,1441,1274,167,104,33,21,9
2021,Coventry 040B,E01009561,1556,1395,161,80,46,31,4
2021,Coventry 040C,E01009562,1554,1349,205,126,54,22,3
2021,Coventry 040D,E01009563,1660,1495,165,90,49,23,3
2021,Coventry 005A,E01009564,1995,1284,711,225,290,167,29
2021,Coventry 009A,E01009565,1704,1051,653,200,230,172,51
2021,Coventry 009B,E01009566,1896,1342,554,208,209,122,15
2021,Coventry 009C,E01009567,1638,1019,619,170,262,159,28
2021,Coventry 009D,E01009568,1795,1085,710,222,264,194,30
2021,Coventry 015A,E01009569,1286,782,504,156,220,112,16
2021,Coventry 015B,E01009570,2158,1395,763,227,278,236,22
2021,Coventry 015C,E01009571,1539,1006,533,158,210,143,22
2021,Coventry 015E,E01009573,1404,940,464,120,177,140,27
2021,Coventry 015F,E01009574,1514,1023,491,160,192,122,17
2021,Coventry 005B,E01009575,1264,844,420,153,143,106,18
2021,Coventry 008A,E01009576,1553,1386,167,99,50,14,4
2021,Coventry 007A,E01009577,1646,1243,403,152,175,67,9
2021,Coventry 008B,E01009578,1349,1185,164,83,49,28,4
2021,Coventry 007B,E01009579,2133,1747,386,168,155,54,9
2021,Coventry 019A,E01009580,1297,1050,247,152,72,22,1
2021,Coventry 007C,E01009581,1704,1436,268,120,102,43,3
2021,Coventry 008C,E01009582,1634,1440,194,110,65,16,3
2021,Coventry 008D,E01009583,1544,1281,263,141,95,22,5
2021,Coventry 007D,E01009584,1999,1776,223,95,90,35,3
2021,Coventry 007E,E01009585,1779,1184,595,245,252,83,15
2021,Coventry 008E,E01009586,1773,1615,158,71,63,24,0
2021,Coventry 011A,E01009587,2200,1669,531,202,224,94,11
2021,Coventry 043A,E01009588,1541,1275,266,121,98,41,6
2021,Coventry 001A,E01009589,1608,1343,265,102,96,57,10
2021,Coventry 002A,E01009590,1480,1402,78,39,29,8,2
2021,Coventry 002B,E01009591,1533,1315,218,70,97,40,11
2021,Coventry 043B,E01009592,1647,1194,453,196,171,76,10
2021,Coventry 002C,E01009593,1604,1290,314,119,125,60,10
2021,Coventry 006D,E01009594,1437,1333,104,43,40,18,3
2021,Coventry 043C,E01009596,1981,1460,521,225,195,80,21
2021,Coventry 043D,E01009597,1822,1375,447,180,163,87,17
2021,Coventry 002D,E01009598,2061,1675,386,178,148,56,4
2021,Coventry 013A,E01009599,1063,956,107,49,37,18,3
2021,Coventry 004A,E01009604,1389,1086,303,101,130,57,15
2021,Coventry 004B,E01009605,1680,1459,221,102,79,37,3
2021,Coventry 005C,E01009606,2118,1595,523,213,208,86,16
2021,Coventry 004C,E01009607,1541,1266,275,87,122,56,10
2021,Coventry 004D,E01009608,1562,1245,317,107,146,58,6
2021,Coventry 005D,E01009609,1498,1106,392,144,154,81,13
2021,Coventry 004E,E01009610,1456,1148,308,121,117,57,13
2021,Coventry 035F,E01009612,1477,1173,304,142,109,47,6
2021,Coventry 018A,E01009613,1264,1123,141,66,50,25,0
2021,Coventry 021A,E01009614,1412,1225,187,95,58,32,2
2021,Coventry 027A,E01009615,1659,1282,377,150,157,61,9
2021,Coventry 027B,E01009616,1509,1247,262,109,89,62,2
2021,Coventry 027C,E01009617,1203,999,204,86,63,48,7
2021,Coventry 027D,E01009618,1629,1499,130,49,50,27,4
2021,Coventry 027E,E01009620,2670,2278,392,195,133,58,6
2021,Coventry 027F,E01009621,1396,1057,339,135,103,92,9
2021,Coventry 012A,E01009622,1769,1498,271,104,117,49,1
2021,Coventry 012B,E01009623,1517,1270,247,102,93,50,2
2021,Coventry 011B,E01009624,1499,1082,417,148,165,90,14
2021,Coventry 011C,E01009625,2334,1781,553,234,222,87,10
2021,Coventry 011D,E01009626,1639,1309,330,127,132,62,9
2021,Coventry 012C,E01009627,1713,1235,478,212,163,88,15
2021,Coventry 012D,E01009628,1511,1331,180,78,71,31,0
2021,Coventry 020B,E01009630,1749,1375,374,162,139,65,8
2021,Coventry 020C,E01009631,1507,1135,372,130,146,89,7
2021,Coventry 020D,E01009632,1751,1244,507,223,193,84,7
2021,Coventry 028A,E01009633,1998,1438,560,233,233,79,15
2021,Coventry 028B,E01009634,2057,1412,645,303,227,106,9
2021,Coventry 024A,E01009636,2408,1582,826,338,333,141,14
2021,Coventry 024B,E01009637,1655,1086,569,150,232,148,39
2021,Coventry 024C,E01009638,1755,1172,583,163,262,139,19
2021,Coventry 024D,E01009639,1653,1020,633,169,247,182,35
2021,Coventry 024E,E01009640,1999,1272,727,244,288,181,14
2021,Coventry 024F,E01009641,3236,2378,858,421,297,123,17
2021,Coventry 017A,E01009643,1362,1300,62,35,19,7,1
2021,Coventry 017B,E01009644,1559,1477,82,38,29,15,0
2021,Coventry 014D,E01009645,1397,1280,117,55,42,16,4
2021,Coventry 022A,E01009646,1455,1388,67,30,24,12,1
2021,Coventry 017C,E01009647,1820,1546,274,148,81,36,9
2021,Coventry 017D,E01009648,1465,1355,110,52,37,19,2
2021,Coventry 026A,E01009649,1378,1282,96,36,45,11,4
2021,Coventry 020E,E01009650,1492,1067,425,190,142,80,13
2021,Coventry 031D,E01009651,1484,1153,331,122,129,72,8
2021,Coventry 017E,E01009652,1427,1385,42,29,11,2,0
2021,Coventry 017F,E01009653,1535,1458,77,39,22,10,6
2021,Coventry 021B,E01009654,1755,1521,234,93,90,44,7
2021,Coventry 016A,E01009655,1984,1512,472,181,222,62,7
2021,Coventry 016B,E01009656,1574,1234,340,113,145,71,11
2021,Coventry 018B,E01009657,1578,1347,231,86,90,49,6
2021,Coventry 021C,E01009658,1650,1241,409,181,132,78,18
2021,Coventry 016C,E01009659,1756,1131,625,196,279,123,27
2021,Coventry 021D,E01009660,1665,1148,517,164,237,103,13
2021,Coventry 028D,E01009661,1968,1280,688,268,251,156,13
2021,Coventry 016D,E01009662,1366,1013,353,127,142,69,15
2021,Coventry 013B,E01009663,1400,1186,214,100,70,42,2
2021,Coventry 016E,E01009664,1528,1297,231,94,84,51,2
2021,Coventry 042A,E01009665,1255,1079,176,95,61,19,1
2021,Coventry 041A,E01009666,1358,1216,142,101,23,13,5
2021,Coventry 041B,E01009667,1292,1086,206,127,47,25,7
2021,Coventry 041C,E01009668,1600,1442,158,99,32,16,11
2021,Coventry 042B,E01009669,1262,1164,98,61,28,8,1
2021,Coventry 041D,E01009670,1639,1475,164,103,44,14,3
2021,Coventry 042C,E01009671,4102,3334,768,525,206,32,5
2021,Coventry 040E,E01009672,2084,1842,242,144,66,29,3
2021,Coventry 029A,E01009674,1655,1440,215,99,86,27,3
2021,Coventry 032A,E01009676,1586,1433,153,67,67,14,5
2021,Coventry 036C,E01009679,2172,1839,333,169,107,43,14
2021,Coventry 032B,E01009681,1266,1194,72,43,25,2,2
2021,Coventry 032C,E01009682,1396,1318,78,39,25,11,3
2021,Coventry 032D,E01009683,1823,1510,313,154,112,42,5
2021,Coventry 026B,E01009684,1431,1315,116,53,47,13,3
2021,Coventry 026C,E01009685,1562,1506,56,29,13,10,4
2021,Coventry 026D,E01009686,1633,1508,125,45,60,16,4
2021,Coventry 026E,E01009687,1353,1248,105,52,30,19,4
2021,Coventry 030A,E01009688,1452,1199,253,122,79,44,8
2021,Coventry 030B,E01009689,1620,1379,241,122,69,44,6
2021,Coventry 030C,E01009690,1425,1226,199,124,57,14,4
2021,Coventry 030D,E01009691,1262,1081,181,88,61,22,10
2021,Coventry 022B,E01009692,1155,1120,35,22,7,4,2
2021,Coventry 022C,E01009693,1437,1368,69,38,20,11,0
2021,Coventry 022D,E01009694,1391,1331,60,33,18,6,3
2021,Coventry 023A,E01009695,1544,1492,52,31,13,4,4
2021,Coventry 023B,E01009696,1396,1334,62,31,21,8,2
2021,Coventry 025A,E01009697,1966,1883,83,55,19,7,2
2021,Coventry 025B,E01009698,1449,1423,26,12,12,2,0
2021,Coventry 029B,E01009699,1391,1303,88,40,36,12,0
2021,Coventry 029C,E01009700,1612,1458,154,58,71,22,3
2021,Coventry 029D,E01009701,1446,1308,138,68,47,21,2
2021,Coventry 029E,E01009702,1577,1406,171,73,72,26,0
2021,Coventry 023C,E01009704,1365,1309,56,33,14,7,2
2021,Coventry 023D,E01009705,1323,1251,72,42,19,11,0
2021,Coventry 025D,E01009706,1430,1407,23,10,7,4,2
2021,Coventry 033E,E01009707,1768,1645,123,78,33,12,0
2021,Coventry 033F,E01009708,1381,1235,146,64,52,26,4
2021,Coventry 007F,E01009709,1188,962,226,81,85,46,14
2021,Coventry 013C,E01009710,1251,1073,178,98,59,20,1
2021,Coventry 013D,E01009711,1836,1635,201,96,75,25,5
2021,Coventry 018C,E01009712,1480,1289,191,88,76,21,6
2021,Coventry 019B,E01009713,1411,1256,155,68,57,26,4
2021,Coventry 018D,E01009714,1445,1308,137,64,52,19,2
2021,Coventry 019C,E01009715,1373,1144,229,137,55,32,5
2021,Coventry 018E,E01009716,1645,1453,192,80,69,39,4
2021,Coventry 019D,E01009717,1444,1253,191,92,65,34,0
2021,Coventry 019E,E01009718,1774,1551,223,93,93,34,3
2021,Dudley 027A,E01009719,1351,1326,25,12,11,1,1
2021,Dudley 028A,E01009720,1263,1245,18,4,10,2,2
2021,Dudley 031A,E01009721,2313,2267,46,19,16,9,2
2021,Dudley 027B,E01009722,1266,1255,11,3,7,1,0
2021,Dudley 028B,E01009723,1155,1145,10,2,3,3,2
2021,Dudley 028C,E01009724,1414,1408,6,1,2,3,0
2021,Dudley 031B,E01009725,1403,1352,51,13,24,13,1
2021,Dudley 031C,E01009726,1240,1221,19,8,9,1,1
2021,Dudley 027C,E01009727,1289,1265,24,7,15,1,1
2021,Dudley 027D,E01009728,1194,1180,14,4,3,5,2
2021,Dudley 027E,E01009729,1504,1475,29,10,12,7,0
2021,Dudley 028D,E01009730,1433,1413,20,9,8,0,3
2021,Dudley 023A,E01009731,1542,1505,37,14,9,13,1
2021,Dudley 039A,E01009732,1813,1710,103,29,38,24,12
2021,Dudley 039B,E01009733,1755,1574,181,51,64,57,9
2021,Dudley 034A,E01009734,1543,1461,82,32,27,20,3
2021,Dudley 034B,E01009735,1610,1575,35,14,13,7,1
2021,Dudley 034C,E01009736,1354,1315,39,24,9,6,0
2021,Dudley 034D,E01009737,1481,1441,40,22,8,7,3
2021,Dudley 034E,E01009738,1628,1538,90,25,34,27,4
2021,Dudley 039C,E01009739,1494,1441,53,23,14,15,1
2021,Dudley 023B,E01009740,2036,1980,56,22,21,11,2
2021,Dudley 022A,E01009741,1967,1786,181,48,88,43,2
2021,Dudley 023C,E01009742,1494,1479,15,6,5,4,0
2021,Dudley 023D,E01009743,1762,1719,43,13,23,3,4
2021,Dudley 022B,E01009744,2073,1939,134,31,57,42,4
2021,Dudley 023E,E01009745,1648,1632,16,5,6,4,1
2021,Dudley 022C,E01009746,1890,1650,240,68,90,69,13
2021,Dudley 022D,E01009747,1480,1407,73,17,31,25,0
2021,Dudley 013A,E01009748,1600,1517,83,34,31,12,6
2021,Dudley 016A,E01009749,2269,2208,61,23,27,6,5
2021,Dudley 016B,E01009750,1450,1404,46,17,18,10,1
2021,Dudley 017A,E01009751,1471,1413,58,24,24,10,0
2021,Dudley 017B,E01009752,1561,1500,61,17,31,12,1
2021,Dudley 017C,E01009753,1529,1452,77,26,27,20,4
2021,Dudley 017D,E01009754,1639,1551,88,29,39,13,7
2021,Dudley 006B,E01009756,1487,1304,183,87,71,19,6
2021,Dudley 006C,E01009757,2055,1872,183,76,66,37,4
2021,Dudley 005A,E01009758,1719,1635,84,40,32,11,1
2021,Dudley 006D,E01009759,1233,1205,28,8,15,4,1
2021,Dudley 005B,E01009760,1277,1235,42,20,12,9,1
2021,Dudley 006F,E01009762,1418,1357,61,17,31,11,2
2021,Dudley 001A,E01009763,2117,2047,70,25,23,20,2
2021,Dudley 001B,E01009764,1446,1407,39,21,6,9,3
2021,Dudley 004A,E01009765,1551,1518,33,12,11,8,2
2021,Dudley 004B,E01009766,1514,1477,37,17,16,2,2
2021,Dudley 001C,E01009767,1453,1397,56,30,15,11,0
2021,Dudley 004C,E01009768,1334,1273,61,21,26,10,4
2021,Dudley 001D,E01009769,1756,1633,123,48,46,25,4
2021,Dudley 001E,E01009770,1402,1321,81,33,27,17,4
2021,Dudley 004D,E01009771,1386,1366,20,11,6,3,0
2021,Dudley 005C,E01009772,1255,1236,19,13,4,2,0
2021,Dudley 002A,E01009773,1499,1476,23,7,9,5,2
2021,Dudley 005D,E01009774,1573,1546,27,9,7,11,0
2021,Dudley 004E,E01009775,1449,1376,73,31,28,12,2
2021,Dudley 004F,E01009776,1513,1481,32,9,14,7,2
2021,Dudley 002B,E01009777,1530,1500,30,15,6,6,3
2021,Dudley 002C,E01009778,1542,1508,34,12,11,8,3
2021,Dudley 008A,E01009779,1355,1328,27,6,11,5,5
2021,Dudley 009A,E01009780,2085,1987,98,61,24,12,1
2021,Dudley 007A,E01009781,1860,1825,35,9,13,13,0
2021,Dudley 008B,E01009782,1801,1767,34,19,9,2,4
2021,Dudley 008C,E01009783,1419,1405,14,5,6,3,0
2021,Dudley 009B,E01009784,1517,1465,52,32,8,9,3
2021,Dudley 008D,E01009785,1452,1437,15,9,2,4,0
2021,Dudley 007B,E01009786,1385,1343,42,18,8,14,2
2021,Dudley 009C,E01009787,1438,1413,25,11,6,8,0
2021,Dudley 005E,E01009788,1528,1480,48,24,14,9,1
2021,Dudley 007C,E01009789,1398,1382,16,9,3,4,0
2021,Dudley 007D,E01009790,1550,1518,32,14,8,7,3
2021,Dudley 026A,E01009791,1500,1419,81,30,34,11,6
2021,Dudley 026B,E01009792,1534,1395,139,42,59,30,8
2021,Dudley 030A,E01009793,1516,1453,63,33,16,12,2
2021,Dudley 030B,E01009794,1471,1387,84,31,33,19,1
2021,Dudley 026C,E01009795,1645,1433,212,57,73,62,20
2021,Dudley 026D,E01009796,1573,1464,109,40,40,19,10
2021,Dudley 030C,E01009797,1321,1271,50,22,18,7,3
2021,Dudley 026E,E01009798,2284,2114,170,62,53,46,9
2021,Dudley 039D,E01009799,1429,1409,20,15,3,2,0
2021,Dudley 036A,E01009800,1493,1445,48,21,14,10,3
2021,Dudley 030D,E01009801,1733,1684,49,20,14,13,2
2021,Dudley 036B,E01009802,1699,1643,56,31,19,5,1
2021,Dudley 036C,E01009803,1542,1509,33,16,8,9,0
2021,Dudley 036D,E01009804,1234,1221,13,8,2,2,1
2021,Dudley 039E,E01009805,1415,1397,18,10,4,4,0
2021,Dudley 039F,E01009806,1427,1386,41,20,12,6,3
2021,Dudley 043A,E01009807,1830,1801,29,13,14,1,1
2021,Dudley 043B,E01009808,1337,1321,16,10,5,1,0
2021,Dudley 033A,E01009809,1631,1521,110,41,36,26,7
2021,Dudley 043C,E01009810,1760,1714,46,12,14,18,2
2021,Dudley 043D,E01009811,1444,1428,16,7,4,4,1
2021,Dudley 043E,E01009812,1475,1461,14,2,10,2,0
2021,Dudley 033B,E01009813,1531,1437,94,47,25,18,4
2021,Dudley 014A,E01009814,1256,1254,2,1,0,0,1
2021,Dudley 014B,E01009815,1242,1231,11,5,2,4,0
2021,Dudley 012A,E01009816,1615,1594,21,11,7,2,1
2021,Dudley 012B,E01009817,1227,1218,9,4,3,2,0
2021,Dudley 014C,E01009818,1199,1181,18,6,7,3,2
2021,Dudley 012C,E01009819,1458,1424,34,7,11,12,4
2021,Dudley 012D,E01009820,1473,1458,15,9,2,4,0
2021,Dudley 014D,E01009821,1280,1275,5,3,2,0,0
2021,Dudley 014E,E01009822,1460,1439,21,5,11,4,1
2021,Dudley 016C,E01009823,1279,1270,9,3,4,2,0
2021,Dudley 016D,E01009824,1817,1786,31,11,17,3,0
2021,Dudley 019A,E01009825,1398,1383,15,7,4,3,1
2021,Dudley 019B,E01009826,1407,1402,5,4,1,0,0
2021,Dudley 019C,E01009827,1589,1583,6,0,3,3,0
2021,Dudley 019D,E01009828,1263,1247,16,6,6,4,0
2021,Dudley 019E,E01009829,1463,1440,23,12,5,4,2
2021,Dudley 019F,E01009830,1629,1611,18,11,4,2,1
2021,Dudley 037A,E01009831,1413,1366,47,16,17,11,3
2021,Dudley 042A,E01009832,1674,1607,67,31,24,11,1
2021,Dudley 032A,E01009833,1502,1170,332,72,142,88,30
2021,Dudley 031D,E01009834,1601,1513,88,29,37,21,1
2021,Dudley 032B,E01009835,1658,1475,183,32,81,51,19
2021,Dudley 037B,E01009836,1801,1484,317,106,107,92,12
2021,Dudley 037C,E01009837,1545,1306,239,62,96,67,14
2021,Dudley 037D,E01009838,1642,1547,95,40,36,17,2
2021,Dudley 013B,E01009839,1747,1535,212,87,69,48,8
2021,Dudley 018A,E01009840,1444,1174,270,71,111,78,10
2021,Dudley 017E,E01009841,1533,1394,139,48,51,37,3
2021,Dudley 018B,E01009842,1453,1305,148,39,48,46,15
2021,Dudley 018C,E01009843,1450,1399,51,20,20,9,2
2021,Dudley 011A,E01009844,1529,1305,224,60,86,70,8
2021,Dudley 041A,E01009845,1520,1488,32,25,5,1,1
2021,Dudley 041B,E01009846,1471,1456,15,6,2,4,3
2021,Dudley 038A,E01009847,1449,1443,6,1,3,2,0
2021,Dudley 038B,E01009848,1322,1310,12,6,3,3,0
2021,Dudley 038C,E01009849,1541,1523,18,10,8,0,0
2021,Dudley 041C,E01009850,1450,1433,17,11,3,2,1
2021,Dudley 038D,E01009851,1437,1425,12,7,3,1,1
2021,Dudley 041D,E01009852,1382,1355,27,10,8,8,1
2021,Dudley 042B,E01009853,1340,1325,15,8,3,4,0
2021,Dudley 040A,E01009854,1467,1430,37,22,12,3,0
2021,Dudley 042C,E01009855,1623,1533,90,51,29,8,2
2021,Dudley 035A,E01009856,1966,1860,106,56,26,20,4
2021,Dudley 040B,E01009857,1639,1550,89,24,30,32,3
2021,Dudley 040C,E01009858,1457,1424,33,20,8,5,0
2021,Dudley 040D,E01009859,1506,1469,37,22,14,0,1
2021,Dudley 042D,E01009860,1478,1433,45,14,19,10,2
2021,Dudley 033C,E01009861,1582,1507,75,21,23,24,7
2021,Dudley 033D,E01009862,1776,1712,64,15,29,16,4
2021,Dudley 033E,E01009863,1875,1803,72,24,19,25,4
2021,Dudley 025A,E01009864,1476,1426,50,25,13,10,2
2021,Dudley 025B,E01009865,1500,1471,29,10,6,10,3
2021,Dudley 025C,E01009866,1618,1559,59,22,24,9,4
2021,Dudley 025D,E01009867,1668,1628,40,6,21,10,3
2021,Dudley 033F,E01009868,1450,1349,101,32,43,22,4
2021,Dudley 032C,E01009869,1483,1447,36,8,17,9,2
2021,Dudley 032D,E01009870,1412,1386,26,10,10,5,1
2021,Dudley 018D,E01009871,1924,1830,94,37,31,20,6
2021,Dudley 020A,E01009872,1293,1224,69,17,35,17,0
2021,Dudley 020B,E01009873,1500,1424,76,34,26,15,1
2021,Dudley 020C,E01009874,1549,1491,58,19,25,13,1
2021,Dudley 018E,E01009875,1491,1434,57,34,20,2,1
2021,Dudley 020D,E01009876,1583,1535,48,12,16,11,9
2021,Dudley 020E,E01009877,1562,1524,38,11,14,12,1
2021,Dudley 025E,E01009878,2150,2110,40,20,7,11,2
2021,Dudley 011B,E01009879,2302,2062,240,97,69,64,10
2021,Dudley 009D,E01009880,1503,1434,69,35,24,10,0
2021,Dudley 009E,E01009882,1386,1302,84,36,28,17,3
2021,Dudley 013C,E01009883,1480,1417,63,25,24,13,1
2021,Dudley 013D,E01009884,1381,1235,146,82,52,12,0
2021,Dudley 011D,E01009885,1553,1299,254,93,81,70,10
2021,Dudley 013E,E01009886,1899,1805,94,33,45,11,5
2021,Dudley 015A,E01009887,1784,1574,210,62,86,53,9
2021,Dudley 015B,E01009888,1693,1586,107,36,42,20,9
2021,Dudley 015C,E01009889,2674,2105,569,155,231,150,33
2021,Dudley 015D,E01009890,1768,1618,150,44,66,30,10
2021,Dudley 010A,E01009891,1772,1537,235,64,103,63,5
2021,Dudley 010B,E01009892,1565,1263,302,69,126,90,17
2021,Dudley 010C,E01009893,1808,1435,373,87,164,83,39
2021,Dudley 010D,E01009894,1645,1489,156,51,67,35,3
2021,Dudley 002D,E01009895,1349,1327,22,13,5,4,0
2021,Dudley 003A,E01009896,1405,1389,16,7,7,2,0
2021,Dudley 003B,E01009897,1375,1359,16,8,7,1,0
2021,Dudley 003C,E01009898,1418,1402,16,7,6,3,0
2021,Dudley 008E,E01009899,1341,1335,6,3,3,0,0
2021,Dudley 008F,E01009900,1370,1367,3,1,1,1,0
2021,Dudley 003D,E01009901,1370,1338,32,14,11,5,2
2021,Dudley 003E,E01009902,1185,1170,15,5,5,4,1
2021,Dudley 029A,E01009903,1374,1371,3,2,0,1,0
2021,Dudley 029B,E01009904,1333,1323,10,7,3,0,0
2021,Dudley 035B,E01009905,1386,1369,17,7,8,0,2
2021,Dudley 035C,E01009906,1667,1635,32,14,10,8,0
2021,Dudley 035D,E01009907,1414,1390,24,12,7,5,0
2021,Dudley 035E,E01009908,1530,1519,11,5,4,2,0
2021,Dudley 029C,E01009909,1394,1377,17,9,6,1,1
2021,Dudley 029D,E01009910,1487,1478,9,3,5,1,0
2021,Dudley 021A,E01009911,1209,1201,8,2,3,3,0
2021,Dudley 021B,E01009912,1948,1932,16,9,7,0,0
2021,Dudley 021C,E01009913,1477,1465,12,2,5,5,0
2021,Dudley 021D,E01009914,1314,1307,7,3,1,2,1
2021,Dudley 021E,E01009915,1624,1612,12,5,4,3,0
2021,Dudley 021F,E01009916,1633,1618,15,9,5,1,0
2021,Dudley 024A,E01009917,1156,1151,5,3,0,1,1
2021,Dudley 024B,E01009918,1386,1377,9,5,4,0,0
2021,Dudley 024C,E01009919,1112,1103,9,6,3,0,0
2021,Dudley 024D,E01009920,1554,1527,27,15,7,3,2
2021,Sandwell 034A,E01009921,1704,1239,465,154,214,88,9
2021,Sandwell 034B,E01009922,1322,1177,145,44,76,21,4
2021,Sandwell 036A,E01009923,1462,1307,155,72,45,35,3
2021,Sandwell 034C,E01009924,1377,1247,130,45,60,18,7
2021,Sandwell 034D,E01009925,1426,1339,87,35,34,17,1
2021,Sandwell 034E,E01009926,1358,1216,142,56,52,30,4
2021,Sandwell 034F,E01009927,1463,1229,234,90,89,46,9
2021,Sandwell 034G,E01009928,1653,1259,394,150,140,90,14
2021,Sandwell 033A,E01009929,1693,1575,118,40,55,21,2
2021,Sandwell 033B,E01009930,1499,1417,82,37,26,13,6
2021,Sandwell 033C,E01009931,2296,2206,90,33,35,20,2
2021,Sandwell 033D,E01009932,1556,1428,128,43,47,36,2
2021,Sandwell 035A,E01009933,1367,1285,82,25,27,24,6
2021,Sandwell 027A,E01009934,1412,1247,165,77,46,37,5
2021,Sandwell 027B,E01009935,2154,1873,281,124,98,50,9
2021,Sandwell 027C,E01009936,1500,1435,65,29,27,7,2
2021,Sandwell 032A,E01009937,1583,1443,140,55,44,33,8
2021,Sandwell 031A,E01009938,1780,1607,173,49,85,36,3
2021,Sandwell 032B,E01009939,1643,1471,172,68,65,32,7
2021,Sandwell 032C,E01009940,1500,1374,126,42,65,15,4
2021,Sandwell 032D,E01009941,1535,1308,227,76,86,59,6
2021,Sandwell 032E,E01009942,1698,1518,180,75,74,26,5
2021,Sandwell 031B,E01009943,1572,1349,223,60,93,57,13
2021,Sandwell 031C,E01009944,1792,1516,276,89,117,57,13
2021,Sandwell 039A,E01009946,1772,1493,279,100,101,70,8
2021,Sandwell 017A,E01009947,2300,1874,426,176,157,77,16
2021,Sandwell 039B,E01009948,1459,1292,167,55,70,36,6
2021,Sandwell 039C,E01009949,1556,1387,169,70,40,46,13
2021,Sandwell 039D,E01009950,1678,1496,182,57,66,53,6
2021,Sandwell 039E,E01009951,2137,1774,363,116,159,75,13
2021,Sandwell 035B,E01009952,2091,1918,173,32,69,55,17
2021,Sandwell 038A,E01009953,2013,1926,87,28,33,21,5
2021,Sandwell 038B,E01009954,1794,1746,48,21,15,9,3
2021,Sandwell 035C,E01009955,2185,1879,306,60,125,105,16
2021,Sandwell 035D,E01009956,1577,1490,87,30,36,19,2
2021,Sandwell 038C,E01009957,1786,1636,150,43,68,35,4
2021,Sandwell 038D,E01009958,1540,1507,33,9,14,6,4
2021,Sandwell 035E,E01009959,1401,1384,17,6,4,2,5
2021,Sandwell 003A,E01009960,1528,1406,122,38,54,21,9
2021,Sandwell 003B,E01009961,1206,1165,41,11,17,11,2
2021,Sandwell 004A,E01009962,1324,1256,68,22,32,11,3
2021,Sandwell 004B,E01009963,1329,1240,89,27,36,21,5
2021,Sandwell 004C,E01009964,1552,1424,128,48,46,29,5
2021,Sandwell 004D,E01009965,1314,1178,136,41,69,22,4
2021,Sandwell 003C,E01009966,1186,1086,100,29,45,25,1
2021,Sandwell 003D,E01009967,1812,1678,134,54,52,24,4
2021,Sandwell 006A,E01009968,1490,1333,157,62,58,30,7
2021,Sandwell 002A,E01009969,2026,1801,225,92,77,42,14
2021,Sandwell 002B,E01009970,1730,1578,152,57,64,24,7
2021,Sandwell 002C,E01009971,1632,1517,115,39,50,22,4
2021,Sandwell 006B,E01009972,1862,1721,141,58,55,21,7
2021,Sandwell 002D,E01009973,2322,1823,499,203,165,109,22
2021,Sandwell 006C,E01009974,1637,1478,159,62,55,36,6
2021,Sandwell 006D,E01009975,1648,1520,128,58,33,28,9
2021,Sandwell 016A,E01009976,2630,2268,362,141,133,71,17
2021,Sandwell 016B,E01009977,1915,1494,421,155,173,72,21
2021,Sandwell 014A,E01009978,1819,1702,117,43,34,35,5
2021,Sandwell 016C,E01009979,1971,1553,418,89,132,145,52
2021,Sandwell 016D,E01009980,2261,1872,389,115,142,109,23
2021,Sandwell 018A,E01009981,2005,1698,307,106,107,76,18
2021,Sandwell 009A,E01009982,1541,1355,186,74,77,27,8
2021,Sandwell 009B,E01009983,1535,1472,63,18,25,14,6
2021,Sandwell 018C,E01009985,1744,1304,440,129,151,132,28
2021,Sandwell 019A,E01009986,1631,1043,588,199,181,157,51
2021,Sandwell 019B,E01009987,1434,971,463,97,142,178,46
2021,Sandwell 020A,E01009988,2713,2027,686,242,281,145,18
2021,Sandwell 019C,E01009989,1920,1335,585,156,232,169,28
2021,Sandwell 010A,E01009991,2281,1825,456,160,172,103,21
2021,Sandwell 017B,E01009992,1751,1223,528,178,181,141,28
2021,Sandwell 017C,E01009993,1893,1459,434,132,167,117,18
2021,Sandwell 010B,E01009994,1700,1444,256,68,91,68,29
2021,Sandwell 010C,E01009995,1545,1404,141,46,56,36,3
2021,Sandwell 010D,E01009996,1591,1404,187,56,76,45,10
2021,Sandwell 010E,E01009997,1712,1460,252,80,90,67,15
2021,Sandwell 010F,E01009998,2096,1720,376,111,153,87,25
2021,Sandwell 033E,E01009999,1418,1247,171,77,54,29,11
2021,Sandwell 030A,E01010000,1769,1596,173,59,50,59,5
2021,Sandwell 037A,E01010001,1875,1689,186,78,78,25,5
2021,Sandwell 030B,E01010002,2125,1826,299,93,141,50,15
2021,Sandwell 030C,E01010003,1449,1204,245,69,101,66,9
2021,Sandwell 027D,E01010004,1798,1598,200,67,77,44,12
2021,Sandwell 030D,E01010005,1591,1331,260,81,84,78,17
2021,Sandwell 030E,E01010006,1690,1477,213,82,68,55,8
2021,Sandwell 012A,E01010007,1331,1082,249,94,99,48,8
2021,Sandwell 011A,E01010008,1606,1425,181,49,84,42,6
2021,Sandwell 012B,E01010009,1408,1215,193,79,81,29,4
2021,Sandwell 011B,E01010010,1422,1190,232,88,78,61,5
2021,Sandwell 011C,E01010011,1706,1508,198,64,62,65,7
2021,Sandwell 011D,E01010012,1375,1287,88,42,33,11,2
2021,Sandwell 012C,E01010013,1291,1126,165,59,58,42,6
2021,Sandwell 012D,E01010014,1607,1441,166,62,63,34,7
2021,Sandwell 021A,E01010015,1950,1556,394,146,136,91,21
2021,Sandwell 021B,E01010016,1784,1433,351,116,119,107,9
2021,Sandwell 024A,E01010017,1910,1433,477,142,200,114,21
2021,Sandwell 021C,E01010018,2306,1978,328,102,137,72,17
2021,Sandwell 024B,E01010019,1889,1236,653,166,255,183,49
2021,Sandwell 024C,E01010020,2183,1683,500,174,188,105,33
2021,Sandwell 024D,E01010021,1931,1489,442,100,184,118,40
2021,Sandwell 037B,E01010022,1533,1446,87,37,30,10,10
2021,Sandwell 037C,E01010023,1776,1627,149,57,53,35,4
2021,Sandwell 036B,E01010024,1526,1397,129,58,46,21,4
2021,Sandwell 037D,E01010025,1670,1538,132,49,49,28,6
2021,Sandwell 036C,E01010026,1795,1618,177,72,58,43,4
2021,Sandwell 036D,E01010027,1583,1371,212,113,44,41,14
2021,Sandwell 037E,E01010028,1536,1423,113,40,42,24,7
2021,Sandwell 009C,E01010029,1569,1441,128,57,43,19,9
2021,Sandwell 007A,E01010030,1631,1498,133,52,41,32,8
2021,Sandwell 014B,E01010031,1450,1333,117,41,44,28,4
2021,Sandwell 014C,E01010032,1575,1373,202,116,62,21,3
2021,Sandwell 014D,E01010033,1586,1437,149,54,53,33,9
2021,Sandwell 007B,E01010034,1205,1148,57,17,20,17,3
2021,Sandwell 007C,E01010035,1303,1247,56,25,25,5,1
2021,Sandwell 007D,E01010036,1918,1780,138,48,55,30,5
2021,Sandwell 009D,E01010037,1267,1177,90,34,31,19,6
2021,Sandwell 029A,E01010038,1776,1699,77,28,29,18,2
2021,Sandwell 025A,E01010039,2053,1883,170,73,68,25,4
2021,Sandwell 029B,E01010040,1389,1339,50,24,19,7,0
2021,Sandwell 029C,E01010041,1662,1566,96,22,57,13,4
2021,Sandwell 035F,E01010042,1821,1732,89,33,30,21,5
2021,Sandwell 025B,E01010043,1373,1300,73,26,32,13,2
2021,Sandwell 025C,E01010044,1481,1404,77,27,33,6,11
2021,Sandwell 029D,E01010045,1640,1543,97,36,40,17,4
2021,Sandwell 023A,E01010046,2779,1884,895,220,314,302,59
2021,Sandwell 023B,E01010047,2078,1254,824,249,267,229,79
2021,Sandwell 023C,E01010048,1791,788,1003,253,378,294,78
2021,Sandwell 023D,E01010049,1656,766,890,191,319,299,81
2021,Sandwell 023E,E01010050,1676,1000,676,195,227,200,54
2021,Sandwell 031D,E01010051,1360,1016,344,120,119,93,12
2021,Sandwell 023F,E01010052,1428,980,448,106,151,155,36
2021,Sandwell 023G,E01010053,2177,1535,642,192,209,200,41
2021,Sandwell 028A,E01010054,2003,1480,523,141,177,138,67
2021,Sandwell 028B,E01010055,1911,1172,739,201,300,192,46
2021,Sandwell 028C,E01010056,1808,1356,452,135,178,115,24
2021,Sandwell 028D,E01010057,2159,1386,773,200,303,215,55
2021,Sandwell 031E,E01010058,1631,1329,302,96,130,62,14
2021,Sandwell 041D,E01010059,2189,1459,730,200,282,191,57
2021,Sandwell 028E,E01010060,2008,1325,683,177,261,204,41
2021,Sandwell 041B,E01010061,1919,1274,645,153,287,176,29
2021,Sandwell 040A,E01010062,2165,1493,672,174,240,218,40
2021,Sandwell 040D,E01010064,2066,1362,704,225,277,166,36
2021,Sandwell 015A,E01010066,1651,1403,248,71,67,68,42
2021,Sandwell 015B,E01010067,1687,1255,432,106,168,130,28
2021,Sandwell 015C,E01010068,1814,1671,143,44,60,36,3
2021,Sandwell 016E,E01010069,2446,1847,599,221,229,118,31
2021,Sandwell 015D,E01010070,1709,1549,160,48,67,40,5
2021,Sandwell 016F,E01010071,1697,1389,308,96,110,85,17
2021,Sandwell 021D,E01010072,2244,1818,426,129,176,100,21
2021,Sandwell 021E,E01010073,1602,1294,308,112,128,63,5
2021,Sandwell 015E,E01010075,1512,1225,287,109,107,57,14
2021,Sandwell 015F,E01010076,1975,1695,280,110,109,52,9
2021,Sandwell 022A,E01010077,1543,1415,128,46,49,27,6
2021,Sandwell 025D,E01010078,1192,1130,62,24,19,15,4
2021,Sandwell 022B,E01010079,1443,1372,71,33,24,12,2
2021,Sandwell 022C,E01010080,1884,1653,231,97,99,29,6
2021,Sandwell 022D,E01010081,1516,1398,118,48,47,17,6
2021,Sandwell 022E,E01010082,2240,2016,224,93,80,43,8
2021,Sandwell 022F,E01010083,1794,1644,150,71,43,31,5
2021,Sandwell 022G,E01010084,1559,1316,243,75,115,46,7
2021,Sandwell 001A,E01010085,1774,1665,109,38,34,29,8
2021,Sandwell 001B,E01010086,1685,1540,145,36,60,43,6
2021,Sandwell 001C,E01010087,1608,1517,91,28,40,20,3
2021,Sandwell 001D,E01010088,1567,1425,142,45,41,43,13
2021,Sandwell 001E,E01010089,1810,1625,185,83,59,42,1
2021,Sandwell 005A,E01010090,2029,1746,283,108,91,55,29
2021,Sandwell 005B,E01010091,1648,1435,213,50,70,78,15
2021,Sandwell 003E,E01010092,1796,1624,172,73,49,49,1
2021,Sandwell 013A,E01010093,1555,1211,344,113,148,72,11
2021,Sandwell 013B,E01010094,1620,1177,443,135,181,100,27
2021,Sandwell 013C,E01010095,1987,1532,455,128,213,98,16
2021,Sandwell 005C,E01010096,1765,1644,121,26,45,32,18
2021,Sandwell 005D,E01010097,1855,1724,131,49,51,23,8
2021,Sandwell 013D,E01010098,1831,1597,234,64,90,65,15
2021,Sandwell 013E,E01010099,1763,1536,227,61,83,61,22
2021,Sandwell 013F,E01010100,1933,1365,568,177,191,170,30
2021,Sandwell 020B,E01010101,1995,1439,556,147,215,160,34
2021,Sandwell 020C,E01010102,1806,1119,687,180,259,220,28
2021,Sandwell 017D,E01010103,2134,1509,625,178,258,160,29
2021,Sandwell 017E,E01010104,1713,1219,494,138,185,155,16
2021,Sandwell 017F,E01010105,1597,986,611,209,246,130,26
2021,Sandwell 019D,E01010106,1842,1211,631,161,248,177,45
2021,Sandwell 020D,E01010107,2089,1431,658,160,267,191,40
2021,Solihull 017A,E01010108,2121,2084,37,22,8,4,3
2021,Solihull 009A,E01010109,1603,1560,43,25,16,2,0
2021,Solihull 009B,E01010110,1560,1512,48,32,9,7,0
2021,Solihull 008A,E01010111,1372,1329,43,14,18,8,3
2021,Solihull 009C,E01010112,1517,1480,37,11,16,9,1
2021,Solihull 009D,E01010113,1309,1269,40,21,13,6,0
2021,Solihull 009E,E01010114,1856,1791,65,41,19,5,0
2021,Solihull 015A,E01010115,1520,1448,72,40,17,13,2
2021,Solihull 015B,E01010116,1346,1230,116,75,21,19,1
2021,Solihull 003A,E01010117,1417,1398,19,14,4,1,0
2021,Solihull 001A,E01010118,1187,1162,25,10,12,3,0
2021,Solihull 003B,E01010119,1477,1441,36,15,14,3,4
2021,Solihull 001B,E01010120,1209,1183,26,10,7,5,4
2021,Solihull 001C,E01010121,1509,1454,55,23,21,7,4
2021,Solihull 001D,E01010122,1385,1344,41,19,12,9,1
2021,Solihull 003C,E01010123,1474,1448,26,8,9,7,2
2021,Solihull 003D,E01010124,1493,1472,21,13,3,3,2
2021,Solihull 006A,E01010125,1758,1682,76,38,29,6,3
2021,Solihull 008B,E01010126,1379,1337,42,14,10,18,0
2021,Solihull 008C,E01010127,1760,1717,43,24,17,2,0
2021,Solihull 008D,E01010128,1448,1427,21,6,12,2,1
2021,Solihull 006B,E01010129,1566,1525,41,19,15,6,1
2021,Solihull 008E,E01010130,1766,1695,71,25,35,8,3
2021,Solihull 008F,E01010131,1425,1368,57,33,16,6,2
2021,Solihull 011A,E01010132,1501,1414,87,38,30,18,1
2021,Solihull 011B,E01010133,1647,1522,125,62,44,17,2
2021,Solihull 011C,E01010134,1426,1377,49,22,16,10,1
2021,Solihull 011D,E01010135,1479,1420,59,38,14,4,3
2021,Solihull 012A,E01010136,1235,1184,51,27,17,5,2
2021,Solihull 012B,E01010137,1327,1266,61,27,19,13,2
2021,Solihull 011E,E01010138,1359,1297,62,35,13,12,2
2021,Solihull 006C,E01010139,1064,1050,14,7,4,3,0
2021,Solihull 007A,E01010140,1414,1376,38,13,18,5,2
2021,Solihull 006D,E01010141,1224,1184,40,23,13,4,0
2021,Solihull 007B,E01010142,1400,1351,49,21,16,10,2
2021,Solihull 007C,E01010143,1518,1469,49,20,19,9,1
2021,Solihull 007D,E01010144,1662,1605,57,25,26,4,2
2021,Solihull 005A,E01010145,1613,1554,59,41,14,2,2
2021,Solihull 004A,E01010146,1632,1577,55,24,25,5,1
2021,Solihull 005B,E01010147,1510,1435,75,32,28,14,1
2021,Solihull 005C,E01010148,1781,1705,76,31,28,12,5
2021,Solihull 005D,E01010149,1482,1444,38,23,10,4,1
2021,Solihull 028A,E01010150,1565,1532,33,23,7,3,0
2021,Solihull 026A,E01010151,1607,1563,44,30,9,5,0
2021,Solihull 026B,E01010152,1267,1253,14,13,1,0,0
2021,Solihull 026C,E01010153,1750,1718,32,18,10,2,2
2021,Solihull 026D,E01010154,1631,1568,63,42,16,5,0
2021,Solihull 026E,E01010155,1770,1738,32,25,3,2,2
2021,Solihull 026F,E01010156,1498,1449,49,38,7,4,0
2021,Solihull 010A,E01010157,1387,1340,47,21,16,10,0
2021,Solihull 012C,E01010158,1503,1413,90,47,25,16,2
2021,Solihull 010B,E01010159,1387,1261,126,55,41,24,6
2021,Solihull 012D,E01010160,1449,1359,90,58,23,8,1
2021,Solihull 012E,E01010161,1531,1453,78,41,26,10,1
2021,Solihull 010C,E01010162,1509,1400,109,66,23,15,5
2021,Solihull 010D,E01010163,1460,1372,88,44,25,17,2
2021,Solihull 017B,E01010164,1678,1659,19,12,6,1,0
2021,Solihull 017C,E01010165,1753,1713,40,25,9,3,3
2021,Solihull 025A,E01010166,1823,1789,34,24,6,1,3
2021,Solihull 017D,E01010167,1610,1585,25,19,6,0,0
2021,Solihull 025B,E01010168,1773,1736,37,28,8,1,0
2021,Solihull 025C,E01010169,1633,1605,28,19,8,1,0
2021,Solihull 025D,E01010170,1449,1419,30,20,6,4,0
2021,Solihull 025E,E01010171,1384,1361,23,14,9,0,0
2021,Solihull 014A,E01010172,1534,1470,64,42,13,9,0
2021,Solihull 014B,E01010173,1401,1330,71,49,16,6,0
2021,Solihull 013A,E01010174,1629,1520,109,39,46,23,1
2021,Solihull 013B,E01010175,1676,1581,95,59,20,13,3
2021,Solihull 014C,E01010176,1365,1293,72,36,26,8,2
2021,Solihull 013C,E01010177,1303,1252,51,26,18,6,1
2021,Solihull 013D,E01010178,1889,1735,154,72,47,32,3
2021,Solihull 014D,E01010179,1544,1477,67,40,11,12,4
2021,Solihull 029A,E01010180,1457,1426,31,28,3,0,0
2021,Solihull 029B,E01010181,2670,2607,63,43,13,5,2
2021,Solihull 029D,E01010183,1818,1762,56,45,7,3,1
2021,Solihull 028B,E01010184,1599,1568,31,22,6,2,1
2021,Solihull 028C,E01010185,1521,1498,23,14,7,2,0
2021,Solihull 028D,E01010186,1805,1763,42,31,6,4,1
2021,Solihull 028E,E01010187,1449,1405,44,22,11,8,3
2021,Solihull 028F,E01010188,1689,1656,33,21,5,5,2
2021,Solihull 029E,E01010189,1582,1560,22,15,6,1,0
2021,Solihull 024A,E01010190,1571,1499,72,46,16,9,1
2021,Solihull 022A,E01010191,1895,1741,154,88,46,17,3
2021,Solihull 019A,E01010192,1763,1539,224,134,59,27,4
2021,Solihull 024B,E01010193,1232,1181,51,31,15,4,1
2021,Solihull 024C,E01010194,1532,1445,87,62,19,5,1
2021,Solihull 016A,E01010195,1561,1453,108,85,12,11,0
2021,Solihull 019B,E01010196,1716,1618,98,68,19,10,1
2021,Solihull 019C,E01010197,1653,1569,84,50,23,10,1
2021,Solihull 019D,E01010198,1635,1488,147,100,38,9,0
2021,Solihull 018A,E01010199,1883,1708,175,108,47,16,4
2021,Solihull 018B,E01010200,1416,1323,93,52,29,11,1
2021,Solihull 018C,E01010201,1699,1560,139,92,30,14,3
2021,Solihull 022B,E01010202,1558,1466,92,60,24,8,0
2021,Solihull 022C,E01010203,1683,1557,126,74,38,14,0
2021,Solihull 018D,E01010204,1312,1230,82,49,25,7,1
2021,Solihull 018E,E01010205,1457,1334,123,85,21,14,3
2021,Solihull 018F,E01010206,1710,1590,120,67,31,17,5
2021,Solihull 024D,E01010207,1408,1309,99,69,16,11,3
2021,Solihull 023A,E01010208,1520,1449,71,45,15,9,2
2021,Solihull 022D,E01010209,1667,1583,84,47,30,6,1
2021,Solihull 023B,E01010210,1501,1445,56,37,14,4,1
2021,Solihull 023C,E01010211,1402,1340,62,37,17,5,3
2021,Solihull 027A,E01010212,1229,1154,75,33,30,10,2
2021,Solihull 022E,E01010213,1715,1642,73,35,22,13,3
2021,Solihull 027B,E01010214,1131,1068,63,34,17,12,0
2021,Solihull 027C,E01010215,1471,1371,100,62,28,9,1
2021,Solihull 027D,E01010216,1450,1333,117,80,21,15,1
2021,Solihull 023D,E01010217,1497,1449,48,27,16,5,0
2021,Solihull 021A,E01010218,1286,1232,54,31,18,4,1
2021,Solihull 021B,E01010219,1526,1479,47,18,18,10,1
2021,Solihull 030A,E01010220,1600,1551,49,31,13,5,0
2021,Solihull 021C,E01010221,1927,1850,77,45,22,9,1
2021,Solihull 021D,E01010222,1345,1309,36,20,8,8,0
2021,Solihull 030B,E01010223,1191,1141,50,26,10,11,3
2021,Solihull 030C,E01010225,1460,1401,59,29,21,9,0
2021,Solihull 016B,E01010226,1694,1514,180,112,48,16,4
2021,Solihull 015C,E01010227,1846,1738,108,81,24,3,0
2021,Solihull 015D,E01010228,1568,1465,103,66,30,7,0
2021,Solihull 016C,E01010229,1560,1461,99,57,24,12,6
2021,Solihull 016D,E01010230,1767,1602,165,82,51,24,8
2021,Solihull 016E,E01010231,1637,1540,97,64,18,13,2
2021,Solihull 015E,E01010232,2098,1945,153,89,51,12,1
2021,Solihull 016F,E01010233,1886,1651,235,137,66,26,6
2021,Solihull 004B,E01010234,1729,1637,92,43,33,13,3
2021,Solihull 002A,E01010235,1425,1377,48,26,14,7,1
2021,Solihull 002B,E01010236,1350,1317,33,21,10,2,0
2021,Solihull 004C,E01010237,1785,1745,40,19,14,7,0
2021,Solihull 004D,E01010238,1306,1251,55,26,20,9,0
2021,Solihull 002C,E01010239,1503,1478,25,15,7,2,1
2021,Solihull 002D,E01010240,1324,1268,56,32,13,11,0
2021,Walsall 015A,E01010241,2294,2242,52,23,16,11,2
2021,Walsall 015B,E01010242,1585,1548,37,11,19,7,0
2021,Walsall 015C,E01010243,1463,1451,12,7,1,3,1
2021,Walsall 015D,E01010244,1392,1336,56,21,17,13,5
2021,Walsall 022A,E01010245,1564,1541,23,13,8,2,0
2021,Walsall 022B,E01010246,1524,1474,50,26,13,10,1
2021,Walsall 022C,E01010247,1543,1518,25,7,5,12,1
2021,Walsall 022D,E01010248,1572,1537,35,18,6,10,1
2021,Walsall 004A,E01010249,1687,1650,37,20,7,9,1
2021,Walsall 004B,E01010250,1355,1310,45,22,16,7,0
2021,Walsall 007A,E01010251,1506,1469,37,15,16,4,2
2021,Walsall 004C,E01010252,1716,1677,39,19,14,5,1
2021,Walsall 007B,E01010253,1191,1162,29,9,13,6,1
2021,Walsall 004D,E01010254,1433,1392,41,25,11,5,0
2021,Walsall 007C,E01010255,1313,1299,14,6,5,2,1
2021,Walsall 007D,E01010256,1454,1432,22,9,9,2,2
2021,Walsall 007E,E01010257,1121,1115,6,5,0,1,0
2021,Walsall 023A,E01010258,1608,1503,105,48,33,22,2
2021,Walsall 023B,E01010259,1551,1433,118,33,49,33,3
2021,Walsall 023C,E01010260,1820,1657,163,41,77,42,3
2021,Walsall 033A,E01010261,1805,1649,156,74,57,24,1
2021,Walsall 036A,E01010262,1708,1516,192,62,73,46,11
2021,Walsall 033B,E01010263,1554,1144,410,102,162,109,37
2021,Walsall 033C,E01010264,1948,1706,242,74,91,66,11
2021,Walsall 033D,E01010265,1904,1498,406,102,155,127,22
2021,Walsall 023D,E01010266,1273,1167,106,46,31,26,3
2021,Walsall 021A,E01010267,1550,1448,102,42,37,19,4
2021,Walsall 021B,E01010268,1678,1289,389,93,140,119,37
2021,Walsall 026A,E01010269,1543,1061,482,131,162,159,30
2021,Walsall 026B,E01010270,1698,1417,281,68,105,89,19
2021,Walsall 017A,E01010271,1964,1887,77,23,34,15,5
2021,Walsall 017B,E01010272,1444,1375,69,24,35,8,2
2021,Walsall 017C,E01010273,1432,1368,64,26,23,12,3
2021,Walsall 021C,E01010274,1498,1443,55,30,16,8,1
2021,Walsall 021D,E01010275,1816,1740,76,31,31,11,3
2021,Walsall 013B,E01010277,1703,1578,125,55,50,17,3
2021,Walsall 018B,E01010279,1933,1647,286,111,124,40,11
2021,Walsall 012A,E01010282,1295,1226,69,23,34,9,3
2021,Walsall 013D,E01010283,1829,1663,166,71,63,23,9
2021,Walsall 006A,E01010284,1611,1569,42,19,9,13,1
2021,Walsall 006B,E01010285,1825,1752,73,32,11,29,1
2021,Walsall 006C,E01010286,1560,1473,87,26,32,24,5
2021,Walsall 012B,E01010287,1660,1604,56,28,14,13,1
2021,Walsall 012C,E01010288,1574,1489,85,36,37,12,0
2021,Walsall 012D,E01010289,1868,1736,132,58,40,27,7
2021,Walsall 006D,E01010290,1587,1539,48,15,26,7,0
2021,Walsall 009A,E01010291,1413,1354,59,36,14,7,2
2021,Walsall 008A,E01010292,1898,1839,59,25,21,13,0
2021,Walsall 009B,E01010293,1634,1594,40,17,16,7,0
2021,Walsall 008B,E01010294,1463,1418,45,17,18,9,1
2021,Walsall 017D,E01010295,1453,1379,74,34,30,10,0
2021,Walsall 008C,E01010296,1423,1404,19,4,10,5,0
2021,Walsall 008D,E01010297,1320,1297,23,12,4,7,0
2021,Walsall 009C,E01010298,1175,1130,45,18,17,7,3
2021,Walsall 009D,E01010299,1492,1417,75,33,30,9,3
2021,Walsall 009E,E01010300,1407,1333,74,27,35,10,2
2021,Walsall 001A,E01010301,1406,1386,20,7,8,5,0
2021,Walsall 002A,E01010302,1490,1437,53,30,17,5,1
2021,Walsall 001B,E01010303,1535,1499,36,12,17,4,3
2021,Walsall 002B,E01010304,1631,1597,34,12,15,4,3
2021,Walsall 002C,E01010305,1332,1315,17,4,12,1,0
2021,Walsall 001C,E01010306,2182,2105,77,33,24,17,3
2021,Walsall 001D,E01010307,1678,1659,19,6,7,5,1
2021,Walsall 002D,E01010308,1748,1675,73,29,29,14,1
2021,Walsall 036B,E01010309,2131,1786,345,130,148,59,8
2021,Walsall 038A,E01010310,2077,1917,160,59,51,41,9
2021,Walsall 036C,E01010311,2608,2323,285,87,110,80,8
2021,Walsall 038B,E01010312,1724,1516,208,71,78,54,5
2021,Walsall 038C,E01010313,1465,1318,147,52,48,31,16
2021,Walsall 038D,E01010314,1590,1470,120,44,47,26,3
2021,Walsall 038E,E01010315,1804,1573,231,92,98,38,3
2021,Walsall 036D,E01010316,1645,1490,155,54,65,34,2
2021,Walsall 024A,E01010317,1577,1457,120,57,41,20,2
2021,Walsall 024B,E01010318,1564,1365,199,81,68,38,12
2021,Walsall 010A,E01010319,1283,1171,112,59,34,16,3
2021,Walsall 016A,E01010320,1288,1258,30,20,8,2,0
2021,Walsall 010B,E01010321,1546,1494,52,27,15,8,2
2021,Walsall 016B,E01010322,1616,1569,47,19,19,9,0
2021,Walsall 016C,E01010323,1447,1408,39,16,16,5,2
2021,Walsall 016D,E01010324,1869,1772,97,44,37,14,2
2021,Walsall 024C,E01010325,1853,1675,178,70,63,34,11
2021,Walsall 029A,E01010326,1611,1389,222,87,67,59,9
2021,Walsall 029B,E01010327,1607,1274,333,75,147,92,19
2021,Walsall 029C,E01010328,1499,1233,266,145,59,44,18
2021,Walsall 039A,E01010329,1625,1510,115,49,42,15,9
2021,Walsall 029D,E01010330,1439,1176,263,97,86,64,16
2021,Walsall 035A,E01010331,1603,1369,234,118,63,44,9
2021,Walsall 035B,E01010332,1941,1561,380,191,121,55,13
2021,Walsall 035C,E01010333,1580,1402,178,91,53,28,6
2021,Walsall 035D,E01010334,1543,1329,214,133,49,26,6
2021,Walsall 037A,E01010335,1578,1338,240,85,77,68,10
2021,Walsall 034A,E01010336,1456,1071,385,111,145,111,18
2021,Walsall 037B,E01010337,1340,1144,196,68,67,49,12
2021,Walsall 037C,E01010338,1815,1446,369,121,137,91,20
2021,Walsall 037D,E01010339,1491,1250,241,93,90,52,6
2021,Walsall 034B,E01010340,1648,1142,506,121,203,153,29
2021,Walsall 034C,E01010341,1610,1098,512,128,175,184,25
2021,Walsall 034D,E01010342,1753,1118,635,194,220,171,50
2021,Walsall 034E,E01010343,1526,1042,484,122,172,159,31
2021,Walsall 034F,E01010344,1766,1333,433,124,160,123,26
2021,Walsall 003A,E01010345,1087,1074,13,4,5,4,0
2021,Walsall 003B,E01010346,1233,1226,7,4,1,2,0
2021,Walsall 003C,E01010347,1441,1425,16,6,5,4,1
2021,Walsall 005A,E01010348,1446,1427,19,11,7,0,1
2021,Walsall 005B,E01010349,1208,1192,16,10,3,2,1
2021,Walsall 003D,E01010350,1380,1359,21,15,4,2,0
2021,Walsall 005C,E01010351,1670,1639,31,8,18,5,0
2021,Walsall 005D,E01010352,1575,1559,16,2,4,9,1
2021,Walsall 010C,E01010353,1486,1449,37,20,13,3,1
2021,Walsall 010D,E01010354,1486,1451,35,14,14,6,1
2021,Walsall 039B,E01010355,1394,1366,28,9,11,8,0
2021,Walsall 039C,E01010356,1434,1405,29,16,6,5,2
2021,Walsall 039D,E01010357,2224,2132,92,48,31,12,1
2021,Walsall 039E,E01010358,1486,1441,45,13,22,10,0
2021,Walsall 039F,E01010359,1462,1427,35,14,10,9,2
2021,Walsall 039G,E01010360,1427,1370,57,29,14,12,2
2021,Walsall 031A,E01010361,1444,1200,244,86,96,54,8
2021,Walsall 026C,E01010362,1795,1466,329,93,127,90,19
2021,Walsall 026D,E01010363,2585,2020,565,246,188,112,19
2021,Walsall 031B,E01010364,1541,1095,446,147,156,118,25
2021,Walsall 031C,E01010365,1625,1170,455,137,178,117,23
2021,Walsall 031D,E01010366,1704,1272,432,143,162,109,18
2021,Walsall 031E,E01010367,1814,1276,538,158,229,127,24
2021,Walsall 030A,E01010368,2095,1634,461,138,174,125,24
2021,Walsall 024D,E01010369,1681,1300,381,122,152,92,15
2021,Walsall 030B,E01010370,1904,1522,382,102,149,107,24
2021,Walsall 030D,E01010372,1554,1187,367,90,136,119,22
2021,Walsall 030E,E01010373,1823,1618,205,98,62,37,8
2021,Walsall 018D,E01010374,2555,2052,503,180,192,105,26
2021,Walsall 018E,E01010375,2201,1595,606,174,239,155,38
2021,Walsall 020A,E01010376,1205,1083,122,43,48,24,7
2021,Walsall 020B,E01010377,1733,1625,108,46,30,30,2
2021,Walsall 019A,E01010378,1151,1002,149,45,66,28,10
2021,Walsall 019B,E01010379,1237,1212,25,10,10,5,0
2021,Walsall 020C,E01010380,1398,1369,29,8,13,6,2
2021,Walsall 020D,E01010381,1529,1464,65,24,17,21,3
2021,Walsall 019C,E01010382,1453,1372,81,33,28,13,7
2021,Walsall 019D,E01010383,1603,1523,80,40,21,18,1
2021,Walsall 032A,E01010384,1373,1336,37,21,12,4,0
2021,Walsall 028A,E01010385,1499,1421,78,45,17,16,0
2021,Walsall 028B,E01010386,1571,1520,51,20,17,12,2
2021,Walsall 028C,E01010387,1421,1360,61,33,13,13,2
2021,Walsall 022E,E01010388,1400,1344,56,28,17,10,1
2021,Walsall 032B,E01010389,1442,1323,119,68,37,11,3
2021,Walsall 032C,E01010390,1641,1596,45,26,11,7,1
2021,Walsall 032D,E01010391,1807,1726,81,43,21,11,6
2021,Walsall 028D,E01010392,1482,1432,50,20,20,5,5
2021,Walsall 014A,E01010393,1435,1337,98,29,38,26,5
2021,Walsall 014B,E01010394,1305,1181,124,33,56,30,5
2021,Walsall 011A,E01010395,1324,1238,86,34,34,12,6
2021,Walsall 014C,E01010396,1623,1581,42,16,18,6,2
2021,Walsall 011B,E01010397,1647,1581,66,35,18,9,4
2021,Walsall 011C,E01010398,1501,1445,56,24,22,6,4
2021,Walsall 011D,E01010399,1458,1407,51,19,15,14,3
2021,Walsall 014D,E01010400,1931,1838,93,28,33,28,4
2021,Walsall 025A,E01010401,1549,1447,102,38,32,27,5
2021,Walsall 027A,E01010402,1689,1459,230,83,81,49,17
2021,Walsall 025B,E01010403,1870,1595,275,91,108,61,15
2021,Walsall 025C,E01010404,1958,1780,178,67,67,39,5
2021,Walsall 027B,E01010405,1770,1459,311,96,142,61,12
2021,Walsall 027C,E01010406,2766,2317,449,158,191,90,10
2021,Walsall 025D,E01010407,1802,1649,153,47,70,19,17
2021,Walsall 025E,E01010408,1686,1487,199,80,69,45,5
2021,Walsall 027D,E01010409,1478,1265,213,79,73,52,9
2021,Wolverhampton 033A,E01010410,2292,2100,192,75,73,35,9
2021,Wolverhampton 033B,E01010411,2082,1892,190,60,88,35,7
2021,Wolverhampton 033C,E01010412,2064,1824,240,107,95,33,5
2021,Wolverhampton 033D,E01010413,1647,1530,117,50,47,17,3
2021,Wolverhampton 027A,E01010414,2115,1715,400,132,162,90,16
2021,Wolverhampton 027B,E01010415,1743,1422,321,124,124,60,13
2021,Wolverhampton 027C,E01010416,1836,1389,447,101,167,141,38
2021,Wolverhampton 023A,E01010417,1568,1392,176,61,69,35,11
2021,Wolverhampton 022A,E01010418,1452,1293,159,39,68,37,15
2021,Wolverhampton 023B,E01010419,1672,1526,146,46,65,27,8
2021,Wolverhampton 023C,E01010420,1287,1047,240,85,96,51,8
2021,Wolverhampton 022B,E01010421,1591,1376,215,73,94,43,5
2021,Wolverhampton 027D,E01010422,1824,1555,269,88,102,72,7
2021,Wolverhampton 022C,E01010423,1539,1311,228,72,92,50,14
2021,Wolverhampton 022D,E01010424,1488,1267,221,44,89,71,17
2021,Wolverhampton 023D,E01010425,1279,1096,183,54,74,45,10
2021,Wolverhampton 035A,E01010426,1477,1108,369,124,128,95,22
2021,Wolverhampton 030A,E01010427,1765,1126,639,222,233,145,39
2021,Wolverhampton 035B,E01010428,1532,749,783,183,326,212,62
2021,Wolverhampton 035C,E01010429,1304,802,502,135,197,137,33
2021,Wolverhampton 035D,E01010430,1737,1190,547,180,186,154,27
2021,Wolverhampton 030B,E01010431,1514,1073,441,137,180,109,15
2021,Wolverhampton 030C,E01010432,1495,959,536,172,212,119,33
2021,Wolverhampton 035E,E01010433,1304,668,636,187,215,184,50
2021,Wolverhampton 001A,E01010434,1711,1541,170,51,61,52,6
2021,Wolverhampton 001B,E01010436,1405,1366,39,19,13,7,0
2021,Wolverhampton 001C,E01010437,1123,1101,22,8,8,5,1
2021,Wolverhampton 001D,E01010438,1373,1287,86,35,33,17,1
2021,Wolverhampton 001E,E01010439,1341,1309,32,10,17,5,0
2021,Wolverhampton 001F,E01010440,1547,1470,77,32,22,18,5
2021,Wolverhampton 001G,E01010441,1310,1232,78,29,33,15,1
2021,Wolverhampton 018A,E01010442,1341,1065,276,85,88,83,20
2021,Wolverhampton 018B,E01010443,1635,1491,144,51,58,33,2
2021,Wolverhampton 018C,E01010444,1239,1056,183,44,76,48,15
2021,Wolverhampton 018D,E01010445,1435,1225,210,83,85,34,8
2021,Wolverhampton 023E,E01010446,1596,1352,244,79,96,59,10
2021,Wolverhampton 018E,E01010447,1810,1612,198,71,88,32,7
2021,Wolverhampton 018F,E01010448,1637,1512,125,49,45,24,7
2021,Wolverhampton 029A,E01010449,2411,1745,666,198,248,189,31
2021,Wolverhampton 029B,E01010450,2516,2011,505,169,189,119,28
2021,Wolverhampton 029C,E01010451,1934,1641,293,106,106,70,11
2021,Wolverhampton 029D,E01010452,1605,1291,314,97,136,62,19
2021,Wolverhampton 035G,E01010454,1648,1056,592,195,227,139,31
2021,Wolverhampton 029E,E01010455,2502,1904,598,225,216,134,23
2021,Wolverhampton 004A,E01010456,1416,1285,131,53,52,25,1
2021,Wolverhampton 004B,E01010457,1535,1457,78,33,31,14,0
2021,Wolverhampton 008A,E01010458,1686,1580,106,55,27,20,4
2021,Wolverhampton 008B,E01010459,1510,1399,111,33,57,17,4
2021,Wolverhampton 008C,E01010460,1548,1393,155,67,47,27,14
2021,Wolverhampton 008D,E01010461,1527,1369,158,67,55,35,1
2021,Wolverhampton 004C,E01010462,1638,1545,93,35,41,15,2
2021,Wolverhampton 020A,E01010463,1757,1248,509,137,223,131,18
2021,Wolverhampton 020B,E01010464,1573,1288,285,102,103,68,12
2021,Wolverhampton 020C,E01010465,1630,1153,477,127,175,145,30
2021,Wolverhampton 020D,E01010466,1529,894,635,141,287,182,25
2021,Wolverhampton 026A,E01010467,1571,1338,233,89,66,68,10
2021,Wolverhampton 026B,E01010468,1478,1340,138,51,49,28,10
2021,Wolverhampton 026C,E01010469,1406,1331,75,19,26,30,0
2021,Wolverhampton 020E,E01010470,1531,1101,430,149,177,84,20
2021,Wolverhampton 015A,E01010471,1723,1124,599,176,243,157,23
2021,Wolverhampton 015B,E01010472,2503,1852,651,232,226,175,18
2021,Wolverhampton 015C,E01010473,2010,1455,555,149,266,131,9
2021,Wolverhampton 012A,E01010474,1607,1458,149,66,48,26,9
2021,Wolverhampton 015D,E01010475,1627,1413,214,75,88,42,9
2021,Wolverhampton 015E,E01010476,1838,1464,374,129,158,72,15
2021,Wolverhampton 015F,E01010477,1600,1307,293,133,97,53,10
2021,Wolverhampton 011A,E01010478,1400,877,523,146,201,135,41
2021,Wolverhampton 011B,E01010479,1569,1378,191,71,75,39,6
2021,Wolverhampton 011C,E01010480,1363,1075,288,88,117,68,15
2021,Wolverhampton 004D,E01010481,1462,1369,93,36,35,20,2
2021,Wolverhampton 007A,E01010482,1423,1376,47,17,20,8,2
2021,Wolverhampton 007B,E01010483,1435,1357,78,27,36,14,1
2021,Wolverhampton 007C,E01010484,1301,1217,84,24,37,20,3
2021,Wolverhampton 007D,E01010485,2065,1635,430,185,153,75,17
2021,Wolverhampton 011D,E01010486,1622,1420,202,81,85,32,4
2021,Wolverhampton 021A,E01010487,1476,1407,69,18,28,18,5
2021,Wolverhampton 021B,E01010488,1430,1288,142,48,60,32,2
2021,Wolverhampton 028A,E01010489,1463,1394,69,26,24,14,5
2021,Wolverhampton 028B,E01010490,1744,1620,124,31,50,32,11
2021,Wolverhampton 028C,E01010491,1526,1428,98,52,33,11,2
2021,Wolverhampton 028D,E01010492,1253,1196,57,26,20,8,3
2021,Wolverhampton 021C,E01010493,1506,1431,75,33,25,16,1
2021,Wolverhampton 028E,E01010494,1537,1473,64,32,17,14,1
2021,Wolverhampton 002A,E01010495,1694,1603,91,41,28,17,5
2021,Wolverhampton 003A,E01010496,1368,1235,133,48,59,23,3
2021,Wolverhampton 002B,E01010497,1090,1007,83,38,34,11,0
2021,Wolverhampton 003B,E01010498,1303,1229,74,31,27,11,5
2021,Wolverhampton 002C,E01010499,1425,1276,149,43,80,24,2
2021,Wolverhampton 002D,E01010500,1397,1254,143,54,48,32,9
2021,Wolverhampton 006B,E01010501,1406,1315,91,28,41,18,4
2021,Wolverhampton 006C,E01010502,1340,1195,145,57,60,27,1
2021,Wolverhampton 006D,E01010503,1216,1067,149,57,67,21,4
2021,Wolverhampton 021D,E01010504,1549,1345,204,109,55,32,8
2021,Wolverhampton 021E,E01010505,1206,1117,89,41,29,16,3
2021,Wolverhampton 017A,E01010506,1505,1267,238,95,94,45,4
2021,Wolverhampton 021F,E01010507,1430,1326,104,44,39,19,2
2021,Wolverhampton 017B,E01010508,1513,1131,382,128,149,99,6
2021,Wolverhampton 019A,E01010509,1474,1405,69,22,33,13,1
2021,Wolverhampton 017C,E01010510,1511,1272,239,85,81,61,12
2021,Wolverhampton 017D,E01010511,1712,1182,530,183,225,112,10
2021,Wolverhampton 017E,E01010512,1354,1150,204,54,88,55,7
2021,Wolverhampton 031A,E01010513,1513,1423,90,43,28,17,2
2021,Wolverhampton 031B,E01010514,1603,1475,128,57,40,29,2
2021,Wolverhampton 031C,E01010515,1601,1529,72,28,21,18,5
2021,Wolverhampton 026D,E01010516,1391,1254,137,66,37,31,3
2021,Wolverhampton 031D,E01010517,1670,1521,149,54,51,37,7
2021,Wolverhampton 026E,E01010518,1596,1397,199,85,52,54,8
2021,Wolverhampton 030D,E01010519,1510,1303,207,94,69,38,6
2021,Wolverhampton 030E,E01010520,1633,1418,215,89,68,47,11
2021,Wolverhampton 013A,E01010522,1677,1246,431,137,183,92,19
2021,Wolverhampton 013B,E01010523,1657,1245,412,125,179,94,14
2021,Wolverhampton 013C,E01010524,1644,1229,415,129,176,100,10
2021,Wolverhampton 013D,E01010525,1746,1041,705,243,269,170,23
2021,Wolverhampton 016A,E01010526,1404,864,540,141,234,143,22
2021,Wolverhampton 016B,E01010527,1808,1070,738,199,325,179,35
2021,Wolverhampton 016C,E01010528,1564,1122,442,149,183,96,14
2021,Wolverhampton 016D,E01010529,1666,1009,657,170,289,171,27
2021,Wolverhampton 035H,E01010530,1825,1102,723,235,286,167,35
2021,Wolverhampton 034A,E01010531,1740,1609,131,31,58,37,5
2021,Wolverhampton 034B,E01010532,1687,1605,82,25,30,23,4
2021,Wolverhampton 032A,E01010533,1730,1406,324,115,126,62,21
2021,Wolverhampton 034C,E01010534,1461,1130,331,119,109,82,21
2021,Wolverhampton 032B,E01010535,1520,1294,226,76,88,49,13
2021,Wolverhampton 032C,E01010536,1626,1407,219,88,69,56,6
2021,Wolverhampton 032D,E01010537,1427,1315,112,51,31,28,2
2021,Wolverhampton 034D,E01010538,1516,1411,105,36,32,33,4
2021,Wolverhampton 009A,E01010539,1514,1420,94,38,34,16,6
2021,Wolverhampton 009B,E01010540,1426,1334,92,37,29,21,5
2021,Wolverhampton 003C,E01010541,1359,1248,111,42,40,23,6
2021,Wolverhampton 009C,E01010542,1558,1439,119,54,41,19,5
2021,Wolverhampton 003D,E01010543,1369,1245,124,46,55,20,3
2021,Wolverhampton 009D,E01010544,1461,1353,108,42,36,28,2
2021,Wolverhampton 009E,E01010545,1612,1492,120,36,40,37,7
2021,Wolverhampton 014A,E01010546,1722,1573,149,63,46,34,6
2021,Wolverhampton 014B,E01010547,1444,1358,86,46,19,15,6
2021,Wolverhampton 014C,E01010548,1397,1302,95,36,33,20,6
2021,Wolverhampton 014D,E01010549,1483,1415,68,35,19,11,3
2021,Wolverhampton 019B,E01010550,1634,1538,96,50,27,14,5
2021,Wolverhampton 019C,E01010551,1551,1473,78,41,29,7,1
2021,Wolverhampton 019D,E01010552,1813,1744,69,46,14,7,2
2021,Wolverhampton 014E,E01010553,1553,1435,118,57,33,23,5
2021,Wolverhampton 010A,E01010554,1366,1305,61,33,16,10,2
2021,Wolverhampton 005A,E01010555,1432,1408,24,6,10,7,1
2021,Wolverhampton 005B,E01010556,1360,1334,26,5,15,5,1
2021,Wolverhampton 005C,E01010557,1378,1346,32,20,6,4,2
2021,Wolverhampton 010B,E01010558,1604,1456,148,58,55,25,10
2021,Wolverhampton 005D,E01010559,1365,1331,34,18,14,2,0
2021,Wolverhampton 005E,E01010560,1641,1591,50,22,21,5,2
2021,Wolverhampton 012B,E01010561,1534,1450,84,35,25,22,2
2021,Wolverhampton 010C,E01010562,1479,1307,172,66,58,41,7
2021,Wolverhampton 010D,E01010563,1346,1257,89,39,28,17,5
2021,Wolverhampton 012C,E01010564,2421,1894,527,182,214,98,33
2021,Wolverhampton 012D,E01010565,1775,1623,152,68,46,29,9
2021,Wolverhampton 008E,E01010566,1796,1634,162,64,67,23,8
2021,Wolverhampton 010E,E01010567,1450,1345,105,31,50,17,7
2021,Bradford 016A,E01010568,1666,1604,62,23,29,10,0
2021,Bradford 016B,E01010569,1703,1670,33,12,16,4,1
2021,Bradford 018A,E01010570,1463,1444,19,13,5,1,0
2021,Bradford 016C,E01010571,1864,1814,50,22,18,6,4
2021,Bradford 016D,E01010572,1441,1424,17,9,7,1,0
2021,Bradford 013A,E01010573,1780,1760,20,11,5,4,0
2021,Bradford 013B,E01010574,1385,1360,25,11,7,2,5
2021,Bradford 013C,E01010575,1546,1533,13,5,6,2,0
2021,Bradford 016E,E01010576,1457,1431,26,13,10,1,2
2021,Bradford 013D,E01010577,1519,1507,12,7,2,2,1
2021,Bradford 015A,E01010578,1571,1549,22,7,11,4,0
2021,Bradford 010A,E01010579,1484,1466,18,12,4,1,1
2021,Bradford 010B,E01010580,2450,2423,27,14,10,3,0
2021,Bradford 015B,E01010581,1590,1563,27,15,8,4,0
2021,Bradford 015C,E01010582,1612,1571,41,19,13,7,2
2021,Bradford 018B,E01010583,1223,1203,20,12,7,1,0
2021,Bradford 015D,E01010584,1726,1638,88,35,28,24,1
2021,Bradford 015E,E01010585,1961,1918,43,31,6,6,0
2021,Bradford 022A,E01010586,1560,1548,12,6,2,2,2
2021,Bradford 022B,E01010587,2006,1960,46,29,12,4,1
2021,Bradford 022C,E01010588,1546,1498,48,21,19,8,0
2021,Bradford 022D,E01010589,1334,1320,14,5,5,3,1
2021,Bradford 031A,E01010590,2128,2094,34,14,9,7,4
2021,Bradford 022E,E01010591,1537,1478,59,27,22,9,1
2021,Bradford 031B,E01010592,1627,1614,13,8,5,0,0
2021,Bradford 022F,E01010593,1664,1645,19,5,7,6,1
2021,Bradford 031C,E01010594,1634,1605,29,6,15,7,1
2021,Bradford 031D,E01010595,2059,2014,45,20,13,10,2
2021,Bradford 022G,E01010596,1498,1461,37,18,14,5,0
2021,Bradford 028A,E01010597,1487,1364,123,43,50,29,1
2021,Bradford 028B,E01010598,1615,1467,148,34,66,39,9
2021,Bradford 028C,E01010599,1320,1113,207,74,79,42,12
2021,Bradford 028D,E01010600,1386,1105,281,93,107,79,2
2021,Bradford 032A,E01010601,1742,1650,92,38,32,18,4
2021,Bradford 028E,E01010602,1577,1352,225,71,98,41,15
2021,Bradford 024A,E01010603,1570,1503,67,29,22,12,4
2021,Bradford 024B,E01010604,1736,1653,83,30,33,17,3
2021,Bradford 024C,E01010605,1534,1477,57,16,19,13,9
2021,Bradford 064E,E01010606,1939,1191,748,161,294,228,65
2021,Bradford 064C,E01010607,2038,1432,606,117,231,224,34
2021,Bradford 045A,E01010608,1665,1086,579,125,208,189,57
2021,Bradford 046A,E01010609,1538,1347,191,45,96,42,8
2021,Bradford 046B,E01010610,1967,1737,230,80,78,60,12
2021,Bradford 046C,E01010611,2084,1717,367,113,136,92,26
2021,Bradford 052A,E01010612,1374,1230,144,49,70,21,4
2021,Bradford 045B,E01010613,1559,1248,311,98,110,89,14
2021,Bradford 046D,E01010614,1646,1462,184,54,91,33,6
2021,Bradford 053A,E01010615,1313,1212,101,37,36,25,3
2021,Bradford 053B,E01010616,1860,1471,389,109,183,84,13
2021,Bradford 064B,E01010617,1613,1163,450,97,173,132,48
2021,Bradford 038A,E01010618,1711,1278,433,87,169,144,33
2021,Bradford 038B,E01010619,2109,1510,599,136,233,195,35
2021,Bradford 042A,E01010620,1921,1323,598,135,214,192,57
2021,Bradford 042B,E01010621,2236,1582,654,157,225,210,62
2021,Bradford 042C,E01010622,2486,1665,821,182,328,253,58
2021,Bradford 042D,E01010623,1627,1180,447,104,174,141,28
2021,Bradford 042E,E01010624,2096,1388,708,141,270,241,56
2021,Bradford 038C,E01010625,1766,1306,460,141,157,131,31
2021,Bradford 038D,E01010626,2035,1570,465,124,173,146,22
2021,Bradford 038E,E01010627,1569,1238,331,93,111,106,21
2021,Bradford 040A,E01010628,1781,1542,239,63,111,59,6
2021,Bradford 040B,E01010629,2225,1812,413,143,167,86,17
2021,Bradford 040C,E01010630,1825,1543,282,95,138,41,8
2021,Bradford 040D,E01010631,1533,1340,193,81,76,26,10
2021,Bradford 040E,E01010632,1443,1147,296,84,126,72,14
2021,Bradford 047A,E01010633,1444,1334,110,46,42,16,6
2021,Bradford 047B,E01010634,1523,1483,40,18,12,8,2
2021,Bradford 047C,E01010635,1402,1280,122,47,40,28,7
2021,Bradford 047D,E01010636,1669,1597,72,30,23,15,4
2021,Bradford 047E,E01010637,2010,1872,138,70,39,26,3
2021,Bradford 062A,E01010638,1399,1396,3,1,2,0,0
2021,Bradford 063C,E01010639,1934,1900,34,15,12,7,0
2021,Bradford 063A,E01010640,1642,1609,33,13,15,5,0
2021,Bradford 063B,E01010641,1490,1479,11,9,1,1,0
2021,Bradford 062B,E01010642,2000,1987,13,8,4,1,0
2021,Bradford 062E,E01010643,1315,1285,30,18,9,3,0
2021,Bradford 062D,E01010644,1978,1912,66,51,8,5,2
2021,Bradford 062C,E01010645,1750,1704,46,31,9,5,1
2021,Bradford 001A,E01010646,1322,1319,3,2,1,0,0
2021,Bradford 001B,E01010647,1039,1031,8,6,1,1,0
2021,Bradford 001C,E01010648,1353,1344,9,5,2,2,0
2021,Bradford 027A,E01010649,1408,1337,71,23,34,7,7
2021,Bradford 027B,E01010650,2071,1657,414,160,170,78,6
2021,Bradford 032B,E01010651,1614,1548,66,18,27,19,2
2021,Bradford 026A,E01010652,1607,1562,45,13,19,11,2
2021,Bradford 026B,E01010653,1879,1741,138,51,56,29,2
2021,Bradford 027C,E01010654,1646,1470,176,62,65,42,7
2021,Bradford 026C,E01010655,1438,1386,52,20,25,6,1
2021,Bradford 026D,E01010656,1507,1416,91,33,35,16,7
2021,Bradford 026E,E01010657,1377,1358,19,5,7,6,1
2021,Bradford 041A,E01010658,1902,1385,517,158,231,110,18
2021,Bradford 049A,E01010659,1847,1336,511,147,195,139,30
2021,Bradford 049D,E01010662,1422,1248,174,60,68,37,9
2021,Bradford 050A,E01010663,1697,1194,503,114,207,156,26
2021,Bradford 049E,E01010664,1541,1284,257,86,104,50,17
2021,Bradford 050B,E01010665,1802,1495,307,78,123,84,22
2021,Bradford 050C,E01010666,1637,1260,377,107,131,122,17
2021,Bradford 050D,E01010667,1750,1356,394,107,151,119,17
2021,Bradford 055A,E01010668,1412,1281,131,44,48,36,3
2021,Bradford 030A,E01010669,2126,1670,456,123,201,112,20
2021,Bradford 029A,E01010670,1769,1473,296,78,99,101,18
2021,Bradford 029B,E01010671,1646,1382,264,60,106,72,26
2021,Bradford 036A,E01010672,1298,1254,44,16,16,5,7
2021,Bradford 029C,E01010673,1858,1408,450,70,166,171,43
2021,Bradford 030B,E01010674,2149,1702,447,131,202,100,14
2021,Bradford 029D,E01010675,2085,1774,311,81,108,99,23
2021,Bradford 034A,E01010676,2313,1722,591,88,230,220,53
2021,Bradford 036B,E01010678,1364,1251,113,40,41,26,6
2021,Bradford 034B,E01010679,2036,1424,612,123,244,214,31
2021,Bradford 019A,E01010680,1667,1588,79,35,29,14,1
2021,Bradford 019B,E01010681,1447,1399,48,25,13,8,2
2021,Bradford 019C,E01010682,1394,1354,40,13,15,11,1
2021,Bradford 017A,E01010683,2210,2160,50,36,11,3,0
2021,Bradford 017B,E01010684,1446,1423,23,14,6,3,0
2021,Bradford 017C,E01010685,1632,1621,11,6,5,0,0
2021,Bradford 017D,E01010686,1712,1685,27,12,8,7,0
2021,Bradford 019D,E01010687,1736,1711,25,17,5,3,0
2021,Bradford 019E,E01010688,1837,1819,18,4,10,4,0
2021,Bradford 019F,E01010689,1882,1822,60,32,17,10,1
2021,Bradford 019G,E01010690,1816,1756,60,22,21,13,4
2021,Bradford 002A,E01010691,1552,1533,19,15,3,0,1
2021,Bradford 001D,E01010692,1899,1865,34,18,13,2,1
2021,Bradford 002B,E01010693,1438,1423,15,8,3,4,0
2021,Bradford 002C,E01010694,1519,1506,13,5,3,0,5
2021,Bradford 002D,E01010695,1529,1468,61,24,24,12,1
2021,Bradford 002E,E01010696,1577,1544,33,16,9,8,0
2021,Bradford 002F,E01010697,1421,1399,22,16,6,0,0
2021,Bradford 002G,E01010698,1895,1843,52,28,17,6,1
2021,Bradford 002H,E01010699,1929,1869,60,35,18,7,0
2021,Bradford 008A,E01010700,1516,1157,359,89,149,104,17
2021,Bradford 008B,E01010701,1428,1041,387,101,120,135,31
2021,Bradford 008C,E01010702,1965,1461,504,107,179,171,47
2021,Bradford 008D,E01010703,1593,1445,148,22,74,41,11
2021,Bradford 008E,E01010704,1307,1280,27,13,9,4,1
2021,Bradford 008F,E01010705,1611,1579,32,10,10,8,4
2021,Bradford 006A,E01010706,1538,1518,20,7,7,5,1
2021,Bradford 006B,E01010707,1773,1705,68,25,21,20,2
2021,Bradford 006C,E01010708,1607,1470,137,40,55,35,7
2021,Bradford 006D,E01010709,2642,2559,83,18,30,26,9
2021,Bradford 008G,E01010710,1932,1476,456,106,179,135,36
2021,Bradford 011A,E01010711,1475,1271,204,71,71,51,11
2021,Bradford 009A,E01010712,1636,1337,299,64,111,103,21
2021,Bradford 011B,E01010713,1512,1421,91,31,38,19,3
2021,Bradford 011C,E01010714,1338,1284,54,21,19,11,3
2021,Bradford 012A,E01010715,1034,1015,19,6,8,5,0
2021,Bradford 011D,E01010716,1927,1880,47,15,22,7,3
2021,Bradford 012B,E01010717,1555,1483,72,26,29,13,4
2021,Bradford 012C,E01010718,1460,1421,39,18,15,6,0
2021,Bradford 007A,E01010719,1767,1351,416,95,169,132,20
2021,Bradford 009B,E01010720,1454,1301,153,46,75,27,5
2021,Bradford 009C,E01010721,1836,1702,134,51,56,26,1
2021,Bradford 014A,E01010722,1580,1542,38,9,17,10,2
2021,Bradford 009D,E01010723,1511,1152,359,101,129,108,21
2021,Bradford 009E,E01010724,1339,1254,85,27,25,31,2
2021,Bradford 009F,E01010725,1490,1416,74,26,26,18,4
2021,Bradford 012D,E01010726,1380,1355,25,7,7,9,2
2021,Bradford 007B,E01010727,1664,1585,79,19,32,25,3
2021,Bradford 007C,E01010728,1797,1478,319,73,120,104,22
2021,Bradford 007D,E01010729,1675,1478,197,55,90,42,10
2021,Bradford 045C,E01010730,1227,785,442,99,166,161,16
2021,Bradford 048A,E01010731,1526,975,551,150,209,156,36
2021,Bradford 048B,E01010732,1554,1155,399,98,154,118,29
2021,Bradford 048C,E01010733,1612,1161,451,72,187,149,43
2021,Bradford 045D,E01010734,1448,1059,389,100,154,112,23
2021,Bradford 051A,E01010735,1794,1286,508,129,212,137,30
2021,Bradford 048D,E01010736,1914,1116,798,261,287,221,29
2021,Bradford 048E,E01010737,1531,989,542,105,191,209,37
2021,Bradford 051B,E01010738,1990,1390,600,174,210,174,42
2021,Bradford 051C,E01010739,1974,1459,515,137,215,144,19
2021,Bradford 051D,E01010740,1840,1247,593,136,230,184,43
2021,Bradford 059A,E01010741,1355,1327,28,7,15,6,0
2021,Bradford 053C,E01010742,2001,1415,586,132,220,208,26
2021,Bradford 053D,E01010743,1598,1107,491,119,165,170,37
2021,Bradford 051E,E01010744,1763,1255,508,89,210,170,39
2021,Bradford 056A,E01010745,1808,1472,336,86,109,128,13
2021,Bradford 060A,E01010746,1981,1867,114,35,55,18,6
2021,Bradford 056B,E01010747,1552,1347,205,54,97,40,14
2021,Bradford 056C,E01010748,1536,1460,76,23,35,17,1
2021,Bradford 056D,E01010749,1285,1245,40,13,12,12,3
2021,Bradford 060B,E01010750,1473,1418,55,18,23,14,0
2021,Bradford 060C,E01010751,1359,1336,23,5,13,4,1
2021,Bradford 058A,E01010752,2019,1945,74,38,24,11,1
2021,Bradford 058B,E01010753,1278,1273,5,1,1,2,1
2021,Bradford 058C,E01010754,1512,1496,16,7,8,1,0
2021,Bradford 055B,E01010755,1887,1751,136,53,56,24,3
2021,Bradford 058D,E01010756,1738,1693,45,21,12,12,0
2021,Bradford 058E,E01010758,1251,1248,3,2,0,1,0
2021,Bradford 058F,E01010759,1491,1474,17,8,6,3,0
2021,Bradford 058G,E01010760,1860,1848,12,5,6,1,0
2021,Bradford 049G,E01010761,1668,1462,206,56,102,36,12
2021,Bradford 055C,E01010762,1517,1350,167,48,60,51,8
2021,Bradford 055D,E01010763,1577,1467,110,48,36,17,9
2021,Bradford 010C,E01010764,1594,1574,20,10,4,5,1
2021,Bradford 010D,E01010765,2215,2182,33,20,9,4,0
2021,Bradford 010E,E01010766,1195,1175,20,8,5,5,2
2021,Bradford 003A,E01010767,1411,1382,29,15,11,3,0
2021,Bradford 003B,E01010768,1576,1563,13,9,2,2,0
2021,Bradford 003C,E01010769,1518,1503,15,8,6,1,0
2021,Bradford 005A,E01010770,1725,1713,12,9,1,2,0
2021,Bradford 003D,E01010771,1194,1188,6,4,1,1,0
2021,Bradford 005B,E01010772,1237,1228,9,8,1,0,0
2021,Bradford 005C,E01010773,1518,1501,17,6,4,6,1
2021,Bradford 005D,E01010774,1557,1546,11,9,1,1,0
2021,Bradford 024D,E01010775,1718,1635,83,38,20,21,4
2021,Bradford 021A,E01010776,1561,1505,56,26,23,6,1
2021,Bradford 021B,E01010777,1394,1297,97,40,34,20,3
2021,Bradford 024E,E01010778,1926,1752,174,72,63,38,1
2021,Bradford 021C,E01010779,1529,1461,68,27,30,10,1
2021,Bradford 021D,E01010781,1426,1374,52,20,25,7,0
2021,Bradford 020B,E01010782,2137,2028,109,48,39,18,4
2021,Bradford 021E,E01010783,1513,1465,48,23,14,7,4
2021,Bradford 018C,E01010784,1534,1467,67,34,24,7,2
2021,Bradford 018D,E01010785,1532,1491,41,27,7,6,1
2021,Bradford 018E,E01010786,1548,1478,70,32,24,14,0
2021,Bradford 020C,E01010787,1513,1460,53,11,19,17,6
2021,Bradford 020D,E01010788,1359,1296,63,23,28,11,1
2021,Bradford 025A,E01010789,1777,1581,196,43,86,51,16
2021,Bradford 018F,E01010790,1544,1462,82,30,26,20,6
2021,Bradford 025B,E01010791,1762,1477,285,94,95,75,21
2021,Bradford 025C,E01010792,1916,1474,442,98,165,147,32
2021,Bradford 025D,E01010793,1755,1395,360,104,139,97,20
2021,Bradford 043A,E01010794,1916,1697,219,85,89,43,2
2021,Bradford 043B,E01010795,1880,1831,49,18,23,7,1
2021,Bradford 043C,E01010796,1643,1594,49,18,23,8,0
2021,Bradford 043D,E01010797,1367,1343,24,16,6,0,2
2021,Bradford 043E,E01010798,1463,1434,29,15,8,6,0
2021,Bradford 036C,E01010799,1532,1384,148,51,60,31,6
2021,Bradford 036D,E01010800,1763,1531,232,93,97,35,7
2021,Bradford 036E,E01010801,1930,1658,272,67,122,60,23
2021,Bradford 036F,E01010802,1927,1676,251,95,118,28,10
2021,Bradford 037A,E01010803,1784,1120,664,176,274,177,37
2021,Bradford 033A,E01010804,2201,1697,504,91,180,176,57
2021,Bradford 030D,E01010805,1736,1489,247,69,79,83,16
2021,Bradford 033B,E01010806,1599,1262,337,87,131,100,19
2021,Bradford 033C,E01010807,2202,1717,485,100,156,196,33
2021,Bradford 033D,E01010808,2228,1580,648,137,226,221,64
2021,Bradford 033E,E01010809,2053,1474,579,96,209,224,50
2021,Bradford 037B,E01010810,2134,1681,453,108,181,130,34
2021,Bradford 037C,E01010811,2144,1463,681,175,255,207,44
2021,Bradford 041B,E01010812,1943,1212,731,182,286,210,53
2021,Bradford 037D,E01010813,1818,1328,490,100,185,164,41
2021,Bradford 057A,E01010814,1556,1446,110,30,50,28,2
2021,Bradford 057B,E01010815,2473,2132,341,118,165,50,8
2021,Bradford 057C,E01010816,1850,1780,70,20,34,14,2
2021,Bradford 057D,E01010817,2518,2099,419,160,173,74,12
2021,Bradford 057E,E01010818,2018,1829,189,90,66,25,8
2021,Bradford 052B,E01010819,1433,1261,172,49,70,41,12
2021,Bradford 052C,E01010820,1397,1237,160,47,56,54,3
2021,Bradford 052D,E01010821,1820,1574,246,96,82,54,14
2021,Bradford 052E,E01010822,1203,1117,86,31,46,7,2
2021,Bradford 034C,E01010824,1818,1300,518,124,225,145,24
2021,Bradford 032C,E01010825,1475,1354,121,33,42,36,10
2021,Bradford 027D,E01010826,1586,1292,294,107,123,57,7
2021,Bradford 032D,E01010827,1500,1352,148,34,61,43,10
2021,Bradford 035A,E01010828,1575,1411,164,51,70,35,8
2021,Bradford 035B,E01010829,1617,1254,363,117,121,100,25
2021,Bradford 035C,E01010830,2300,1633,667,240,243,155,29
2021,Bradford 035D,E01010831,2099,1601,498,117,198,144,39
2021,Bradford 035E,E01010832,2350,1902,448,150,151,119,28
2021,Bradford 041C,E01010833,1668,1142,526,143,196,160,27
2021,Bradford 044A,E01010834,2809,1711,1098,400,485,183,30
2021,Bradford 044C,E01010836,1947,1221,726,196,260,214,56
2021,Bradford 044D,E01010837,2016,1440,576,120,216,201,39
2021,Bradford 044E,E01010838,1984,1221,763,195,296,219,53
2021,Bradford 044F,E01010839,1576,1011,565,151,178,195,41
2021,Bradford 034D,E01010840,1779,1280,499,72,159,225,43
2021,Bradford 034E,E01010841,1758,1225,533,92,182,201,58
2021,Bradford 065A,E01010842,2224,1596,628,170,216,202,40
2021,Bradford 041D,E01010843,1966,1393,573,113,190,224,46
2021,Bradford 059B,E01010845,1994,1805,189,78,72,31,8
2021,Bradford 055E,E01010846,2055,1918,137,48,62,23,4
2021,Bradford 054A,E01010847,1549,1469,80,26,31,19,4
2021,Bradford 054B,E01010848,1519,1443,76,25,33,15,3
2021,Bradford 059C,E01010849,1354,1321,33,16,11,4,2
2021,Bradford 059D,E01010850,1338,1299,39,15,16,7,1
2021,Bradford 059E,E01010851,1364,1328,36,12,16,7,1
2021,Bradford 054C,E01010852,1800,1488,312,91,138,72,11
2021,Bradford 054D,E01010853,1349,1260,89,26,38,19,6
2021,Bradford 023A,E01010854,1694,1681,13,3,5,5,0
2021,Bradford 023B,E01010855,1583,1573,10,5,3,1,1
2021,Bradford 023C,E01010856,1439,1424,15,9,2,4,0
2021,Bradford 023D,E01010857,1574,1570,4,1,1,2,0
2021,Bradford 023E,E01010858,1533,1517,16,10,3,2,1
2021,Bradford 012E,E01010859,1759,1726,33,12,13,6,2
2021,Bradford 014B,E01010860,1672,1656,16,3,8,5,0
2021,Bradford 023F,E01010861,1732,1719,13,8,1,4,0
2021,Bradford 014C,E01010862,1595,1588,7,5,0,0,2
2021,Bradford 014D,E01010863,1374,1363,11,3,6,1,1
2021,Bradford 059F,E01010864,1196,1142,54,25,21,6,2
2021,Bradford 060D,E01010865,1547,1510,37,10,22,5,0
2021,Bradford 060E,E01010866,1281,1257,24,13,6,5,0
2021,Bradford 059G,E01010867,1685,1586,99,46,37,15,1
2021,Bradford 061A,E01010868,1586,1526,60,23,20,11,6
2021,Bradford 061B,E01010869,1702,1636,66,35,21,8,2
2021,Bradford 061C,E01010870,1378,1353,25,11,13,1,0
2021,Bradford 061D,E01010871,1679,1631,48,18,16,12,2
2021,Bradford 061E,E01010872,1779,1729,50,21,25,4,0
2021,Bradford 061F,E01010873,1165,1147,18,6,9,1,2
2021,Bradford 059H,E01010874,1460,1379,81,35,34,9,3
2021,Calderdale 019A,E01010875,1664,1657,7,6,1,0,0
2021,Calderdale 019B,E01010876,1574,1555,19,12,3,4,0
2021,Calderdale 019C,E01010877,1388,1367,21,17,4,0,0
2021,Calderdale 015A,E01010878,1609,1585,24,14,9,1,0
2021,Calderdale 015B,E01010879,1757,1733,24,15,7,2,0
2021,Calderdale 019D,E01010880,1316,1281,35,20,10,5,0
2021,Calderdale 004A,E01010881,1530,1510,20,16,1,2,1
2021,Calderdale 004B,E01010882,1283,1267,16,7,6,2,1
2021,Calderdale 004C,E01010883,1549,1538,11,10,1,0,0
2021,Calderdale 022A,E01010884,1578,1557,21,12,7,2,0
2021,Calderdale 022B,E01010885,1474,1463,11,6,2,3,0
2021,Calderdale 022C,E01010886,1089,1085,4,1,1,2,0
2021,Calderdale 004D,E01010887,1441,1436,5,4,0,1,0
2021,Calderdale 004E,E01010888,1415,1375,40,31,6,3,0
2021,Calderdale 025A,E01010889,1655,1591,64,25,21,15,3
2021,Calderdale 025B,E01010890,1716,1650,66,24,35,5,2
2021,Calderdale 024A,E01010891,1672,1651,21,8,8,5,0
2021,Calderdale 024B,E01010892,1849,1819,30,13,13,3,1
2021,Calderdale 025C,E01010893,1394,1379,15,3,8,4,0
2021,Calderdale 025D,E01010894,1740,1659,81,31,36,14,0
2021,Calderdale 024C,E01010895,1343,1305,38,9,18,10,1
2021,Calderdale 026A,E01010896,1538,1532,6,2,1,3,0
2021,Calderdale 026B,E01010897,1622,1604,18,9,4,2,3
2021,Calderdale 026C,E01010898,1581,1552,29,13,7,9,0
2021,Calderdale 026D,E01010899,1315,1302,13,4,5,4,0
2021,Calderdale 026E,E01010900,1551,1531,20,7,5,7,1
2021,Calderdale 025E,E01010901,1820,1780,40,26,8,6,0
2021,Calderdale 026F,E01010902,1501,1478,23,9,10,4,0
2021,Calderdale 025F,E01010903,1644,1630,14,8,4,2,0
2021,Calderdale 011A,E01010904,1550,1538,12,5,3,4,0
2021,Calderdale 015C,E01010905,1900,1876,24,14,7,2,1
2021,Calderdale 011B,E01010906,1381,1359,22,13,6,2,1
2021,Calderdale 011C,E01010907,1444,1424,20,9,9,2,0
2021,Calderdale 015D,E01010908,2095,2065,30,15,12,3,0
2021,Calderdale 011D,E01010909,1669,1649,20,6,9,5,0
2021,Calderdale 015E,E01010910,1287,1264,23,8,10,5,0
2021,Calderdale 001A,E01010911,1702,1698,4,0,0,1,3
2021,Calderdale 001B,E01010912,1492,1469,23,9,12,2,0
2021,Calderdale 001C,E01010913,1257,1253,4,3,1,0,0
2021,Calderdale 002A,E01010914,1561,1539,22,11,10,1,0
2021,Calderdale 001D,E01010915,1469,1455,14,8,5,1,0
2021,Calderdale 005A,E01010916,1498,1397,101,35,40,19,7
2021,Calderdale 007A,E01010917,1717,1704,13,10,1,2,0
2021,Calderdale 007B,E01010918,1608,1599,9,4,4,1,0
2021,Calderdale 007C,E01010919,1549,1538,11,5,1,4,1
2021,Calderdale 007D,E01010920,1567,1556,11,8,2,1,0
2021,Calderdale 007E,E01010921,1585,1540,45,21,17,4,3
2021,Calderdale 020A,E01010922,1769,1748,21,6,9,6,0
2021,Calderdale 004F,E01010923,1518,1498,20,16,1,2,1
2021,Calderdale 002B,E01010924,1023,992,31,11,11,7,2
2021,Calderdale 002C,E01010925,1433,1406,27,12,10,2,3
2021,Calderdale 002D,E01010926,1141,1118,23,14,7,1,1
2021,Calderdale 009A,E01010927,2196,2146,50,26,18,4,2
2021,Calderdale 009B,E01010928,1399,1263,136,38,62,33,3
2021,Calderdale 010A,E01010929,2580,2142,438,119,182,115,22
2021,Calderdale 010B,E01010930,1591,1388,203,75,68,55,5
2021,Calderdale 003A,E01010931,1380,1374,6,4,0,2,0
2021,Calderdale 003B,E01010932,1517,1489,28,10,14,4,0
2021,Calderdale 003C,E01010933,1623,1601,22,15,6,1,0
2021,Calderdale 008A,E01010934,1891,1834,57,29,20,7,1
2021,Calderdale 003D,E01010935,1372,1359,13,8,5,0,0
2021,Calderdale 003E,E01010936,1966,1949,17,10,5,2,0
2021,Calderdale 003F,E01010937,1463,1450,13,11,0,1,1
2021,Calderdale 006A,E01010938,1458,1354,104,49,34,15,6
2021,Calderdale 005B,E01010939,1623,1611,12,8,3,1,0
2021,Calderdale 006B,E01010940,1374,1355,19,10,5,3,1
2021,Calderdale 005C,E01010941,1339,1294,45,16,14,14,1
2021,Calderdale 005D,E01010942,1713,1632,81,31,33,12,5
2021,Calderdale 006C,E01010943,1398,1272,126,47,45,28,6
2021,Calderdale 005E,E01010944,1321,1251,70,17,36,14,3
2021,Calderdale 024D,E01010945,1521,1506,15,9,2,3,1
2021,Calderdale 023A,E01010946,1258,1242,16,10,3,2,1
2021,Calderdale 023B,E01010947,1449,1431,18,12,5,0,1
2021,Calderdale 024E,E01010948,1379,1362,17,6,6,5,0
2021,Calderdale 019E,E01010949,1532,1494,38,20,14,4,0
2021,Calderdale 023C,E01010950,1405,1379,26,7,10,6,3
2021,Calderdale 023D,E01010951,1468,1427,41,6,16,15,4
2021,Calderdale 027A,E01010952,1583,1571,12,7,4,1,0
2021,Calderdale 027B,E01010953,1477,1472,5,5,0,0,0
2021,Calderdale 027C,E01010954,2415,2398,17,13,3,0,1
2021,Calderdale 027D,E01010955,1374,1351,23,11,11,1,0
2021,Calderdale 020B,E01010956,1592,1584,8,5,2,1,0
2021,Calderdale 027E,E01010957,1451,1444,7,2,2,3,0
2021,Calderdale 020C,E01010958,1288,1281,7,2,3,1,1
2021,Calderdale 020D,E01010959,1665,1653,12,8,4,0,0
2021,Calderdale 012A,E01010960,1531,1138,393,87,147,137,22
2021,Calderdale 006D,E01010961,1134,1106,28,9,14,5,0
2021,Calderdale 012B,E01010964,1533,1065,468,107,182,146,33
2021,Calderdale 012C,E01010965,1357,975,382,78,136,132,36
2021,Calderdale 012D,E01010966,1660,1176,484,120,145,179,40
2021,Calderdale 008D,E01010967,1435,1352,83,32,30,19,2
2021,Calderdale 021A,E01010968,1718,1643,75,31,27,16,1
2021,Calderdale 016A,E01010969,1708,1589,119,57,39,20,3
2021,Calderdale 016B,E01010970,1971,1867,104,50,34,16,4
2021,Calderdale 021B,E01010971,1886,1838,48,27,14,7,0
2021,Calderdale 021C,E01010972,1578,1516,62,33,18,8,3
2021,Calderdale 021D,E01010973,1696,1652,44,32,8,4,0
2021,Calderdale 016C,E01010974,1457,1271,186,48,83,47,8
2021,Calderdale 017A,E01010975,1439,1406,33,11,12,8,2
2021,Calderdale 017B,E01010976,1820,1798,22,10,5,5,2
2021,Calderdale 016D,E01010977,1763,1749,14,11,2,0,1
2021,Calderdale 017C,E01010978,1346,1331,15,7,8,0,0
2021,Calderdale 017D,E01010979,1348,1309,39,17,16,4,2
2021,Calderdale 017E,E01010980,1428,1416,12,3,8,1,0
2021,Calderdale 017F,E01010981,1413,1387,26,17,6,3,0
2021,Calderdale 013A,E01010982,1330,1288,42,15,15,11,1
2021,Calderdale 013B,E01010983,1598,1532,66,22,22,14,8
2021,Calderdale 022D,E01010984,1324,1297,27,8,8,11,0
2021,Calderdale 013C,E01010985,1375,1335,40,16,15,7,2
2021,Calderdale 013D,E01010986,1650,1628,22,2,10,4,6
2021,Calderdale 013E,E01010987,1817,1805,12,10,0,1,1
2021,Calderdale 013F,E01010988,1386,1370,16,7,8,1,0
2021,Calderdale 018A,E01010989,1432,1324,108,78,23,6,1
2021,Calderdale 018B,E01010990,1560,1543,17,6,7,2,2
2021,Calderdale 018C,E01010991,1389,1370,19,12,4,2,1
2021,Calderdale 018D,E01010992,1648,1558,90,45,35,8,2
2021,Calderdale 018E,E01010993,1647,1559,88,36,34,11,7
2021,Calderdale 012E,E01010995,1302,938,364,111,111,119,23
2021,Calderdale 014A,E01010996,1421,1006,415,90,138,155,32
2021,Calderdale 009C,E01010997,1464,1407,57,22,18,12,5
2021,Calderdale 010C,E01010998,1722,1517,205,72,75,51,7
2021,Calderdale 009D,E01010999,1488,1408,80,26,35,16,3
2021,Calderdale 010D,E01011000,2283,1804,479,129,181,141,28
2021,Calderdale 014B,E01011001,1597,1190,407,84,158,138,27
2021,Calderdale 014C,E01011002,1770,1468,302,65,123,88,26
2021,Calderdale 014D,E01011003,1422,1143,279,60,125,80,14
2021,Kirklees 040A,E01011004,1266,1191,75,32,32,10,1
2021,Kirklees 044A,E01011005,1437,1401,36,16,11,8,1
2021,Kirklees 040B,E01011006,1441,1383,58,23,30,5,0
2021,Kirklees 042A,E01011007,1711,1485,226,103,89,32,2
2021,Kirklees 040C,E01011008,1387,1328,59,27,17,12,3
2021,Kirklees 044B,E01011009,1320,1283,37,21,7,8,1
2021,Kirklees 044C,E01011010,1528,1424,104,34,41,26,3
2021,Kirklees 044D,E01011011,1443,1424,19,7,6,6,0
2021,Kirklees 040D,E01011012,1472,1421,51,24,18,5,4
2021,Kirklees 007A,E01011013,1530,1478,52,25,19,4,4
2021,Kirklees 007B,E01011014,1505,1333,172,52,60,52,8
2021,Kirklees 010A,E01011015,1498,1097,401,106,132,135,28
2021,Kirklees 013A,E01011016,1377,1086,291,68,106,109,8
2021,Kirklees 013B,E01011017,1478,1020,458,88,155,172,43
2021,Kirklees 013C,E01011018,1362,1048,314,90,124,87,13
2021,Kirklees 013D,E01011019,1394,1130,264,59,89,105,11
2021,Kirklees 013E,E01011020,1304,1001,303,75,102,107,19
2021,Kirklees 014A,E01011021,1541,1501,40,18,12,7,3
2021,Kirklees 014B,E01011022,1378,1280,98,20,39,29,10
2021,Kirklees 007C,E01011023,1738,1446,292,94,100,85,13
2021,Kirklees 007D,E01011024,1856,1607,249,77,97,63,12
2021,Kirklees 016A,E01011025,1505,1337,168,53,70,37,8
2021,Kirklees 016B,E01011026,1502,1244,258,81,110,54,13
2021,Kirklees 006A,E01011027,1267,1211,56,25,19,9,3
2021,Kirklees 006B,E01011028,1382,1295,87,35,28,21,3
2021,Kirklees 010B,E01011029,1493,1341,152,41,66,41,4
2021,Kirklees 006C,E01011030,1581,1455,126,45,50,30,1
2021,Kirklees 006D,E01011031,1935,1830,105,40,39,25,1
2021,Kirklees 010C,E01011032,2100,1881,219,76,83,48,12
2021,Kirklees 012A,E01011033,1648,1492,156,55,63,33,5
2021,Kirklees 010D,E01011034,1490,1149,341,80,110,121,30
2021,Kirklees 012B,E01011035,1561,1185,376,91,139,124,22
2021,Kirklees 012C,E01011036,1695,1391,304,81,108,102,13
2021,Kirklees 012D,E01011037,2191,1896,295,85,111,86,13
2021,Kirklees 029A,E01011038,1714,1269,445,118,203,111,13
2021,Kirklees 027A,E01011039,1733,1396,337,118,127,83,9
2021,Kirklees 031A,E01011040,1830,1450,380,100,154,109,17
2021,Kirklees 029B,E01011041,1501,1251,250,63,106,74,7
2021,Kirklees 027B,E01011042,1563,1400,163,58,68,28,9
2021,Kirklees 031B,E01011043,2618,1988,630,187,241,179,23
2021,Kirklees 031C,E01011044,1570,1313,257,77,104,68,8
2021,Kirklees 031D,E01011045,1866,1326,540,112,206,190,32
2021,Kirklees 022A,E01011046,1376,1303,73,28,30,12,3
2021,Kirklees 027C,E01011047,1460,1401,59,31,21,7,0
2021,Kirklees 002A,E01011048,1606,1582,24,9,7,8,0
2021,Kirklees 002B,E01011049,1664,1636,28,11,12,4,1
2021,Kirklees 002C,E01011050,1418,1401,17,10,5,2,0
2021,Kirklees 001A,E01011051,1625,1611,14,7,5,0,2
2021,Kirklees 002D,E01011052,1547,1479,68,27,26,12,3
2021,Kirklees 002E,E01011053,1360,1343,17,8,4,3,2
2021,Kirklees 006E,E01011054,1339,1303,36,12,18,5,1
2021,Kirklees 001B,E01011055,1245,1215,30,16,9,5,0
2021,Kirklees 001C,E01011056,1631,1617,14,9,3,2,0
2021,Kirklees 001D,E01011057,1576,1565,11,6,3,2,0
2021,Kirklees 001E,E01011058,1221,1203,18,9,5,2,2
2021,Kirklees 002F,E01011059,1728,1634,94,31,48,13,2
2021,Kirklees 005A,E01011060,1556,1517,39,13,21,4,1
2021,Kirklees 005B,E01011061,1614,1521,93,27,38,25,3
2021,Kirklees 003A,E01011062,1841,1795,46,12,17,15,2
2021,Kirklees 005C,E01011063,2081,2005,76,25,29,20,2
2021,Kirklees 003B,E01011064,1618,1575,43,17,14,11,1
2021,Kirklees 005D,E01011065,1570,1528,42,14,15,12,1
2021,Kirklees 005E,E01011066,1465,1436,29,12,10,5,2
2021,Kirklees 008A,E01011067,1611,1584,27,16,8,3,0
2021,Kirklees 003C,E01011068,1528,1520,8,4,3,1,0
2021,Kirklees 003D,E01011069,1383,1374,9,2,3,3,1
2021,Kirklees 052A,E01011070,1614,1605,9,6,2,1,0
2021,Kirklees 049A,E01011071,1865,1848,17,7,6,4,0
2021,Kirklees 049B,E01011072,1559,1553,6,4,2,0,0
2021,Kirklees 049C,E01011073,1506,1487,19,15,4,0,0
2021,Kirklees 052B,E01011074,1783,1777,6,4,2,0,0
2021,Kirklees 052C,E01011075,1425,1412,13,5,5,3,0
2021,Kirklees 052D,E01011076,1380,1363,17,11,4,2,0
2021,Kirklees 045A,E01011077,1558,1522,36,12,11,11,2
2021,Kirklees 049D,E01011078,1796,1777,19,13,4,1,1
2021,Kirklees 047A,E01011079,1912,1669,243,65,108,58,12
2021,Kirklees 043A,E01011080,1978,1521,457,99,219,114,25
2021,Kirklees 043B,E01011081,1732,1408,324,95,106,102,21
2021,Kirklees 043C,E01011082,1777,1222,555,124,199,182,50
2021,Kirklees 047B,E01011083,1710,1584,126,38,52,31,5
2021,Kirklees 047C,E01011084,1876,1464,412,125,153,120,14
2021,Kirklees 047D,E01011085,1660,1514,146,38,71,31,6
2021,Kirklees 050A,E01011086,1547,1494,53,19,20,13,1
2021,Kirklees 050B,E01011087,1458,1424,34,15,16,3,0
2021,Kirklees 050C,E01011088,1276,1257,19,12,5,2,0
2021,Kirklees 032A,E01011089,1218,1195,23,10,9,3,1
2021,Kirklees 037A,E01011090,1405,1340,65,28,25,11,1
2021,Kirklees 032B,E01011091,1327,1310,17,7,7,3,0
2021,Kirklees 032C,E01011092,1243,1231,12,6,6,0,0
2021,Kirklees 035A,E01011093,1391,1208,183,50,85,41,7
2021,Kirklees 035B,E01011094,1529,1322,207,85,74,39,9
2021,Kirklees 037B,E01011095,1334,1278,56,16,27,10,3
2021,Kirklees 035C,E01011096,1480,1351,129,42,48,34,5
2021,Kirklees 037C,E01011097,1583,1510,73,24,31,16,2
2021,Kirklees 035D,E01011098,1560,1408,152,55,57,37,3
2021,Kirklees 037D,E01011099,1400,1327,73,31,29,13,0
2021,Kirklees 022B,E01011100,1436,1327,109,35,48,19,7
2021,Kirklees 025A,E01011101,1713,1460,253,73,110,58,12
2021,Kirklees 022C,E01011102,1303,1235,68,30,15,20,3
2021,Kirklees 025B,E01011103,1328,1250,78,24,26,24,4
2021,Kirklees 025C,E01011104,1569,1430,139,37,56,41,5
2021,Kirklees 025D,E01011105,2343,1962,381,165,146,57,13
2021,Kirklees 029C,E01011106,1555,1362,193,63,86,37,7
2021,Kirklees 029D,E01011107,2148,1464,684,205,295,164,20
2021,Kirklees 022D,E01011108,1351,1255,96,35,36,23,2
2021,Kirklees 054A,E01011109,1839,1831,8,5,2,1,0
2021,Kirklees 057A,E01011110,1421,1399,22,14,5,3,0
2021,Kirklees 057B,E01011111,1828,1801,27,11,13,3,0
2021,Kirklees 057C,E01011112,1563,1555,8,5,1,2,0
2021,Kirklees 054B,E01011113,1516,1510,6,6,0,0,0
2021,Kirklees 054C,E01011114,1659,1649,10,6,2,2,0
2021,Kirklees 057D,E01011115,1785,1776,9,6,2,1,0
2021,Kirklees 057E,E01011116,1532,1529,3,1,1,1,0
2021,Kirklees 057F,E01011117,1685,1673,12,8,2,1,1
2021,Kirklees 056A,E01011118,1481,1461,20,14,5,1,0
2021,Kirklees 054D,E01011119,1391,1387,4,2,2,0,0
2021,Kirklees 056B,E01011120,1393,1382,11,6,2,3,0
2021,Kirklees 018A,E01011121,1710,1654,56,17,24,14,1
2021,Kirklees 018B,E01011122,1318,1275,43,10,21,8,4
2021,Kirklees 018C,E01011123,1587,1438,149,43,60,39,7
2021,Kirklees 018D,E01011124,1892,1830,62,24,31,7,0
2021,Kirklees 018E,E01011125,2022,1941,81,34,36,10,1
2021,Kirklees 014C,E01011126,1795,1720,75,32,32,9,2
2021,Kirklees 014D,E01011127,1316,1286,30,9,14,4,3
2021,Kirklees 017A,E01011128,1933,1491,442,151,159,113,19
2021,Kirklees 018F,E01011129,1233,1162,71,15,35,17,4
2021,Kirklees 017B,E01011130,2100,1658,442,97,198,124,23
2021,Kirklees 020A,E01011132,1505,1481,24,9,6,9,0
2021,Kirklees 023A,E01011133,1607,1220,387,90,142,121,34
2021,Kirklees 023B,E01011134,2018,1438,580,131,208,204,37
2021,Kirklees 016C,E01011136,1565,1379,186,55,72,48,11
2021,Kirklees 016D,E01011137,1419,1298,121,45,46,26,4
2021,Kirklees 019A,E01011138,1832,1428,404,92,161,129,22
2021,Kirklees 019B,E01011139,1511,1246,265,58,111,79,17
2021,Kirklees 019C,E01011140,1660,1296,364,104,128,111,21
2021,Kirklees 019D,E01011141,1721,1377,344,85,136,107,16
2021,Kirklees 020B,E01011142,1521,1499,22,3,10,6,3
2021,Kirklees 023C,E01011143,1757,1218,539,122,196,179,42
2021,Kirklees 023D,E01011144,1616,1039,577,113,214,200,50
2021,Kirklees 041A,E01011145,1399,1381,18,9,9,0,0
2021,Kirklees 036A,E01011146,1510,1508,2,1,1,0,0
2021,Kirklees 041B,E01011147,1620,1579,41,23,13,5,0
2021,Kirklees 041C,E01011148,1670,1600,70,29,23,13,5
2021,Kirklees 045B,E01011149,1734,1662,72,26,22,21,3
2021,Kirklees 038A,E01011150,1585,1557,28,16,7,5,0
2021,Kirklees 036B,E01011151,1466,1454,12,10,2,0,0
2021,Kirklees 041D,E01011152,1638,1623,15,6,4,5,0
2021,Kirklees 045C,E01011153,1633,1594,39,8,22,8,1
2021,Kirklees 045D,E01011154,1550,1495,55,28,15,9,3
2021,Kirklees 038B,E01011155,2059,2039,20,7,9,4,0
2021,Kirklees 015A,E01011156,1477,1450,27,14,4,7,2
2021,Kirklees 011A,E01011157,1672,1392,280,72,100,91,17
2021,Kirklees 015B,E01011158,1886,1806,80,20,30,24,6
2021,Kirklees 015C,E01011159,1674,1658,16,3,1,0,12
2021,Kirklees 015D,E01011160,1286,1273,13,5,7,1,0
2021,Kirklees 011B,E01011161,1280,1223,57,25,25,7,0
2021,Kirklees 015E,E01011162,1437,1431,6,3,1,2,0
2021,Kirklees 011C,E01011163,1334,1244,90,35,32,21,2
2021,Kirklees 011D,E01011164,1710,1652,58,19,24,12,3
2021,Kirklees 011E,E01011165,1707,1439,268,54,118,77,19
2021,Kirklees 011F,E01011166,1620,1398,222,55,62,87,18
2021,Kirklees 011G,E01011167,1893,1581,312,64,114,108,26
2021,Kirklees 055A,E01011168,1583,1570,13,6,7,0,0
2021,Kirklees 053A,E01011169,1374,1368,6,3,3,0,0
2021,Kirklees 053B,E01011170,1833,1822,11,7,1,3,0
2021,Kirklees 053E,E01011173,1186,1181,5,1,1,2,1
2021,Kirklees 055B,E01011174,1802,1792,10,5,4,1,0
2021,Kirklees 055C,E01011175,1671,1642,29,11,14,1,3
2021,Kirklees 053F,E01011176,1336,1330,6,4,0,1,1
2021,Kirklees 055D,E01011177,1960,1950,10,5,2,3,0
2021,Kirklees 055E,E01011178,1816,1797,19,13,4,2,0
2021,Kirklees 059A,E01011179,1638,1634,4,3,1,0,0
2021,Kirklees 058A,E01011180,1846,1835,11,5,4,2,0
2021,Kirklees 059B,E01011181,1713,1698,15,11,3,1,0
2021,Kirklees 058B,E01011182,1635,1628,7,4,1,1,1
2021,Kirklees 059C,E01011183,2194,2181,13,11,0,1,1
2021,Kirklees 059D,E01011184,1366,1343,23,4,13,5,1
2021,Kirklees 059E,E01011185,1552,1543,9,6,2,1,0
2021,Kirklees 058C,E01011186,1765,1747,18,8,5,5,0
2021,Kirklees 059F,E01011187,1635,1619,16,13,1,1,1
2021,Kirklees 058D,E01011188,1609,1587,22,13,6,3,0
2021,Kirklees 059G,E01011189,1807,1792,15,12,2,0,1
2021,Kirklees 051A,E01011190,1561,1535,26,7,16,3,0
2021,Kirklees 046A,E01011191,1506,1473,33,19,10,3,1
2021,Kirklees 046B,E01011192,1528,1506,22,12,5,4,1
2021,Kirklees 046C,E01011193,2203,2183,20,14,4,2,0
2021,Kirklees 046D,E01011194,1271,1260,11,8,1,2,0
2021,Kirklees 051B,E01011195,1715,1680,35,24,11,0,0
2021,Kirklees 051C,E01011196,1894,1884,10,10,0,0,0
2021,Kirklees 051D,E01011197,1469,1459,10,5,4,0,1
2021,Kirklees 056C,E01011198,1535,1516,19,15,3,1,0
2021,Kirklees 056D,E01011199,1433,1419,14,9,5,0,0
2021,Kirklees 032D,E01011200,2229,2180,49,28,14,5,2
2021,Kirklees 030A,E01011201,1669,1579,90,50,26,7,7
2021,Kirklees 036C,E01011202,1517,1466,51,23,15,11,2
2021,Kirklees 030B,E01011203,1798,1722,76,33,38,3,2
2021,Kirklees 033A,E01011204,1498,1429,69,31,20,17,1
2021,Kirklees 036D,E01011205,1542,1506,36,12,13,8,3
2021,Kirklees 033B,E01011206,1614,1528,86,44,29,10,3
2021,Kirklees 038C,E01011207,1431,1379,52,19,22,11,0
2021,Kirklees 033C,E01011208,1586,1498,88,52,25,11,0
2021,Kirklees 027D,E01011210,2020,1904,116,58,36,21,1
2021,Kirklees 030D,E01011211,1915,1838,77,41,24,9,3
2021,Kirklees 026A,E01011212,1522,1484,38,23,5,8,2
2021,Kirklees 026B,E01011213,1496,1481,15,8,5,2,0
2021,Kirklees 026C,E01011214,1465,1450,15,9,4,2,0
2021,Kirklees 026D,E01011215,2246,2211,35,17,15,1,2
2021,Kirklees 021A,E01011216,1458,1427,31,19,7,5,0
2021,Kirklees 020C,E01011217,1510,1498,12,9,2,1,0
2021,Kirklees 020D,E01011218,1594,1574,20,12,3,4,1
2021,Kirklees 021B,E01011219,1532,1520,12,2,8,2,0
2021,Kirklees 021C,E01011220,1728,1649,79,28,32,14,5
2021,Kirklees 021D,E01011221,1648,1614,34,13,9,11,1
2021,Kirklees 050D,E01011222,1580,1513,67,32,23,10,2
2021,Kirklees 042B,E01011223,1831,1652,179,94,51,28,6
2021,Kirklees 048A,E01011224,1719,1527,192,77,62,42,11
2021,Kirklees 042C,E01011225,1599,1406,193,77,78,34,4
2021,Kirklees 048B,E01011226,1450,1385,65,26,27,9,3
2021,Kirklees 048C,E01011227,1456,1336,120,47,40,26,7
2021,Kirklees 048D,E01011228,1331,1295,36,16,9,10,1
2021,Kirklees 042D,E01011229,2744,2163,581,255,220,97,9
2021,Kirklees 043D,E01011230,1952,1361,591,152,218,183,38
2021,Kirklees 034A,E01011231,1390,1317,73,27,27,17,2
2021,Kirklees 039A,E01011232,1512,1248,264,82,111,62,9
2021,Kirklees 039B,E01011233,1647,1493,154,64,53,32,5
2021,Kirklees 038D,E01011234,1489,1399,90,33,32,21,4
2021,Kirklees 039C,E01011235,1808,1340,468,144,189,116,19
2021,Kirklees 034B,E01011236,1689,1378,311,128,115,57,11
2021,Kirklees 039D,E01011237,1615,1350,265,58,120,73,14
2021,Kirklees 034C,E01011238,1692,1476,216,93,76,42,5
2021,Kirklees 034D,E01011239,1567,1453,114,47,46,19,2
2021,Kirklees 033D,E01011240,1742,1582,160,62,63,31,4
2021,Kirklees 004A,E01011241,1573,1558,15,11,4,0,0
2021,Kirklees 004B,E01011242,1572,1540,32,14,12,6,0
2021,Kirklees 004C,E01011243,1593,1574,19,6,8,5,0
2021,Kirklees 004D,E01011244,1955,1919,36,16,16,4,0
2021,Kirklees 009A,E01011245,1490,1455,35,14,10,10,1
2021,Kirklees 009B,E01011246,1479,1395,84,27,33,18,6
2021,Kirklees 008B,E01011247,1525,1496,29,16,9,3,1
2021,Kirklees 009C,E01011248,1370,1342,28,7,14,7,0
2021,Kirklees 008C,E01011249,1742,1661,81,33,22,21,5
2021,Kirklees 009D,E01011250,1712,1643,69,26,22,18,3
2021,Kirklees 008D,E01011251,1621,1574,47,23,15,7,2
2021,Kirklees 028A,E01011252,1107,1094,13,10,3,0,0
2021,Kirklees 028B,E01011253,1194,1168,26,9,11,5,1
2021,Kirklees 028C,E01011254,1498,1484,14,5,3,5,1
2021,Kirklees 028D,E01011255,1390,1345,45,20,15,9,1
2021,Kirklees 028E,E01011256,1255,1228,27,12,15,0,0
2021,Kirklees 024A,E01011257,1950,1340,610,137,198,218,57
2021,Kirklees 024B,E01011258,1918,1407,511,117,195,153,46
2021,Kirklees 024C,E01011259,1998,1540,458,153,166,113,26
2021,Kirklees 023E,E01011260,1406,1182,224,72,79,62,11
2021,Kirklees 024D,E01011261,1405,1077,328,102,129,86,11
2021,Kirklees 024E,E01011262,1682,1315,367,107,131,109,20
2021,Kirklees 024F,E01011263,1723,1518,205,59,80,58,8
2021,Leeds 011A,E01011264,1261,1227,34,16,11,6,1
2021,Leeds 009A,E01011265,1894,1845,49,30,9,10,0
2021,Leeds 008A,E01011266,2554,2505,49,30,13,6,0
2021,Leeds 009B,E01011267,1635,1608,27,19,4,4,0
2021,Leeds 010A,E01011268,1346,1315,31,18,8,4,1
2021,Leeds 011B,E01011269,1539,1516,23,11,10,2,0
2021,Leeds 008B,E01011270,1680,1669,11,7,3,0,1
2021,Leeds 009C,E01011271,2123,2097,26,19,7,0,0
2021,Leeds 009D,E01011272,1414,1403,11,6,3,2,0
2021,Leeds 010B,E01011273,1436,1397,39,17,20,1,1
2021,Leeds 010C,E01011274,1325,1291,34,19,13,2,0
2021,Leeds 010D,E01011275,1356,1347,9,2,5,1,1
2021,Leeds 011C,E01011276,1671,1643,28,14,10,2,2
2021,Leeds 014A,E01011277,1552,1526,26,19,6,1,0
2021,Leeds 014B,E01011278,1573,1544,29,14,8,6,1
2021,Leeds 008C,E01011279,1282,1273,9,6,3,0,0
2021,Leeds 008D,E01011280,1999,1956,43,30,8,3,2
2021,Leeds 059A,E01011281,2097,1849,248,109,90,35,14
2021,Leeds 059B,E01011282,1332,1299,33,13,14,4,2
2021,Leeds 059C,E01011283,1488,1346,142,60,52,27,3
2021,Leeds 071A,E01011284,2054,1606,448,170,203,64,11
2021,Leeds 059D,E01011286,1244,1157,87,38,33,16,0
2021,Leeds 067B,E01011287,1392,1345,47,13,17,14,3
2021,Leeds 071B,E01011292,1879,1397,482,168,195,108,11
2021,Leeds 071C,E01011293,1877,1359,518,153,193,155,17
2021,Leeds 071D,E01011294,1660,1453,207,53,81,63,10
2021,Leeds 059E,E01011295,1623,1412,211,104,72,23,12
2021,Leeds 030A,E01011296,1589,1582,7,6,0,0,1
2021,Leeds 030B,E01011297,1677,1659,18,9,6,3,0
2021,Leeds 088A,E01011298,1497,1469,28,11,13,2,2
2021,Leeds 088B,E01011299,2727,2689,38,29,6,2,1
2021,Leeds 089A,E01011300,1408,1402,6,3,2,0,1
2021,Leeds 089B,E01011301,1219,1206,13,9,4,0,0
2021,Leeds 088C,E01011302,1730,1714,16,8,5,3,0
2021,Leeds 088D,E01011303,1114,1102,12,4,0,3,5
2021,Leeds 089C,E01011304,1536,1509,27,13,7,7,0
2021,Leeds 089D,E01011305,1453,1431,22,11,7,2,2
2021,Leeds 089E,E01011306,1263,1255,8,5,1,1,1
2021,Leeds 103A,E01011307,1560,1540,20,5,7,5,3
2021,Leeds 103B,E01011308,1458,1440,18,10,5,3,0
2021,Leeds 030C,E01011309,1473,1453,20,11,2,6,1
2021,Leeds 030D,E01011310,1581,1558,23,8,8,5,2
2021,Leeds 022A,E01011311,1228,1176,52,35,11,5,1
2021,Leeds 086A,E01011312,1903,1315,588,125,269,183,11
2021,Leeds 091A,E01011313,1673,1322,351,122,139,75,15
2021,Leeds 091B,E01011314,1516,1189,327,102,147,65,13
2021,Leeds 090A,E01011315,1559,1387,172,69,71,27,5
2021,Leeds 086B,E01011316,1901,1255,646,197,229,195,25
2021,Leeds 090B,E01011317,1690,1445,245,101,95,38,11
2021,Leeds 090C,E01011318,1468,1169,299,121,118,49,11
2021,Leeds 091C,E01011319,1515,1259,256,68,107,67,14
2021,Leeds 091D,E01011320,1719,1473,246,94,93,54,5
2021,Leeds 090D,E01011321,1567,1269,298,127,117,43,11
2021,Leeds 091E,E01011322,1604,1434,170,79,62,25,4
2021,Leeds 051A,E01011323,1265,1230,35,17,13,2,3
2021,Leeds 046A,E01011324,1758,1595,163,81,54,23,5
2021,Leeds 046B,E01011325,1569,1459,110,57,40,13,0
2021,Leeds 046C,E01011326,1443,1308,135,53,55,23,4
2021,Leeds 052A,E01011327,1305,1278,27,13,13,0,1
2021,Leeds 052B,E01011328,1533,1505,28,9,13,6,0
2021,Leeds 051B,E01011329,1456,1412,44,26,14,2,2
2021,Leeds 051C,E01011330,1309,1290,19,8,10,1,0
2021,Leeds 058A,E01011331,1299,1258,41,24,9,6,2
2021,Leeds 046D,E01011332,1550,1422,128,70,36,21,1
2021,Leeds 051D,E01011333,1329,1288,41,24,13,4,0
2021,Leeds 058B,E01011334,1363,1305,58,23,26,8,1
2021,Leeds 052C,E01011335,1655,1598,57,38,12,5,2
2021,Leeds 058C,E01011336,1512,1455,57,34,17,6,0
2021,Leeds 058D,E01011337,1656,1506,150,65,59,26,0
2021,Leeds 064A,E01011338,1955,1299,656,257,285,105,9
2021,Leeds 060A,E01011339,2035,1645,390,165,158,61,6
2021,Leeds 060B,E01011340,1713,1397,316,134,117,58,7
2021,Leeds 061A,E01011341,2071,1950,121,70,30,18,3
2021,Leeds 060C,E01011342,1812,1385,427,168,181,70,8
2021,Leeds 061B,E01011343,1885,1744,141,73,41,27,0
2021,Leeds 065A,E01011344,1907,1252,655,180,267,163,45
2021,Leeds 061C,E01011345,1455,1355,100,49,32,9,10
2021,Leeds 060D,E01011346,1839,1609,230,117,75,33,5
2021,Leeds 065B,E01011347,1843,1320,523,187,210,121,5
2021,Leeds 065C,E01011348,1729,1335,394,151,165,66,12
2021,Leeds 065D,E01011349,1716,1222,494,158,231,89,16
2021,Leeds 034A,E01011350,1492,1390,102,63,28,10,1
2021,Leeds 034B,E01011351,1661,1600,61,32,14,5,10
2021,Leeds 034C,E01011352,1815,1694,121,64,32,21,4
2021,Leeds 034D,E01011353,1862,1749,113,63,37,10,3
2021,Leeds 038A,E01011354,1509,1280,229,92,94,34,9
2021,Leeds 038B,E01011355,1442,1285,157,62,61,32,2
2021,Leeds 042A,E01011356,1955,1733,222,123,66,28,5
2021,Leeds 038C,E01011357,1988,1628,360,144,152,50,14
2021,Leeds 042B,E01011358,1504,1300,204,101,63,31,9
2021,Leeds 042C,E01011359,1821,1564,257,92,83,66,16
2021,Leeds 042D,E01011360,2154,1506,648,177,258,183,30
2021,Leeds 042E,E01011361,2753,2078,675,242,266,145,22
2021,Leeds 081A,E01011362,1845,1499,346,139,136,63,8
2021,Leeds 071E,E01011363,1854,1454,400,140,181,74,5
2021,Leeds 085A,E01011364,2044,1549,495,208,187,80,20
2021,Leeds 082A,E01011366,1701,1267,434,138,205,87,4
2021,Leeds 082C,E01011368,1558,1172,386,156,138,85,7
2021,Leeds 090E,E01011369,1543,1366,177,80,65,29,3
2021,Leeds 082D,E01011370,1625,1302,323,123,125,64,11
2021,Leeds 085B,E01011371,1750,1282,468,161,185,114,8
2021,Leeds 086C,E01011372,1674,1138,536,145,198,166,27
2021,Leeds 085C,E01011373,1491,1100,391,129,169,79,14
2021,Leeds 085D,E01011374,1202,839,363,119,130,104,10
2021,Leeds 086D,E01011375,1961,1331,630,161,246,187,36
2021,Leeds 013A,E01011376,1614,1568,46,22,14,7,3
2021,Leeds 013B,E01011377,1345,1303,42,18,14,8,2
2021,Leeds 013C,E01011378,1373,1252,121,44,44,31,2
2021,Leeds 017A,E01011379,1542,1399,143,48,67,24,4
2021,Leeds 016A,E01011380,1507,1432,75,47,20,6,2
2021,Leeds 016B,E01011381,1441,1281,160,44,44,37,35
2021,Leeds 013D,E01011382,1553,1508,45,27,13,4,1
2021,Leeds 019A,E01011383,1620,1447,173,86,56,26,5
2021,Leeds 017B,E01011384,1449,1366,83,40,26,17,0
2021,Leeds 016C,E01011385,1309,1185,124,74,22,23,5
2021,Leeds 016D,E01011386,1752,1623,129,66,37,26,0
2021,Leeds 019B,E01011388,1534,1372,162,74,63,21,4
2021,Leeds 087A,E01011390,1326,1305,21,13,7,1,0
2021,Leeds 087B,E01011391,1525,1510,15,5,6,3,1
2021,Leeds 087C,E01011392,1904,1889,15,11,4,0,0
2021,Leeds 103C,E01011393,2129,2102,27,20,5,2,0
2021,Leeds 103D,E01011394,1128,1119,9,4,2,2,1
2021,Leeds 103E,E01011395,1161,1143,18,7,6,3,2
2021,Leeds 074A,E01011396,1834,1793,41,23,12,5,1
2021,Leeds 077A,E01011397,1424,1413,11,5,3,3,0
2021,Leeds 077B,E01011398,1119,1114,5,5,0,0,0
2021,Leeds 074B,E01011399,1463,1444,19,13,3,3,0
2021,Leeds 074C,E01011400,1360,1330,30,18,10,2,0
2021,Leeds 077C,E01011401,1714,1685,29,16,5,6,2
2021,Leeds 087D,E01011402,2004,1961,43,17,16,10,0
2021,Leeds 074D,E01011403,1493,1481,12,8,1,1,2
2021,Leeds 077D,E01011404,1346,1336,10,5,3,0,2
2021,Leeds 077E,E01011405,1438,1431,7,3,3,0,1
2021,Leeds 057A,E01011406,1268,1251,17,13,2,2,0
2021,Leeds 057B,E01011407,1381,1352,29,14,11,3,1
2021,Leeds 057C,E01011408,1470,1436,34,12,12,6,4
2021,Leeds 057D,E01011409,1407,1394,13,8,2,1,2
2021,Leeds 057E,E01011410,1626,1593,33,19,12,2,0
2021,Leeds 073A,E01011411,1675,1636,39,25,8,5,1
2021,Leeds 057F,E01011412,1759,1730,29,14,11,4,0
2021,Leeds 069A,E01011413,1411,1382,29,10,5,11,3
2021,Leeds 073B,E01011414,1448,1417,31,25,4,1,1
2021,Leeds 069B,E01011415,1583,1503,80,35,44,1,0
2021,Leeds 069C,E01011416,1449,1429,20,7,9,2,2
2021,Leeds 069D,E01011417,1504,1471,33,13,16,4,0
2021,Leeds 073C,E01011418,1427,1393,34,24,8,2,0
2021,Leeds 073D,E01011419,1087,1077,10,8,2,0,0
2021,Leeds 069E,E01011420,1327,1313,14,4,5,3,2
2021,Leeds 040A,E01011421,1476,1280,196,80,69,37,10
2021,Leeds 048A,E01011422,1554,1073,481,137,173,135,36
2021,Leeds 047A,E01011423,1665,1435,230,89,90,43,8
2021,Leeds 047B,E01011424,1856,1445,411,156,138,100,17
2021,Leeds 040B,E01011425,1494,1341,153,70,54,21,8
2021,Leeds 048B,E01011426,1625,1177,448,131,147,132,38
2021,Leeds 047C,E01011427,1940,1397,543,165,215,134,29
2021,Leeds 048C,E01011428,2010,1233,777,191,327,227,32
2021,Leeds 048D,E01011429,1975,1345,630,173,221,183,53
2021,Leeds 053A,E01011430,1633,1016,617,154,243,176,44
2021,Leeds 047D,E01011431,2017,1593,424,175,150,89,10
2021,Leeds 053B,E01011432,1657,1026,631,170,249,183,29
2021,Leeds 053C,E01011433,1797,1019,778,200,315,218,45
2021,Leeds 053D,E01011434,1634,886,748,215,278,221,34
2021,Leeds 044A,E01011435,1815,1748,67,48,15,2,2
2021,Leeds 044D,E01011440,1670,1603,67,41,13,13,0
2021,Leeds 044E,E01011441,1928,1795,133,64,44,22,3
2021,Leeds 110A,E01011442,1865,1781,84,47,29,8,0
2021,Leeds 110B,E01011443,1859,1682,177,97,55,22,3
2021,Leeds 110C,E01011444,1980,1851,129,81,27,19,2
2021,Leeds 054A,E01011445,1777,1704,73,45,18,8,2
2021,Leeds 054B,E01011446,1736,1572,164,75,39,45,5
2021,Leeds 054C,E01011447,1413,1270,143,72,43,22,6
2021,Leeds 054D,E01011448,1662,1517,145,53,56,33,3
2021,Leeds 054E,E01011449,1453,1255,198,80,63,51,4
2021,Leeds 038D,E01011450,1268,1096,172,67,67,32,6
2021,Leeds 110D,E01011451,1532,1457,75,56,13,6,0
2021,Leeds 027A,E01011452,1601,1573,28,19,9,0,0
2021,Leeds 028A,E01011453,1529,1494,35,22,9,3,1
2021,Leeds 027B,E01011454,1542,1495,47,33,10,4,0
2021,Leeds 021A,E01011455,1342,1316,26,18,6,2,0
2021,Leeds 021B,E01011456,1998,1951,47,32,11,4,0
2021,Leeds 027C,E01011457,1588,1526,62,27,22,12,1
2021,Leeds 027D,E01011458,2519,2406,113,71,24,17,1
2021,Leeds 021C,E01011459,1643,1600,43,28,12,3,0
2021,Leeds 028B,E01011460,1478,1419,59,31,14,14,0
2021,Leeds 021D,E01011461,1519,1499,20,11,7,1,1
2021,Leeds 028C,E01011462,1679,1592,87,36,36,10,5
2021,Leeds 028D,E01011463,1627,1553,74,33,25,13,3
2021,Leeds 028E,E01011464,1748,1641,107,69,26,9,3
2021,Leeds 027E,E01011465,1673,1617,56,36,17,3,0
2021,Leeds 094A,E01011466,1490,1396,94,34,45,9,6
2021,Leeds 112A,E01011467,1921,1548,373,177,135,51,10
2021,Leeds 112B,E01011468,1931,1710,221,92,93,33,3
2021,Leeds 094B,E01011469,1371,1291,80,35,28,14,3
2021,Leeds 112C,E01011470,1231,1106,125,43,51,25,6
2021,Leeds 092A,E01011471,1497,1297,200,90,66,39,5
2021,Leeds 092B,E01011472,1588,1452,136,45,58,31,2
2021,Leeds 092C,E01011473,1481,1256,225,95,93,30,7
2021,Leeds 092D,E01011474,1524,1405,119,38,50,30,1
2021,Leeds 094C,E01011475,1540,1416,124,50,52,20,2
2021,Leeds 094D,E01011476,1173,1068,105,45,34,20,6
2021,Leeds 045A,E01011477,1951,1619,332,133,129,60,10
2021,Leeds 056A,E01011478,1740,1622,118,69,24,22,3
2021,Leeds 056B,E01011479,1512,1422,90,60,20,9,1
2021,Leeds 045B,E01011480,1590,1430,160,74,58,26,2
2021,Leeds 056C,E01011481,1757,1488,269,119,109,37,4
2021,Leeds 056D,E01011482,1718,1569,149,74,54,17,4
2021,Leeds 056E,E01011483,1590,1331,259,93,109,49,8
2021,Leeds 033A,E01011484,1537,1390,147,42,64,37,4
2021,Leeds 033B,E01011485,1546,1396,150,64,52,30,4
2021,Leeds 045C,E01011488,1429,1365,64,34,23,5,2
2021,Leeds 045D,E01011489,1700,1571,129,50,48,27,4
2021,Leeds 101A,E01011491,1367,1266,101,38,44,18,1
2021,Leeds 101B,E01011492,1628,1483,145,65,53,23,4
2021,Leeds 101C,E01011493,1534,1374,160,59,68,30,3
2021,Leeds 101D,E01011494,1619,1427,192,75,79,35,3
2021,Leeds 100A,E01011496,1465,1428,37,22,10,5,0
2021,Leeds 101E,E01011497,1632,1437,195,79,90,23,3
2021,Leeds 105D,E01011500,1542,1526,16,8,6,2,0
2021,Leeds 099C,E01011502,1335,1256,79,37,31,11,0
2021,Leeds 032A,E01011504,1476,1351,125,64,43,18,0
2021,Leeds 025A,E01011505,1636,1413,223,113,59,43,8
2021,Leeds 025B,E01011506,1475,1256,219,84,76,54,5
2021,Leeds 025C,E01011507,1578,1455,123,70,37,13,3
2021,Leeds 024A,E01011508,1379,1221,158,83,37,31,7
2021,Leeds 023A,E01011509,1392,1304,88,53,23,9,3
2021,Leeds 025D,E01011510,1494,1337,157,71,57,24,5
2021,Leeds 023B,E01011511,1358,1177,181,91,52,33,5
2021,Leeds 023C,E01011512,1663,1509,154,67,55,27,5
2021,Leeds 031A,E01011513,2145,2001,144,61,66,17,0
2021,Leeds 025E,E01011514,1703,1499,204,99,69,30,6
2021,Leeds 023D,E01011515,1438,1297,141,97,35,8,1
2021,Leeds 023E,E01011516,1683,1579,104,35,40,25,4
2021,Leeds 024B,E01011517,1652,1512,140,71,38,25,6
2021,Leeds 093A,E01011518,2220,2079,141,97,28,16,0
2021,Leeds 095A,E01011519,1466,1437,29,11,14,4,0
2021,Leeds 096A,E01011520,1464,1434,30,12,12,4,2
2021,Leeds 096B,E01011521,2109,2065,44,21,16,5,2
2021,Leeds 095B,E01011522,1333,1310,23,7,8,5,3
2021,Leeds 096C,E01011523,1824,1793,31,25,3,3,0
2021,Leeds 093B,E01011524,1185,1150,35,19,10,3,3
2021,Leeds 095C,E01011525,1501,1449,52,31,12,8,1
2021,Leeds 093C,E01011526,1229,1184,45,19,18,7,1
2021,Leeds 096D,E01011527,1702,1671,31,15,10,6,0
2021,Leeds 095D,E01011528,1555,1508,47,19,17,8,3
2021,Leeds 096E,E01011529,1326,1298,28,15,8,4,1
2021,Leeds 106A,E01011530,1334,1286,48,31,12,4,1
2021,Leeds 093D,E01011531,1624,1577,47,35,9,2,1
2021,Leeds 095E,E01011532,1551,1483,68,33,20,14,1
2021,Leeds 104A,E01011533,1330,1256,74,41,20,12,1
2021,Leeds 106B,E01011534,2230,2116,114,83,24,7,0
2021,Leeds 108A,E01011535,1676,1657,19,11,6,1,1
2021,Leeds 108B,E01011536,1607,1583,24,15,5,4,0
2021,Leeds 107A,E01011537,1981,1962,19,9,4,5,1
2021,Leeds 107B,E01011538,1539,1522,17,11,4,2,0
2021,Leeds 102B,E01011540,1930,1813,117,60,44,10,3
2021,Leeds 104B,E01011541,1990,1874,116,60,35,13,8
2021,Leeds 104C,E01011545,1303,1281,22,14,6,0,2
2021,Leeds 106C,E01011546,1663,1589,74,41,21,11,1
2021,Leeds 104D,E01011547,1922,1845,77,30,29,17,1
2021,Leeds 106D,E01011548,1457,1436,21,7,8,6,0
2021,Leeds 108C,E01011549,1389,1352,37,22,7,8,0
2021,Leeds 106E,E01011550,1324,1307,17,4,8,5,0
2021,Leeds 107C,E01011551,1688,1673,15,7,7,1,0
2021,Leeds 107D,E01011552,1465,1429,36,13,16,7,0
2021,Leeds 108D,E01011553,1336,1317,19,10,4,4,1
2021,Leeds 012A,E01011554,1400,1307,93,58,21,13,1
2021,Leeds 018A,E01011555,1338,1224,114,66,33,13,2
2021,Leeds 015A,E01011556,1601,1363,238,140,60,32,6
2021,Leeds 015B,E01011557,1388,1260,128,76,37,13,2
2021,Leeds 018B,E01011558,1678,1420,258,110,104,37,7
2021,Leeds 018C,E01011559,1403,1146,257,94,89,61,13
2021,Leeds 018D,E01011560,1815,1532,283,88,136,52,7
2021,Leeds 006A,E01011561,1159,1111,48,38,9,1,0
2021,Leeds 012B,E01011562,1530,1383,147,106,21,19,1
2021,Leeds 012C,E01011563,1366,1299,67,49,10,8,0
2021,Leeds 012D,E01011564,1507,1422,85,45,23,17,0
2021,Leeds 015C,E01011565,1434,1293,141,91,33,11,6
2021,Leeds 015D,E01011566,1293,1090,203,129,48,24,2
2021,Leeds 012E,E01011567,1428,1280,148,78,46,20,4
2021,Leeds 015E,E01011568,1852,1649,203,129,51,20,3
2021,Leeds 004A,E01011569,1695,1672,23,16,3,4,0
2021,Leeds 007A,E01011570,2239,2215,24,13,8,2,1
2021,Leeds 004B,E01011571,1566,1551,15,12,2,1,0
2021,Leeds 004C,E01011572,1723,1700,23,18,3,2,0
2021,Leeds 004D,E01011573,1269,1257,12,10,0,1,1
2021,Leeds 004E,E01011574,1381,1367,14,8,5,1,0
2021,Leeds 007C,E01011576,1423,1406,17,7,5,4,1
2021,Leeds 011D,E01011578,1246,1225,21,8,6,5,2
2021,Leeds 014C,E01011579,1296,1271,25,8,10,7,0
2021,Leeds 014D,E01011580,1337,1315,22,6,8,5,3
2021,Leeds 003A,E01011581,1604,1577,27,13,9,5,0
2021,Leeds 003B,E01011582,1554,1537,17,11,1,5,0
2021,Leeds 003C,E01011583,1529,1514,15,8,5,2,0
2021,Leeds 003D,E01011584,1636,1614,22,13,5,2,2
2021,Leeds 062A,E01011585,1357,1322,35,16,15,2,2
2021,Leeds 066A,E01011586,1769,1555,214,95,79,32,8
2021,Leeds 062B,E01011587,1688,1648,40,23,14,2,1
2021,Leeds 039A,E01011588,1705,1693,12,5,1,5,1
2021,Leeds 039B,E01011589,1534,1503,31,18,11,1,1
2021,Leeds 039C,E01011590,1656,1635,21,11,3,6,1
2021,Leeds 052D,E01011591,1576,1542,34,21,8,5,0
2021,Leeds 039D,E01011592,1554,1537,17,9,4,4,0
2021,Leeds 039E,E01011593,1877,1843,34,20,12,0,2
2021,Leeds 062C,E01011594,1475,1442,33,20,9,4,0
2021,Leeds 066B,E01011595,2093,1777,316,140,96,68,12
2021,Leeds 062D,E01011596,1601,1576,25,12,8,5,0
2021,Leeds 066C,E01011597,1657,1380,277,118,103,48,8
2021,Leeds 062E,E01011598,1527,1509,18,9,5,4,0
2021,Leeds 066D,E01011599,1611,1506,105,44,30,26,5
2021,Leeds 079A,E01011600,1487,1460,27,12,11,3,1
2021,Leeds 079B,E01011601,1571,1535,36,18,10,7,1
2021,Leeds 076A,E01011602,1913,1884,29,13,12,2,2
2021,Leeds 076B,E01011603,1553,1519,34,21,11,2,0
2021,Leeds 079C,E01011604,1303,1269,34,18,14,1,1
2021,Leeds 076C,E01011605,1709,1697,12,8,3,1,0
2021,Leeds 076D,E01011606,1959,1746,213,78,86,41,8
2021,Leeds 079D,E01011607,1589,1530,59,38,13,6,2
2021,Leeds 068A,E01011608,1337,1286,51,21,21,9,0
2021,Leeds 068B,E01011609,1385,1307,78,36,24,17,1
2021,Leeds 068C,E01011610,1491,1448,43,18,16,6,3
2021,Leeds 068D,E01011611,1424,1356,68,24,32,10,2
2021,Leeds 079E,E01011612,1370,1331,39,21,10,5,3
2021,Leeds 076E,E01011613,1716,1657,59,29,17,13,0
2021,Leeds 068E,E01011614,1810,1751,59,31,11,14,3
2021,Leeds 070A,E01011615,1531,1424,107,36,46,21,4
2021,Leeds 072A,E01011616,1575,1433,142,70,46,22,4
2021,Leeds 070B,E01011617,1586,1433,153,72,65,16,0
2021,Leeds 070C,E01011618,1574,1407,167,50,74,39,4
2021,Leeds 072B,E01011620,1300,1189,111,49,41,19,2
2021,Leeds 070D,E01011621,1504,1340,164,69,64,24,7
2021,Leeds 072C,E01011622,1651,1426,225,98,81,39,7
2021,Leeds 075B,E01011623,1609,1239,370,139,141,81,9
2021,Leeds 072D,E01011624,1772,1569,203,96,75,28,4
2021,Leeds 075C,E01011625,1616,1241,375,137,159,68,11
2021,Leeds 075D,E01011626,2263,1797,466,185,198,71,12
2021,Leeds 098A,E01011627,1315,1280,35,19,10,3,3
2021,Leeds 098B,E01011628,1204,1193,11,8,1,2,0
2021,Leeds 098C,E01011629,1257,1222,35,14,14,6,1
2021,Leeds 100B,E01011630,1954,1911,43,29,8,2,4
2021,Leeds 098D,E01011632,1285,1227,58,28,25,5,0
2021,Leeds 098E,E01011633,1429,1406,23,14,4,5,0
2021,Leeds 100C,E01011634,1541,1516,25,12,9,3,1
2021,Leeds 097B,E01011635,1771,1687,84,18,23,29,14
2021,Leeds 100D,E01011636,1820,1781,39,17,16,5,1
2021,Leeds 097C,E01011637,1645,1607,38,22,8,7,1
2021,Leeds 097D,E01011638,1361,1341,20,15,2,2,1
2021,Leeds 100E,E01011639,1468,1418,50,27,16,3,4
2021,Leeds 032B,E01011641,1554,1491,63,43,14,4,2
2021,Leeds 032C,E01011642,1325,1216,109,55,38,13,3
2021,Leeds 037A,E01011643,1475,1383,92,47,29,12,4
2021,Leeds 037B,E01011644,1280,1224,56,23,28,5,0
2021,Leeds 032D,E01011645,1464,1379,85,30,27,26,2
2021,Leeds 037C,E01011646,1744,1561,183,52,67,49,15
2021,Leeds 037D,E01011647,1803,1317,486,139,189,132,26
2021,Leeds 037E,E01011648,1809,1523,286,114,106,59,7
2021,Leeds 022B,E01011649,1531,1483,48,35,12,0,1
2021,Leeds 020A,E01011650,1463,1392,71,38,21,10,2
2021,Leeds 020B,E01011651,1416,1330,86,43,32,10,1
2021,Leeds 024C,E01011652,1339,1257,82,43,24,10,5
2021,Leeds 020C,E01011653,1339,1235,104,59,32,11,2
2021,Leeds 024D,E01011654,1414,1351,63,44,12,6,1
2021,Leeds 020D,E01011655,1430,1363,67,32,21,14,0
2021,Leeds 035A,E01011656,1463,1378,85,32,39,12,2
2021,Leeds 035B,E01011657,1228,1158,70,26,34,7,3
2021,Leeds 040C,E01011658,1611,1388,223,115,72,32,4
2021,Leeds 035C,E01011659,1396,1330,66,38,14,10,4
2021,Leeds 040D,E01011660,1718,1513,205,86,101,16,2
2021,Leeds 035D,E01011661,1645,1592,53,19,26,7,1
2021,Leeds 040E,E01011662,1315,1202,113,32,51,25,5
2021,Leeds 050A,E01011663,1608,1457,151,64,60,26,1
2021,Leeds 050B,E01011664,1268,1192,76,39,27,9,1
2021,Leeds 050C,E01011665,1338,1273,65,25,30,6,4
2021,Leeds 061D,E01011666,1387,1363,24,13,6,4,1
2021,Leeds 050D,E01011667,1507,1378,129,46,63,17,3
2021,Leeds 110E,E01011668,1687,1541,146,83,42,19,2
2021,Leeds 110F,E01011669,1461,1316,145,99,27,16,3
2021,Leeds 055A,E01011670,2546,1975,571,219,231,115,6
2021,Leeds 055B,E01011671,1599,1205,394,175,143,60,16
2021,Leeds 064B,E01011673,1747,920,827,229,338,224,36
2021,Leeds 064D,E01011677,1529,974,555,154,236,134,31
2021,Leeds 063B,E01011678,4312,3451,861,385,370,104,2
2021,Leeds 063D,E01011681,1654,1310,344,144,127,67,6
2021,Leeds 019C,E01011684,1496,1368,128,66,39,17,6
2021,Leeds 109A,E01011685,2162,2040,122,73,36,13,0
2021,Leeds 033E,E01011686,1487,1335,152,42,68,34,8
2021,Leeds 109B,E01011687,1466,1356,110,59,30,19,2
2021,Leeds 031B,E01011688,1469,1311,158,80,38,36,4
2021,Leeds 031C,E01011689,1564,1500,64,46,12,5,1
2021,Leeds 109C,E01011690,1341,1295,46,39,3,0,4
2021,Leeds 031D,E01011691,1460,1349,111,45,42,19,5
2021,Leeds 109D,E01011692,1458,1373,85,52,21,9,3
2021,Leeds 109E,E01011693,1477,1383,94,44,40,9,1
2021,Leeds 109F,E01011694,1818,1670,148,79,46,21,2
2021,Leeds 019D,E01011695,1642,1459,183,80,62,37,4
2021,Leeds 006B,E01011696,1508,1487,21,12,2,4,3
2021,Leeds 002A,E01011697,2234,2200,34,18,10,5,1
2021,Leeds 001A,E01011698,1429,1412,17,8,6,1,2
2021,Leeds 001B,E01011699,1258,1234,24,12,8,4,0
2021,Leeds 002B,E01011700,1452,1435,17,11,4,0,2
2021,Leeds 001C,E01011701,1327,1316,11,8,2,0,1
2021,Leeds 001D,E01011702,1594,1585,9,6,3,0,0
2021,Leeds 001E,E01011703,1210,1205,5,4,0,0,1
2021,Leeds 002C,E01011704,2155,2100,55,14,33,8,0
2021,Leeds 002D,E01011705,1324,1300,24,12,10,2,0
2021,Leeds 006C,E01011706,1501,1493,8,4,3,1,0
2021,Leeds 005A,E01011707,1276,1260,16,6,7,3,0
2021,Leeds 006D,E01011708,1423,1406,17,12,2,3,0
2021,Leeds 005B,E01011709,1971,1939,32,14,11,4,3
2021,Leeds 005C,E01011710,1375,1361,14,11,2,1,0
2021,Leeds 005D,E01011711,1380,1356,24,3,13,7,1
2021,Leeds 005E,E01011712,1397,1378,19,14,4,1,0
2021,Leeds 006E,E01011713,1727,1694,33,19,8,5,1
2021,Leeds 029A,E01011714,1846,1760,86,53,18,12,3
2021,Leeds 022C,E01011715,1313,1282,31,16,10,5,0
2021,Leeds 029B,E01011716,1527,1428,99,45,34,15,5
2021,Leeds 029C,E01011717,1561,1485,76,42,22,12,0
2021,Leeds 029D,E01011718,1883,1814,69,27,18,23,1
2021,Leeds 022D,E01011719,1400,1376,24,10,8,6,0
2021,Leeds 029E,E01011720,1453,1419,34,12,13,9,0
2021,Leeds 041A,E01011721,1493,1456,37,13,17,6,1
2021,Leeds 041B,E01011722,2021,1941,80,40,23,13,4
2021,Leeds 041C,E01011723,1636,1574,62,19,20,19,4
2021,Leeds 041D,E01011724,1789,1739,50,20,21,9,0
2021,Leeds 078A,E01011725,1452,1296,156,63,65,28,0
2021,Leeds 080A,E01011726,1491,1395,96,49,32,13,2
2021,Leeds 080B,E01011727,1503,1447,56,24,24,8,0
2021,Leeds 080C,E01011728,1361,1337,24,10,10,3,1
2021,Leeds 078B,E01011729,1633,1392,241,90,105,39,7
2021,Leeds 078C,E01011730,1484,1400,84,35,35,11,3
2021,Leeds 081B,E01011731,1388,1315,73,48,20,4,1
2021,Leeds 081C,E01011732,1914,1733,181,64,83,30,4
2021,Leeds 081D,E01011733,1531,1441,90,40,30,19,1
2021,Leeds 083A,E01011734,2688,2512,176,101,43,25,7
2021,Leeds 078D,E01011735,1642,1521,121,57,49,15,0
2021,Leeds 083B,E01011736,1362,1325,37,22,11,4,0
2021,Leeds 083C,E01011737,1491,1405,86,32,37,14,3
2021,Leeds 083D,E01011738,1447,1410,37,28,5,4,0
2021,Leeds 080D,E01011739,1558,1464,94,30,42,20,2
2021,Wakefield 001A,E01011740,1515,1431,84,30,37,15,2
2021,Wakefield 001B,E01011741,1378,1359,19,11,6,0,2
2021,Wakefield 001C,E01011742,1610,1544,66,26,21,13,6
2021,Wakefield 003A,E01011743,1376,1359,17,5,6,4,2
2021,Wakefield 003B,E01011744,1563,1539,24,2,18,2,2
2021,Wakefield 001D,E01011745,1669,1569,100,33,36,23,8
2021,Wakefield 001E,E01011746,2390,2238,152,48,67,31,6
2021,Wakefield 003C,E01011747,1630,1525,105,24,45,33,3
2021,Wakefield 005A,E01011748,1507,1464,43,21,16,6,0
2021,Wakefield 003D,E01011750,1589,1487,102,39,28,28,7
2021,Wakefield 005C,E01011751,1260,1233,27,9,12,6,0
2021,Wakefield 002A,E01011752,1605,1532,73,33,30,8,2
2021,Wakefield 002B,E01011753,1394,1364,30,10,19,1,0
2021,Wakefield 003E,E01011754,1491,1453,38,12,11,10,5
2021,Wakefield 005D,E01011755,1518,1490,28,12,9,5,2
2021,Wakefield 002C,E01011756,1349,1291,58,21,19,15,3
2021,Wakefield 004A,E01011757,2300,2213,87,44,33,10,0
2021,Wakefield 013A,E01011758,2427,2188,239,82,107,40,10
2021,Wakefield 004B,E01011759,1936,1861,75,34,24,17,0
2021,Wakefield 004C,E01011761,2125,2069,56,21,21,10,4
2021,Wakefield 002E,E01011762,1479,1395,84,27,34,22,1
2021,Wakefield 004D,E01011763,1376,1318,58,10,30,15,3
2021,Wakefield 004E,E01011764,1679,1586,93,32,41,20,0
2021,Wakefield 032A,E01011765,1897,1850,47,22,18,7,0
2021,Wakefield 032B,E01011766,1587,1560,27,14,8,4,1
2021,Wakefield 034A,E01011767,1768,1754,14,7,6,1,0
2021,Wakefield 034B,E01011768,1292,1278,14,11,3,0,0
2021,Wakefield 034D,E01011770,1823,1782,41,11,25,5,0
2021,Wakefield 040A,E01011771,1315,1272,43,24,13,6,0
2021,Wakefield 040B,E01011772,1568,1533,35,21,10,3,1
2021,Wakefield 032C,E01011773,1389,1378,11,4,5,2,0
2021,Wakefield 032D,E01011774,1436,1382,54,31,10,12,1
2021,Wakefield 024B,E01011776,1646,1587,59,32,13,14,0
2021,Wakefield 024C,E01011777,1395,1369,26,9,12,4,1
2021,Wakefield 024D,E01011778,1529,1496,33,9,15,6,3
2021,Wakefield 027A,E01011779,1415,1392,23,6,16,1,0
2021,Wakefield 027B,E01011780,1780,1698,82,20,37,24,1
2021,Wakefield 027C,E01011781,2304,2233,71,32,25,10,4
2021,Wakefield 027D,E01011782,1537,1494,43,16,14,12,1
2021,Wakefield 027E,E01011783,1651,1528,123,51,55,11,6
2021,Wakefield 040C,E01011784,1710,1681,29,14,8,7,0
2021,Wakefield 039A,E01011785,2158,2061,97,34,48,14,1
2021,Wakefield 040D,E01011786,1496,1433,63,24,27,8,4
2021,Wakefield 042A,E01011787,1594,1564,30,10,19,1,0
2021,Wakefield 042B,E01011788,1617,1594,23,10,11,1,1
2021,Wakefield 039B,E01011789,1386,1321,65,20,28,16,1
2021,Wakefield 042C,E01011790,1544,1492,52,15,24,11,2
2021,Wakefield 039C,E01011791,1465,1437,28,7,13,8,0
2021,Wakefield 039D,E01011792,1394,1310,84,33,32,13,6
2021,Wakefield 029A,E01011793,1605,1585,20,7,5,8,0
2021,Wakefield 029B,E01011794,1323,1303,20,7,10,3,0
2021,Wakefield 029C,E01011795,1277,1262,15,6,5,3,1
2021,Wakefield 029D,E01011796,1588,1573,15,7,4,3,1
2021,Wakefield 031A,E01011797,1808,1791,17,6,11,0,0
2021,Wakefield 031B,E01011798,1318,1292,26,14,6,6,0
2021,Wakefield 029E,E01011799,1437,1422,15,5,2,8,0
2021,Wakefield 029F,E01011800,1570,1553,17,5,8,2,2
2021,Wakefield 031C,E01011801,1440,1410,30,15,10,4,1
2021,Wakefield 031D,E01011802,1429,1410,19,8,9,2,0
2021,Wakefield 011A,E01011803,1851,1762,89,27,34,24,4
2021,Wakefield 011B,E01011804,1493,1477,16,9,4,2,1
2021,Wakefield 010A,E01011805,1316,1256,60,23,22,15,0
2021,Wakefield 011C,E01011806,1374,1352,22,12,8,2,0
2021,Wakefield 010B,E01011807,1343,1299,44,12,20,12,0
2021,Wakefield 010C,E01011808,1930,1871,59,19,26,11,3
2021,Wakefield 011D,E01011809,1461,1414,47,18,18,10,1
2021,Wakefield 010D,E01011810,1358,1327,31,11,16,4,0
2021,Wakefield 011E,E01011811,1592,1481,111,30,47,26,8
2021,Wakefield 013B,E01011812,2431,2322,109,51,23,28,7
2021,Wakefield 016A,E01011813,1726,1546,180,52,79,41,8
2021,Wakefield 016B,E01011814,1729,1463,266,92,98,69,7
2021,Wakefield 016C,E01011815,1428,1373,55,19,21,12,3
2021,Wakefield 016D,E01011816,1409,1278,131,33,56,36,6
2021,Wakefield 024E,E01011817,1470,1429,41,19,16,2,4
2021,Wakefield 024F,E01011818,1309,1283,26,15,6,3,2
2021,Wakefield 016E,E01011819,1636,1408,228,71,105,48,4
2021,Wakefield 013C,E01011820,1432,1333,99,30,44,22,3
2021,Wakefield 013D,E01011821,1347,1294,53,21,19,11,2
2021,Wakefield 016F,E01011822,1409,1284,125,33,60,31,1
2021,Wakefield 021A,E01011823,1402,1382,20,12,5,3,0
2021,Wakefield 021B,E01011824,1619,1581,38,16,14,6,2
2021,Wakefield 021C,E01011825,1774,1735,39,24,11,4,0
2021,Wakefield 021D,E01011826,1440,1415,25,13,9,3,0
2021,Wakefield 021E,E01011827,1158,1151,7,5,0,2,0
2021,Wakefield 021F,E01011828,1402,1378,24,10,7,4,3
2021,Wakefield 025A,E01011829,1345,1330,15,5,9,1,0
2021,Wakefield 025B,E01011830,1356,1316,40,13,18,8,1
2021,Wakefield 025C,E01011831,1656,1634,22,11,4,6,1
2021,Wakefield 025D,E01011832,1448,1430,18,9,3,5,1
2021,Wakefield 025E,E01011833,1425,1405,20,10,7,1,2
2021,Wakefield 015A,E01011834,1928,1858,70,33,25,9,3
2021,Wakefield 012A,E01011835,2095,2052,43,16,15,11,1
2021,Wakefield 012B,E01011836,1417,1377,40,15,16,9,0
2021,Wakefield 015B,E01011837,1633,1504,129,49,51,29,0
2021,Wakefield 015C,E01011838,1892,1778,114,40,46,28,0
2021,Wakefield 012C,E01011839,2403,2336,67,32,23,11,1
2021,Wakefield 018A,E01011840,1721,1645,76,28,34,12,2
2021,Wakefield 015D,E01011841,2105,2036,69,27,32,8,2
2021,Wakefield 015E,E01011842,1320,1268,52,13,25,11,3
2021,Wakefield 012D,E01011843,1661,1570,91,32,40,18,1
2021,Wakefield 012E,E01011844,1865,1829,36,14,13,6,3
2021,Wakefield 023A,E01011845,1761,1744,17,6,5,6,0
2021,Wakefield 023B,E01011846,1330,1295,35,11,16,8,0
2021,Wakefield 023C,E01011847,1387,1377,10,6,2,1,1
2021,Wakefield 023D,E01011848,1399,1391,8,1,5,1,1
2021,Wakefield 034E,E01011849,1537,1511,26,11,6,8,1
2021,Wakefield 018B,E01011850,1553,1508,45,7,27,10,1
2021,Wakefield 023E,E01011851,1417,1384,33,15,8,10,0
2021,Wakefield 018C,E01011852,1646,1577,69,30,29,9,1
2021,Wakefield 018D,E01011853,1338,1310,28,11,14,3,0
2021,Wakefield 041A,E01011854,1496,1403,93,41,44,6,2
2021,Wakefield 041B,E01011855,1432,1394,38,14,15,6,3
2021,Wakefield 041C,E01011856,1375,1334,41,16,19,4,2
2021,Wakefield 034F,E01011857,1629,1603,26,10,11,2,3
2021,Wakefield 041D,E01011858,1738,1684,54,20,27,6,1
2021,Wakefield 043A,E01011859,1342,1270,72,18,41,12,1
2021,Wakefield 044A,E01011860,1470,1434,36,14,17,4,1
2021,Wakefield 044B,E01011861,1882,1790,92,37,44,9,2
2021,Wakefield 044C,E01011862,2242,2002,240,75,125,34,6
2021,Wakefield 044D,E01011863,1524,1391,133,55,59,18,1
2021,Wakefield 045A,E01011864,1648,1537,111,37,49,25,0
2021,Wakefield 042D,E01011865,1624,1589,35,13,14,8,0
2021,Wakefield 045B,E01011866,1660,1588,72,26,33,13,0
2021,Wakefield 042E,E01011867,1544,1498,46,15,25,5,1
2021,Wakefield 045C,E01011868,2102,2009,93,23,35,29,6
2021,Wakefield 043B,E01011869,1241,1008,233,66,105,53,9
2021,Wakefield 043C,E01011870,1325,1299,26,9,14,3,0
2021,Wakefield 043D,E01011871,1410,1338,72,19,42,9,2
2021,Wakefield 045D,E01011872,1494,1440,54,18,20,15,1
2021,Wakefield 006A,E01011873,1987,1944,43,22,15,6,0
2021,Wakefield 009A,E01011874,1534,1506,28,9,10,6,3
2021,Wakefield 007A,E01011875,1394,1361,33,18,8,5,2
2021,Wakefield 007B,E01011876,2274,2135,139,79,47,11,2
2021,Wakefield 006B,E01011877,1319,1286,33,18,11,2,2
2021,Wakefield 007C,E01011878,1471,1443,28,15,5,7,1
2021,Wakefield 009B,E01011879,1390,1363,27,11,10,6,0
2021,Wakefield 007D,E01011880,1537,1471,66,37,17,12,0
2021,Wakefield 008A,E01011881,1337,1314,23,13,8,2,0
2021,Wakefield 009C,E01011882,1383,1370,13,2,8,3,0
2021,Wakefield 009D,E01011883,1460,1401,59,27,24,8,0
2021,Wakefield 017A,E01011884,2649,2341,308,172,91,40,5
2021,Wakefield 014A,E01011885,1525,1507,18,13,3,2,0
2021,Wakefield 014B,E01011886,2029,1966,63,37,17,7,2
2021,Wakefield 008B,E01011887,2448,2313,135,78,42,14,1
2021,Wakefield 014C,E01011888,1355,1339,16,9,5,1,1
2021,Wakefield 022A,E01011889,1519,1478,41,19,15,6,1
2021,Wakefield 014D,E01011890,1352,1330,22,16,4,2,0
2021,Wakefield 014E,E01011891,1484,1447,37,16,13,7,1
2021,Wakefield 022B,E01011892,1791,1723,68,25,23,20,0
2021,Wakefield 008C,E01011893,1454,1429,25,13,7,5,0
2021,Wakefield 006C,E01011894,1261,1230,31,15,11,4,1
2021,Wakefield 006D,E01011895,1378,1331,47,31,11,5,0
2021,Wakefield 008D,E01011896,1482,1433,49,20,16,11,2
2021,Wakefield 008E,E01011897,1508,1474,34,23,5,6,0
2021,Wakefield 030A,E01011898,1443,1164,279,93,137,43,6
2021,Wakefield 026A,E01011899,1560,1422,138,50,58,27,3
2021,Wakefield 026B,E01011900,1473,1328,145,65,55,20,5
2021,Wakefield 026C,E01011901,1651,1449,202,67,87,40,8
2021,Wakefield 028A,E01011902,1356,1293,63,19,29,15,0
2021,Wakefield 028B,E01011903,1200,1128,72,21,35,13,3
2021,Wakefield 026D,E01011904,1629,1458,171,49,79,36,7
2021,Wakefield 028C,E01011905,1575,1536,39,15,14,7,3
2021,Wakefield 030B,E01011906,1610,1296,314,104,133,67,10
2021,Wakefield 028D,E01011907,1809,1491,318,106,131,70,11
2021,Wakefield 030C,E01011908,2470,1950,520,146,215,129,30
2021,Wakefield 020A,E01011909,1342,1176,166,71,60,31,4
2021,Wakefield 020B,E01011910,1531,1272,259,76,109,63,11
2021,Wakefield 020C,E01011911,1575,1285,290,100,121,63,6
2021,Wakefield 017B,E01011912,1817,1289,528,137,229,136,26
2021,Wakefield 017C,E01011913,1900,1287,613,147,230,191,45
2021,Wakefield 020D,E01011914,1574,1295,279,83,120,63,13
2021,Wakefield 020E,E01011915,1616,1192,424,130,182,91,21
2021,Wakefield 030D,E01011917,1689,1174,515,135,226,148,6
2021,Wakefield 026E,E01011918,2270,2028,242,109,90,36,7
2021,Wakefield 022C,E01011919,1817,1567,250,81,105,54,10
2021,Wakefield 019A,E01011920,2782,2276,506,137,201,136,32
2021,Wakefield 022D,E01011921,1452,1410,42,19,12,10,1
2021,Wakefield 026F,E01011922,1366,1286,80,29,34,14,3
2021,Wakefield 019B,E01011923,1605,1513,92,52,26,10,4
2021,Wakefield 019C,E01011924,1659,1445,214,81,88,41,4
2021,Wakefield 019D,E01011925,1754,1479,275,86,111,72,6
2021,Wakefield 022E,E01011926,1699,1351,348,89,161,85,13
2021,Wakefield 022F,E01011927,1386,1307,79,35,25,16,3
2021,Wakefield 035A,E01011928,1312,1303,9,5,2,1,1
2021,Wakefield 036A,E01011929,2089,1972,117,19,36,27,35
2021,Wakefield 036B,E01011930,1614,1597,17,7,4,6,0
2021,Wakefield 035B,E01011931,1354,1344,10,5,4,1,0
2021,Wakefield 035C,E01011932,1360,1348,12,6,4,1,1
2021,Wakefield 036C,E01011933,1549,1508,41,21,10,8,2
2021,Wakefield 037A,E01011934,1579,1543,36,18,14,4,0
2021,Wakefield 038A,E01011935,1957,1933,24,14,6,3,1
2021,Wakefield 037B,E01011936,1527,1481,46,29,8,8,1
2021,Wakefield 036D,E01011937,1269,1251,18,7,8,2,1
2021,Wakefield 035D,E01011938,1593,1582,11,5,4,2,0
2021,Wakefield 033A,E01011939,1396,1368,28,12,11,4,1
2021,Wakefield 037C,E01011940,1588,1489,99,52,34,12,1
2021,Wakefield 038B,E01011941,1488,1473,15,11,2,2,0
2021,Wakefield 038C,E01011942,1266,1253,13,5,4,3,1
2021,Wakefield 037D,E01011943,2032,1952,80,29,35,15,1
2021,Wakefield 030E,E01011944,1388,1140,248,70,114,55,9
2021,Wakefield 033B,E01011945,1433,1387,46,27,12,5,2
2021,Wakefield 038D,E01011946,1413,1382,31,22,9,0,0
2021,Wakefield 033C,E01011947,1485,1439,46,19,13,10,4
2021,Wakefield 033D,E01011948,1560,1521,39,31,5,2,1
2021,Hartlepool 009A,E01011949,1766,1719,47,19,13,9,6
2021,Hartlepool 008A,E01011950,995,939,56,8,19,21,8
2021,Hartlepool 007A,E01011951,1163,1128,35,12,14,8,1
2021,Hartlepool 002A,E01011952,1540,1514,26,14,10,2,0
2021,Hartlepool 002B,E01011953,1875,1851,24,5,11,7,1
2021,Hartlepool 001A,E01011954,2201,2176,25,9,9,5,2
2021,Hartlepool 003A,E01011955,1258,1200,58,15,18,25,0
2021,Hartlepool 003C,E01011957,1197,1157,40,13,19,8,0
2021,Hartlepool 014A,E01011959,2781,2743,38,29,6,3,0
2021,Hartlepool 014B,E01011960,1263,1261,2,2,0,0,0
2021,Hartlepool 012A,E01011961,1348,1331,17,9,6,2,0
2021,Hartlepool 012B,E01011962,1376,1369,7,2,5,0,0
2021,Hartlepool 014C,E01011963,1375,1371,4,2,1,1,0
2021,Hartlepool 007B,E01011964,1296,1228,68,22,28,16,2
2021,Hartlepool 015G,E01011965,1586,1570,16,3,4,8,1
2021,Hartlepool 015E,E01011966,1269,1240,29,12,10,7,0
2021,Hartlepool 007C,E01011967,1445,1430,15,8,5,2,0
2021,Hartlepool 014D,E01011968,1904,1892,12,3,6,2,1
2021,Hartlepool 001B,E01011969,1308,1300,8,3,2,2,1
2021,Hartlepool 001C,E01011970,1042,1035,7,5,1,1,0
2021,Hartlepool 001D,E01011971,1292,1288,4,3,1,0,0
2021,Hartlepool 015B,E01011974,1482,1374,108,33,38,33,4
2021,Hartlepool 015D,E01011975,1062,1011,51,17,9,22,3
2021,Hartlepool 012C,E01011977,1613,1590,23,5,12,6,0
2021,Hartlepool 012D,E01011978,1564,1546,18,7,8,3,0
2021,Hartlepool 012E,E01011979,1414,1400,14,6,6,2,0
2021,Hartlepool 009B,E01011980,1617,1594,23,13,6,1,3
2021,Hartlepool 009C,E01011981,1695,1664,31,9,12,8,2
2021,Hartlepool 014E,E01011982,1636,1623,13,9,3,1,0
2021,Hartlepool 015F,E01011983,1645,1622,23,13,9,1,0
2021,Hartlepool 009D,E01011984,1196,1195,1,1,0,0,0
2021,Hartlepool 010A,E01011985,1227,1208,19,7,2,7,3
2021,Hartlepool 008B,E01011986,1224,1209,15,4,8,3,0
2021,Hartlepool 008C,E01011987,1297,1261,36,9,12,13,2
2021,Hartlepool 010B,E01011988,1752,1732,20,5,8,4,3
2021,Hartlepool 010C,E01011989,1813,1775,38,14,12,10,2
2021,Hartlepool 010D,E01011990,1746,1721,25,7,12,4,2
2021,Hartlepool 002C,E01011991,1590,1580,10,3,6,0,1
2021,Hartlepool 002D,E01011992,1795,1741,54,24,20,6,4
2021,Hartlepool 002E,E01011993,1696,1689,7,4,3,0,0
2021,Hartlepool 002F,E01011994,1387,1343,44,17,12,14,1
2021,Hartlepool 011A,E01011995,1269,1264,5,2,0,3,0
2021,Hartlepool 011B,E01011996,1356,1345,11,5,3,3,0
2021,Hartlepool 011C,E01011997,1876,1862,14,7,4,3,0
2021,Hartlepool 011D,E01011998,2087,2069,18,7,5,3,3
2021,Hartlepool 007D,E01011999,1777,1695,82,21,27,22,12
2021,Hartlepool 007E,E01012000,1230,1157,73,27,28,13,5
2021,Hartlepool 008D,E01012001,2077,1897,180,37,70,62,11
2021,Hartlepool 015A,E01012002,1354,1325,29,6,7,12,4
2021,Hartlepool 014F,E01012003,1621,1609,12,5,3,3,1
2021,Hartlepool 014G,E01012005,1838,1828,10,5,3,2,0
2021,Middlesbrough 012A,E01012007,1379,1331,48,19,8,20,1
2021,Middlesbrough 012B,E01012008,1343,1311,32,10,17,4,1
2021,Middlesbrough 012C,E01012009,1885,1819,66,27,24,10,5
2021,Middlesbrough 012D,E01012010,1418,1357,61,29,21,10,1
2021,Middlesbrough 008A,E01012011,1899,1800,99,34,45,17,3
2021,Middlesbrough 008B,E01012012,1714,1638,76,21,33,18,4
2021,Middlesbrough 008C,E01012013,1399,1296,103,41,34,25,3
2021,Middlesbrough 008D,E01012014,1534,1403,131,40,55,36,0
2021,Middlesbrough 007A,E01012015,1398,1387,11,4,5,2,0
2021,Middlesbrough 007B,E01012016,1705,1653,52,18,22,9,3
2021,Middlesbrough 007C,E01012017,1465,1456,9,3,4,2,0
2021,Middlesbrough 011A,E01012018,1542,1358,184,114,38,23,9
2021,Middlesbrough 011B,E01012019,1132,1091,41,10,21,8,2
2021,Middlesbrough 011C,E01012020,1451,1361,90,42,33,11,4
2021,Middlesbrough 011D,E01012021,1297,1250,47,17,22,5,3
2021,Middlesbrough 015A,E01012022,2701,2669,32,21,11,0,0
2021,Middlesbrough 015B,E01012023,1420,1385,35,19,10,5,1
2021,Middlesbrough 015C,E01012024,1519,1491,28,17,7,4,0
2021,Middlesbrough 015D,E01012025,1208,1185,23,10,8,5,0
2021,Middlesbrough 006A,E01012026,2029,1873,156,55,75,21,5
2021,Middlesbrough 006B,E01012027,1870,1716,154,45,69,34,6
2021,Middlesbrough 019A,E01012030,1371,1350,21,8,10,3,0
2021,Middlesbrough 019B,E01012031,1435,1416,19,5,9,5,0
2021,Middlesbrough 019C,E01012032,1638,1620,18,7,6,4,1
2021,Middlesbrough 019D,E01012033,1189,1177,12,3,6,1,2
2021,Middlesbrough 019E,E01012034,1349,1322,27,7,10,9,1
2021,Middlesbrough 019F,E01012035,1172,1158,14,6,3,5,0
2021,Middlesbrough 003A,E01012036,1465,914,551,154,234,143,20
2021,Middlesbrough 003B,E01012037,1405,1028,377,108,193,68,8
2021,Middlesbrough 003C,E01012038,1381,895,486,144,196,128,18
2021,Middlesbrough 003D,E01012039,1451,941,510,166,226,100,18
2021,Middlesbrough 003E,E01012040,1331,833,498,153,202,114,29
2021,Middlesbrough 003F,E01012041,1072,956,116,26,52,38,0
2021,Middlesbrough 018A,E01012042,1307,1297,10,6,2,2,0
2021,Middlesbrough 018B,E01012043,1273,1262,11,6,3,1,1
2021,Middlesbrough 018C,E01012044,1471,1448,23,10,7,6,0
2021,Middlesbrough 018D,E01012045,1400,1388,12,6,4,2,0
2021,Middlesbrough 013A,E01012046,1957,1911,46,21,14,10,1
2021,Middlesbrough 013B,E01012047,1564,1488,76,21,42,12,1
2021,Middlesbrough 013C,E01012048,1742,1659,83,42,28,12,1
2021,Middlesbrough 014A,E01012049,1229,1209,20,8,4,7,1
2021,Middlesbrough 014B,E01012050,1359,1298,61,25,22,8,6
2021,Middlesbrough 014C,E01012051,1191,1159,32,16,11,4,1
2021,Middlesbrough 014D,E01012052,1196,1173,23,13,3,6,1
2021,Middlesbrough 009A,E01012053,1696,1567,129,35,54,36,4
2021,Middlesbrough 009B,E01012054,1686,1552,134,38,51,42,3
2021,Middlesbrough 009C,E01012055,1891,1794,97,28,41,21,7
2021,Middlesbrough 009D,E01012056,2273,1956,317,122,117,73,5
2021,Middlesbrough 009E,E01012057,1885,1741,144,50,61,26,7
2021,Middlesbrough 002A,E01012058,1583,1218,365,105,143,104,13
2021,Middlesbrough 002B,E01012059,1544,1341,203,43,87,62,11
2021,Middlesbrough 002C,E01012060,1556,1533,23,7,9,4,3
2021,Middlesbrough 002D,E01012061,1173,1138,35,10,19,6,0
2021,Middlesbrough 020A,E01012062,1752,1734,18,7,6,5,0
2021,Middlesbrough 020B,E01012063,1357,1333,24,11,7,5,1
2021,Middlesbrough 017A,E01012065,1855,1836,19,12,3,4,0
2021,Middlesbrough 017B,E01012066,1812,1789,23,15,4,3,1
2021,Middlesbrough 017C,E01012067,1532,1509,23,13,6,3,1
2021,Middlesbrough 001A,E01012068,1788,1301,487,181,175,115,16
2021,Middlesbrough 020D,E01012071,1348,1318,30,17,10,3,0
2021,Middlesbrough 020E,E01012073,1362,1341,21,10,9,2,0
2021,Middlesbrough 004A,E01012074,1450,1425,25,8,13,3,1
2021,Middlesbrough 004B,E01012075,1477,1433,44,18,15,9,2
2021,Middlesbrough 004C,E01012076,1306,1271,35,10,18,6,1
2021,Middlesbrough 004D,E01012077,1427,1392,35,12,15,8,0
2021,Middlesbrough 005A,E01012078,1449,1195,254,89,101,51,13
2021,Middlesbrough 005B,E01012079,1402,1319,83,30,31,21,1
2021,Middlesbrough 005C,E01012080,1167,1094,73,26,31,14,2
2021,Middlesbrough 005D,E01012081,1688,1556,132,42,54,28,8
2021,Middlesbrough 010A,E01012082,1447,1432,15,7,3,5,0
2021,Middlesbrough 010B,E01012083,1547,1518,29,14,10,3,2
2021,Middlesbrough 010C,E01012084,1573,1534,39,14,15,8,2
2021,Middlesbrough 010D,E01012085,1518,1484,34,12,8,12,2
2021,Middlesbrough 004E,E01012088,1649,1622,27,10,14,3,0
2021,Middlesbrough 007D,E01012089,1503,1487,16,9,5,2,0
2021,Middlesbrough 007E,E01012090,1474,1436,38,14,15,9,0
2021,Middlesbrough 007F,E01012091,1861,1794,67,27,26,10,4
2021,Middlesbrough 001D,E01012092,1875,1397,478,203,173,85,17
2021,Middlesbrough 001E,E01012093,1942,1218,724,276,266,154,28
2021,Redcar and Cleveland 010A,E01012095,1199,1199,0,0,0,0,0
2021,Redcar and Cleveland 013A,E01012096,1396,1378,18,8,8,0,2
2021,Redcar and Cleveland 010B,E01012097,1092,1092,0,0,0,0,0
2021,Redcar and Cleveland 010C,E01012098,1535,1531,4,1,2,0,1
2021,Redcar and Cleveland 010D,E01012099,1416,1412,4,3,1,0,0
2021,Redcar and Cleveland 001A,E01012100,1420,1352,68,13,24,25,6
2021,Redcar and Cleveland 001B,E01012101,1515,1477,38,9,18,7,4
2021,Redcar and Cleveland 001C,E01012102,2007,1951,56,22,21,13,0
2021,Redcar and Cleveland 002A,E01012105,1330,1316,14,6,5,3,0
2021,Redcar and Cleveland 003C,E01012106,1304,1287,17,5,2,7,3
2021,Redcar and Cleveland 003D,E01012107,1310,1285,25,6,12,6,1
2021,Redcar and Cleveland 011A,E01012108,1333,1326,7,1,4,2,0
2021,Redcar and Cleveland 011B,E01012109,1283,1269,14,6,2,3,3
2021,Redcar and Cleveland 011C,E01012110,1266,1229,37,5,17,14,1
2021,Redcar and Cleveland 011D,E01012111,1255,1244,11,1,5,4,1
2021,Redcar and Cleveland 015A,E01012112,1340,1328,12,4,2,3,3
2021,Redcar and Cleveland 009A,E01012113,1367,1358,9,4,5,0,0
2021,Redcar and Cleveland 009B,E01012114,1332,1243,89,23,43,22,1
2021,Redcar and Cleveland 018A,E01012117,1978,1958,20,10,7,3,0
2021,Redcar and Cleveland 018B,E01012118,1302,1293,9,4,3,2,0
2021,Redcar and Cleveland 018C,E01012119,2006,1998,8,5,1,2,0
2021,Redcar and Cleveland 020A,E01012120,1237,1231,6,4,2,0,0
2021,Redcar and Cleveland 018D,E01012121,1242,1234,8,1,3,4,0
2021,Redcar and Cleveland 020B,E01012124,1527,1521,6,5,1,0,0
2021,Redcar and Cleveland 005A,E01012127,1062,1038,24,6,9,9,0
2021,Redcar and Cleveland 005B,E01012128,1314,1296,18,4,6,6,2
2021,Redcar and Cleveland 005C,E01012129,2366,2346,20,9,6,4,1
2021,Redcar and Cleveland 005D,E01012130,1178,1169,9,7,2,0,0
2021,Redcar and Cleveland 005E,E01012131,1315,1308,7,5,2,0,0
2021,Redcar and Cleveland 016A,E01012132,1807,1803,4,2,2,0,0
2021,Redcar and Cleveland 016B,E01012134,1334,1327,7,7,0,0,0
2021,Redcar and Cleveland 013D,E01012136,1355,1341,14,11,0,3,0
2021,Redcar and Cleveland 016C,E01012137,1330,1328,2,2,0,0,0
2021,Redcar and Cleveland 006A,E01012138,2853,2832,21,9,5,4,3
2021,Redcar and Cleveland 006B,E01012139,1714,1710,4,4,0,0,0
2021,Redcar and Cleveland 006C,E01012140,1217,1206,11,4,2,3,2
2021,Redcar and Cleveland 006D,E01012141,1020,1018,2,1,0,1,0
2021,Redcar and Cleveland 002B,E01012142,1557,1543,14,3,6,4,1
2021,Redcar and Cleveland 002C,E01012143,1440,1421,19,10,5,4,0
2021,Redcar and Cleveland 002D,E01012144,1326,1312,14,6,8,0,0
2021,Redcar and Cleveland 015B,E01012145,1376,1358,18,7,4,4,3
2021,Redcar and Cleveland 022A,E01012146,1130,1126,4,0,1,3,0
2021,Redcar and Cleveland 015C,E01012147,1728,1718,10,6,2,1,1
2021,Redcar and Cleveland 021A,E01012148,1360,1343,17,3,10,3,1
2021,Redcar and Cleveland 015D,E01012149,1122,1117,5,1,0,3,1
2021,Redcar and Cleveland 021B,E01012150,1509,1499,10,2,5,3,0
2021,Redcar and Cleveland 021C,E01012151,1386,1370,16,5,8,1,2
2021,Redcar and Cleveland 021D,E01012152,1730,1715,15,5,7,2,1
2021,Redcar and Cleveland 006E,E01012154,1114,1109,5,2,2,1,0
2021,Redcar and Cleveland 006F,E01012155,1746,1737,9,5,2,2,0
2021,Redcar and Cleveland 006G,E01012156,1578,1569,9,7,1,1,0
2021,Redcar and Cleveland 006H,E01012157,1570,1556,14,6,4,1,3
2021,Redcar and Cleveland 007A,E01012158,1481,1475,6,5,1,0,0
2021,Redcar and Cleveland 007B,E01012159,1352,1309,43,24,18,0,1
2021,Redcar and Cleveland 007C,E01012160,1512,1502,10,7,2,0,1
2021,Redcar and Cleveland 007D,E01012161,1445,1424,21,11,9,1,0
2021,Redcar and Cleveland 012A,E01012162,1296,1286,10,5,3,2,0
2021,Redcar and Cleveland 012B,E01012163,2347,2337,10,4,2,4,0
2021,Redcar and Cleveland 012C,E01012164,1520,1519,1,1,0,0,0
2021,Redcar and Cleveland 012D,E01012165,2330,2312,18,5,7,6,0
2021,Redcar and Cleveland 022B,E01012167,2037,2002,35,11,15,5,4
2021,Redcar and Cleveland 022C,E01012168,1944,1928,16,8,2,5,1
2021,Redcar and Cleveland 022D,E01012170,1204,1151,53,20,23,10,0
2021,Redcar and Cleveland 011E,E01012171,1392,1388,4,0,3,1,0
2021,Redcar and Cleveland 011F,E01012172,1245,1239,6,3,1,2,0
2021,Redcar and Cleveland 022E,E01012173,1077,1074,3,1,2,0,0
2021,Redcar and Cleveland 022F,E01012174,1088,1085,3,2,1,0,0
2021,Redcar and Cleveland 009E,E01012175,1329,1320,9,2,4,3,0
2021,Redcar and Cleveland 004A,E01012176,1394,1385,9,4,1,3,1
2021,Redcar and Cleveland 004B,E01012177,1340,1337,3,2,1,0,0
2021,Redcar and Cleveland 004C,E01012178,1336,1329,7,4,2,1,0
2021,Redcar and Cleveland 004D,E01012179,2058,2041,17,12,2,3,0
2021,Redcar and Cleveland 004E,E01012180,1585,1575,10,3,5,2,0
2021,Redcar and Cleveland 016D,E01012181,1547,1539,8,4,2,1,1
2021,Redcar and Cleveland 020C,E01012182,1299,1297,2,2,0,0,0
2021,Redcar and Cleveland 020D,E01012183,1411,1400,11,4,3,4,0
2021,Redcar and Cleveland 001D,E01012184,1369,1366,3,2,0,1,0
2021,Redcar and Cleveland 004F,E01012185,1324,1318,6,1,2,1,2
2021,Redcar and Cleveland 004G,E01012186,1567,1551,16,10,3,2,1
2021,Stockton-on-Tees 011A,E01012187,1212,1190,22,6,10,3,3
2021,Stockton-on-Tees 011B,E01012188,1083,1074,9,5,1,2,1
2021,Stockton-on-Tees 011C,E01012189,1263,1252,11,4,2,4,1
2021,Stockton-on-Tees 015A,E01012190,1375,1367,8,5,1,2,0
2021,Stockton-on-Tees 015B,E01012191,1528,1506,22,9,8,5,0
2021,Stockton-on-Tees 007A,E01012192,1462,1430,32,14,4,3,11
2021,Stockton-on-Tees 007B,E01012193,1470,1421,49,25,17,6,1
2021,Stockton-on-Tees 010A,E01012194,1441,1421,20,8,7,3,2
2021,Stockton-on-Tees 010B,E01012195,1478,1372,106,48,52,6,0
2021,Stockton-on-Tees 003A,E01012196,1483,1468,15,2,8,3,2
2021,Stockton-on-Tees 002A,E01012197,1715,1700,15,12,2,1,0
2021,Stockton-on-Tees 003B,E01012198,1293,1255,38,16,15,7,0
2021,Stockton-on-Tees 021A,E01012199,1293,1267,26,17,3,5,1
2021,Stockton-on-Tees 021B,E01012200,1940,1880,60,35,19,5,1
2021,Stockton-on-Tees 021C,E01012201,2063,2020,43,30,6,7,0
2021,Stockton-on-Tees 021D,E01012202,1580,1537,43,30,8,5,0
2021,Stockton-on-Tees 021E,E01012203,1847,1821,26,21,2,1,2
2021,Stockton-on-Tees 013A,E01012204,1257,1250,7,5,1,1,0
2021,Stockton-on-Tees 011D,E01012205,1356,1342,14,7,2,4,1
2021,Stockton-on-Tees 013B,E01012206,1277,1261,16,4,7,5,0
2021,Stockton-on-Tees 013C,E01012207,1875,1810,65,28,17,13,7
2021,Stockton-on-Tees 013D,E01012208,1535,1520,15,6,4,4,1
2021,Stockton-on-Tees 016A,E01012209,1615,1555,60,24,18,15,3
2021,Stockton-on-Tees 006A,E01012210,1457,1442,15,5,7,2,1
2021,Stockton-on-Tees 006B,E01012211,1734,1723,11,8,2,0,1
2021,Stockton-on-Tees 006C,E01012212,1466,1455,11,8,1,1,1
2021,Stockton-on-Tees 006D,E01012213,1265,1260,5,3,0,2,0
2021,Stockton-on-Tees 003C,E01012214,1484,1456,28,17,7,4,0
2021,Stockton-on-Tees 003D,E01012215,1175,1167,8,2,3,1,2
2021,Stockton-on-Tees 003E,E01012216,1144,1121,23,14,7,2,0
2021,Stockton-on-Tees 016B,E01012217,1297,1205,92,24,35,25,8
2021,Stockton-on-Tees 016C,E01012218,1486,1447,39,7,16,13,3
2021,Stockton-on-Tees 012A,E01012219,1700,1662,38,19,14,5,0
2021,Stockton-on-Tees 016D,E01012223,1460,1440,20,13,6,1,0
2021,Stockton-on-Tees 015C,E01012224,1651,1633,18,8,5,3,2
2021,Stockton-on-Tees 015D,E01012225,1445,1437,8,4,3,1,0
2021,Stockton-on-Tees 015E,E01012226,1296,1277,19,7,10,2,0
2021,Stockton-on-Tees 027D,E01012227,1431,1402,29,20,4,5,0
2021,Stockton-on-Tees 022A,E01012228,1283,1258,25,17,6,2,0
2021,Stockton-on-Tees 022B,E01012230,1597,1541,56,37,14,4,1
2021,Stockton-on-Tees 028C,E01012231,1793,1746,47,26,14,5,2
2021,Stockton-on-Tees 028D,E01012232,1329,1312,17,9,5,1,2
2021,Stockton-on-Tees 022C,E01012233,1712,1686,26,19,6,1,0
2021,Stockton-on-Tees 028E,E01012234,1518,1504,14,7,5,2,0
2021,Stockton-on-Tees 024A,E01012235,2292,2242,50,40,8,2,0
2021,Stockton-on-Tees 022D,E01012236,1215,1185,30,12,6,9,3
2021,Stockton-on-Tees 022E,E01012237,1270,1239,31,15,12,3,1
2021,Stockton-on-Tees 018A,E01012238,1510,1485,25,8,13,2,2
2021,Stockton-on-Tees 018B,E01012239,2385,2304,81,41,27,11,2
2021,Stockton-on-Tees 018C,E01012240,1643,1624,19,9,5,2,3
2021,Stockton-on-Tees 018D,E01012241,1380,1371,9,5,3,1,0
2021,Stockton-on-Tees 001A,E01012242,1366,1354,12,3,5,3,1
2021,Stockton-on-Tees 001B,E01012243,1464,1458,6,6,0,0,0
2021,Stockton-on-Tees 001C,E01012244,1319,1316,3,0,2,1,0
2021,Stockton-on-Tees 003F,E01012245,1481,1476,5,1,2,1,1
2021,Stockton-on-Tees 001D,E01012246,1244,1239,5,4,0,0,1
2021,Stockton-on-Tees 008A,E01012247,1124,1090,34,22,9,3,0
2021,Stockton-on-Tees 009D,E01012248,1226,1208,18,7,6,5,0
2021,Stockton-on-Tees 008B,E01012249,1534,1511,23,11,11,1,0
2021,Stockton-on-Tees 009E,E01012250,1843,1793,50,27,19,3,1
2021,Stockton-on-Tees 012B,E01012251,1505,1454,51,16,18,12,5
2021,Stockton-on-Tees 012C,E01012252,1498,1414,84,45,28,9,2
2021,Stockton-on-Tees 012D,E01012253,1172,1146,26,16,8,2,0
2021,Stockton-on-Tees 012E,E01012254,1301,1155,146,28,52,61,5
2021,Stockton-on-Tees 005A,E01012255,1292,1284,8,2,5,1,0
2021,Stockton-on-Tees 002B,E01012256,1187,1182,5,3,0,2,0
2021,Stockton-on-Tees 002C,E01012257,1352,1342,10,6,4,0,0
2021,Stockton-on-Tees 010C,E01012258,2165,2126,39,14,16,7,2
2021,Stockton-on-Tees 010D,E01012259,1534,1512,22,5,8,5,4
2021,Stockton-on-Tees 007C,E01012260,1576,1562,14,12,1,0,1
2021,Stockton-on-Tees 007D,E01012261,1338,1331,7,5,1,1,0
2021,Stockton-on-Tees 026B,E01012262,2511,2082,429,157,174,86,12
2021,Stockton-on-Tees 025C,E01012267,1633,1317,316,51,106,132,27
2021,Stockton-on-Tees 010E,E01012268,2042,1991,51,23,17,8,3
2021,Stockton-on-Tees 005B,E01012269,1578,1569,9,5,1,3,0
2021,Stockton-on-Tees 021F,E01012270,1318,1295,23,14,6,3,0
2021,Stockton-on-Tees 008C,E01012271,1379,1337,42,24,13,4,1
2021,Stockton-on-Tees 008D,E01012272,1020,1014,6,1,2,3,0
2021,Stockton-on-Tees 008E,E01012273,1453,1437,16,11,3,2,0
2021,Stockton-on-Tees 008F,E01012274,1231,1225,6,5,1,0,0
2021,Stockton-on-Tees 002D,E01012275,1515,1494,21,15,4,1,1
2021,Stockton-on-Tees 002E,E01012276,1666,1650,16,11,4,1,0
2021,Stockton-on-Tees 002F,E01012277,1628,1604,24,15,4,5,0
2021,Stockton-on-Tees 004A,E01012278,1142,1112,30,16,11,2,1
2021,Stockton-on-Tees 004B,E01012279,1609,1604,5,3,1,1,0
2021,Stockton-on-Tees 004C,E01012280,1475,1463,12,7,5,0,0
2021,Stockton-on-Tees 004D,E01012281,1231,1209,22,15,7,0,0
2021,Stockton-on-Tees 020A,E01012282,1107,1102,5,4,1,0,0
2021,Stockton-on-Tees 020B,E01012283,1173,1161,12,1,6,3,2
2021,Stockton-on-Tees 020C,E01012284,1401,1381,20,7,6,6,1
2021,Stockton-on-Tees 020D,E01012285,1220,1204,16,3,10,1,2
2021,Stockton-on-Tees 017A,E01012286,1033,925,108,28,40,30,10
2021,Stockton-on-Tees 017B,E01012287,1751,1600,151,74,53,19,5
2021,Stockton-on-Tees 017C,E01012288,1195,1051,144,54,41,41,8
2021,Stockton-on-Tees 017D,E01012289,1204,1114,90,20,35,29,6
2021,Stockton-on-Tees 019A,E01012290,1866,1845,21,12,6,3,0
2021,Stockton-on-Tees 019B,E01012291,1789,1742,47,16,16,12,3
2021,Stockton-on-Tees 019C,E01012292,1974,1921,53,19,20,13,1
2021,Stockton-on-Tees 005D,E01012294,1304,1295,9,6,2,1,0
2021,Stockton-on-Tees 005E,E01012295,1363,1350,13,6,5,2,0
2021,Stockton-on-Tees 001E,E01012296,1162,1152,10,1,4,4,1
2021,Stockton-on-Tees 001F,E01012297,2402,2388,14,5,7,1,1
2021,Stockton-on-Tees 024B,E01012298,1291,1252,39,28,7,4,0
2021,Stockton-on-Tees 024C,E01012299,1262,1195,67,34,22,8,3
2021,Stockton-on-Tees 024D,E01012300,1413,1381,32,19,10,2,1
2021,Stockton-on-Tees 024E,E01012301,1226,1195,31,21,6,4,0
2021,Stockton-on-Tees 024F,E01012302,1212,1172,40,24,9,6,1
2021,Stockton-on-Tees 024G,E01012303,2033,1980,53,36,12,5,0
2021,Darlington 012A,E01012304,1016,905,111,28,58,23,2
2021,Darlington 012B,E01012305,1044,937,107,29,51,19,8
2021,Darlington 012C,E01012306,1408,1360,48,21,22,5,0
2021,Darlington 009A,E01012307,2136,1992,144,59,61,23,1
2021,Darlington 006A,E01012309,1882,1824,58,38,13,5,2
2021,Darlington 006B,E01012310,2090,2057,33,10,13,8,2
2021,Darlington 006C,E01012311,1438,1423,15,10,2,3,0
2021,Darlington 006D,E01012312,1344,1295,49,17,20,11,1
2021,Darlington 006E,E01012313,1355,1315,40,21,16,3,0
2021,Darlington 006F,E01012314,1307,1270,37,18,13,5,1
2021,Darlington 010A,E01012315,1595,1581,14,7,6,1,0
2021,Darlington 013A,E01012317,1283,1259,24,14,7,2,1
2021,Darlington 013B,E01012318,2253,2015,238,87,103,42,6
2021,Darlington 013C,E01012319,2582,2385,197,79,88,30,0
2021,Darlington 002C,E01012323,1417,1403,14,6,5,3,0
2021,Darlington 002D,E01012324,1285,1266,19,6,5,7,1
2021,Darlington 005A,E01012325,1363,1336,27,10,11,5,1
2021,Darlington 005B,E01012326,1080,1051,29,17,8,4,0
2021,Darlington 009B,E01012327,1568,1490,78,34,22,21,1
2021,Darlington 003A,E01012328,1476,1436,40,23,8,6,3
2021,Darlington 003B,E01012329,1669,1643,26,10,10,5,1
2021,Darlington 003C,E01012330,1057,1036,21,8,8,5,0
2021,Darlington 003D,E01012331,1105,1075,30,10,16,3,1
2021,Darlington 005C,E01012332,1391,1347,44,21,15,7,1
2021,Darlington 005D,E01012333,1585,1553,32,15,15,2,0
2021,Darlington 001B,E01012334,2636,2616,20,11,4,5,0
2021,Darlington 001C,E01012335,1506,1497,9,5,3,1,0
2021,Darlington 011A,E01012336,1587,1543,44,25,14,3,2
2021,Darlington 011B,E01012337,1791,1756,35,25,8,2,0
2021,Darlington 015A,E01012338,2087,2017,70,22,36,12,0
2021,Darlington 015B,E01012339,1900,1892,8,6,2,0,0
2021,Darlington 012D,E01012340,2216,2106,110,41,43,21,5
2021,Darlington 012E,E01012341,1603,1539,64,28,26,7,3
2021,Darlington 009C,E01012342,2564,2369,195,82,75,32,6
2021,Darlington 015C,E01012344,1392,1367,25,11,11,3,0
2021,Darlington 015D,E01012345,1537,1530,7,2,4,1,0
2021,Darlington 015E,E01012346,2210,2184,26,13,7,6,0
2021,Darlington 011C,E01012347,1661,1630,31,19,6,6,0
2021,Darlington 011D,E01012348,2091,2068,23,11,5,7,0
2021,Darlington 004A,E01012349,1388,1270,118,33,49,29,7
2021,Darlington 004B,E01012350,1340,1273,67,30,27,9,1
2021,Darlington 004C,E01012351,1313,1286,27,10,13,4,0
2021,Darlington 004D,E01012352,1398,1317,81,22,42,13,4
2021,Darlington 016E,E01012353,1402,1231,171,74,61,28,8
2021,Darlington 016F,E01012354,1452,1153,299,73,122,90,14
2021,Darlington 016G,E01012355,1356,1136,220,104,74,35,7
2021,Darlington 014A,E01012356,1545,1481,64,31,26,6,1
2021,Darlington 014B,E01012357,1268,1212,56,20,22,13,1
2021,Darlington 014C,E01012358,1540,1432,108,41,49,18,0
2021,Darlington 014D,E01012359,1701,1510,191,66,78,43,4
2021,Darlington 010C,E01012360,1719,1691,28,17,4,6,1
2021,Darlington 011E,E01012361,1851,1825,26,22,4,0,0
2021,Darlington 016A,E01012362,1168,1064,104,40,37,24,3
2021,Darlington 016B,E01012363,1205,1146,59,26,22,11,0
2021,Darlington 016D,E01012364,1317,1255,62,25,15,16,6
2021,Darlington 016C,E01012365,1150,1136,14,9,5,0,0
2021,Darlington 001D,E01012366,1944,1936,8,6,2,0,0
2021,Halton 007A,E01012367,1793,1656,137,48,59,22,8
2021,Halton 003A,E01012368,1961,1897,64,25,24,14,1
2021,Halton 005A,E01012369,1731,1707,24,15,6,3,0
2021,Halton 007B,E01012370,1765,1609,156,53,62,37,4
2021,Halton 016A,E01012371,1175,1166,9,6,2,1,0
2021,Halton 016B,E01012372,1081,1073,8,6,2,0,0
2021,Halton 016C,E01012373,1190,1185,5,2,3,0,0
2021,Halton 002A,E01012374,2636,2602,34,22,8,2,2
2021,Halton 002B,E01012375,1473,1463,10,7,2,1,0
2021,Halton 002C,E01012376,2732,2684,48,22,18,7,1
2021,Halton 004A,E01012377,1680,1652,28,8,11,7,2
2021,Halton 006A,E01012378,1478,1472,6,1,4,1,0
2021,Halton 006B,E01012379,1604,1566,38,14,14,9,1
2021,Halton 006C,E01012380,1387,1359,28,9,11,6,2
2021,Halton 010A,E01012381,1643,1576,67,21,29,12,5
2021,Halton 010B,E01012382,1542,1492,50,19,17,13,1
2021,Halton 013A,E01012383,1492,1484,8,4,0,4,0
2021,Halton 010C,E01012384,1539,1510,29,10,17,2,0
2021,Halton 009A,E01012385,2025,1876,149,27,25,43,54
2021,Halton 009B,E01012386,2563,2508,55,31,18,5,1
2021,Halton 009C,E01012387,1039,1030,9,5,4,0,0
2021,Halton 006D,E01012388,1722,1690,32,13,12,5,2
2021,Halton 008A,E01012389,1661,1658,3,1,1,1,0
2021,Halton 004B,E01012390,1548,1523,25,7,15,3,0
2021,Halton 008B,E01012391,2071,2000,71,38,24,7,2
2021,Halton 001A,E01012392,2813,2775,38,18,14,6,0
2021,Halton 001B,E01012393,2787,2759,28,22,5,1,0
2021,Halton 005B,E01012394,1858,1813,45,15,15,13,2
2021,Halton 001C,E01012395,1557,1548,9,3,3,2,1
2021,Halton 013B,E01012396,1356,1321,35,8,10,16,1
2021,Halton 013C,E01012397,1534,1489,45,29,13,1,2
2021,Halton 011A,E01012398,1134,1121,13,5,5,3,0
2021,Halton 013D,E01012399,1295,1270,25,4,15,5,1
2021,Halton 011B,E01012400,1162,1152,10,1,4,4,1
2021,Halton 008C,E01012401,1755,1745,10,5,4,0,1
2021,Halton 011C,E01012402,1462,1413,49,17,26,6,0
2021,Halton 013E,E01012403,1746,1637,109,43,42,22,2
2021,Halton 011D,E01012404,1333,1298,35,16,11,7,1
2021,Halton 011E,E01012405,2008,1963,45,20,20,5,0
2021,Halton 015A,E01012406,1352,1325,27,10,10,4,3
2021,Halton 015B,E01012407,1646,1585,61,20,28,11,2
2021,Halton 013F,E01012408,1754,1661,93,27,40,26,0
2021,Halton 015C,E01012409,1298,1281,17,7,9,0,1
2021,Halton 003B,E01012410,1057,1042,15,12,2,1,0
2021,Halton 001D,E01012411,1276,1254,22,9,3,9,1
2021,Halton 003C,E01012412,1709,1662,47,16,20,9,2
2021,Halton 003D,E01012413,1402,1369,33,14,16,3,0
2021,Halton 003E,E01012414,1087,1087,0,0,0,0,0
2021,Halton 016D,E01012415,1278,1275,3,2,1,0,0
2021,Halton 012A,E01012416,1805,1791,14,6,8,0,0
2021,Halton 012B,E01012417,1161,1137,24,6,12,5,1
2021,Halton 016E,E01012418,1395,1383,12,7,3,2,0
2021,Halton 004C,E01012419,1052,1040,12,8,4,0,0
2021,Halton 004D,E01012420,1338,1290,48,14,11,21,2
2021,Halton 002D,E01012421,1154,1132,22,15,5,1,1
2021,Halton 004E,E01012422,1395,1376,19,7,7,3,2
2021,Halton 002E,E01012423,1243,1229,14,5,8,1,0
2021,Halton 007C,E01012424,1848,1788,60,22,24,11,3
2021,Halton 005C,E01012425,1516,1440,76,21,46,9,0
2021,Halton 005D,E01012426,1325,1308,17,6,7,4,0
2021,Halton 005E,E01012427,1738,1667,71,21,37,11,2
2021,Halton 012D,E01012429,1318,1306,12,4,4,4,0
2021,Halton 012E,E01012430,1532,1424,108,37,51,20,0
2021,Halton 012F,E01012431,2034,1936,98,45,31,20,2
2021,Halton 014A,E01012432,1285,1254,31,16,12,2,1
2021,Halton 014B,E01012433,1527,1483,44,22,13,9,0
2021,Halton 009D,E01012434,1393,1367,26,10,14,2,0
2021,Halton 009E,E01012435,2041,2008,33,20,10,1,2
2021,Halton 014C,E01012436,1189,1158,31,11,10,9,1
2021,Halton 015D,E01012437,1230,1196,34,10,11,10,3
2021,Halton 014D,E01012438,1084,1036,48,20,21,5,2
2021,Halton 015E,E01012439,1391,1366,25,10,5,6,4
2021,Halton 014E,E01012440,1168,1162,6,4,0,2,0
2021,Halton 007D,E01012441,2158,1922,236,58,125,48,5
2021,Halton 006E,E01012442,1414,1344,70,33,23,14,0
2021,Halton 008D,E01012443,1423,1399,24,13,8,3,0
2021,Halton 010D,E01012444,1435,1373,62,21,22,17,2
2021,Halton 010E,E01012445,1193,1144,49,20,14,13,2
2021,Warrington 025A,E01012446,1292,1273,19,14,4,1,0
2021,Warrington 025B,E01012447,1339,1289,50,42,7,1,0
2021,Warrington 024A,E01012448,1589,1561,28,18,7,1,2
2021,Warrington 025C,E01012449,1369,1348,21,15,3,3,0
2021,Warrington 023A,E01012450,1371,1346,25,14,9,2,0
2021,Warrington 023B,E01012451,1474,1423,51,22,19,8,2
2021,Warrington 025D,E01012452,1712,1687,25,17,3,5,0
2021,Warrington 013A,E01012453,1755,1541,214,75,99,35,5
2021,Warrington 013B,E01012454,2487,2057,430,175,188,59,8
2021,Warrington 013C,E01012455,1955,1588,367,135,153,74,5
2021,Warrington 013D,E01012457,1635,1255,380,136,184,54,6
2021,Warrington 018B,E01012458,2538,2225,313,123,129,58,3
2021,Warrington 005A,E01012459,1466,1366,100,44,40,15,1
2021,Warrington 004A,E01012460,1382,1297,85,37,26,18,4
2021,Warrington 005B,E01012461,1220,1195,25,12,11,2,0
2021,Warrington 004B,E01012462,1186,1134,52,31,12,9,0
2021,Warrington 004C,E01012463,1049,1035,14,10,4,0,0
2021,Warrington 004D,E01012464,1324,1293,31,14,13,3,1
2021,Warrington 005C,E01012465,1175,1126,49,21,12,14,2
2021,Warrington 005D,E01012466,1491,1377,114,46,48,17,3
2021,Warrington 003A,E01012467,1161,1144,17,7,5,5,0
2021,Warrington 003B,E01012468,2355,2319,36,22,10,4,0
2021,Warrington 003C,E01012469,1439,1416,23,8,8,7,0
2021,Warrington 003D,E01012470,1126,1102,24,8,12,4,0
2021,Warrington 001A,E01012471,2189,2084,105,26,57,13,9
2021,Warrington 001B,E01012472,1815,1801,14,7,6,1,0
2021,Warrington 002A,E01012473,1543,1530,13,9,4,0,0
2021,Warrington 002B,E01012474,1376,1354,22,11,3,6,2
2021,Warrington 002C,E01012475,1456,1421,35,14,11,9,1
2021,Warrington 001C,E01012476,1574,1551,23,15,4,2,2
2021,Warrington 001D,E01012477,1585,1573,12,7,5,0,0
2021,Warrington 012A,E01012478,2114,2049,65,29,26,10,0
2021,Warrington 017A,E01012479,1599,1388,211,62,100,49,0
2021,Warrington 017B,E01012480,2187,1767,420,221,151,41,7
2021,Warrington 011A,E01012481,1492,1435,57,17,25,15,0
2021,Warrington 011B,E01012482,1594,1376,218,63,104,44,7
2021,Warrington 018C,E01012483,1561,1325,236,90,91,46,9
2021,Warrington 022A,E01012485,1506,1478,28,13,12,2,1
2021,Warrington 022B,E01012486,1412,1400,12,6,5,1,0
2021,Warrington 022C,E01012487,1471,1445,26,12,10,3,1
2021,Warrington 024B,E01012488,1814,1781,33,21,10,2,0
2021,Warrington 022D,E01012489,1810,1790,20,16,3,1,0
2021,Warrington 022E,E01012490,1388,1378,10,6,1,3,0
2021,Warrington 015A,E01012491,1370,1333,37,13,17,7,0
2021,Warrington 015B,E01012492,1345,1335,10,4,5,1,0
2021,Warrington 015C,E01012493,1629,1601,28,19,4,5,0
2021,Warrington 015D,E01012494,1864,1813,51,21,13,15,2
2021,Warrington 016A,E01012495,1551,1495,56,31,16,8,1
2021,Warrington 016B,E01012496,1355,1323,32,14,9,4,5
2021,Warrington 016C,E01012497,1191,1137,54,21,24,9,0
2021,Warrington 016D,E01012498,1487,1421,66,35,22,5,4
2021,Warrington 016E,E01012499,1765,1709,56,24,16,14,2
2021,Warrington 015E,E01012500,1346,1331,15,5,10,0,0
2021,Warrington 016F,E01012501,1343,1310,33,13,12,8,0
2021,Warrington 024C,E01012502,1537,1525,12,5,5,2,0
2021,Warrington 024D,E01012503,1743,1716,27,20,5,2,0
2021,Warrington 020B,E01012505,1369,1307,62,25,28,8,1
2021,Warrington 020C,E01012506,1541,1409,132,52,60,18,2
2021,Warrington 020D,E01012507,1785,1637,148,64,58,23,3
2021,Warrington 020E,E01012508,1637,1467,170,89,51,27,3
2021,Warrington 018D,E01012509,2178,2093,85,40,34,6,5
2021,Warrington 017D,E01012510,2164,1960,204,84,88,30,2
2021,Warrington 017E,E01012511,1544,1399,145,41,71,30,3
2021,Warrington 018E,E01012512,1471,1427,44,21,16,7,0
2021,Warrington 021A,E01012513,1951,1923,28,21,4,1,2
2021,Warrington 021B,E01012514,1826,1794,32,17,7,7,1
2021,Warrington 021C,E01012515,1490,1450,40,22,9,7,2
2021,Warrington 021D,E01012516,1317,1291,26,15,10,1,0
2021,Warrington 021E,E01012517,2256,2211,45,31,7,7,0
2021,Warrington 021F,E01012518,2084,2058,26,13,9,4,0
2021,Warrington 021G,E01012519,1438,1408,30,18,10,2,0
2021,Warrington 011C,E01012520,1556,1408,148,43,69,28,8
2021,Warrington 008A,E01012521,1504,1409,95,37,37,18,3
2021,Warrington 008B,E01012522,1335,1264,71,27,34,10,0
2021,Warrington 011D,E01012523,1348,1188,160,48,69,33,10
2021,Warrington 011E,E01012524,1438,1418,20,8,8,4,0
2021,Warrington 011F,E01012525,1447,1282,165,57,80,26,2
2021,Warrington 006A,E01012526,1650,1405,245,94,108,41,2
2021,Warrington 019A,E01012527,1430,1393,37,11,17,7,2
2021,Warrington 019B,E01012528,1151,1140,11,8,2,1,0
2021,Warrington 019C,E01012529,1381,1374,7,2,5,0,0
2021,Warrington 019D,E01012530,1314,1305,9,3,3,3,0
2021,Warrington 019E,E01012531,1467,1457,10,6,4,0,0
2021,Warrington 019F,E01012532,1299,1276,23,13,6,3,1
2021,Warrington 008C,E01012533,1436,1226,210,64,95,43,8
2021,Warrington 006B,E01012534,1424,1293,131,56,49,20,6
2021,Warrington 006C,E01012535,1715,1597,118,50,52,15,1
2021,Warrington 008D,E01012536,1462,1369,93,34,44,13,2
2021,Warrington 006D,E01012537,1508,1420,88,32,44,11,1
2021,Warrington 007A,E01012538,1307,1276,31,15,11,1,4
2021,Warrington 006E,E01012539,1455,1401,54,32,18,3,1
2021,Warrington 007B,E01012540,1307,1277,30,7,18,5,0
2021,Warrington 007C,E01012541,1172,1131,41,13,16,10,2
2021,Warrington 007D,E01012542,1350,1319,31,19,6,2,4
2021,Warrington 007E,E01012543,1295,1269,26,10,10,6,0
2021,Warrington 007F,E01012544,1424,1381,43,13,12,18,0
2021,Warrington 008E,E01012545,1586,1423,163,64,65,29,5
2021,Warrington 008F,E01012546,1546,1473,73,27,27,18,1
2021,Warrington 012B,E01012547,1601,1576,25,12,7,5,1
2021,Warrington 012C,E01012548,1748,1712,36,12,12,5,7
2021,Warrington 012D,E01012549,1691,1674,17,9,6,2,0
2021,Warrington 012E,E01012550,1598,1576,22,6,11,5,0
2021,Warrington 014A,E01012551,1501,1482,19,6,8,3,2
2021,Warrington 014B,E01012552,1346,1293,53,16,20,14,3
2021,Warrington 014C,E01012553,1228,1213,15,2,8,4,1
2021,Warrington 002D,E01012554,1943,1931,12,10,0,2,0
2021,Warrington 014D,E01012555,1304,1276,28,5,9,12,2
2021,Warrington 014E,E01012556,1408,1376,32,8,16,8,0
2021,Warrington 023C,E01012557,1476,1448,28,19,7,2,0
2021,Warrington 023D,E01012558,1655,1613,42,18,15,8,1
2021,Warrington 023E,E01012559,1513,1500,13,6,6,1,0
2021,Warrington 023F,E01012560,1434,1419,15,11,4,0,0
2021,Warrington 009A,E01012561,1440,1369,71,36,21,11,3
2021,Warrington 009B,E01012562,2159,2044,115,65,32,18,0
2021,Warrington 010A,E01012563,1676,1615,61,30,18,12,1
2021,Warrington 010B,E01012564,1285,1211,74,38,24,11,1
2021,Warrington 010D,E01012566,2028,1890,138,88,33,10,7
2021,Warrington 010E,E01012569,1744,1666,78,48,24,5,1
2021,Warrington 010F,E01012570,1118,1040,78,33,35,9,1
2021,Blackburn with Darwen 007A,E01012571,1677,1201,476,118,194,140,24
2021,Blackburn with Darwen 007B,E01012572,1408,995,413,98,158,130,27
2021,Blackburn with Darwen 007C,E01012573,1687,1192,495,111,180,157,47
2021,Blackburn with Darwen 003A,E01012574,1422,1125,297,94,103,90,10
2021,Blackburn with Darwen 007D,E01012575,1244,908,336,95,109,99,33
2021,Blackburn with Darwen 008A,E01012576,1740,1338,402,118,141,109,34
2021,Blackburn with Darwen 003B,E01012577,1958,1409,549,93,212,204,40
2021,Blackburn with Darwen 003C,E01012578,1919,1344,575,131,205,189,50
2021,Blackburn with Darwen 004A,E01012579,1707,1277,430,112,169,117,32
2021,Blackburn with Darwen 004B,E01012580,2114,1428,686,143,271,222,50
2021,Blackburn with Darwen 002A,E01012581,1298,1201,97,51,27,17,2
2021,Blackburn with Darwen 002B,E01012582,1624,1447,177,72,68,29,8
2021,Blackburn with Darwen 002C,E01012583,1923,1774,149,54,67,24,4
2021,Blackburn with Darwen 010A,E01012584,1560,1427,133,54,41,24,14
2021,Blackburn with Darwen 005A,E01012585,1732,1426,306,88,117,85,16
2021,Blackburn with Darwen 005B,E01012586,1648,1237,411,116,146,126,23
2021,Blackburn with Darwen 002D,E01012587,2234,1908,326,91,123,98,14
2021,Blackburn with Darwen 002E,E01012588,2098,1538,560,150,243,143,24
2021,Blackburn with Darwen 014A,E01012589,1320,1287,33,13,16,4,0
2021,Blackburn with Darwen 014B,E01012590,1267,1237,30,10,10,10,0
2021,Blackburn with Darwen 014C,E01012591,1504,1461,43,15,15,13,0
2021,Blackburn with Darwen 018A,E01012592,1885,1867,18,6,8,3,1
2021,Blackburn with Darwen 013A,E01012593,1545,1501,44,16,18,9,1
2021,Blackburn with Darwen 012A,E01012594,1353,1308,45,13,22,6,4
2021,Blackburn with Darwen 009A,E01012595,2046,1855,191,73,72,41,5
2021,Blackburn with Darwen 009B,E01012596,1956,1658,298,74,128,76,20
2021,Blackburn with Darwen 013B,E01012597,1620,1601,19,8,7,4,0
2021,Blackburn with Darwen 013C,E01012598,2864,2802,62,33,23,5,1
2021,Blackburn with Darwen 013D,E01012599,1257,1240,17,13,2,2,0
2021,Blackburn with Darwen 011A,E01012600,1285,1226,59,21,23,13,2
2021,Blackburn with Darwen 011B,E01012601,1477,1345,132,56,47,23,6
2021,Blackburn with Darwen 011C,E01012602,1527,1500,27,12,9,6,0
2021,Blackburn with Darwen 011D,E01012603,1661,1493,168,50,69,26,23
2021,Blackburn with Darwen 011E,E01012604,1596,1388,208,140,46,19,3
2021,Blackburn with Darwen 003D,E01012605,2259,1664,595,141,230,186,38
2021,Blackburn with Darwen 003E,E01012606,1679,1255,424,125,162,105,32
2021,Blackburn with Darwen 001A,E01012607,1550,1430,120,42,39,34,5
2021,Blackburn with Darwen 001B,E01012608,2155,1803,352,90,162,80,20
2021,Blackburn with Darwen 010B,E01012609,1514,1506,8,1,3,4,0
2021,Blackburn with Darwen 010C,E01012610,1234,1224,10,6,2,2,0
2021,Blackburn with Darwen 010D,E01012611,1050,1038,12,5,5,1,1
2021,Blackburn with Darwen 010E,E01012612,1354,1337,17,3,8,4,2
2021,Blackburn with Darwen 010F,E01012613,1796,1760,36,19,5,10,2
2021,Blackburn with Darwen 017A,E01012614,1612,1590,22,8,12,2,0
2021,Blackburn with Darwen 017B,E01012615,1334,1304,30,4,13,11,2
2021,Blackburn with Darwen 017C,E01012616,1903,1884,19,8,6,2,3
2021,Blackburn with Darwen 015A,E01012617,1288,1271,17,7,5,4,1
2021,Blackburn with Darwen 012B,E01012618,1480,1446,34,17,15,2,0
2021,Blackburn with Darwen 012C,E01012619,1344,1269,75,30,26,18,1
2021,Blackburn with Darwen 012D,E01012620,1425,1410,15,9,4,2,0
2021,Blackburn with Darwen 012E,E01012621,1451,1406,45,25,13,7,0
2021,Blackburn with Darwen 009C,E01012622,1517,1124,393,95,167,97,34
2021,Blackburn with Darwen 009D,E01012623,1350,1276,74,17,30,22,5
2021,Blackburn with Darwen 009E,E01012624,1395,1301,94,37,34,22,1
2021,Blackburn with Darwen 009F,E01012625,1717,1647,70,20,32,15,3
2021,Blackburn with Darwen 018D,E01012628,1137,1131,6,4,2,0,0
2021,Blackburn with Darwen 006A,E01012629,1222,1040,182,59,84,31,8
2021,Blackburn with Darwen 007E,E01012630,2197,1537,660,144,246,217,53
2021,Blackburn with Darwen 006B,E01012631,1366,1146,220,59,91,59,11
2021,Blackburn with Darwen 011F,E01012632,2127,1789,338,159,102,67,10
2021,Blackburn with Darwen 001C,E01012633,1629,1553,76,22,31,22,1
2021,Blackburn with Darwen 001D,E01012634,1510,1382,128,52,42,30,4
2021,Blackburn with Darwen 001E,E01012635,1798,1597,201,66,82,48,5
2021,Blackburn with Darwen 001F,E01012636,1671,1641,30,15,13,2,0
2021,Blackburn with Darwen 008B,E01012637,1651,1436,215,92,86,28,9
2021,Blackburn with Darwen 008C,E01012638,1586,1361,225,82,89,48,6
2021,Blackburn with Darwen 008D,E01012639,1931,1592,339,115,133,77,14
2021,Blackburn with Darwen 008E,E01012640,1905,1536,369,76,156,105,32
2021,Blackburn with Darwen 008F,E01012641,1772,1394,378,108,145,106,19
2021,Blackburn with Darwen 004C,E01012642,1806,1354,452,118,157,156,21
2021,Blackburn with Darwen 006C,E01012643,1595,1177,418,83,166,143,26
2021,Blackburn with Darwen 006D,E01012644,2376,1654,722,174,274,228,46
2021,Blackburn with Darwen 004D,E01012645,2044,1658,386,108,164,95,19
2021,Blackburn with Darwen 015B,E01012646,1573,1500,73,26,24,21,2
2021,Blackburn with Darwen 015C,E01012647,1482,1429,53,21,22,8,2
2021,Blackburn with Darwen 014D,E01012648,1138,1080,58,21,20,14,3
2021,Blackburn with Darwen 016A,E01012649,1498,1445,53,11,18,21,3
2021,Blackburn with Darwen 015D,E01012650,1388,1183,205,62,76,56,11
2021,Blackburn with Darwen 016B,E01012651,1464,1432,32,9,11,12,0
2021,Blackburn with Darwen 014E,E01012652,1393,1383,10,3,2,4,1
2021,Blackburn with Darwen 016C,E01012653,1489,1449,40,12,16,11,1
2021,Blackburn with Darwen 016D,E01012654,1683,1574,109,27,46,29,7
2021,Blackburn with Darwen 006E,E01012655,2131,1626,505,147,206,120,32
2021,Blackburn with Darwen 005C,E01012656,1750,1292,458,85,172,167,34
2021,Blackburn with Darwen 005D,E01012657,2018,1359,659,152,278,182,47
2021,Blackburn with Darwen 005E,E01012658,1821,1616,205,56,88,47,14
2021,Blackburn with Darwen 017D,E01012659,1314,1294,20,12,8,0,0
2021,Blackburn with Darwen 017E,E01012660,1091,1083,8,4,3,0,1
2021,Blackburn with Darwen 017F,E01012661,1425,1407,18,10,8,0,0
2021,Blackpool 002A,E01012662,1393,1380,13,7,2,4,0
2021,Blackpool 001A,E01012663,1515,1497,18,11,7,0,0
2021,Blackpool 001B,E01012664,1551,1533,18,11,4,3,0
2021,Blackpool 001C,E01012665,1615,1599,16,8,6,2,0
2021,Blackpool 003A,E01012666,1366,1325,41,12,18,10,1
2021,Blackpool 003B,E01012667,1425,1409,16,9,6,1,0
2021,Blackpool 003C,E01012668,1542,1508,34,19,13,1,1
2021,Blackpool 003D,E01012669,1725,1697,28,13,10,3,2
2021,Blackpool 011A,E01012670,1403,1135,268,64,109,81,14
2021,Blackpool 013A,E01012671,1398,1279,119,40,56,17,6
2021,Blackpool 013B,E01012672,1501,1377,124,40,55,26,3
2021,Blackpool 010A,E01012673,1276,1108,168,53,66,41,8
2021,Blackpool 013C,E01012674,1678,1511,167,68,79,19,1
2021,Blackpool 010B,E01012675,1548,1441,107,35,49,17,6
2021,Blackpool 009A,E01012676,1348,1234,114,49,48,14,3
2021,Blackpool 009B,E01012677,1368,1307,61,25,27,7,2
2021,Blackpool 008A,E01012678,1032,886,146,66,58,22,0
2021,Blackpool 008B,E01012679,1339,1238,101,40,42,19,0
2021,Blackpool 008C,E01012680,1626,1495,131,49,54,27,1
2021,Blackpool 006A,E01012681,1590,1368,222,83,93,41,5
2021,Blackpool 008D,E01012682,1421,1332,89,25,43,18,3
2021,Blackpool 006B,E01012683,1365,1290,75,25,26,22,2
2021,Blackpool 008E,E01012684,1362,1265,97,35,44,16,2
2021,Blackpool 016A,E01012685,1314,1276,38,18,19,1,0
2021,Blackpool 014A,E01012686,1394,1331,63,29,27,6,1
2021,Blackpool 014B,E01012687,1250,1196,54,23,24,6,1
2021,Blackpool 014C,E01012688,1062,1045,17,7,5,5,0
2021,Blackpool 014D,E01012689,1320,1295,25,9,12,3,1
2021,Blackpool 004A,E01012690,1596,1536,60,26,27,4,3
2021,Blackpool 004B,E01012691,1794,1736,58,29,22,0,7
2021,Blackpool 004C,E01012692,1576,1524,52,22,23,6,1
2021,Blackpool 005A,E01012693,1507,1451,56,21,29,5,1
2021,Blackpool 016B,E01012694,1303,1271,32,19,11,2,0
2021,Blackpool 015A,E01012695,1350,1313,37,17,14,5,1
2021,Blackpool 016C,E01012696,1460,1435,25,12,7,5,1
2021,Blackpool 016D,E01012697,1237,1209,28,10,14,3,1
2021,Blackpool 016E,E01012698,1559,1443,116,48,51,15,2
2021,Blackpool 019A,E01012699,1613,1588,25,11,12,2,0
2021,Blackpool 019B,E01012700,1733,1700,33,16,7,6,4
2021,Blackpool 018A,E01012701,1425,1405,20,8,9,2,1
2021,Blackpool 019C,E01012702,1372,1345,27,8,13,6,0
2021,Blackpool 002B,E01012703,1421,1396,25,9,8,8,0
2021,Blackpool 002C,E01012704,1954,1922,32,18,9,4,1
2021,Blackpool 004D,E01012705,1480,1450,30,16,11,2,1
2021,Blackpool 002D,E01012706,1517,1491,26,19,4,1,2
2021,Blackpool 007A,E01012707,1205,1132,73,31,23,19,0
2021,Blackpool 009C,E01012708,1239,1149,90,44,30,15,1
2021,Blackpool 009D,E01012709,1453,1360,93,40,32,21,0
2021,Blackpool 009E,E01012710,1201,1120,81,50,26,4,1
2021,Blackpool 005B,E01012711,1369,1310,59,23,25,11,0
2021,Blackpool 012A,E01012712,1610,1587,23,8,12,3,0
2021,Blackpool 012B,E01012713,1769,1738,31,20,5,5,1
2021,Blackpool 014E,E01012714,1834,1799,35,24,6,5,0
2021,Blackpool 012C,E01012715,1418,1367,51,26,22,2,1
2021,Blackpool 001D,E01012716,1356,1342,14,4,7,3,0
2021,Blackpool 002E,E01012717,1537,1526,11,3,2,6,0
2021,Blackpool 003E,E01012718,1551,1530,21,14,6,1,0
2021,Blackpool 001E,E01012719,1418,1386,32,9,11,10,2
2021,Blackpool 007B,E01012720,1613,1489,124,61,45,17,1
2021,Blackpool 007C,E01012721,1605,1507,98,41,39,16,2
2021,Blackpool 009F,E01012722,1122,1040,82,47,23,8,4
2021,Blackpool 004E,E01012723,1325,1279,46,25,9,12,0
2021,Blackpool 007D,E01012724,1431,1342,89,32,44,10,3
2021,Blackpool 019D,E01012725,1383,1360,23,12,10,1,0
2021,Blackpool 017A,E01012726,1639,1623,16,6,7,3,0
2021,Blackpool 019E,E01012727,1556,1537,19,7,7,5,0
2021,Blackpool 017B,E01012728,1442,1415,27,9,15,3,0
2021,Blackpool 018B,E01012729,1550,1517,33,17,9,6,1
2021,Blackpool 018C,E01012730,1883,1855,28,16,11,1,0
2021,Blackpool 018D,E01012731,1487,1458,29,14,8,7,0
2021,Blackpool 018E,E01012732,1704,1665,39,19,12,7,1
2021,Blackpool 011B,E01012733,1002,919,83,43,30,10,0
2021,Blackpool 011C,E01012734,1343,1264,79,37,38,3,1
2021,Blackpool 010C,E01012735,1239,1147,92,59,26,6,1
2021,Blackpool 010D,E01012736,1513,1347,166,51,80,29,6
2021,Blackpool 010E,E01012737,1286,1139,147,43,75,23,6
2021,Blackpool 011D,E01012738,1295,1183,112,23,56,27,6
2021,Blackpool 011E,E01012739,1331,1280,51,15,23,13,0
2021,Blackpool 012D,E01012740,1468,1429,39,23,10,6,0
2021,Blackpool 012E,E01012741,1322,1286,36,16,10,6,4
2021,Blackpool 011F,E01012742,1112,1062,50,20,23,6,1
2021,Blackpool 015B,E01012743,1608,1524,84,34,37,13,0
2021,Blackpool 015C,E01012744,1542,1469,73,30,29,12,2
2021,Blackpool 015D,E01012745,1589,1522,67,25,28,12,2
2021,Blackpool 015E,E01012746,1624,1537,87,29,40,14,4
2021,Blackpool 005C,E01012747,1487,1443,44,17,16,10,1
2021,Blackpool 006C,E01012748,1700,1593,107,29,53,25,0
2021,Blackpool 006D,E01012749,1670,1615,55,27,16,12,0
2021,Blackpool 005D,E01012750,1691,1616,75,29,32,13,1
2021,Blackpool 013D,E01012751,1538,1381,157,43,81,29,4
2021,Blackpool 017C,E01012752,1303,1257,46,16,27,3,0
2021,Blackpool 017D,E01012753,1130,1115,15,6,7,0,2
2021,Blackpool 017E,E01012754,1192,1153,39,16,20,3,0
2021,Blackpool 017F,E01012755,1408,1391,17,8,5,1,3
2021,Kingston upon Hull 025A,E01012756,1418,1349,69,34,19,13,3
2021,Kingston upon Hull 025B,E01012757,1326,1145,181,46,59,71,5
2021,Kingston upon Hull 018A,E01012758,1517,1404,113,53,31,27,2
2021,Kingston upon Hull 025C,E01012759,1550,1416,134,31,54,39,10
2021,Kingston upon Hull 025D,E01012760,1386,1180,206,60,77,61,8
2021,Kingston upon Hull 015A,E01012761,1663,1124,539,120,210,174,35
2021,Kingston upon Hull 018B,E01012762,1318,1203,115,27,39,41,8
2021,Kingston upon Hull 018C,E01012763,1677,1342,335,107,132,84,12
2021,Kingston upon Hull 005A,E01012764,1114,1069,45,14,23,7,1
2021,Kingston upon Hull 005B,E01012765,1328,1278,50,13,14,19,4
2021,Kingston upon Hull 012A,E01012766,1346,1282,64,22,22,16,4
2021,Kingston upon Hull 012B,E01012767,1484,1360,124,52,47,21,4
2021,Kingston upon Hull 005C,E01012768,1269,1212,57,29,15,10,3
2021,Kingston upon Hull 005D,E01012769,1269,1234,35,12,17,3,3
2021,Kingston upon Hull 028A,E01012770,1459,1449,10,6,4,0,0
2021,Kingston upon Hull 028B,E01012771,1474,1422,52,22,16,14,0
2021,Kingston upon Hull 028C,E01012772,1508,1431,77,29,28,16,4
2021,Kingston upon Hull 027A,E01012773,1521,1481,40,16,17,6,1
2021,Kingston upon Hull 019A,E01012774,1457,1383,74,38,25,10,1
2021,Kingston upon Hull 028D,E01012775,1560,1505,55,25,21,8,1
2021,Kingston upon Hull 027B,E01012776,1399,1345,54,23,20,10,1
2021,Kingston upon Hull 028E,E01012777,1510,1454,56,19,18,15,4
2021,Kingston upon Hull 004A,E01012778,1374,1333,41,18,12,10,1
2021,Kingston upon Hull 034A,E01012779,1273,1212,61,32,22,6,1
2021,Kingston upon Hull 034D,E01012780,1782,1724,58,20,25,10,3
2021,Kingston upon Hull 034B,E01012781,1237,1212,25,7,7,9,2
2021,Kingston upon Hull 002A,E01012782,1376,1304,72,22,30,15,5
2021,Kingston upon Hull 004B,E01012783,1264,1186,78,21,30,18,9
2021,Kingston upon Hull 004C,E01012784,1918,1855,63,24,25,13,1
2021,Kingston upon Hull 002B,E01012785,1252,1211,41,16,11,12,2
2021,Kingston upon Hull 002C,E01012786,1195,1170,25,9,7,8,1
2021,Kingston upon Hull 002D,E01012787,1410,1360,50,23,18,8,1
2021,Kingston upon Hull 002E,E01012788,1375,1342,33,11,16,5,1
2021,Kingston upon Hull 002F,E01012789,1229,1203,26,11,8,7,0
2021,Kingston upon Hull 004D,E01012790,1281,1245,36,16,11,6,3
2021,Kingston upon Hull 014A,E01012791,1567,1521,46,17,17,8,4
2021,Kingston upon Hull 014B,E01012792,1450,1411,39,15,13,8,3
2021,Kingston upon Hull 014C,E01012793,1379,1312,67,27,23,12,5
2021,Kingston upon Hull 014D,E01012794,1428,1400,28,13,8,5,2
2021,Kingston upon Hull 019B,E01012795,1943,1873,70,28,21,17,4
2021,Kingston upon Hull 023A,E01012796,1202,1188,14,4,6,4,0
2021,Kingston upon Hull 019C,E01012797,1260,1237,23,13,8,1,1
2021,Kingston upon Hull 019D,E01012798,1642,1569,73,33,25,14,1
2021,Kingston upon Hull 023B,E01012799,1161,1136,25,12,8,3,2
2021,Kingston upon Hull 023C,E01012800,1387,1353,34,11,10,7,6
2021,Kingston upon Hull 019E,E01012801,1363,1322,41,20,13,8,0
2021,Kingston upon Hull 023D,E01012802,1295,1285,10,4,6,0,0
2021,Kingston upon Hull 023E,E01012803,1323,1299,24,9,12,3,0
2021,Kingston upon Hull 016A,E01012804,1641,1594,47,15,19,12,1
2021,Kingston upon Hull 026A,E01012805,1337,1168,169,53,66,38,12
2021,Kingston upon Hull 016B,E01012806,1374,1206,168,38,81,37,12
2021,Kingston upon Hull 016C,E01012807,1311,1254,57,23,18,16,0
2021,Kingston upon Hull 026B,E01012808,1634,1421,213,70,71,61,11
2021,Kingston upon Hull 026C,E01012809,1709,1502,207,67,95,36,9
2021,Kingston upon Hull 026D,E01012810,1785,1628,157,85,51,19,2
2021,Kingston upon Hull 026E,E01012811,1528,1372,156,98,38,18,2
2021,Kingston upon Hull 013A,E01012812,1296,1289,7,0,7,0,0
2021,Kingston upon Hull 013B,E01012813,1631,1619,12,6,5,0,1
2021,Kingston upon Hull 013C,E01012814,1457,1446,11,8,2,1,0
2021,Kingston upon Hull 013D,E01012815,1459,1431,28,9,14,3,2
2021,Kingston upon Hull 020A,E01012816,1402,1326,76,27,26,22,1
2021,Kingston upon Hull 016D,E01012817,1377,1254,123,56,35,29,3
2021,Kingston upon Hull 013E,E01012818,1181,1169,12,6,4,2,0
2021,Kingston upon Hull 016E,E01012819,1349,1295,54,27,13,14,0
2021,Kingston upon Hull 022A,E01012820,1288,1249,39,19,13,6,1
2021,Kingston upon Hull 011A,E01012821,1801,1762,39,21,10,6,2
2021,Kingston upon Hull 007A,E01012822,1466,1448,18,6,7,4,1
2021,Kingston upon Hull 010A,E01012824,1905,1867,38,16,15,6,1
2021,Kingston upon Hull 010B,E01012825,1452,1425,27,12,13,1,1
2021,Kingston upon Hull 011D,E01012827,1529,1489,40,10,15,12,3
2021,Kingston upon Hull 011E,E01012828,1448,1429,19,6,12,0,1
2021,Kingston upon Hull 006A,E01012829,1816,1756,60,26,26,7,1
2021,Kingston upon Hull 006B,E01012830,1357,1320,37,11,15,10,1
2021,Kingston upon Hull 034E,E01012832,1721,1645,76,39,32,5,0
2021,Kingston upon Hull 009A,E01012833,1536,1507,29,12,12,5,0
2021,Kingston upon Hull 010C,E01012834,1652,1581,71,26,29,12,4
2021,Kingston upon Hull 009B,E01012835,1044,1038,6,4,0,2,0
2021,Kingston upon Hull 009C,E01012836,1412,1341,71,31,22,14,4
2021,Kingston upon Hull 010D,E01012837,1563,1506,57,27,21,9,0
2021,Kingston upon Hull 010E,E01012838,1609,1557,52,15,21,13,3
2021,Kingston upon Hull 009D,E01012839,1290,1283,7,4,3,0,0
2021,Kingston upon Hull 009E,E01012840,1456,1348,108,49,24,32,3
2021,Kingston upon Hull 017A,E01012841,1516,1459,57,23,22,9,3
2021,Kingston upon Hull 021A,E01012842,1440,1345,95,34,36,22,3
2021,Kingston upon Hull 021B,E01012843,1544,1461,83,26,30,22,5
2021,Kingston upon Hull 017B,E01012844,1214,1140,74,21,35,15,3
2021,Kingston upon Hull 021C,E01012845,1478,1369,109,35,45,25,4
2021,Kingston upon Hull 021D,E01012846,1289,1217,72,22,33,16,1
2021,Kingston upon Hull 021E,E01012847,1230,1138,92,29,33,24,6
2021,Kingston upon Hull 020B,E01012848,1846,1709,137,49,51,29,8
2021,Kingston upon Hull 017C,E01012849,1511,1466,45,18,18,6,3
2021,Kingston upon Hull 024A,E01012850,1603,1042,561,139,224,169,29
2021,Kingston upon Hull 024B,E01012852,1610,1182,428,128,152,126,22
2021,Kingston upon Hull 029C,E01012854,2088,1322,766,291,253,188,34
2021,Kingston upon Hull 029D,E01012855,2049,1457,592,200,232,135,25
2021,Kingston upon Hull 024C,E01012856,1666,1187,479,144,197,123,15
2021,Kingston upon Hull 024D,E01012857,1685,1138,547,155,217,147,28
2021,Kingston upon Hull 031A,E01012858,2069,1781,288,113,122,48,5
2021,Kingston upon Hull 030A,E01012859,1527,1128,399,113,144,126,16
2021,Kingston upon Hull 031B,E01012860,2389,2113,276,128,106,37,5
2021,Kingston upon Hull 025E,E01012862,1332,1069,263,69,114,73,7
2021,Kingston upon Hull 027C,E01012863,2290,2031,259,97,99,55,8
2021,Kingston upon Hull 027D,E01012864,1698,1325,373,106,155,95,17
2021,Kingston upon Hull 027E,E01012865,1281,998,283,70,112,87,14
2021,Kingston upon Hull 018D,E01012866,1595,1150,445,126,146,140,33
2021,Kingston upon Hull 024E,E01012867,1682,1055,627,131,280,187,29
2021,Kingston upon Hull 015B,E01012868,1606,1105,501,118,180,141,62
2021,Kingston upon Hull 015C,E01012869,1550,954,596,130,266,160,40
2021,Kingston upon Hull 018E,E01012870,1660,1200,460,115,161,159,25
2021,Kingston upon Hull 015D,E01012871,1617,908,709,169,283,211,46
2021,Kingston upon Hull 015E,E01012872,1435,889,546,125,205,169,47
2021,Kingston upon Hull 008A,E01012873,1441,1268,173,50,68,39,16
2021,Kingston upon Hull 008B,E01012874,1460,1342,118,40,42,31,5
2021,Kingston upon Hull 003A,E01012875,1604,1237,367,193,60,106,8
2021,Kingston upon Hull 003B,E01012876,1639,1349,290,114,98,62,16
2021,Kingston upon Hull 003C,E01012877,1546,1413,133,40,59,31,3
2021,Kingston upon Hull 003D,E01012878,1662,1453,209,85,73,43,8
2021,Kingston upon Hull 003E,E01012879,1374,1286,88,32,29,22,5
2021,Kingston upon Hull 008C,E01012880,1664,1459,205,68,79,49,9
2021,Kingston upon Hull 008D,E01012881,1470,1252,218,74,75,52,17
2021,Kingston upon Hull 033A,E01012882,1502,1451,51,29,11,9,2
2021,Kingston upon Hull 033B,E01012883,1429,1394,35,15,13,6,1
2021,Kingston upon Hull 033C,E01012884,1777,1694,83,37,28,14,4
2021,Kingston upon Hull 031D,E01012886,1524,1466,58,14,29,10,5
2021,Kingston upon Hull 033D,E01012887,1489,1383,106,50,30,20,6
2021,Kingston upon Hull 031E,E01012888,1520,1290,230,62,94,64,10
2021,Kingston upon Hull 030B,E01012889,1556,1162,394,127,130,114,23
2021,Kingston upon Hull 030C,E01012891,2219,1428,791,213,308,229,41
2021,Kingston upon Hull 030D,E01012892,1935,1314,621,171,229,170,51
2021,Kingston upon Hull 030E,E01012893,1530,1221,309,102,120,72,15
2021,Kingston upon Hull 020C,E01012894,2079,1897,182,73,77,30,2
2021,Kingston upon Hull 020D,E01012896,1915,1812,103,35,39,20,9
2021,Kingston upon Hull 017F,E01012898,1645,1546,99,37,40,18,4
2021,Kingston upon Hull 022B,E01012899,1385,1316,69,13,43,12,1
2021,Kingston upon Hull 022C,E01012900,1505,1259,246,79,102,47,18
2021,Kingston upon Hull 020E,E01012901,1459,1438,21,7,7,4,3
2021,Kingston upon Hull 022D,E01012902,1477,1436,41,18,9,7,7
2021,Kingston upon Hull 022E,E01012903,1597,1466,131,57,33,36,5
2021,Kingston upon Hull 007B,E01012904,1210,1190,20,6,5,6,3
2021,Kingston upon Hull 006C,E01012905,1293,1254,39,14,12,12,1
2021,Kingston upon Hull 004E,E01012906,1554,1474,80,36,28,12,4
2021,Kingston upon Hull 007C,E01012907,1480,1446,34,11,16,6,1
2021,Kingston upon Hull 004F,E01012908,1020,983,37,19,10,6,2
2021,Kingston upon Hull 007D,E01012909,1151,1142,9,3,4,2,0
2021,Kingston upon Hull 006D,E01012910,1177,1153,24,11,8,5,0
2021,Kingston upon Hull 007E,E01012911,1083,1077,6,5,0,1,0
2021,Kingston upon Hull 006E,E01012912,1643,1580,63,23,25,13,2
2021,Kingston upon Hull 014E,E01012913,1918,1682,236,95,76,53,12
2021,Kingston upon Hull 012C,E01012914,3268,2874,394,162,141,86,5
2021,Kingston upon Hull 008E,E01012915,1461,1246,215,74,79,60,2
2021,Kingston upon Hull 012D,E01012916,1858,1632,226,68,85,68,5
2021,Kingston upon Hull 008F,E01012917,1682,1453,229,96,80,48,5
2021,Kingston upon Hull 008G,E01012918,1674,1417,257,95,87,60,15
2021,East Riding of Yorkshire 020A,E01012919,1436,1413,23,18,5,0,0
2021,East Riding of Yorkshire 020B,E01012921,1121,1110,11,8,2,1,0
2021,East Riding of Yorkshire 013A,E01012922,1454,1446,8,4,4,0,0
2021,East Riding of Yorkshire 013B,E01012923,1982,1898,84,40,41,1,2
2021,East Riding of Yorkshire 014A,E01012924,1662,1647,15,8,4,3,0
2021,East Riding of Yorkshire 013C,E01012925,1275,1262,13,10,3,0,0
2021,East Riding of Yorkshire 014B,E01012926,2301,2289,12,8,3,1,0
2021,East Riding of Yorkshire 013D,E01012927,1425,1411,14,10,3,1,0
2021,East Riding of Yorkshire 003A,E01012928,1623,1601,22,5,10,6,1
2021,East Riding of Yorkshire 002A,E01012929,1779,1733,46,14,14,16,2
2021,East Riding of Yorkshire 002B,E01012930,1325,1308,17,8,8,1,0
2021,East Riding of Yorkshire 003B,E01012931,1498,1462,36,11,11,13,1
2021,East Riding of Yorkshire 003C,E01012932,1601,1571,30,8,12,8,2
2021,East Riding of Yorkshire 001A,E01012933,1003,998,5,4,1,0,0
2021,East Riding of Yorkshire 001B,E01012934,1686,1670,16,4,6,6,0
2021,East Riding of Yorkshire 002C,E01012935,1300,1293,7,5,1,0,1
2021,East Riding of Yorkshire 004A,E01012936,1208,1193,15,6,5,4,0
2021,East Riding of Yorkshire 002D,E01012937,2083,2075,8,7,0,1,0
2021,East Riding of Yorkshire 001D,E01012939,1806,1788,18,10,5,3,0
2021,East Riding of Yorkshire 001E,E01012940,1551,1542,9,6,3,0,0
2021,East Riding of Yorkshire 001F,E01012941,1333,1321,12,7,4,0,1
2021,East Riding of Yorkshire 002E,E01012942,1183,1175,8,3,3,2,0
2021,East Riding of Yorkshire 004B,E01012943,1646,1610,36,9,17,7,3
2021,East Riding of Yorkshire 005A,E01012944,1397,1326,71,27,20,22,2
2021,East Riding of Yorkshire 004C,E01012945,1436,1399,37,9,18,10,0
2021,East Riding of Yorkshire 003D,E01012946,1491,1474,17,6,5,5,1
2021,East Riding of Yorkshire 005B,E01012947,1382,1355,27,6,11,10,0
2021,East Riding of Yorkshire 005C,E01012948,1314,1271,43,8,17,17,1
2021,East Riding of Yorkshire 003E,E01012949,1292,1275,17,7,7,1,2
2021,East Riding of Yorkshire 006A,E01012950,1295,1280,15,9,5,1,0
2021,East Riding of Yorkshire 005D,E01012951,1188,1176,12,5,5,2,0
2021,East Riding of Yorkshire 004D,E01012952,1459,1428,31,9,9,9,4
2021,East Riding of Yorkshire 023A,E01012953,1282,1252,30,8,15,5,2
2021,East Riding of Yorkshire 022A,E01012954,1395,1352,43,29,11,3,0
2021,East Riding of Yorkshire 023B,E01012955,1561,1538,23,16,5,1,1
2021,East Riding of Yorkshire 022B,E01012956,1136,1108,28,14,9,3,2
2021,East Riding of Yorkshire 025A,E01012957,1339,1311,28,19,6,1,2
2021,East Riding of Yorkshire 022C,E01012958,1004,981,23,12,5,5,1
2021,East Riding of Yorkshire 023C,E01012959,1418,1379,39,19,11,5,4
2021,East Riding of Yorkshire 025B,E01012960,1602,1580,22,15,5,2,0
2021,East Riding of Yorkshire 022D,E01012961,2116,2063,53,36,7,8,2
2021,East Riding of Yorkshire 023D,E01012962,1150,1126,24,14,8,2,0
2021,East Riding of Yorkshire 025C,E01012963,1388,1365,23,11,6,6,0
2021,East Riding of Yorkshire 023E,E01012964,1678,1630,48,24,18,6,0
2021,East Riding of Yorkshire 022E,E01012966,1221,1213,8,6,1,0,1
2021,East Riding of Yorkshire 024C,E01012967,1518,1503,15,10,3,2,0
2021,East Riding of Yorkshire 024D,E01012968,1578,1566,12,5,2,5,0
2021,East Riding of Yorkshire 024E,E01012969,1069,1044,25,15,10,0,0
2021,East Riding of Yorkshire 032A,E01012970,1768,1742,26,19,4,2,1
2021,East Riding of Yorkshire 032C,E01012972,1531,1519,12,10,2,0,0
2021,East Riding of Yorkshire 032E,E01012974,1520,1486,34,13,12,9,0
2021,East Riding of Yorkshire 044A,E01012975,1530,1524,6,5,1,0,0
2021,East Riding of Yorkshire 045A,E01012976,1268,1241,27,8,13,5,1
2021,East Riding of Yorkshire 008A,E01012978,1642,1630,12,3,3,5,1
2021,East Riding of Yorkshire 045B,E01012979,1684,1660,24,10,13,0,1
2021,East Riding of Yorkshire 045C,E01012980,1613,1582,31,14,11,5,1
2021,East Riding of Yorkshire 008B,E01012981,1328,1322,6,5,1,0,0
2021,East Riding of Yorkshire 045D,E01012982,1496,1468,28,14,13,1,0
2021,East Riding of Yorkshire 008C,E01012983,1736,1709,27,11,9,6,1
2021,East Riding of Yorkshire 044C,E01012984,1807,1801,6,3,1,0,2
2021,East Riding of Yorkshire 044D,E01012985,1674,1669,5,5,0,0,0
2021,East Riding of Yorkshire 010A,E01012986,1495,1492,3,0,3,0,0
2021,East Riding of Yorkshire 010B,E01012987,1666,1659,7,5,1,1,0
2021,East Riding of Yorkshire 010C,E01012988,1540,1531,9,6,1,1,1
2021,East Riding of Yorkshire 008D,E01012989,1750,1735,15,10,4,0,1
2021,East Riding of Yorkshire 006B,E01012990,1382,1379,3,2,1,0,0
2021,East Riding of Yorkshire 006C,E01012991,1564,1554,10,10,0,0,0
2021,East Riding of Yorkshire 006D,E01012992,1375,1371,4,3,1,0,0
2021,East Riding of Yorkshire 040A,E01012993,1441,1396,45,16,19,9,1
2021,East Riding of Yorkshire 041A,E01012994,1806,1655,151,64,50,31,6
2021,East Riding of Yorkshire 041B,E01012995,1844,1626,218,74,99,37,8
2021,East Riding of Yorkshire 037A,E01012996,1711,1684,27,16,8,3,0
2021,East Riding of Yorkshire 040B,E01012997,1844,1231,613,136,266,191,20
2021,East Riding of Yorkshire 037B,E01012998,2220,2146,74,31,29,14,0
2021,East Riding of Yorkshire 040C,E01012999,1615,1028,587,129,249,181,28
2021,East Riding of Yorkshire 041C,E01013000,2114,1691,423,119,179,111,14
2021,East Riding of Yorkshire 040D,E01013001,1738,1584,154,38,72,32,12
2021,East Riding of Yorkshire 041D,E01013002,1734,1530,204,63,92,43,6
2021,East Riding of Yorkshire 038A,E01013003,1395,1327,68,24,38,6,0
2021,East Riding of Yorkshire 041E,E01013004,1741,1420,321,107,139,63,12
2021,East Riding of Yorkshire 036A,E01013005,1899,1855,44,25,9,10,0
2021,East Riding of Yorkshire 043A,E01013006,1469,1447,22,4,12,6,0
2021,East Riding of Yorkshire 036B,E01013007,1446,1422,24,10,11,2,1
2021,East Riding of Yorkshire 034A,E01013008,1352,1315,37,16,15,5,1
2021,East Riding of Yorkshire 034B,E01013009,1524,1503,21,5,6,6,4
2021,East Riding of Yorkshire 043B,E01013010,1387,1367,20,10,8,2,0
2021,East Riding of Yorkshire 036C,E01013011,1483,1463,20,13,4,1,2
2021,East Riding of Yorkshire 036D,E01013012,1724,1675,49,35,8,5,1
2021,East Riding of Yorkshire 034C,E01013013,1390,1369,21,10,8,3,0
2021,East Riding of Yorkshire 034D,E01013014,1352,1341,11,6,2,0,3
2021,East Riding of Yorkshire 037C,E01013015,1721,1687,34,15,16,3,0
2021,East Riding of Yorkshire 037D,E01013016,1751,1733,18,9,8,1,0
2021,East Riding of Yorkshire 038B,E01013017,1786,1772,14,6,5,3,0
2021,East Riding of Yorkshire 026A,E01013018,1858,1822,36,20,10,5,1
2021,East Riding of Yorkshire 026B,E01013019,1940,1911,29,12,14,2,1
2021,East Riding of Yorkshire 038C,E01013020,1833,1825,8,5,2,1,0
2021,East Riding of Yorkshire 026C,E01013021,1386,1374,12,2,7,3,0
2021,East Riding of Yorkshire 018A,E01013022,1931,1918,13,11,1,1,0
2021,East Riding of Yorkshire 018B,E01013023,1777,1765,12,6,2,4,0
2021,East Riding of Yorkshire 018C,E01013024,1782,1757,25,13,9,2,1
2021,East Riding of Yorkshire 026D,E01013025,1327,1311,16,11,1,2,2
2021,East Riding of Yorkshire 026E,E01013026,1616,1606,10,5,3,2,0
2021,East Riding of Yorkshire 014C,E01013027,1670,1664,6,4,1,1,0
2021,East Riding of Yorkshire 031A,E01013028,1543,1534,9,6,3,0,0
2021,East Riding of Yorkshire 021A,E01013029,1444,1436,8,3,4,1,0
2021,East Riding of Yorkshire 021B,E01013030,1385,1377,8,2,4,2,0
2021,East Riding of Yorkshire 021C,E01013031,1370,1362,8,5,1,2,0
2021,East Riding of Yorkshire 021D,E01013032,1386,1381,5,4,1,0,0
2021,East Riding of Yorkshire 033A,E01013033,1507,1479,28,10,17,1,0
2021,East Riding of Yorkshire 014D,E01013034,1760,1748,12,5,5,2,0
2021,East Riding of Yorkshire 021E,E01013035,1439,1437,2,2,0,0,0
2021,East Riding of Yorkshire 019A,E01013036,1376,1345,31,15,11,5,0
2021,East Riding of Yorkshire 019B,E01013037,1349,1321,28,17,6,2,3
2021,East Riding of Yorkshire 017A,E01013038,1416,1376,40,12,14,10,4
2021,East Riding of Yorkshire 020C,E01013039,1890,1862,28,19,6,2,1
2021,East Riding of Yorkshire 019C,E01013040,2267,2224,43,23,14,5,1
2021,East Riding of Yorkshire 019D,E01013041,1536,1510,26,13,7,6,0
2021,East Riding of Yorkshire 020D,E01013042,1489,1457,32,22,9,1,0
2021,East Riding of Yorkshire 020E,E01013043,1263,1234,29,18,7,4,0
2021,East Riding of Yorkshire 020F,E01013044,1893,1865,28,13,8,6,1
2021,East Riding of Yorkshire 017B,E01013045,1474,1448,26,12,7,7,0
2021,East Riding of Yorkshire 012A,E01013046,1582,1572,10,4,5,1,0
2021,East Riding of Yorkshire 012B,E01013047,1519,1512,7,3,4,0,0
2021,East Riding of Yorkshire 010D,E01013048,2191,2178,13,12,0,1,0
2021,East Riding of Yorkshire 012C,E01013049,1649,1618,31,8,9,14,0
2021,East Riding of Yorkshire 012D,E01013050,1686,1680,6,2,3,1,0
2021,East Riding of Yorkshire 012E,E01013051,1618,1611,7,4,3,0,0
2021,East Riding of Yorkshire 011B,E01013053,1706,1676,30,13,10,4,3
2021,East Riding of Yorkshire 011C,E01013054,1893,1843,50,26,14,9,1
2021,East Riding of Yorkshire 011D,E01013055,1700,1667,33,16,13,4,0
2021,East Riding of Yorkshire 011E,E01013056,1537,1481,56,24,18,11,3
2021,East Riding of Yorkshire 009A,E01013057,1604,1579,25,16,5,1,3
2021,East Riding of Yorkshire 011F,E01013058,1415,1392,23,17,4,1,1
2021,East Riding of Yorkshire 009B,E01013059,1609,1584,25,11,11,1,2
2021,East Riding of Yorkshire 009C,E01013060,2360,2323,37,23,9,5,0
2021,East Riding of Yorkshire 009D,E01013061,1531,1521,10,3,3,3,1
2021,East Riding of Yorkshire 019E,E01013062,1558,1507,51,23,19,6,3
2021,East Riding of Yorkshire 019F,E01013063,1458,1437,21,13,4,1,3
2021,East Riding of Yorkshire 016A,E01013064,1331,1312,19,8,7,3,1
2021,East Riding of Yorkshire 016B,E01013065,1540,1512,28,19,5,4,0
2021,East Riding of Yorkshire 016C,E01013066,1533,1518,15,13,1,1,0
2021,East Riding of Yorkshire 016D,E01013067,1593,1578,15,12,2,1,0
2021,East Riding of Yorkshire 016E,E01013068,2213,2167,46,26,16,3,1
2021,East Riding of Yorkshire 017C,E01013069,1491,1463,28,19,5,4,0
2021,East Riding of Yorkshire 016F,E01013070,1404,1387,17,13,4,0,0
2021,East Riding of Yorkshire 017D,E01013071,1472,1439,33,17,8,7,1
2021,East Riding of Yorkshire 042A,E01013072,1646,1632,14,10,2,2,0
2021,East Riding of Yorkshire 042B,E01013073,1759,1751,8,5,3,0,0
2021,East Riding of Yorkshire 040E,E01013074,1565,1553,12,11,0,1,0
2021,East Riding of Yorkshire 042C,E01013075,1309,1303,6,4,2,0,0
2021,East Riding of Yorkshire 038D,E01013076,1482,1465,17,11,2,4,0
2021,East Riding of Yorkshire 042D,E01013077,2015,1995,20,4,4,3,9
2021,East Riding of Yorkshire 031B,E01013078,1411,1405,6,4,1,1,0
2021,East Riding of Yorkshire 039A,E01013079,1548,1534,14,5,5,4,0
2021,East Riding of Yorkshire 039B,E01013080,1328,1318,10,3,4,3,0
2021,East Riding of Yorkshire 031C,E01013081,1484,1474,10,1,8,0,1
2021,East Riding of Yorkshire 031D,E01013082,1592,1586,6,4,2,0,0
2021,East Riding of Yorkshire 039C,E01013083,1355,1339,16,6,6,4,0
2021,East Riding of Yorkshire 039D,E01013084,1264,1261,3,1,1,1,0
2021,East Riding of Yorkshire 031E,E01013085,1673,1659,14,11,2,1,0
2021,East Riding of Yorkshire 039E,E01013086,1444,1434,10,5,5,0,0
2021,East Riding of Yorkshire 039F,E01013087,1317,1311,6,4,1,1,0
2021,East Riding of Yorkshire 035A,E01013088,1797,1741,56,44,10,1,1
2021,East Riding of Yorkshire 035B,E01013089,1632,1604,28,22,2,4,0
2021,East Riding of Yorkshire 035C,E01013090,1418,1405,13,8,5,0,0
2021,East Riding of Yorkshire 035D,E01013091,1477,1451,26,19,6,1,0
2021,East Riding of Yorkshire 032F,E01013092,2599,2535,64,52,8,4,0
2021,East Riding of Yorkshire 035E,E01013093,1574,1528,46,31,8,7,0
2021,East Riding of Yorkshire 029A,E01013094,1366,1357,9,2,7,0,0
2021,East Riding of Yorkshire 029B,E01013095,1451,1441,10,4,6,0,0
2021,East Riding of Yorkshire 029C,E01013096,1757,1746,11,7,1,2,1
2021,East Riding of Yorkshire 029D,E01013097,1231,1221,10,5,3,2,0
2021,East Riding of Yorkshire 033B,E01013098,2150,2135,15,11,2,1,1
2021,East Riding of Yorkshire 033C,E01013099,1397,1387,10,6,3,1,0
2021,East Riding of Yorkshire 033D,E01013100,1610,1600,10,7,1,2,0
2021,East Riding of Yorkshire 033E,E01013101,1581,1570,11,4,4,3,0
2021,East Riding of Yorkshire 029E,E01013102,1373,1367,6,3,3,0,0
2021,East Riding of Yorkshire 043C,E01013103,1305,1300,5,3,2,0,0
2021,East Riding of Yorkshire 043D,E01013104,1138,1118,20,10,8,2,0
2021,East Riding of Yorkshire 027A,E01013105,1386,1376,10,6,3,0,1
2021,East Riding of Yorkshire 043E,E01013106,1158,1137,21,12,5,4,0
2021,East Riding of Yorkshire 034E,E01013107,2086,2030,56,36,12,7,1
2021,East Riding of Yorkshire 028A,E01013108,1590,1563,27,11,12,3,1
2021,East Riding of Yorkshire 027B,E01013110,1475,1460,15,11,4,0,0
2021,East Riding of Yorkshire 027C,E01013111,1361,1345,16,11,2,2,1
2021,East Riding of Yorkshire 025D,E01013112,1357,1340,17,12,3,1,1
2021,East Riding of Yorkshire 028B,E01013113,1416,1394,22,18,2,2,0
2021,East Riding of Yorkshire 028C,E01013114,1467,1437,30,16,10,4,0
2021,East Riding of Yorkshire 027D,E01013115,1354,1337,17,8,6,2,1
2021,East Riding of Yorkshire 028D,E01013116,1795,1762,33,16,6,8,3
2021,East Riding of Yorkshire 027E,E01013117,1464,1451,13,8,3,2,0
2021,East Riding of Yorkshire 028E,E01013118,1430,1406,24,15,6,2,1
2021,East Riding of Yorkshire 011G,E01013119,1431,1413,18,11,3,4,0
2021,East Riding of Yorkshire 015A,E01013120,1941,1901,40,13,25,2,0
2021,East Riding of Yorkshire 015B,E01013121,2146,2119,27,19,6,2,0
2021,East Riding of Yorkshire 018D,E01013122,1416,1410,6,4,2,0,0
2021,East Riding of Yorkshire 015C,E01013123,2016,1985,31,20,9,2,0
2021,East Riding of Yorkshire 015D,E01013124,2174,2133,41,24,9,6,2
2021,East Riding of Yorkshire 008E,E01013125,1662,1643,19,9,6,2,2
2021,East Riding of Yorkshire 009E,E01013126,2340,2260,80,35,25,19,1
2021,East Riding of Yorkshire 018E,E01013127,1566,1555,11,8,3,0,0
2021,North East Lincolnshire 024E,E01013128,1236,1196,40,9,20,10,1
2021,North East Lincolnshire 024D,E01013129,1329,1282,47,15,24,6,2
2021,North East Lincolnshire 018A,E01013130,1337,1327,10,1,5,4,0
2021,North East Lincolnshire 014A,E01013131,1441,1409,32,18,10,4,0
2021,North East Lincolnshire 014B,E01013132,1394,1379,15,7,4,4,0
2021,North East Lincolnshire 014C,E01013133,1385,1353,32,11,15,6,0
2021,North East Lincolnshire 014D,E01013134,1361,1346,15,7,4,3,1
2021,North East Lincolnshire 018B,E01013135,1436,1419,17,4,10,3,0
2021,North East Lincolnshire 002A,E01013136,1191,1054,137,37,53,40,7
2021,North East Lincolnshire 006A,E01013138,1257,1108,149,23,72,50,4
2021,North East Lincolnshire 006B,E01013140,1350,1191,159,46,80,32,1
2021,North East Lincolnshire 006C,E01013141,1436,1357,79,16,47,16,0
2021,North East Lincolnshire 002D,E01013142,1584,1418,166,43,75,46,2
2021,North East Lincolnshire 006D,E01013143,1306,1262,44,17,22,5,0
2021,North East Lincolnshire 004A,E01013144,1363,1322,41,19,12,8,2
2021,North East Lincolnshire 004B,E01013145,1166,1153,13,7,5,1,0
2021,North East Lincolnshire 004C,E01013146,1630,1597,33,12,14,6,1
2021,North East Lincolnshire 009A,E01013147,1320,1263,57,15,29,12,1
2021,North East Lincolnshire 004D,E01013148,1285,1273,12,4,7,1,0
2021,North East Lincolnshire 013A,E01013149,1066,1058,8,2,5,1,0
2021,North East Lincolnshire 013B,E01013150,1197,1185,12,5,5,2,0
2021,North East Lincolnshire 024G,E01013151,1153,1150,3,0,2,1,0
2021,North East Lincolnshire 024F,E01013152,1430,1421,9,1,5,2,1
2021,North East Lincolnshire 020A,E01013153,1228,1222,6,3,2,1,0
2021,North East Lincolnshire 018C,E01013154,1268,1262,6,3,1,2,0
2021,North East Lincolnshire 024H,E01013155,1243,1241,2,0,0,1,1
2021,North East Lincolnshire 018D,E01013156,1271,1254,17,11,4,2,0
2021,North East Lincolnshire 020B,E01013157,1666,1634,32,15,11,6,0
2021,North East Lincolnshire 012A,E01013158,1311,1291,20,11,5,3,1
2021,North East Lincolnshire 011A,E01013159,1399,1235,164,27,84,50,3
2021,North East Lincolnshire 012B,E01013160,1347,1328,19,7,2,10,0
2021,North East Lincolnshire 011B,E01013161,1256,1207,49,13,15,18,3
2021,North East Lincolnshire 011C,E01013162,1459,1358,101,34,41,24,2
2021,North East Lincolnshire 012C,E01013163,1245,1236,9,1,7,1,0
2021,North East Lincolnshire 012D,E01013164,1812,1749,63,17,26,18,2
2021,North East Lincolnshire 011D,E01013165,1229,1072,157,41,74,41,1
2021,North East Lincolnshire 020D,E01013167,1726,1714,12,3,4,3,2
2021,North East Lincolnshire 022B,E01013170,1408,1401,7,5,1,1,0
2021,North East Lincolnshire 022C,E01013171,1784,1750,34,11,15,8,0
2021,North East Lincolnshire 022D,E01013172,1443,1420,23,13,6,4,0
2021,North East Lincolnshire 007A,E01013173,1287,1284,3,3,0,0,0
2021,North East Lincolnshire 001A,E01013174,1454,1346,108,27,36,38,7
2021,North East Lincolnshire 001B,E01013175,1718,1691,27,10,11,6,0
2021,North East Lincolnshire 001C,E01013176,1347,1240,107,30,54,23,0
2021,North East Lincolnshire 001D,E01013177,1349,1279,70,24,25,21,0
2021,North East Lincolnshire 001E,E01013178,1315,1290,25,8,7,10,0
2021,North East Lincolnshire 001F,E01013179,1534,1462,72,31,27,12,2
2021,North East Lincolnshire 001G,E01013180,1355,1294,61,19,25,14,3
2021,North East Lincolnshire 016A,E01013181,1433,1310,123,39,38,42,4
2021,North East Lincolnshire 016B,E01013182,1420,1375,45,26,13,6,0
2021,North East Lincolnshire 016C,E01013183,1445,1406,39,19,13,7,0
2021,North East Lincolnshire 016D,E01013184,1445,1376,69,16,36,16,1
2021,North East Lincolnshire 016E,E01013185,1439,1377,62,47,13,2,0
2021,North East Lincolnshire 016F,E01013186,1485,1446,39,16,18,5,0
2021,North East Lincolnshire 008A,E01013187,1292,1209,83,36,31,15,1
2021,North East Lincolnshire 008B,E01013188,1527,1491,36,10,14,10,2
2021,North East Lincolnshire 021A,E01013189,1555,1542,13,6,4,3,0
2021,North East Lincolnshire 021C,E01013191,1469,1458,11,6,3,2,0
2021,North East Lincolnshire 021D,E01013192,1410,1376,34,17,10,7,0
2021,North East Lincolnshire 022E,E01013193,1477,1462,15,7,6,2,0
2021,North East Lincolnshire 021E,E01013194,1374,1360,14,8,3,3,0
2021,North East Lincolnshire 005A,E01013195,1297,1267,30,9,13,7,1
2021,North East Lincolnshire 005B,E01013196,1211,1149,62,19,28,13,2
2021,North East Lincolnshire 012E,E01013197,1166,1124,42,9,13,17,3
2021,North East Lincolnshire 024A,E01013198,1330,1304,26,7,13,5,1
2021,North East Lincolnshire 024B,E01013199,999,971,28,11,4,9,4
2021,North East Lincolnshire 024C,E01013200,1145,1134,11,1,7,2,1
2021,North East Lincolnshire 005C,E01013201,1456,1351,105,20,50,31,4
2021,North East Lincolnshire 005D,E01013202,1391,1354,37,12,16,6,3
2021,North East Lincolnshire 005E,E01013203,1459,1397,62,21,27,14,0
2021,North East Lincolnshire 019A,E01013204,1340,1289,51,12,26,8,5
2021,North East Lincolnshire 019B,E01013205,1334,1254,80,27,33,19,1
2021,North East Lincolnshire 015A,E01013206,1331,1263,68,18,35,15,0
2021,North East Lincolnshire 015B,E01013207,1286,1247,39,11,21,6,1
2021,North East Lincolnshire 019C,E01013208,1308,1236,72,22,40,10,0
2021,North East Lincolnshire 019D,E01013209,1343,1273,70,26,34,9,1
2021,North East Lincolnshire 019E,E01013210,1322,1235,87,34,33,17,3
2021,North East Lincolnshire 015C,E01013211,1376,1327,49,26,17,6,0
2021,North East Lincolnshire 015D,E01013212,1299,1240,59,24,23,10,2
2021,North East Lincolnshire 023A,E01013213,1117,1102,15,6,4,1,4
2021,North East Lincolnshire 023B,E01013214,1400,1384,16,13,2,1,0
2021,North East Lincolnshire 023C,E01013215,1633,1603,30,18,9,3,0
2021,North East Lincolnshire 023D,E01013216,1171,1156,15,4,6,5,0
2021,North East Lincolnshire 023E,E01013217,1347,1326,21,10,5,5,1
2021,North East Lincolnshire 003A,E01013218,1242,1051,191,46,100,39,6
2021,North East Lincolnshire 003B,E01013219,1395,1279,116,32,54,30,0
2021,North East Lincolnshire 003C,E01013220,1488,1275,213,58,92,57,6
2021,North East Lincolnshire 003D,E01013221,1623,1471,152,38,73,38,3
2021,North East Lincolnshire 003E,E01013222,1466,1321,145,44,69,29,3
2021,North East Lincolnshire 007C,E01013224,1958,1944,14,10,0,3,1
2021,North East Lincolnshire 023F,E01013225,1138,1114,24,13,9,1,1
2021,North East Lincolnshire 007D,E01013226,1404,1386,18,5,8,5,0
2021,North East Lincolnshire 013C,E01013227,1470,1424,46,15,23,4,4
2021,North East Lincolnshire 013D,E01013228,1435,1403,32,10,18,4,0
2021,North East Lincolnshire 013E,E01013229,1532,1458,74,27,36,11,0
2021,North East Lincolnshire 008C,E01013231,1477,1407,70,26,35,8,1
2021,North East Lincolnshire 008D,E01013233,1294,1225,69,13,43,11,2
2021,North East Lincolnshire 009D,E01013234,1321,1283,38,18,11,7,2
2021,North Lincolnshire 017A,E01013236,1531,1489,42,14,18,10,0
2021,North Lincolnshire 018B,E01013237,1693,1596,97,30,45,20,2
2021,North Lincolnshire 015A,E01013238,1591,1511,80,30,38,11,1
2021,North Lincolnshire 017B,E01013239,1412,1345,67,18,24,23,2
2021,North Lincolnshire 020A,E01013241,1444,1426,18,10,7,1,0
2021,North Lincolnshire 020B,E01013242,1803,1783,20,8,7,5,0
2021,North Lincolnshire 020C,E01013243,2183,2167,16,10,6,0,0
2021,North Lincolnshire 020D,E01013244,1868,1853,15,6,6,2,1
2021,North Lincolnshire 006A,E01013245,1395,1358,37,19,14,4,0
2021,North Lincolnshire 006B,E01013246,1499,1492,7,3,4,0,0
2021,North Lincolnshire 006C,E01013247,1655,1648,7,4,3,0,0
2021,North Lincolnshire 006D,E01013248,1743,1726,17,3,11,3,0
2021,North Lincolnshire 006E,E01013249,1744,1721,23,11,10,2,0
2021,North Lincolnshire 023A,E01013250,1678,1667,11,3,7,1,0
2021,North Lincolnshire 023B,E01013251,1762,1749,13,3,3,3,4
2021,North Lincolnshire 023C,E01013252,1604,1571,33,15,9,8,1
2021,North Lincolnshire 023D,E01013253,1899,1891,8,8,0,0,0
2021,North Lincolnshire 001A,E01013254,1701,1669,32,7,13,8,4
2021,North Lincolnshire 001B,E01013255,1999,1946,53,13,21,16,3
2021,North Lincolnshire 001C,E01013256,2424,2387,37,8,13,12,4
2021,North Lincolnshire 001D,E01013257,1821,1796,25,11,11,3,0
2021,North Lincolnshire 001E,E01013258,1671,1653,18,9,6,3,0
2021,North Lincolnshire 001F,E01013259,1940,1872,68,25,29,11,3
2021,North Lincolnshire 019A,E01013260,1373,1348,25,13,6,6,0
2021,North Lincolnshire 018C,E01013261,1373,1362,11,7,3,1,0
2021,North Lincolnshire 018D,E01013262,1261,1241,20,13,7,0,0
2021,North Lincolnshire 018E,E01013263,1346,1332,14,5,8,1,0
2021,North Lincolnshire 019B,E01013264,1784,1731,53,22,24,7,0
2021,North Lincolnshire 019C,E01013265,1543,1530,13,8,2,3,0
2021,North Lincolnshire 019D,E01013266,1777,1748,29,13,7,9,0
2021,North Lincolnshire 011A,E01013267,1196,1183,13,9,3,1,0
2021,North Lincolnshire 011B,E01013268,1187,1176,11,7,0,3,1
2021,North Lincolnshire 011C,E01013269,1729,1722,7,5,0,2,0
2021,North Lincolnshire 004A,E01013270,1967,1945,22,8,7,4,3
2021,North Lincolnshire 011D,E01013271,1939,1896,43,21,22,0,0
2021,North Lincolnshire 011E,E01013272,1657,1632,25,10,9,6,0
2021,North Lincolnshire 011F,E01013273,1659,1639,20,9,2,8,1
2021,North Lincolnshire 013A,E01013274,1895,1845,50,23,12,9,6
2021,North Lincolnshire 013B,E01013275,1448,1441,7,1,5,1,0
2021,North Lincolnshire 013C,E01013276,1560,1555,5,4,0,1,0
2021,North Lincolnshire 013D,E01013277,1389,1369,20,9,5,4,2
2021,North Lincolnshire 016A,E01013278,1531,1326,205,66,87,47,5
2021,North Lincolnshire 012A,E01013279,1462,1350,112,38,45,26,3
2021,North Lincolnshire 016B,E01013280,1411,1325,86,23,45,14,4
2021,North Lincolnshire 016C,E01013281,1365,1210,155,56,64,30,5
2021,North Lincolnshire 017C,E01013282,1539,1449,90,34,44,11,1
2021,North Lincolnshire 016D,E01013283,1439,1304,135,50,62,18,5
2021,North Lincolnshire 017D,E01013284,1469,1387,82,33,33,16,0
2021,North Lincolnshire 012B,E01013285,1166,1097,69,25,32,12,0
2021,North Lincolnshire 005A,E01013286,2182,2034,148,59,59,21,9
2021,North Lincolnshire 005B,E01013287,1428,1400,28,6,17,5,0
2021,North Lincolnshire 003A,E01013288,1463,1437,26,9,9,8,0
2021,North Lincolnshire 005C,E01013289,1552,1429,123,56,39,27,1
2021,North Lincolnshire 005D,E01013290,1662,1653,9,8,1,0,0
2021,North Lincolnshire 003B,E01013291,1528,1498,30,16,11,3,0
2021,North Lincolnshire 003C,E01013292,1662,1646,16,8,4,4,0
2021,North Lincolnshire 005E,E01013293,1445,1431,14,6,7,1,0
2021,North Lincolnshire 003D,E01013294,1558,1544,14,5,7,2,0
2021,North Lincolnshire 009A,E01013295,1343,1234,109,47,49,13,0
2021,North Lincolnshire 008A,E01013296,1785,918,867,158,372,291,46
2021,North Lincolnshire 007A,E01013297,2462,1821,641,188,295,146,12
2021,North Lincolnshire 008B,E01013298,1718,1259,459,133,203,102,21
2021,North Lincolnshire 008C,E01013299,1552,1242,310,96,136,70,8
2021,North Lincolnshire 007B,E01013300,1687,919,768,142,342,239,45
2021,North Lincolnshire 009B,E01013301,1564,1376,188,58,83,45,2
2021,North Lincolnshire 007C,E01013302,1553,1301,252,104,98,43,7
2021,North Lincolnshire 002A,E01013303,1307,1296,11,5,3,3,0
2021,North Lincolnshire 002B,E01013304,1570,1567,3,2,1,0,0
2021,North Lincolnshire 002C,E01013305,1586,1568,18,11,7,0,0
2021,North Lincolnshire 004B,E01013306,1564,1553,11,4,6,1,0
2021,North Lincolnshire 002D,E01013307,1767,1753,14,8,1,4,1
2021,North Lincolnshire 004C,E01013308,1793,1735,58,21,25,11,1
2021,North Lincolnshire 004D,E01013309,1583,1567,16,9,1,6,0
2021,North Lincolnshire 010A,E01013310,1424,1263,161,63,58,31,9
2021,North Lincolnshire 015C,E01013311,1751,1542,209,72,94,35,8
2021,North Lincolnshire 010B,E01013312,1785,1485,300,72,120,99,9
2021,North Lincolnshire 010C,E01013313,1472,1315,157,54,80,20,3
2021,North Lincolnshire 010D,E01013314,1495,1375,120,46,52,18,4
2021,North Lincolnshire 014A,E01013315,1447,1399,48,21,21,6,0
2021,North Lincolnshire 012C,E01013316,1404,1361,43,25,13,4,1
2021,North Lincolnshire 014B,E01013317,1348,1294,54,19,27,7,1
2021,North Lincolnshire 014C,E01013318,1397,1335,62,31,23,8,0
2021,North Lincolnshire 014D,E01013319,2013,1842,171,53,87,30,1
2021,North Lincolnshire 015D,E01013320,1262,1194,68,21,29,18,0
2021,North Lincolnshire 012D,E01013321,1594,1517,77,31,32,14,0
2021,North Lincolnshire 022A,E01013322,2081,2057,24,18,3,3,0
2021,North Lincolnshire 022B,E01013323,1527,1505,22,14,4,4,0
2021,North Lincolnshire 021A,E01013324,1417,1401,16,8,6,1,1
2021,North Lincolnshire 022C,E01013325,1441,1439,2,2,0,0,0
2021,North Lincolnshire 021B,E01013326,1532,1514,18,9,4,5,0
2021,North Lincolnshire 021C,E01013327,1347,1322,25,9,8,8,0
2021,North Lincolnshire 021D,E01013328,1225,1205,20,9,10,1,0
2021,North Lincolnshire 022D,E01013329,1811,1792,19,10,6,3,0
2021,North Lincolnshire 008D,E01013330,1790,1089,701,165,332,167,37
2021,North Lincolnshire 007D,E01013331,1532,1185,347,106,137,94,10
2021,North Lincolnshire 008E,E01013332,1807,1121,686,169,286,208,23
2021,North Lincolnshire 009C,E01013333,1597,1266,331,136,131,53,11
2021,North Lincolnshire 009D,E01013334,1600,1371,229,96,74,50,9
2021,York 012A,E01013335,1581,1530,51,19,27,4,1
2021,York 012B,E01013336,1479,1437,42,13,21,8,0
2021,York 012C,E01013337,1589,1547,42,16,20,6,0
2021,York 012D,E01013338,2233,2168,65,37,20,8,0
2021,York 012E,E01013339,1513,1479,34,19,7,7,1
2021,York 024A,E01013340,1301,1283,18,11,6,0,1
2021,York 024B,E01013341,1303,1284,19,14,4,1,0
2021,York 024C,E01013342,1455,1442,13,6,4,3,0
2021,York 009A,E01013343,1740,1619,121,58,47,14,2
2021,York 007A,E01013344,1360,1257,103,60,35,7,1
2021,York 009B,E01013345,1636,1539,97,51,34,11,1
2021,York 007B,E01013346,1617,1554,63,41,15,7,0
2021,York 009C,E01013347,1556,1410,146,54,60,28,4
2021,York 010A,E01013348,1728,1622,106,56,41,7,2
2021,York 009D,E01013349,1350,1256,94,43,37,13,1
2021,York 009E,E01013350,1560,1420,140,59,60,18,3
2021,York 020A,E01013351,1898,1879,19,15,4,0,0
2021,York 020B,E01013352,1715,1670,45,22,17,5,1
2021,York 022A,E01013353,1521,1459,62,40,17,5,0
2021,York 022B,E01013354,1282,1265,17,6,8,2,1
2021,York 022C,E01013355,1759,1716,43,26,12,5,0
2021,York 022D,E01013356,1324,1296,28,12,10,3,3
2021,York 021A,E01013357,2288,2243,45,33,9,3,0
2021,York 021B,E01013358,1470,1430,40,29,9,2,0
2021,York 022E,E01013359,1543,1490,53,23,28,2,0
2021,York 019A,E01013360,1733,1504,229,139,66,18,6
2021,York 019B,E01013361,1662,1550,112,79,26,6,1
2021,York 019C,E01013362,1892,1648,244,150,89,5,0
2021,York 019D,E01013363,2972,2175,797,233,398,160,6
2021,York 019E,E01013364,1839,1673,166,81,67,18,0
2021,York 013A,E01013366,1719,1538,181,91,55,35,0
2021,York 010B,E01013368,2102,1968,134,81,43,10,0
2021,York 013C,E01013369,1670,1535,135,89,30,12,4
2021,York 002A,E01013370,1449,1436,13,4,8,1,0
2021,York 003A,E01013371,1394,1377,17,9,5,3,0
2021,York 003B,E01013372,1531,1520,11,6,3,2,0
2021,York 002B,E01013373,1482,1467,15,14,0,0,1
2021,York 003C,E01013374,1477,1462,15,4,6,5,0
2021,York 002C,E01013375,1213,1203,10,5,2,3,0
2021,York 002D,E01013376,1404,1389,15,7,6,2,0
2021,York 003D,E01013377,1546,1536,10,5,3,2,0
2021,York 023B,E01013378,6204,5470,734,361,301,68,4
2021,York 008A,E01013379,1368,1349,19,12,4,3,0
2021,York 008B,E01013380,1636,1569,67,47,12,8,0
2021,York 014A,E01013381,1583,1528,55,35,16,4,0
2021,York 010C,E01013382,1561,1429,132,69,46,17,0
2021,York 010D,E01013383,2752,2481,271,148,80,37,6
2021,York 015A,E01013384,1589,1519,70,29,25,10,6
2021,York 008C,E01013385,1350,1300,50,30,15,4,1
2021,York 010E,E01013386,1703,1548,155,48,86,19,2
2021,York 008D,E01013387,1512,1496,16,11,3,2,0
2021,York 008E,E01013388,992,966,26,15,8,2,1
2021,York 008F,E01013389,1126,1097,29,18,10,1,0
2021,York 017A,E01013390,1418,1309,109,44,54,11,0
2021,York 017B,E01013391,1896,1759,137,76,53,8,0
2021,York 012F,E01013392,1581,1541,40,20,14,6,0
2021,York 016A,E01013393,1424,1394,30,17,10,3,0
2021,York 016B,E01013394,1347,1287,60,26,28,5,1
2021,York 016C,E01013395,1380,1332,48,26,14,8,0
2021,York 016D,E01013396,1501,1423,78,45,22,9,2
2021,York 017C,E01013397,1440,1389,51,28,19,3,1
2021,York 015B,E01013398,1545,1450,95,52,27,16,0
2021,York 015C,E01013399,1701,1594,107,46,38,19,4
2021,York 015D,E01013400,1678,1451,227,114,78,33,2
2021,York 015E,E01013401,1567,1443,124,81,34,9,0
2021,York 014B,E01013402,1702,1593,109,63,38,7,1
2021,York 015F,E01013403,1870,1758,112,66,33,11,2
2021,York 004A,E01013404,1678,1654,24,13,7,3,1
2021,York 005A,E01013405,1334,1299,35,16,13,6,0
2021,York 005B,E01013406,1956,1864,92,57,29,5,1
2021,York 004B,E01013407,1413,1393,20,12,7,0,1
2021,York 004C,E01013408,1222,1201,21,9,6,5,1
2021,York 005C,E01013409,1791,1760,31,21,9,1,0
2021,York 004D,E01013410,1306,1287,19,12,3,4,0
2021,York 005D,E01013411,1413,1372,41,19,13,8,1
2021,York 021C,E01013412,2094,1999,95,53,31,10,1
2021,York 017D,E01013413,1539,1485,54,31,17,6,0
2021,York 021D,E01013414,1707,1637,70,49,16,5,0
2021,York 013E,E01013416,1432,1336,96,46,41,8,1
2021,York 017E,E01013417,1757,1688,69,46,21,2,0
2021,York 019F,E01013418,1457,1373,84,54,22,8,0
2021,York 014C,E01013419,2633,2536,97,71,21,5,0
2021,York 014D,E01013420,1986,1898,88,53,20,13,2
2021,York 011A,E01013421,1542,1529,13,10,3,0,0
2021,York 011B,E01013422,1681,1638,43,22,12,6,3
2021,York 024D,E01013423,1292,1277,15,8,5,2,0
2021,York 024E,E01013424,1273,1257,16,11,2,3,0
2021,York 024F,E01013425,1511,1492,19,12,7,0,0
2021,York 011C,E01013426,1687,1670,17,10,7,0,0
2021,York 011D,E01013427,1389,1383,6,4,1,1,0
2021,York 006A,E01013428,1660,1592,68,34,29,3,2
2021,York 006B,E01013429,1904,1790,114,52,42,17,3
2021,York 006C,E01013430,1613,1581,32,22,4,5,1
2021,York 006D,E01013431,2052,1885,167,78,62,22,5
2021,York 007C,E01013432,1933,1867,66,36,21,8,1
2021,York 007D,E01013433,1342,1304,38,15,13,10,0
2021,York 007E,E01013434,1456,1429,27,13,11,3,0
2021,York 006E,E01013435,1411,1384,27,14,10,3,0
2021,York 001A,E01013436,1656,1628,28,18,5,5,0
2021,York 008G,E01013437,1355,1331,24,12,8,4,0
2021,York 001B,E01013438,1948,1924,24,14,7,3,0
2021,York 001C,E01013439,1354,1330,24,19,4,0,1
2021,York 001D,E01013440,1793,1767,26,20,2,4,0
2021,York 016E,E01013441,1446,1376,70,35,25,10,0
2021,York 018A,E01013442,1426,1390,36,21,12,2,1
2021,York 018B,E01013443,1582,1516,66,34,26,6,0
2021,York 018C,E01013444,1462,1416,46,21,20,5,0
2021,York 016F,E01013445,1519,1459,60,42,11,5,2
2021,York 018D,E01013446,1616,1534,82,49,23,10,0
2021,York 018E,E01013447,1459,1397,62,41,12,6,3
2021,York 018F,E01013448,1383,1306,77,43,18,12,4
2021,York 022F,E01013449,1579,1555,24,15,9,0,0
2021,York 023C,E01013450,1213,1194,19,14,3,2,0
2021,York 020C,E01013451,1243,1230,13,5,4,3,1
2021,York 020D,E01013452,1611,1600,11,6,4,1,0
2021,Derby 013A,E01013453,2195,1840,355,160,116,61,18
2021,Derby 013B,E01013454,1388,1059,329,157,114,40,18
2021,Derby 017A,E01013455,1899,1663,236,114,85,25,12
2021,Derby 013C,E01013456,1729,1340,389,128,161,84,16
2021,Derby 013D,E01013457,1702,1420,282,123,98,49,12
2021,Derby 017B,E01013458,1747,1410,337,145,108,64,20
2021,Derby 020A,E01013459,2021,1540,481,173,167,118,23
2021,Derby 013E,E01013460,1723,1320,403,167,157,69,10
2021,Derby 001A,E01013461,1678,1658,20,14,3,2,1
2021,Derby 001B,E01013462,1501,1476,25,16,4,4,1
2021,Derby 001C,E01013463,1477,1454,23,8,6,5,4
2021,Derby 001D,E01013464,1367,1347,20,10,3,7,0
2021,Derby 002A,E01013465,1584,1548,36,19,7,9,1
2021,Derby 002B,E01013466,1470,1444,26,17,4,2,3
2021,Derby 002C,E01013467,1336,1294,42,21,12,6,3
2021,Derby 002D,E01013468,1561,1497,64,36,19,6,3
2021,Derby 002E,E01013469,1251,1206,45,27,12,5,1
2021,Derby 024A,E01013470,1330,1263,67,29,25,10,3
2021,Derby 025A,E01013471,1801,1567,234,59,108,43,24
2021,Derby 026A,E01013472,2286,1978,308,100,140,67,1
2021,Derby 025B,E01013473,1523,1371,152,66,53,32,1
2021,Derby 024B,E01013474,1511,1430,81,33,24,18,6
2021,Derby 025C,E01013475,1562,1315,247,113,94,39,1
2021,Derby 024C,E01013476,1358,1267,91,48,27,11,5
2021,Derby 025D,E01013477,1626,1481,145,53,52,37,3
2021,Derby 016A,E01013480,2108,1380,728,214,348,144,22
2021,Derby 018A,E01013481,1936,1240,696,203,250,198,45
2021,Derby 016B,E01013483,1939,1267,672,192,250,175,55
2021,Derby 018C,E01013484,2093,1309,784,190,284,255,55
2021,Derby 016C,E01013485,2155,1309,846,196,353,236,61
2021,Derby 018D,E01013486,2055,1371,684,156,255,219,54
2021,Derby 018E,E01013487,2494,1569,925,235,394,245,51
2021,Derby 022A,E01013488,1514,1276,238,87,81,57,13
2021,Derby 022B,E01013489,1479,1278,201,88,67,35,11
2021,Derby 022C,E01013490,1491,1335,156,74,47,24,11
2021,Derby 022D,E01013491,1604,1289,315,111,126,67,11
2021,Derby 027A,E01013492,1569,1385,184,77,70,30,7
2021,Derby 027B,E01013493,1507,1188,319,130,116,60,13
2021,Derby 027C,E01013494,1839,1659,180,86,57,33,4
2021,Derby 027D,E01013495,1757,1489,268,130,85,42,11
2021,Derby 028A,E01013496,1468,1396,72,24,25,22,1
2021,Derby 026B,E01013497,1711,1379,332,146,138,37,11
2021,Derby 028B,E01013498,1410,1362,48,22,20,4,2
2021,Derby 028C,E01013499,1492,1386,106,42,42,20,2
2021,Derby 028D,E01013500,1658,1583,75,30,27,17,1
2021,Derby 028E,E01013501,1411,1362,49,23,21,4,1
2021,Derby 025E,E01013502,1439,1356,83,32,24,25,2
2021,Derby 025F,E01013503,1467,1358,109,44,41,23,1
2021,Derby 026C,E01013504,1839,1563,276,105,115,48,8
2021,Derby 006A,E01013505,1443,1396,47,21,13,9,4
2021,Derby 006B,E01013506,1483,1456,27,15,7,5,0
2021,Derby 012A,E01013507,1502,1460,42,20,12,5,5
2021,Derby 012B,E01013508,1249,1191,58,20,25,11,2
2021,Derby 012C,E01013509,1588,1534,54,27,21,6,0
2021,Derby 012D,E01013510,1524,1446,78,29,35,14,0
2021,Derby 012E,E01013511,1512,1475,37,17,17,3,0
2021,Derby 012F,E01013512,1374,1279,95,50,27,14,4
2021,Derby 006C,E01013513,1309,1258,51,27,18,3,3
2021,Derby 031A,E01013514,1462,1399,63,36,18,8,1
2021,Derby 031B,E01013515,2008,1875,133,67,43,20,3
2021,Derby 030B,E01013517,1423,1290,133,50,58,25,0
2021,Derby 030C,E01013518,1482,1410,72,28,24,19,1
2021,Derby 031C,E01013519,1537,1487,50,22,21,7,0
2021,Derby 031D,E01013520,1872,1813,59,34,19,4,2
2021,Derby 030D,E01013521,1309,1233,76,33,20,19,4
2021,Derby 008A,E01013522,1905,1721,184,94,64,21,5
2021,Derby 008B,E01013523,1762,1588,174,104,38,30,2
2021,Derby 008C,E01013524,2573,2326,247,143,75,24,5
2021,Derby 008D,E01013525,1832,1736,96,59,25,11,1
2021,Derby 005A,E01013526,1593,1553,40,17,14,8,1
2021,Derby 005B,E01013527,1517,1483,34,26,3,3,2
2021,Derby 005C,E01013528,1539,1462,77,38,26,13,0
2021,Derby 005D,E01013529,2189,2062,127,75,28,20,4
2021,Derby 004A,E01013530,1740,1570,170,80,72,15,3
2021,Derby 004B,E01013531,1426,1321,105,51,38,11,5
2021,Derby 004C,E01013532,1464,1377,87,37,39,11,0
2021,Derby 007A,E01013533,1539,1406,133,51,47,29,6
2021,Derby 006D,E01013534,1556,1512,44,22,17,5,0
2021,Derby 007B,E01013535,1661,1497,164,61,63,34,6
2021,Derby 007C,E01013536,1488,1361,127,39,52,32,4
2021,Derby 007D,E01013537,1553,1484,69,29,25,13,2
2021,Derby 007E,E01013538,1433,1297,136,45,61,28,2
2021,Derby 021A,E01013539,2272,1866,406,233,121,43,9
2021,Derby 019A,E01013540,1607,1442,165,84,53,26,2
2021,Derby 021B,E01013541,1703,1544,159,80,40,32,7
2021,Derby 017C,E01013542,2305,2042,263,147,87,22,7
2021,Derby 021C,E01013543,1661,1512,149,95,36,17,1
2021,Derby 021D,E01013544,1830,1590,240,154,52,27,7
2021,Derby 021E,E01013545,1657,1468,189,100,57,27,5
2021,Derby 017D,E01013546,1654,1509,145,68,41,31,5
2021,Derby 011A,E01013547,1785,1592,193,94,63,31,5
2021,Derby 009A,E01013548,1649,1583,66,29,24,7,6
2021,Derby 009B,E01013549,1465,1372,93,40,29,19,5
2021,Derby 011B,E01013550,1231,1093,138,63,53,20,2
2021,Derby 011C,E01013551,1676,1456,220,116,67,32,5
2021,Derby 009C,E01013552,1631,1531,100,43,30,17,10
2021,Derby 009D,E01013553,1493,1375,118,55,40,21,2
2021,Derby 011D,E01013554,1525,1276,249,124,82,34,9
2021,Derby 009E,E01013555,2531,2284,247,123,73,17,34
2021,Derby 015A,E01013556,1333,1299,34,24,8,2,0
2021,Derby 015B,E01013557,1316,1273,43,24,14,3,2
2021,Derby 015C,E01013558,2483,2246,237,134,79,23,1
2021,Derby 015D,E01013559,1295,1243,52,33,15,3,1
2021,Derby 019B,E01013560,1349,1273,76,39,20,12,5
2021,Derby 019C,E01013561,1466,1442,24,11,10,3,0
2021,Derby 019D,E01013562,1304,1251,53,28,12,10,3
2021,Derby 019E,E01013563,1298,1262,36,22,11,3,0
2021,Derby 015E,E01013564,2427,2303,124,61,35,11,17
2021,Derby 016D,E01013565,1925,1091,834,287,258,247,42
2021,Derby 016E,E01013566,2289,1246,1043,270,370,347,56
2021,Derby 020B,E01013567,2228,1256,972,270,378,263,61
2021,Derby 020C,E01013568,2460,1376,1084,319,406,302,57
2021,Derby 020D,E01013569,1767,1139,628,166,237,187,38
2021,Derby 023A,E01013570,2417,1573,844,260,329,214,41
2021,Derby 023B,E01013571,1994,1371,623,214,228,151,30
2021,Derby 023C,E01013572,1693,1296,397,131,161,84,21
2021,Derby 023D,E01013573,2057,1594,463,135,205,109,14
2021,Derby 003A,E01013574,1868,1803,65,40,16,6,3
2021,Derby 003B,E01013575,1441,1377,64,29,25,7,3
2021,Derby 003C,E01013576,1287,1248,39,18,15,6,0
2021,Derby 003D,E01013577,1433,1403,30,14,7,7,2
2021,Derby 003E,E01013578,1281,1254,27,15,2,8,2
2021,Derby 003F,E01013579,1333,1271,62,32,17,10,3
2021,Derby 003G,E01013580,1420,1364,56,26,24,6,0
2021,Derby 004D,E01013581,1477,1400,77,38,25,12,2
2021,Derby 006E,E01013582,1437,1386,51,25,19,5,2
2021,Derby 026D,E01013583,1779,1350,429,169,162,79,19
2021,Derby 029A,E01013584,1965,1629,336,121,148,60,7
2021,Derby 029B,E01013585,1975,1539,436,182,154,80,20
2021,Derby 029C,E01013586,1683,1398,285,112,117,50,6
2021,Derby 029D,E01013587,1613,1168,445,169,166,85,25
2021,Derby 029E,E01013588,1513,1222,291,94,114,58,25
2021,Derby 029F,E01013589,1629,1358,271,105,75,83,8
2021,Derby 026E,E01013590,2220,1718,502,215,187,83,17
2021,Derby 026F,E01013591,2078,1706,372,131,168,65,8
2021,Derby 010A,E01013592,1367,1346,21,11,3,5,2
2021,Derby 014A,E01013593,1408,1403,5,3,1,0,1
2021,Derby 010B,E01013594,1266,1252,14,7,2,4,1
2021,Derby 014B,E01013595,2376,2287,89,35,42,8,4
2021,Derby 010C,E01013596,1481,1469,12,8,2,2,0
2021,Derby 014C,E01013597,1538,1503,35,15,12,6,2
2021,Derby 014D,E01013598,1522,1481,41,21,11,6,3
2021,Derby 010D,E01013599,1358,1340,18,12,4,2,0
2021,Leicester 003A,E01013600,2096,1723,373,143,153,62,15
2021,Leicester 003B,E01013601,1813,1389,424,153,167,78,26
2021,Leicester 003C,E01013602,1874,1452,422,150,178,76,18
2021,Leicester 003D,E01013603,1673,1349,324,148,122,43,11
2021,Leicester 003E,E01013604,1822,1450,372,123,182,60,7
2021,Leicester 003F,E01013605,2027,1393,634,251,233,110,40
2021,Leicester 008A,E01013606,1870,1285,585,216,236,106,27
2021,Leicester 034A,E01013608,1532,1412,120,54,47,19,0
2021,Leicester 034B,E01013609,1526,1430,96,34,42,18,2
2021,Leicester 034C,E01013610,1669,1518,151,56,65,22,8
2021,Leicester 034D,E01013611,1621,1462,159,70,65,21,3
2021,Leicester 034E,E01013612,1745,1598,147,75,43,27,2
2021,Leicester 031A,E01013613,1775,1508,267,105,105,49,8
2021,Leicester 031B,E01013614,1653,1445,208,97,85,22,4
2021,Leicester 001A,E01013615,1672,1441,231,112,87,29,3
2021,Leicester 001B,E01013616,1587,1374,213,90,87,28,8
2021,Leicester 004A,E01013617,2600,2070,530,267,196,60,7
2021,Leicester 001C,E01013618,1591,1322,269,108,116,36,9
2021,Leicester 001D,E01013619,1750,1359,391,160,154,65,12
2021,Leicester 004B,E01013620,1791,1401,390,149,151,75,15
2021,Leicester 004C,E01013621,2338,1807,531,236,207,76,12
2021,Leicester 004D,E01013622,1666,1259,407,169,162,65,11
2021,Leicester 004E,E01013623,2157,1633,524,245,198,67,14
2021,Leicester 007A,E01013624,1678,1025,653,221,226,149,57
2021,Leicester 006A,E01013625,2131,864,1267,326,407,388,146
2021,Leicester 007B,E01013626,1961,772,1189,295,421,347,126
2021,Leicester 007C,E01013627,1315,599,716,215,233,187,81
2021,Leicester 006B,E01013628,1709,933,776,207,274,214,81
2021,Leicester 007D,E01013629,1752,747,1005,309,336,274,86
2021,Leicester 007E,E01013630,1967,750,1217,345,418,342,112
2021,Leicester 026A,E01013631,1543,1282,261,88,117,47,9
2021,Leicester 026B,E01013632,1841,1560,281,145,90,41,5
2021,Leicester 028A,E01013633,1649,1388,261,107,110,38,6
2021,Leicester 028B,E01013634,1456,1234,222,81,88,48,5
2021,Leicester 029A,E01013635,1505,1060,445,163,180,89,13
2021,Leicester 029B,E01013636,1318,980,338,150,124,48,16
2021,Leicester 028C,E01013637,2020,1717,303,136,114,43,10
2021,Leicester 026C,E01013638,1708,1502,206,84,81,34,7
2021,Leicester 028D,E01013639,1579,1307,272,101,126,41,4
2021,Leicester 026D,E01013640,2049,1745,304,148,104,48,4
2021,Leicester 028E,E01013641,1470,1024,446,148,188,97,13
2021,Leicester 030A,E01013642,1676,1480,196,103,67,25,1
2021,Leicester 030B,E01013643,1820,1578,242,129,73,34,6
2021,Leicester 040C,E01013648,3451,2599,852,412,305,119,16
2021,Leicester 030C,E01013649,1285,1117,168,76,58,25,9
2021,Leicester 030D,E01013650,1731,1549,182,103,54,24,1
2021,Leicester 011A,E01013651,2078,1280,798,251,330,160,57
2021,Leicester 011B,E01013652,2069,1298,771,250,282,187,52
2021,Leicester 011C,E01013653,2856,1842,1014,277,345,289,103
2021,Leicester 017A,E01013654,2564,1059,1505,346,448,444,267
2021,Leicester 011D,E01013655,2596,1121,1475,374,431,448,222
2021,Leicester 017B,E01013656,2126,647,1479,294,413,480,292
2021,Leicester 017C,E01013657,1866,936,930,224,300,260,146
2021,Leicester 017D,E01013658,2723,806,1917,437,627,542,311
2021,Leicester 017E,E01013659,2157,977,1180,251,393,386,150
2021,Leicester 019A,E01013660,1958,1138,820,217,297,222,84
2021,Leicester 019B,E01013661,1874,1205,669,216,222,185,46
2021,Leicester 021A,E01013662,1888,948,940,207,322,306,105
2021,Leicester 021B,E01013663,1770,1009,761,231,259,217,54
2021,Leicester 019C,E01013664,1769,1186,583,160,215,166,42
2021,Leicester 019D,E01013665,2253,1234,1019,276,362,249,132
2021,Leicester 025A,E01013666,1664,1224,440,205,138,78,19
2021,Leicester 019E,E01013667,1560,1138,422,164,129,104,25
2021,Leicester 019F,E01013668,1311,924,387,130,161,76,20
2021,Leicester 025B,E01013669,1485,1049,436,185,134,94,23
2021,Leicester 025C,E01013670,1929,1498,431,182,148,84,17
2021,Leicester 025D,E01013671,1895,1417,478,177,173,102,26
2021,Leicester 025E,E01013672,1506,1150,356,156,124,60,16
2021,Leicester 036A,E01013673,1622,1441,181,66,64,40,11
2021,Leicester 036B,E01013674,1509,1413,96,25,36,28,7
2021,Leicester 036C,E01013675,1659,1470,189,80,70,37,2
2021,Leicester 036D,E01013676,2081,1772,309,125,105,61,18
2021,Leicester 036E,E01013677,1456,1301,155,75,62,12,6
2021,Leicester 035A,E01013678,1699,1522,177,70,67,37,3
2021,Leicester 035B,E01013679,1529,1337,192,99,64,27,2
2021,Leicester 008C,E01013680,2030,1521,509,202,219,74,14
2021,Leicester 016A,E01013681,1959,1256,703,224,321,134,24
2021,Leicester 016B,E01013682,1821,1288,533,188,229,99,17
2021,Leicester 016C,E01013683,2280,1319,961,322,438,183,18
2021,Leicester 016D,E01013684,2292,1399,893,268,396,198,31
2021,Leicester 008D,E01013685,1462,1225,237,104,86,36,11
2021,Leicester 008E,E01013686,1797,1327,470,174,204,80,12
2021,Leicester 031C,E01013687,1596,1336,260,96,117,44,3
2021,Leicester 031D,E01013688,1900,1558,342,140,136,59,7
2021,Leicester 038A,E01013689,1970,1610,360,167,125,55,13
2021,Leicester 038B,E01013690,2242,1911,331,144,136,40,11
2021,Leicester 035C,E01013691,1681,1423,258,82,105,52,19
2021,Leicester 035D,E01013692,1424,1251,173,68,69,30,6
2021,Leicester 035E,E01013693,1597,1390,207,64,78,55,10
2021,Leicester 013A,E01013694,2197,1718,479,202,175,87,15
2021,Leicester 043D,E01013696,2416,1786,630,298,200,113,19
2021,Leicester 037B,E01013698,1636,1352,284,124,89,60,11
2021,Leicester 043C,E01013699,1950,1542,408,178,129,74,27
2021,Leicester 013B,E01013700,1565,1321,244,76,87,73,8
2021,Leicester 030E,E01013702,1603,1371,232,116,63,49,4
2021,Leicester 032A,E01013703,1275,1166,109,66,27,13,3
2021,Leicester 032B,E01013704,1416,1325,91,57,22,12,0
2021,Leicester 038C,E01013705,1592,1342,250,101,84,59,6
2021,Leicester 032C,E01013706,1661,1539,122,74,36,9,3
2021,Leicester 032D,E01013707,1524,1348,176,85,58,33,0
2021,Leicester 038D,E01013709,1604,1135,469,231,128,95,15
2021,Leicester 030F,E01013710,1360,1085,275,150,76,40,9
2021,Leicester 030G,E01013711,1593,1347,246,120,82,36,8
2021,Leicester 032E,E01013712,1271,1111,160,93,35,21,11
2021,Leicester 010A,E01013713,1796,613,1183,228,417,402,136
2021,Leicester 010B,E01013714,1811,671,1140,269,379,336,156
2021,Leicester 006C,E01013715,1420,492,928,199,311,293,125
2021,Leicester 010C,E01013717,1621,823,798,219,266,224,89
2021,Leicester 010D,E01013718,1837,689,1148,248,372,372,156
2021,Leicester 010E,E01013719,1964,605,1359,315,467,382,195
2021,Leicester 010F,E01013720,1858,629,1229,254,473,324,178
2021,Leicester 012A,E01013721,1655,1332,323,154,112,54,3
2021,Leicester 039A,E01013722,1915,1627,288,122,111,48,7
2021,Leicester 012B,E01013723,1453,1203,250,112,90,40,8
2021,Leicester 012C,E01013725,1630,1286,344,128,141,72,3
2021,Leicester 012D,E01013726,1810,1488,322,137,128,47,10
2021,Leicester 039B,E01013727,1629,1357,272,107,131,25,9
2021,Leicester 012E,E01013728,1739,1439,300,115,115,59,11
2021,Leicester 020A,E01013729,1250,1047,203,105,72,25,1
2021,Leicester 039C,E01013730,1649,1353,296,119,130,40,7
2021,Leicester 039D,E01013731,1529,1331,198,82,86,25,5
2021,Leicester 005A,E01013732,2441,1381,1060,346,391,261,62
2021,Leicester 002A,E01013733,1954,1452,502,205,184,90,23
2021,Leicester 002B,E01013734,1416,844,572,236,217,101,18
2021,Leicester 002C,E01013735,1183,659,524,227,176,105,16
2021,Leicester 002D,E01013736,2092,1652,440,198,162,74,6
2021,Leicester 002E,E01013737,1360,759,601,221,220,130,30
2021,Leicester 006E,E01013738,1372,815,557,222,195,115,25
2021,Leicester 005B,E01013739,1474,890,584,196,223,134,31
2021,Leicester 005C,E01013740,1447,760,687,261,249,138,39
2021,Leicester 005D,E01013741,1680,925,755,262,286,172,35
2021,Leicester 018A,E01013742,1768,924,844,208,235,283,118
2021,Leicester 017F,E01013743,2095,952,1143,242,331,381,189
2021,Leicester 018B,E01013744,1799,1026,773,200,259,222,92
2021,Leicester 017G,E01013745,1634,883,751,193,212,266,80
2021,Leicester 018C,E01013746,1743,844,899,225,336,241,97
2021,Leicester 021C,E01013747,1910,1074,836,209,307,256,64
2021,Leicester 018D,E01013748,1853,1110,743,185,288,198,72
2021,Leicester 021D,E01013749,1542,1020,522,173,184,131,34
2021,Leicester 021E,E01013750,1526,807,719,194,278,187,60
2021,Leicester 022A,E01013751,1897,1022,875,234,334,249,58
2021,Leicester 022B,E01013752,1554,805,749,202,239,239,69
2021,Leicester 022C,E01013753,1699,918,781,225,265,217,74
2021,Leicester 018E,E01013754,2371,1183,1188,413,413,292,70
2021,Leicester 018F,E01013755,2348,1237,1111,334,412,284,81
2021,Leicester 027A,E01013756,1976,1300,676,221,245,186,24
2021,Leicester 027B,E01013757,1631,1216,415,166,134,101,14
2021,Leicester 021F,E01013758,1627,1121,506,158,186,130,32
2021,Leicester 027C,E01013759,1848,1450,398,164,119,96,19
2021,Leicester 022D,E01013760,1837,1202,635,171,247,168,49
2021,Leicester 022E,E01013761,1945,1098,847,247,307,230,63
2021,Leicester 022F,E01013762,1736,914,822,259,283,217,63
2021,Leicester 027D,E01013763,2162,1333,829,227,297,247,58
2021,Leicester 027E,E01013764,1579,1136,443,150,176,101,16
2021,Leicester 027F,E01013765,1810,971,839,241,291,247,60
2021,Leicester 027G,E01013766,1944,1416,528,210,185,114,19
2021,Leicester 037C,E01013767,1627,1284,343,137,123,69,14
2021,Leicester 037D,E01013768,1845,1560,285,117,98,59,11
2021,Leicester 013C,E01013770,1423,1139,284,128,90,51,15
2021,Leicester 013D,E01013771,1620,1284,336,133,117,76,10
2021,Leicester 037E,E01013772,1598,1333,265,129,79,51,6
2021,Leicester 013E,E01013773,1400,1168,232,98,91,36,7
2021,Leicester 023A,E01013774,1782,1016,766,202,357,181,26
2021,Leicester 023B,E01013776,1812,1062,750,241,317,167,25
2021,Leicester 029D,E01013777,1829,1045,784,224,346,184,30
2021,Leicester 023D,E01013779,1999,1135,864,272,365,179,48
2021,Leicester 020B,E01013780,1552,1333,219,86,86,40,7
2021,Leicester 023E,E01013781,1668,1213,455,176,208,65,6
2021,Leicester 023F,E01013782,1436,1076,360,115,149,72,24
2021,Leicester 020C,E01013783,1456,1248,208,71,95,34,8
2021,Leicester 023G,E01013784,1308,973,335,112,149,63,11
2021,Leicester 020D,E01013785,1497,1360,137,69,48,20,0
2021,Leicester 020E,E01013786,1552,1180,372,117,175,64,16
2021,Rutland 005A,E01013787,1253,1241,12,7,4,1,0
2021,Rutland 001A,E01013788,3521,3438,83,55,23,4,1
2021,Rutland 001B,E01013789,1348,1325,23,13,9,1,0
2021,Rutland 001C,E01013790,2445,2378,67,18,25,24,0
2021,Rutland 004A,E01013791,1128,1118,10,7,2,1,0
2021,Rutland 004B,E01013792,1643,1612,31,17,9,4,1
2021,Rutland 002A,E01013793,1373,1363,10,6,4,0,0
2021,Rutland 005B,E01013794,1322,1307,15,13,1,1,0
2021,Rutland 005C,E01013795,1118,1111,7,4,2,1,0
2021,Rutland 001D,E01013796,1418,1397,21,8,9,4,0
2021,Rutland 004C,E01013797,1681,1666,15,13,1,1,0
2021,Rutland 003A,E01013798,1299,1273,26,16,6,3,1
2021,Rutland 003B,E01013799,1637,1563,74,46,19,9,0
2021,Rutland 002B,E01013800,1467,1452,15,11,2,2,0
2021,Rutland 003D,E01013803,2204,2162,42,19,18,3,2
2021,Rutland 004D,E01013804,1568,1555,13,8,3,2,0
2021,Rutland 004E,E01013805,1321,1308,13,12,0,0,1
2021,Rutland 005D,E01013806,1803,1725,78,56,18,4,0
2021,Rutland 005E,E01013807,1246,1230,16,7,6,3,0
2021,Rutland 005F,E01013808,1571,1540,31,21,6,4,0
2021,Rutland 002D,E01013809,1224,1213,11,7,3,1,0
2021,Nottingham 018A,E01013810,1862,1143,719,212,268,191,48
2021,Nottingham 018B,E01013811,1292,877,415,105,168,123,19
2021,Nottingham 018C,E01013812,1561,966,595,164,248,151,32
2021,Nottingham 022A,E01013813,2897,2653,244,103,94,40,7
2021,Nottingham 022B,E01013814,2207,1895,312,128,124,51,9
2021,Nottingham 022C,E01013815,2131,1994,137,76,38,20,3
2021,Nottingham 022D,E01013816,3976,3451,525,245,208,66,6
2021,Nottingham 011A,E01013817,1672,1443,229,96,86,42,5
2021,Nottingham 011B,E01013818,1651,1420,231,85,94,49,3
2021,Nottingham 013A,E01013819,1750,1454,296,134,116,34,12
2021,Nottingham 013B,E01013820,1675,1458,217,89,78,49,1
2021,Nottingham 013C,E01013821,1673,1367,306,142,132,30,2
2021,Nottingham 011C,E01013822,1827,1495,332,114,167,43,8
2021,Nottingham 013D,E01013823,1702,1475,227,89,85,49,4
2021,Nottingham 013E,E01013824,1614,1363,251,106,109,31,5
2021,Nottingham 011D,E01013825,1954,1653,301,111,149,41,0
2021,Nottingham 011E,E01013826,1831,1531,300,141,99,51,9
2021,Nottingham 008A,E01013827,1374,1217,157,65,64,25,3
2021,Nottingham 008B,E01013828,1742,1518,224,90,90,36,8
2021,Nottingham 009A,E01013829,1613,1421,192,86,67,34,5
2021,Nottingham 009B,E01013830,1551,1386,165,59,78,23,5
2021,Nottingham 009C,E01013831,1438,1348,90,33,39,17,1
2021,Nottingham 009D,E01013832,1798,1581,217,101,63,44,9
2021,Nottingham 009E,E01013833,1287,1147,140,51,56,29,4
2021,Nottingham 008C,E01013834,1537,1417,120,46,56,15,3
2021,Nottingham 008D,E01013835,1555,1432,123,48,48,19,8
2021,Nottingham 008E,E01013836,1923,1656,267,106,113,37,11
2021,Nottingham 012A,E01013837,1989,1749,240,132,64,43,1
2021,Nottingham 012B,E01013838,1709,1513,196,74,77,40,5
2021,Nottingham 012C,E01013839,1946,1544,402,139,156,90,17
2021,Nottingham 012D,E01013840,2365,1854,511,203,190,87,31
2021,Nottingham 012E,E01013841,1579,1237,342,116,139,73,14
2021,Nottingham 018D,E01013842,1871,1207,664,201,262,175,26
2021,Nottingham 017A,E01013843,2046,1492,554,205,198,140,11
2021,Nottingham 017B,E01013844,1672,1112,560,196,223,100,41
2021,Nottingham 017C,E01013845,1805,1125,680,185,263,192,40
2021,Nottingham 018E,E01013846,1670,1128,542,176,191,140,35
2021,Nottingham 017D,E01013847,1520,974,546,124,233,142,47
2021,Nottingham 038A,E01013849,1465,1346,119,46,41,29,3
2021,Nottingham 038B,E01013850,1371,1258,113,43,45,21,4
2021,Nottingham 038C,E01013851,1447,1332,115,71,25,15,4
2021,Nottingham 038D,E01013852,1637,1539,98,44,37,13,4
2021,Nottingham 006A,E01013853,1482,1348,134,69,48,17,0
2021,Nottingham 006B,E01013854,1401,1299,102,41,48,12,1
2021,Nottingham 006C,E01013855,1585,1352,233,99,91,34,9
2021,Nottingham 006D,E01013856,1576,1401,175,95,49,25,6
2021,Nottingham 025A,E01013858,1405,1212,193,92,78,19,4
2021,Nottingham 020A,E01013859,1455,1325,130,47,49,28,6
2021,Nottingham 025B,E01013860,1630,1379,251,89,99,38,25
2021,Nottingham 020B,E01013861,1533,1395,138,51,51,28,8
2021,Nottingham 025C,E01013862,1507,1336,171,91,48,23,9
2021,Nottingham 025D,E01013863,1449,1290,159,63,62,30,4
2021,Nottingham 014A,E01013864,2068,1836,232,88,106,34,4
2021,Nottingham 014B,E01013865,1514,1368,146,61,58,21,6
2021,Nottingham 014C,E01013866,1448,1313,135,54,52,25,4
2021,Nottingham 014D,E01013867,1565,1395,170,51,75,35,9
2021,Nottingham 020C,E01013868,1511,1349,162,68,70,20,4
2021,Nottingham 040A,E01013870,2264,1920,344,176,122,38,8
2021,Nottingham 040B,E01013871,1705,1391,314,136,108,62,8
2021,Nottingham 040C,E01013872,1949,1528,421,181,140,77,23
2021,Nottingham 040D,E01013873,1708,1296,412,188,139,74,11
2021,Nottingham 039A,E01013874,1628,1386,242,94,79,64,5
2021,Nottingham 005A,E01013875,1244,1214,30,17,8,4,1
2021,Nottingham 005B,E01013876,1631,1481,150,57,62,27,4
2021,Nottingham 005C,E01013877,1502,1390,112,49,40,17,6
2021,Nottingham 005D,E01013878,1321,1216,105,35,43,24,3
2021,Nottingham 002A,E01013879,1241,1159,82,35,35,10,2
2021,Nottingham 002B,E01013880,1482,1378,104,47,43,13,1
2021,Nottingham 002C,E01013881,1488,1387,101,35,42,21,3
2021,Nottingham 002D,E01013882,1420,1310,110,38,38,33,1
2021,Nottingham 005E,E01013883,1405,1326,79,24,35,18,2
2021,Nottingham 005F,E01013884,1298,1150,148,50,76,22,0
2021,Nottingham 002E,E01013885,1574,1461,113,46,35,30,2
2021,Nottingham 004A,E01013886,1388,1299,89,47,25,13,4
2021,Nottingham 001A,E01013887,1593,1475,118,56,39,21,2
2021,Nottingham 004B,E01013888,1551,1475,76,45,23,7,1
2021,Nottingham 004C,E01013889,1644,1535,109,49,45,14,1
2021,Nottingham 004D,E01013890,1447,1360,87,44,34,9,0
2021,Nottingham 004E,E01013891,1653,1519,134,52,56,24,2
2021,Nottingham 001B,E01013892,1337,1259,78,40,28,9,1
2021,Nottingham 001C,E01013893,1428,1317,111,39,52,19,1
2021,Nottingham 001D,E01013894,1459,1366,93,48,30,12,3
2021,Nottingham 034A,E01013895,1414,1359,55,33,12,7,3
2021,Nottingham 034B,E01013896,1245,1129,116,58,39,15,4
2021,Nottingham 035A,E01013897,1455,1329,126,59,50,16,1
2021,Nottingham 035B,E01013898,2267,2125,142,83,37,16,6
2021,Nottingham 035C,E01013899,1259,1118,141,47,63,24,7
2021,Nottingham 035D,E01013900,1473,1336,137,64,36,34,3
2021,Nottingham 034C,E01013901,1470,1427,43,27,11,5,0
2021,Nottingham 034D,E01013902,1823,1703,120,70,34,12,4
2021,Nottingham 035E,E01013903,1175,1055,120,68,39,9,4
2021,Nottingham 037A,E01013904,1510,1383,127,53,60,14,0
2021,Nottingham 036A,E01013905,1426,1321,105,39,48,14,4
2021,Nottingham 037B,E01013906,1685,1553,132,50,57,20,5
2021,Nottingham 035F,E01013907,1468,1371,97,51,35,10,1
2021,Nottingham 036B,E01013908,1445,1345,100,53,33,13,1
2021,Nottingham 036C,E01013909,1421,1315,106,49,49,8,0
2021,Nottingham 037C,E01013910,1494,1406,88,51,26,8,3
2021,Nottingham 037D,E01013911,1492,1412,80,30,32,13,5
2021,Nottingham 036D,E01013912,1413,1346,67,30,31,6,0
2021,Nottingham 024A,E01013913,1706,1538,168,56,68,36,8
2021,Nottingham 024B,E01013914,1643,1447,196,62,74,54,6
2021,Nottingham 024C,E01013915,1474,1363,111,46,45,19,1
2021,Nottingham 024D,E01013916,1502,1284,218,66,87,59,6
2021,Nottingham 024E,E01013917,1882,1571,311,75,158,69,9
2021,Nottingham 029A,E01013918,1906,1378,528,155,215,144,14
2021,Nottingham 029B,E01013919,1907,1396,511,176,209,108,18
2021,Nottingham 029C,E01013920,2185,1759,426,172,158,84,12
2021,Nottingham 029D,E01013921,2115,1506,609,211,226,146,26
2021,Nottingham 031G,E01013928,1497,1207,290,138,115,33,4
2021,Nottingham 020D,E01013929,1977,1736,241,111,87,36,7
2021,Nottingham 019A,E01013930,1891,1384,507,175,200,111,21
2021,Nottingham 019B,E01013931,2099,1732,367,167,118,67,15
2021,Nottingham 019C,E01013932,2417,1894,523,218,190,92,23
2021,Nottingham 019D,E01013933,1886,1459,427,165,159,90,13
2021,Nottingham 019E,E01013934,1544,1233,311,120,116,67,8
2021,Nottingham 010A,E01013935,1430,1317,113,59,25,19,10
2021,Nottingham 016A,E01013936,2053,1816,237,98,90,40,9
2021,Nottingham 015A,E01013937,1724,1567,157,81,48,24,4
2021,Nottingham 015B,E01013938,1589,1430,159,100,43,15,1
2021,Nottingham 016B,E01013939,1374,1292,82,31,40,11,0
2021,Nottingham 016C,E01013940,1859,1472,387,169,132,80,6
2021,Nottingham 015C,E01013941,1895,1573,322,144,102,63,13
2021,Nottingham 016D,E01013942,2093,1642,451,160,160,123,8
2021,Nottingham 015D,E01013943,1835,1487,348,167,117,46,18
2021,Nottingham 026A,E01013944,1735,1109,626,177,251,176,22
2021,Nottingham 026B,E01013945,2290,1784,506,212,169,112,13
2021,Nottingham 026D,E01013947,1956,1453,503,190,191,108,14
2021,Nottingham 026E,E01013948,1323,967,356,110,148,87,11
2021,Nottingham 026F,E01013953,1953,1763,190,91,67,30,2
2021,Nottingham 021A,E01013954,1883,1443,440,186,184,66,4
2021,Nottingham 029E,E01013957,1577,1250,327,123,129,64,11
2021,Nottingham 023C,E01013958,1679,1237,442,139,177,108,18
2021,Nottingham 021B,E01013959,1786,1338,448,118,183,114,33
2021,Nottingham 021C,E01013960,1690,1283,407,122,166,98,21
2021,Nottingham 023D,E01013961,2408,2104,304,142,103,50,9
2021,Nottingham 021D,E01013962,1985,1593,392,137,160,88,7
2021,Nottingham 007A,E01013963,1484,1327,157,65,62,28,2
2021,Nottingham 007B,E01013964,1759,1555,204,109,68,21,6
2021,Nottingham 007C,E01013965,1431,1298,133,57,43,30,3
2021,Nottingham 007D,E01013966,1331,1205,126,55,53,13,5
2021,Nottingham 007E,E01013967,1830,1602,228,89,103,34,2
2021,Nottingham 010B,E01013968,1328,1271,57,34,12,9,2
2021,Nottingham 010C,E01013969,1701,1507,194,70,78,40,6
2021,Nottingham 010D,E01013970,1497,1389,108,40,38,22,8
2021,Nottingham 010E,E01013971,1528,1410,118,63,40,15,0
2021,Nottingham 015E,E01013972,1484,1341,143,56,63,20,4
2021,Nottingham 041D,E01013977,1883,1734,149,61,61,24,3
2021,Nottingham 041A,E01013978,1744,1484,260,109,99,43,9
2021,Nottingham 041C,E01013979,1656,1448,208,98,72,30,8
2021,Nottingham 030A,E01013980,1648,1516,132,71,37,20,4
2021,Nottingham 041B,E01013981,1686,1517,169,73,67,25,4
2021,Nottingham 030B,E01013982,1668,1539,129,63,30,33,3
2021,Nottingham 030C,E01013983,1288,1083,205,94,74,29,8
2021,Nottingham 030D,E01013984,1427,1294,133,76,38,13,6
2021,Nottingham 030E,E01013985,1672,1433,239,112,87,36,4
2021,Herefordshire 012A,E01013986,1573,1450,123,50,49,22,2
2021,Herefordshire 011A,E01013987,1559,1496,63,40,17,5,1
2021,Herefordshire 011B,E01013988,1792,1707,85,46,29,5,5
2021,Herefordshire 012B,E01013989,1485,1350,135,60,56,19,0
2021,Herefordshire 018A,E01013990,2055,2009,46,21,16,6,3
2021,Herefordshire 018B,E01013991,1299,1279,20,7,10,3,0
2021,Herefordshire 017A,E01013992,1494,1299,195,67,94,30,4
2021,Herefordshire 017B,E01013993,1514,1378,136,40,65,24,7
2021,Herefordshire 017C,E01013994,1364,1225,139,44,58,32,5
2021,Herefordshire 017D,E01013995,1748,1471,277,100,119,49,9
2021,Herefordshire 016A,E01013996,1486,1350,136,49,56,19,12
2021,Herefordshire 016B,E01013997,1802,1657,145,47,67,27,4
2021,Herefordshire 001A,E01013998,1397,1391,6,4,1,0,1
2021,Herefordshire 004A,E01013999,1556,1535,21,12,7,2,0
2021,Herefordshire 005A,E01014000,1284,1269,15,5,6,4,0
2021,Herefordshire 005B,E01014001,1584,1559,25,12,9,3,1
2021,Herefordshire 005C,E01014002,1387,1348,39,28,7,3,1
2021,Herefordshire 005D,E01014003,1535,1480,55,18,21,5,11
2021,Herefordshire 005E,E01014004,1413,1384,29,7,19,2,1
2021,Herefordshire 005F,E01014005,1648,1569,79,33,30,14,2
2021,Herefordshire 007A,E01014006,1521,1496,25,16,8,1,0
2021,Herefordshire 006A,E01014008,1578,1561,17,13,4,0,0
2021,Herefordshire 006B,E01014009,1514,1484,30,14,12,4,0
2021,Herefordshire 012C,E01014010,1778,1365,413,154,151,94,14
2021,Herefordshire 012D,E01014011,1436,1277,159,65,64,28,2
2021,Herefordshire 007B,E01014012,1628,1598,30,19,5,6,0
2021,Herefordshire 007C,E01014013,1931,1868,63,30,25,6,2
2021,Herefordshire 018C,E01014014,1817,1775,42,12,13,13,4
2021,Herefordshire 005G,E01014015,1590,1564,26,9,13,4,0
2021,Herefordshire 007D,E01014016,1511,1487,24,13,5,5,1
2021,Herefordshire 004B,E01014017,1440,1428,12,4,6,1,1
2021,Herefordshire 020A,E01014018,1488,1470,18,10,4,4,0
2021,Herefordshire 020B,E01014019,1486,1479,7,4,1,1,1
2021,Herefordshire 020C,E01014020,1562,1549,13,5,3,5,0
2021,Herefordshire 020D,E01014021,1392,1387,5,3,2,0,0
2021,Herefordshire 008A,E01014022,2273,2222,51,28,12,8,3
2021,Herefordshire 008B,E01014023,1902,1846,56,28,19,9,0
2021,Herefordshire 004C,E01014024,1250,1241,9,7,2,0,0
2021,Herefordshire 004D,E01014025,1478,1449,29,15,8,6,0
2021,Herefordshire 021A,E01014026,2012,1987,25,13,10,2,0
2021,Herefordshire 009A,E01014027,1400,1300,100,14,71,14,1
2021,Herefordshire 009B,E01014028,1466,1405,61,26,17,13,5
2021,Herefordshire 009C,E01014029,1460,1437,23,10,11,2,0
2021,Herefordshire 009D,E01014030,1381,1366,15,14,0,0,1
2021,Herefordshire 023A,E01014031,1558,1531,27,10,13,4,0
2021,Herefordshire 023B,E01014032,1482,1450,32,12,15,5,0
2021,Herefordshire 006C,E01014033,1727,1671,56,16,28,10,2
2021,Herefordshire 006D,E01014034,1393,1304,89,38,36,14,1
2021,Herefordshire 019A,E01014035,1676,1542,134,50,70,13,1
2021,Herefordshire 019B,E01014036,1645,1601,44,15,18,10,1
2021,Herefordshire 019C,E01014037,1409,1358,51,15,29,7,0
2021,Herefordshire 019D,E01014038,1364,1303,61,26,26,9,0
2021,Herefordshire 019E,E01014039,1617,1541,76,28,37,10,1
2021,Herefordshire 019F,E01014040,1530,1487,43,13,26,4,0
2021,Herefordshire 002A,E01014041,1439,1381,58,21,23,13,1
2021,Herefordshire 002B,E01014042,1528,1411,117,32,52,26,7
2021,Herefordshire 002C,E01014043,1019,982,37,13,13,6,5
2021,Herefordshire 002D,E01014044,1476,1409,67,21,26,15,5
2021,Herefordshire 003A,E01014045,1595,1514,81,26,41,9,5
2021,Herefordshire 003B,E01014046,1502,1446,56,23,23,9,1
2021,Herefordshire 003C,E01014047,1400,1320,80,36,31,11,2
2021,Herefordshire 003D,E01014048,1601,1405,196,66,81,44,5
2021,Herefordshire 023C,E01014049,1535,1505,30,14,9,6,1
2021,Herefordshire 023D,E01014050,1775,1753,22,14,8,0,0
2021,Herefordshire 001B,E01014051,1792,1747,45,17,18,8,2
2021,Herefordshire 001C,E01014052,1463,1450,13,10,3,0,0
2021,Herefordshire 023E,E01014053,1746,1714,32,16,10,6,0
2021,Herefordshire 018D,E01014054,1295,1276,19,13,4,2,0
2021,Herefordshire 004E,E01014055,1652,1626,26,17,7,2,0
2021,Herefordshire 006E,E01014056,1454,1430,24,10,6,7,1
2021,Herefordshire 023F,E01014057,1840,1809,31,16,13,2,0
2021,Herefordshire 023G,E01014058,1612,1597,15,11,3,1,0
2021,Herefordshire 021B,E01014059,1875,1846,29,15,7,7,0
2021,Herefordshire 021C,E01014060,1543,1516,27,16,10,0,1
2021,Herefordshire 022A,E01014061,1803,1765,38,16,21,1,0
2021,Herefordshire 022B,E01014062,1717,1474,243,56,111,70,6
2021,Herefordshire 022C,E01014063,1713,1680,33,15,12,6,0
2021,Herefordshire 022D,E01014064,1519,1387,132,34,68,28,2
2021,Herefordshire 022E,E01014065,1446,1338,108,41,49,16,2
2021,Herefordshire 022F,E01014066,1184,1135,49,12,19,18,0
2021,Herefordshire 022G,E01014067,1338,1312,26,14,4,8,0
2021,Herefordshire 015A,E01014068,1383,1289,94,33,42,13,6
2021,Herefordshire 021D,E01014069,1725,1594,131,53,53,21,4
2021,Herefordshire 015B,E01014070,2239,2098,141,64,55,16,6
2021,Herefordshire 017E,E01014071,1401,1267,134,45,54,25,10
2021,Herefordshire 015C,E01014072,1879,1728,151,55,71,22,3
2021,Herefordshire 015D,E01014073,1812,1634,178,82,70,21,5
2021,Herefordshire 015E,E01014074,1435,1248,187,58,94,28,7
2021,Herefordshire 013A,E01014075,1731,1627,104,40,35,28,1
2021,Herefordshire 013B,E01014076,2049,1768,281,91,112,57,21
2021,Herefordshire 013C,E01014077,1517,1463,54,25,19,10,0
2021,Herefordshire 013D,E01014078,1369,1234,135,49,52,27,7
2021,Herefordshire 016C,E01014079,1589,1562,27,17,2,5,3
2021,Herefordshire 016D,E01014080,1473,1452,21,9,9,3,0
2021,Herefordshire 008C,E01014081,1450,1439,11,8,3,0,0
2021,Herefordshire 008D,E01014082,1759,1640,119,30,47,32,10
2021,Herefordshire 010A,E01014083,1526,1469,57,26,19,10,2
2021,Herefordshire 010B,E01014084,1547,1367,180,42,80,55,3
2021,Herefordshire 010C,E01014085,1588,1456,132,42,56,28,6
2021,Herefordshire 012E,E01014086,1421,1165,256,78,96,69,13
2021,Herefordshire 010D,E01014087,1388,1227,161,58,74,28,1
2021,Herefordshire 010E,E01014088,1303,1179,124,37,57,28,2
2021,Herefordshire 010F,E01014089,1354,1278,76,31,26,17,2
2021,Herefordshire 014A,E01014090,1426,1379,47,29,12,6,0
2021,Herefordshire 014B,E01014091,1493,1458,35,19,11,5,0
2021,Herefordshire 012F,E01014092,1776,1642,134,69,41,22,2
2021,Herefordshire 014C,E01014093,1340,1303,37,22,11,4,0
2021,Herefordshire 014D,E01014094,1394,1320,74,27,29,17,1
2021,Herefordshire 011D,E01014095,1354,1242,112,44,41,25,2
2021,Herefordshire 001D,E01014096,1510,1494,16,11,2,2,1
2021,Herefordshire 004F,E01014097,1260,1248,12,8,4,0,0
2021,Herefordshire 021E,E01014098,1618,1585,33,14,12,6,1
2021,Herefordshire 021F,E01014099,1788,1760,28,14,9,4,1
2021,Herefordshire 007E,E01014100,1734,1711,23,12,4,5,2
2021,Herefordshire 007F,E01014101,995,966,29,13,12,3,1
2021,Telford and Wrekin 007A,E01014102,1867,1764,103,41,31,25,6
2021,Telford and Wrekin 007B,E01014103,1149,1052,97,41,32,19,5
2021,Telford and Wrekin 011A,E01014104,1685,1455,230,69,99,54,8
2021,Telford and Wrekin 011B,E01014105,2241,1930,311,78,140,82,11
2021,Telford and Wrekin 020A,E01014106,1434,1336,98,33,39,24,2
2021,Telford and Wrekin 020B,E01014107,1111,1088,23,13,5,4,1
2021,Telford and Wrekin 020C,E01014108,1403,1188,215,72,95,39,9
2021,Telford and Wrekin 020D,E01014109,1213,1145,68,27,30,10,1
2021,Telford and Wrekin 020E,E01014110,1677,1551,126,47,50,21,8
2021,Telford and Wrekin 004A,E01014111,1543,1521,22,15,4,3,0
2021,Telford and Wrekin 002A,E01014112,1764,1733,31,14,10,5,2
2021,Telford and Wrekin 011C,E01014113,1730,1315,415,126,158,108,23
2021,Telford and Wrekin 011D,E01014114,1391,1297,94,35,28,29,2
2021,Telford and Wrekin 023A,E01014115,1446,1334,112,36,47,27,2
2021,Telford and Wrekin 023B,E01014116,1688,1554,134,43,58,26,7
2021,Telford and Wrekin 023C,E01014117,1166,1114,52,28,19,5,0
2021,Telford and Wrekin 023D,E01014118,1344,1252,92,26,43,23,0
2021,Telford and Wrekin 019A,E01014119,1510,1484,26,11,8,7,0
2021,Telford and Wrekin 019B,E01014120,1693,1629,64,27,28,9,0
2021,Telford and Wrekin 019C,E01014121,1268,1258,10,6,4,0,0
2021,Telford and Wrekin 019D,E01014122,1471,1388,83,36,33,14,0
2021,Telford and Wrekin 019E,E01014123,1374,1353,21,11,5,5,0
2021,Telford and Wrekin 017A,E01014124,1490,1401,89,41,39,6,3
2021,Telford and Wrekin 005A,E01014125,1388,1251,137,46,71,17,3
2021,Telford and Wrekin 005B,E01014126,1470,1280,190,60,99,24,7
2021,Telford and Wrekin 005C,E01014127,1669,1494,175,70,63,36,6
2021,Telford and Wrekin 005D,E01014128,2322,2188,134,59,45,28,2
2021,Telford and Wrekin 006A,E01014129,1065,993,72,34,28,8,2
2021,Telford and Wrekin 006B,E01014130,1445,1370,75,36,31,7,1
2021,Telford and Wrekin 002B,E01014131,2502,2415,87,34,44,9,0
2021,Telford and Wrekin 002C,E01014132,1052,1043,9,8,1,0,0
2021,Telford and Wrekin 012A,E01014133,2108,2003,105,28,46,28,3
2021,Telford and Wrekin 012B,E01014134,1521,1503,18,7,5,5,1
2021,Telford and Wrekin 002D,E01014135,1224,1206,18,8,9,1,0
2021,Telford and Wrekin 010A,E01014136,1771,1755,16,7,7,1,1
2021,Telford and Wrekin 009A,E01014137,2029,1888,141,46,59,34,2
2021,Telford and Wrekin 007C,E01014138,1622,1523,99,41,35,20,3
2021,Telford and Wrekin 009B,E01014139,1356,1102,254,78,95,73,8
2021,Telford and Wrekin 007D,E01014140,1357,1126,231,65,103,57,6
2021,Telford and Wrekin 009D,E01014142,1320,1020,300,111,111,70,8
2021,Telford and Wrekin 009E,E01014143,1601,1282,319,97,130,77,15
2021,Telford and Wrekin 012C,E01014144,1766,1606,160,61,65,31,3
2021,Telford and Wrekin 012D,E01014145,1934,1658,276,119,106,42,9
2021,Telford and Wrekin 010B,E01014148,1454,1444,10,7,2,1,0
2021,Telford and Wrekin 010C,E01014149,1103,1097,6,4,1,0,1
2021,Telford and Wrekin 014A,E01014150,1553,1516,37,16,15,4,2
2021,Telford and Wrekin 014B,E01014151,1366,1298,68,31,28,9,0
2021,Telford and Wrekin 014C,E01014152,1847,1734,113,52,43,12,6
2021,Telford and Wrekin 014D,E01014153,1865,1777,88,29,42,12,5
2021,Telford and Wrekin 014E,E01014154,1666,1591,75,34,28,12,1
2021,Telford and Wrekin 014F,E01014155,1839,1712,127,53,43,23,8
2021,Telford and Wrekin 024C,E01014157,1349,1280,69,20,36,9,4
2021,Telford and Wrekin 024E,E01014158,1844,1748,96,36,42,12,6
2021,Telford and Wrekin 022A,E01014159,1211,1193,18,8,7,2,1
2021,Telford and Wrekin 022B,E01014160,1195,1168,27,13,12,2,0
2021,Telford and Wrekin 022C,E01014161,1033,1019,14,6,6,1,1
2021,Telford and Wrekin 022D,E01014162,1759,1686,73,26,29,14,4
2021,Telford and Wrekin 017B,E01014163,1996,1805,191,93,66,29,3
2021,Telford and Wrekin 017C,E01014164,1625,1544,81,26,37,14,4
2021,Telford and Wrekin 017D,E01014165,1438,1247,191,78,85,26,2
2021,Telford and Wrekin 017E,E01014166,1473,1393,80,25,43,9,3
2021,Telford and Wrekin 004B,E01014167,2123,2029,94,38,38,16,2
2021,Telford and Wrekin 004C,E01014168,1318,1257,61,28,23,8,2
2021,Telford and Wrekin 005E,E01014169,1790,1631,159,56,65,32,6
2021,Telford and Wrekin 004D,E01014170,1439,1384,55,14,26,12,3
2021,Telford and Wrekin 001A,E01014171,1389,1359,30,21,8,1,0
2021,Telford and Wrekin 001B,E01014172,1308,1283,25,16,8,1,0
2021,Telford and Wrekin 001C,E01014173,1674,1642,32,18,10,4,0
2021,Telford and Wrekin 001D,E01014174,1567,1544,23,16,7,0,0
2021,Telford and Wrekin 003A,E01014175,1541,1515,26,20,4,2,0
2021,Telford and Wrekin 003B,E01014176,1504,1480,24,15,6,3,0
2021,Telford and Wrekin 003C,E01014177,2027,1954,73,45,22,4,2
2021,Telford and Wrekin 003D,E01014178,1727,1633,94,44,31,16,3
2021,Telford and Wrekin 006C,E01014179,1149,1111,38,6,20,9,3
2021,Telford and Wrekin 006D,E01014180,1283,1208,75,29,35,11,0
2021,Telford and Wrekin 015A,E01014181,2240,2034,206,111,63,25,7
2021,Telford and Wrekin 015B,E01014182,1406,1330,76,41,24,6,5
2021,Telford and Wrekin 015C,E01014183,1966,1892,74,36,19,19,0
2021,Telford and Wrekin 015D,E01014184,2147,2085,62,26,20,10,6
2021,Telford and Wrekin 013A,E01014185,1609,1555,54,21,21,11,1
2021,Telford and Wrekin 013B,E01014186,1335,1299,36,12,18,5,1
2021,Telford and Wrekin 013C,E01014187,1416,1356,60,22,26,11,1
2021,Telford and Wrekin 013D,E01014188,1339,1308,31,14,10,7,0
2021,Telford and Wrekin 006E,E01014189,1366,1304,62,24,24,9,5
2021,Telford and Wrekin 006F,E01014190,1488,1456,32,17,10,5,0
2021,Telford and Wrekin 018A,E01014191,1664,1225,439,218,163,54,4
2021,Telford and Wrekin 018B,E01014192,1456,1265,191,90,62,34,5
2021,Telford and Wrekin 018C,E01014193,1623,1487,136,46,65,21,4
2021,Telford and Wrekin 018D,E01014194,1554,1426,128,55,47,24,2
2021,Telford and Wrekin 018E,E01014195,1376,1335,41,24,13,4,0
2021,Telford and Wrekin 018F,E01014196,1469,1333,136,61,54,15,6
2021,Telford and Wrekin 021A,E01014197,1845,1739,106,45,43,13,5
2021,Telford and Wrekin 021B,E01014198,1362,1278,84,27,36,18,3
2021,Telford and Wrekin 021C,E01014199,1576,1503,73,26,36,10,1
2021,Telford and Wrekin 021D,E01014200,1289,1221,68,23,34,8,3
2021,Telford and Wrekin 021E,E01014201,1173,1087,86,31,41,12,2
2021,Telford and Wrekin 010D,E01014202,2659,2578,81,34,22,24,1
2021,Telford and Wrekin 010E,E01014203,1574,1543,31,17,8,5,1
2021,Telford and Wrekin 010F,E01014204,1920,1888,32,24,7,1,0
2021,Telford and Wrekin 008A,E01014205,1294,1224,70,24,29,16,1
2021,Telford and Wrekin 008B,E01014206,1247,1088,159,46,84,29,0
2021,Telford and Wrekin 008C,E01014207,1252,1095,157,53,70,28,6
2021,Telford and Wrekin 008D,E01014208,1307,1215,92,47,26,13,6
2021,Telford and Wrekin 008E,E01014209,1437,1317,120,45,46,26,3
2021,Stoke-on-Trent 012A,E01014210,1500,1453,47,18,24,5,0
2021,Stoke-on-Trent 012B,E01014211,1534,1484,50,17,23,9,1
2021,Stoke-on-Trent 012C,E01014212,1872,1778,94,45,29,20,0
2021,Stoke-on-Trent 012D,E01014213,1258,1154,104,41,49,11,3
2021,Stoke-on-Trent 007A,E01014214,1456,1444,12,4,4,3,1
2021,Stoke-on-Trent 007B,E01014215,1445,1424,21,11,7,3,0
2021,Stoke-on-Trent 007C,E01014216,1318,1305,13,5,8,0,0
2021,Stoke-on-Trent 012E,E01014217,1400,1337,63,24,25,13,1
2021,Stoke-on-Trent 014A,E01014218,1596,1485,111,46,43,19,3
2021,Stoke-on-Trent 014B,E01014219,1238,1199,39,21,16,2,0
2021,Stoke-on-Trent 017A,E01014220,1653,1520,133,57,59,17,0
2021,Stoke-on-Trent 017B,E01014221,1573,1438,135,53,60,20,2
2021,Stoke-on-Trent 017C,E01014222,1487,1309,178,56,86,32,4
2021,Stoke-on-Trent 017D,E01014223,1696,1525,171,59,83,25,4
2021,Stoke-on-Trent 017E,E01014224,1640,1460,180,74,78,25,3
2021,Stoke-on-Trent 014C,E01014225,1456,1418,38,14,18,5,1
2021,Stoke-on-Trent 014D,E01014226,1399,1354,45,17,16,11,1
2021,Stoke-on-Trent 014E,E01014228,1191,1168,23,12,11,0,0
2021,Stoke-on-Trent 017F,E01014229,1935,1837,98,48,41,9,0
2021,Stoke-on-Trent 014F,E01014230,1498,1390,108,37,52,17,2
2021,Stoke-on-Trent 026A,E01014233,1362,1333,29,9,13,7,0
2021,Stoke-on-Trent 026B,E01014234,1509,1430,79,29,35,14,1
2021,Stoke-on-Trent 032A,E01014235,1581,1521,60,26,32,2,0
2021,Stoke-on-Trent 032C,E01014237,1605,1510,95,37,39,17,2
2021,Stoke-on-Trent 032D,E01014238,1567,1500,67,31,27,8,1
2021,Stoke-on-Trent 026C,E01014239,1438,1388,50,16,19,11,4
2021,Stoke-on-Trent 026D,E01014240,1487,1427,60,17,37,5,1
2021,Stoke-on-Trent 006A,E01014241,1528,1466,62,22,26,12,2
2021,Stoke-on-Trent 006B,E01014242,1491,1421,70,30,23,14,3
2021,Stoke-on-Trent 006C,E01014243,1389,1325,64,20,30,13,1
2021,Stoke-on-Trent 006D,E01014244,1616,1439,177,71,70,31,5
2021,Stoke-on-Trent 006E,E01014245,1608,1480,128,50,46,30,2
2021,Stoke-on-Trent 008A,E01014246,1556,1457,99,38,39,20,2
2021,Stoke-on-Trent 009A,E01014247,1536,1324,212,69,85,49,9
2021,Stoke-on-Trent 006F,E01014248,1310,1167,143,45,72,21,5
2021,Stoke-on-Trent 011A,E01014249,1695,1263,432,116,185,110,21
2021,Stoke-on-Trent 009B,E01014250,1227,1042,185,62,66,53,4
2021,Stoke-on-Trent 009D,E01014252,1521,1318,203,70,88,40,5
2021,Stoke-on-Trent 011B,E01014253,1542,1383,159,57,58,37,7
2021,Stoke-on-Trent 011C,E01014254,1803,1195,608,163,281,140,24
2021,Stoke-on-Trent 009E,E01014255,1884,1396,488,155,201,109,23
2021,Stoke-on-Trent 011D,E01014256,1928,1463,465,152,191,103,19
2021,Stoke-on-Trent 001A,E01014257,1443,1390,53,24,18,9,2
2021,Stoke-on-Trent 001B,E01014258,1468,1448,20,6,9,4,1
2021,Stoke-on-Trent 001C,E01014259,1509,1480,29,15,11,1,2
2021,Stoke-on-Trent 001D,E01014260,1317,1261,56,32,14,7,3
2021,Stoke-on-Trent 003A,E01014261,1528,1443,85,32,37,14,2
2021,Stoke-on-Trent 003B,E01014262,1289,1231,58,31,18,7,2
2021,Stoke-on-Trent 003C,E01014263,1618,1539,79,24,42,9,4
2021,Stoke-on-Trent 001E,E01014264,1872,1847,25,10,11,2,2
2021,Stoke-on-Trent 007D,E01014265,1448,1411,37,20,10,7,0
2021,Stoke-on-Trent 008B,E01014266,1192,1107,85,25,47,12,1
2021,Stoke-on-Trent 007E,E01014267,2251,2168,83,39,24,20,0
2021,Stoke-on-Trent 008C,E01014268,2464,2368,96,43,35,16,2
2021,Stoke-on-Trent 010A,E01014269,1602,1328,274,119,105,43,7
2021,Stoke-on-Trent 008D,E01014270,1481,1438,43,14,24,5,0
2021,Stoke-on-Trent 008E,E01014271,1478,1377,101,47,33,18,3
2021,Stoke-on-Trent 007F,E01014272,1388,1368,20,8,5,5,2
2021,Stoke-on-Trent 035A,E01014273,1203,998,205,56,90,41,18
2021,Stoke-on-Trent 020A,E01014274,1693,1565,128,52,55,20,1
2021,Stoke-on-Trent 020B,E01014275,1378,1250,128,39,66,16,7
2021,Stoke-on-Trent 020C,E01014276,1449,1306,143,63,66,14,0
2021,Stoke-on-Trent 020D,E01014277,1386,1328,58,16,31,8,3
2021,Stoke-on-Trent 035C,E01014278,1158,1099,59,16,27,13,3
2021,Stoke-on-Trent 020E,E01014279,1695,1550,145,44,65,32,4
2021,Stoke-on-Trent 035B,E01014280,1171,1160,11,6,3,2,0
2021,Stoke-on-Trent 015A,E01014281,2023,1460,563,162,237,143,21
2021,Stoke-on-Trent 016D,E01014282,1549,1354,195,63,89,35,8
2021,Stoke-on-Trent 016E,E01014283,1924,1385,539,210,202,112,15
2021,Stoke-on-Trent 016F,E01014284,1334,1023,311,113,135,53,10
2021,Stoke-on-Trent 015B,E01014285,2285,1705,580,245,204,116,15
2021,Stoke-on-Trent 015C,E01014286,1630,1121,509,151,192,141,25
2021,Stoke-on-Trent 015D,E01014287,2022,1519,503,165,217,105,16
2021,Stoke-on-Trent 018A,E01014288,1501,1333,168,77,75,14,2
2021,Stoke-on-Trent 018B,E01014289,1473,1355,118,62,37,19,0
2021,Stoke-on-Trent 018C,E01014290,1417,1202,215,97,76,35,7
2021,Stoke-on-Trent 018D,E01014291,1971,1653,318,177,104,35,2
2021,Stoke-on-Trent 018E,E01014292,1460,1344,116,43,53,12,8
2021,Stoke-on-Trent 019A,E01014293,1521,1286,235,91,88,47,9
2021,Stoke-on-Trent 018F,E01014294,1355,1177,178,112,46,18,2
2021,Stoke-on-Trent 019B,E01014295,1617,1509,108,42,45,20,1
2021,Stoke-on-Trent 035H,E01014296,1327,1282,45,16,19,5,5
2021,Stoke-on-Trent 035D,E01014297,1109,1094,15,6,5,4,0
2021,Stoke-on-Trent 035G,E01014298,1489,1427,62,24,25,12,1
2021,Stoke-on-Trent 025A,E01014299,1303,1286,17,1,8,7,1
2021,Stoke-on-Trent 035F,E01014300,1383,1321,62,27,21,11,3
2021,Stoke-on-Trent 025B,E01014301,1597,1578,19,7,9,2,1
2021,Stoke-on-Trent 035E,E01014302,1763,1648,115,29,53,29,4
2021,Stoke-on-Trent 025C,E01014303,1369,1352,17,5,9,3,0
2021,Stoke-on-Trent 025D,E01014304,1406,1378,28,7,14,4,3
2021,Stoke-on-Trent 029A,E01014305,1528,1151,377,87,182,89,19
2021,Stoke-on-Trent 029B,E01014306,1433,1156,277,70,97,97,13
2021,Stoke-on-Trent 029C,E01014307,1470,1065,405,128,145,115,17
2021,Stoke-on-Trent 027A,E01014308,1506,1471,35,23,8,4,0
2021,Stoke-on-Trent 027B,E01014309,1196,1093,103,37,36,27,3
2021,Stoke-on-Trent 031A,E01014310,2042,1906,136,50,54,29,3
2021,Stoke-on-Trent 027C,E01014311,1262,1208,54,22,19,12,1
2021,Stoke-on-Trent 029D,E01014312,1365,1253,112,39,34,30,9
2021,Stoke-on-Trent 027D,E01014313,1467,1413,54,28,20,4,2
2021,Stoke-on-Trent 031B,E01014314,1368,1324,44,13,19,10,2
2021,Stoke-on-Trent 033A,E01014315,1248,1227,21,14,5,2,0
2021,Stoke-on-Trent 031C,E01014316,1649,1583,66,17,37,9,3
2021,Stoke-on-Trent 031D,E01014317,1562,1491,71,24,32,14,1
2021,Stoke-on-Trent 033B,E01014318,1329,1324,5,5,0,0,0
2021,Stoke-on-Trent 033C,E01014319,1392,1365,27,13,9,5,0
2021,Stoke-on-Trent 033D,E01014320,1205,1189,16,8,6,2,0
2021,Stoke-on-Trent 028A,E01014321,1304,1265,39,10,19,10,0
2021,Stoke-on-Trent 031E,E01014322,1656,1508,148,22,63,52,11
2021,Stoke-on-Trent 013A,E01014323,1243,1107,136,38,59,30,9
2021,Stoke-on-Trent 010B,E01014324,1383,1328,55,21,25,7,2
2021,Stoke-on-Trent 010C,E01014325,1251,1236,15,4,5,6,0
2021,Stoke-on-Trent 010D,E01014326,1337,1326,11,1,7,2,1
2021,Stoke-on-Trent 013B,E01014327,1369,1267,102,37,54,9,2
2021,Stoke-on-Trent 013C,E01014328,1431,1218,213,63,104,41,5
2021,Stoke-on-Trent 013D,E01014329,1508,1360,148,55,57,36,0
2021,Stoke-on-Trent 013E,E01014330,1279,970,309,84,148,69,8
2021,Stoke-on-Trent 004A,E01014331,1508,1397,111,44,48,16,3
2021,Stoke-on-Trent 004B,E01014332,1570,1541,29,15,10,3,1
2021,Stoke-on-Trent 003D,E01014333,1358,1336,22,11,5,4,2
2021,Stoke-on-Trent 003E,E01014334,1307,1274,33,9,16,8,0
2021,Stoke-on-Trent 004C,E01014335,1676,1650,26,9,12,4,1
2021,Stoke-on-Trent 004D,E01014336,1589,1488,101,43,52,5,1
2021,Stoke-on-Trent 004E,E01014337,1647,1616,31,10,17,3,1
2021,Stoke-on-Trent 023A,E01014338,1375,1248,127,58,48,19,2
2021,Stoke-on-Trent 019C,E01014339,1807,1486,321,107,157,52,5
2021,Stoke-on-Trent 019D,E01014340,2070,1792,278,119,119,36,4
2021,Stoke-on-Trent 023B,E01014341,1737,1539,198,116,62,18,2
2021,Stoke-on-Trent 023C,E01014342,1502,1385,117,50,43,19,5
2021,Stoke-on-Trent 023D,E01014343,1721,1554,167,70,66,21,10
2021,Stoke-on-Trent 023E,E01014344,1513,1321,192,84,81,23,4
2021,Stoke-on-Trent 019E,E01014345,2073,1692,381,155,146,68,12
2021,Stoke-on-Trent 030A,E01014346,1498,1460,38,23,12,2,1
2021,Stoke-on-Trent 034A,E01014347,1317,1287,30,26,3,0,1
2021,Stoke-on-Trent 030B,E01014348,1403,1381,22,10,6,4,2
2021,Stoke-on-Trent 030C,E01014349,1343,1319,24,10,9,4,1
2021,Stoke-on-Trent 034B,E01014350,1291,1260,31,16,13,1,1
2021,Stoke-on-Trent 034C,E01014351,1409,1379,30,19,9,1,1
2021,Stoke-on-Trent 034D,E01014352,1325,1290,35,26,7,2,0
2021,Stoke-on-Trent 030D,E01014353,1632,1501,131,73,43,11,4
2021,Stoke-on-Trent 005A,E01014354,1712,1458,254,64,110,68,12
2021,Stoke-on-Trent 005B,E01014355,1949,1612,337,91,150,83,13
2021,Stoke-on-Trent 005C,E01014356,1749,1423,326,87,139,88,12
2021,Stoke-on-Trent 002A,E01014357,1491,1441,50,24,18,8,0
2021,Stoke-on-Trent 002B,E01014358,1277,1197,80,35,30,15,0
2021,Stoke-on-Trent 002C,E01014359,1807,1622,185,70,76,32,7
2021,Stoke-on-Trent 002D,E01014360,2685,2578,107,50,50,6,1
2021,Stoke-on-Trent 005D,E01014361,1688,1328,360,92,148,109,11
2021,Stoke-on-Trent 025E,E01014362,1252,1247,5,4,1,0,0
2021,Stoke-on-Trent 024A,E01014363,1275,1255,20,9,7,4,0
2021,Stoke-on-Trent 024B,E01014364,1491,1443,48,21,16,11,0
2021,Stoke-on-Trent 024C,E01014365,1436,1412,24,10,8,5,1
2021,Stoke-on-Trent 028B,E01014366,1797,1695,102,49,30,19,4
2021,Stoke-on-Trent 028C,E01014367,1721,1623,98,45,41,10,2
2021,Stoke-on-Trent 028D,E01014368,1681,1561,120,57,48,14,1
2021,Stoke-on-Trent 024D,E01014369,1756,1705,51,27,21,3,0
2021,Bath and North East Somerset 007A,E01014370,1795,1512,283,164,86,29,4
2021,Bath and North East Somerset 007B,E01014371,1937,1649,288,181,88,16,3
2021,Bath and North East Somerset 007C,E01014372,1849,1648,201,136,61,4,0
2021,Bath and North East Somerset 010A,E01014373,1565,1508,57,37,17,3,0
2021,Bath and North East Somerset 010B,E01014374,1517,1474,43,29,8,5,1
2021,Bath and North East Somerset 010C,E01014375,1267,1252,15,14,1,0,0
2021,Bath and North East Somerset 010D,E01014376,1563,1540,23,15,5,3,0
2021,Bath and North East Somerset 010E,E01014377,1444,1417,27,19,5,3,0
2021,Bath and North East Somerset 012A,E01014380,4189,3823,366,295,66,4,1
2021,Bath and North East Somerset 012B,E01014381,1470,1341,129,91,32,6,0
2021,Bath and North East Somerset 021A,E01014382,2445,2428,17,7,7,3,0
2021,Bath and North East Somerset 021B,E01014383,1113,1104,9,7,2,0,0
2021,Bath and North East Somerset 021C,E01014384,1575,1558,17,8,7,2,0
2021,Bath and North East Somerset 020A,E01014385,1422,1409,13,13,0,0,0
2021,Bath and North East Somerset 020B,E01014386,1171,1158,13,7,6,0,0
2021,Bath and North East Somerset 018A,E01014387,1614,1506,108,67,36,5,0
2021,Bath and North East Somerset 018B,E01014388,1271,1242,29,19,7,2,1
2021,Bath and North East Somerset 018C,E01014389,1880,1783,97,63,18,14,2
2021,Bath and North East Somerset 018D,E01014390,1336,1219,117,68,34,11,4
2021,Bath and North East Somerset 016A,E01014391,1657,1633,24,14,9,1,0
2021,Bath and North East Somerset 016B,E01014392,1079,1046,33,17,13,3,0
2021,Bath and North East Somerset 023A,E01014393,1314,1300,14,7,4,3,0
2021,Bath and North East Somerset 023B,E01014394,1696,1684,12,6,4,2,0
2021,Bath and North East Somerset 003A,E01014395,1253,1239,14,10,4,0,0
2021,Bath and North East Somerset 003B,E01014396,1480,1414,66,28,29,9,0
2021,Bath and North East Somerset 003C,E01014397,1289,1274,15,11,0,3,1
2021,Bath and North East Somerset 003D,E01014398,1608,1581,27,21,1,5,0
2021,Bath and North East Somerset 001A,E01014399,2363,2320,43,27,11,4,1
2021,Bath and North East Somerset 001B,E01014400,2530,2456,74,43,22,7,2
2021,Bath and North East Somerset 001C,E01014401,1643,1619,24,12,10,2,0
2021,Bath and North East Somerset 002B,E01014403,1740,1685,55,50,3,2,0
2021,Bath and North East Somerset 002C,E01014404,2002,1912,90,47,33,6,4
2021,Bath and North East Somerset 009A,E01014405,2074,2005,69,45,19,5,0
2021,Bath and North East Somerset 009C,E01014407,1657,1351,306,146,127,31,2
2021,Bath and North East Somerset 004A,E01014409,1562,1497,65,42,19,4,0
2021,Bath and North East Somerset 004B,E01014410,1735,1656,79,55,18,5,1
2021,Bath and North East Somerset 004C,E01014411,2125,2019,106,77,24,5,0
2021,Bath and North East Somerset 007D,E01014412,1308,1252,56,38,13,4,1
2021,Bath and North East Somerset 007E,E01014413,2426,2268,158,85,63,8,2
2021,Bath and North East Somerset 007F,E01014414,1498,1333,165,98,52,14,1
2021,Bath and North East Somerset 017A,E01014415,1907,1845,62,48,10,4,0
2021,Bath and North East Somerset 017B,E01014416,1714,1644,70,39,23,6,2
2021,Bath and North East Somerset 017C,E01014417,1799,1736,63,38,18,7,0
2021,Bath and North East Somerset 021D,E01014418,1444,1438,6,6,0,0,0
2021,Bath and North East Somerset 020C,E01014419,1468,1445,23,11,11,1,0
2021,Bath and North East Somerset 025A,E01014420,1433,1410,23,14,7,2,0
2021,Bath and North East Somerset 025B,E01014421,1480,1472,8,7,1,0,0
2021,Bath and North East Somerset 025C,E01014422,1660,1644,16,9,7,0,0
2021,Bath and North East Somerset 025D,E01014423,1462,1421,41,22,15,4,0
2021,Bath and North East Somerset 027A,E01014424,2117,2090,27,14,8,3,2
2021,Bath and North East Somerset 027B,E01014425,2286,2262,24,14,9,1,0
2021,Bath and North East Somerset 027C,E01014426,1411,1367,44,20,13,9,2
2021,Bath and North East Somerset 008A,E01014427,1231,1160,71,48,12,11,0
2021,Bath and North East Somerset 008B,E01014428,1299,1235,64,45,12,3,4
2021,Bath and North East Somerset 008C,E01014429,1526,1459,67,52,12,3,0
2021,Bath and North East Somerset 008D,E01014430,1549,1441,108,66,36,6,0
2021,Bath and North East Somerset 019A,E01014431,1186,1095,91,41,36,13,1
2021,Bath and North East Somerset 019B,E01014432,1350,1212,138,75,52,8,3
2021,Bath and North East Somerset 019C,E01014433,1306,1184,122,56,43,21,2
2021,Bath and North East Somerset 019D,E01014434,1882,1760,122,77,35,9,1
2021,Bath and North East Somerset 014A,E01014435,1677,1570,107,89,12,5,1
2021,Bath and North East Somerset 014B,E01014436,1549,1442,107,72,28,5,2
2021,Bath and North East Somerset 014C,E01014437,1391,1312,79,45,28,6,0
2021,Bath and North East Somerset 014D,E01014438,1229,1162,67,40,19,5,3
2021,Bath and North East Somerset 023C,E01014439,1772,1758,14,6,6,2,0
2021,Bath and North East Somerset 023D,E01014440,2474,2404,70,36,27,6,1
2021,Bath and North East Somerset 023E,E01014441,2010,1966,44,27,11,6,0
2021,Bath and North East Somerset 022B,E01014442,1614,1533,81,35,35,11,0
2021,Bath and North East Somerset 022C,E01014443,1570,1530,40,16,16,5,3
2021,Bath and North East Somerset 022D,E01014444,1623,1552,71,47,20,3,1
2021,Bath and North East Somerset 022E,E01014445,1652,1590,62,38,17,5,2
2021,Bath and North East Somerset 020D,E01014446,1169,1158,11,6,3,2,0
2021,Bath and North East Somerset 020E,E01014447,1915,1849,66,33,29,4,0
2021,Bath and North East Somerset 024A,E01014448,1410,1385,25,12,9,2,2
2021,Bath and North East Somerset 024B,E01014449,1420,1397,23,12,8,3,0
2021,Bath and North East Somerset 024C,E01014450,1406,1366,40,25,12,3,0
2021,Bath and North East Somerset 024D,E01014451,1680,1626,54,32,21,1,0
2021,Bath and North East Somerset 016C,E01014452,1388,1363,25,18,5,2,0
2021,Bath and North East Somerset 016D,E01014453,1327,1293,34,17,15,1,1
2021,Bath and North East Somerset 016E,E01014454,1338,1313,25,14,7,4,0
2021,Bath and North East Somerset 015A,E01014455,1304,1201,103,52,38,11,2
2021,Bath and North East Somerset 015B,E01014456,1461,1400,61,35,18,8,0
2021,Bath and North East Somerset 015C,E01014457,1374,1322,52,34,15,3,0
2021,Bath and North East Somerset 015D,E01014458,1326,1227,99,34,45,15,5
2021,Bath and North East Somerset 016F,E01014459,1463,1443,20,8,7,4,1
2021,Bath and North East Somerset 016G,E01014460,1102,1096,6,6,0,0,0
2021,Bath and North East Somerset 011A,E01014461,1141,1057,84,40,32,9,3
2021,Bath and North East Somerset 011B,E01014462,1441,1359,82,46,31,4,1
2021,Bath and North East Somerset 011C,E01014463,1555,1394,161,42,41,35,43
2021,Bath and North East Somerset 011D,E01014464,1414,1259,155,52,62,39,2
2021,Bath and North East Somerset 006A,E01014465,1484,1403,81,47,26,4,4
2021,Bath and North East Somerset 006B,E01014466,1252,1055,197,87,69,38,3
2021,Bath and North East Somerset 006C,E01014467,1514,1388,126,81,32,11,2
2021,Bath and North East Somerset 006D,E01014468,1445,1291,154,94,44,14,2
2021,Bath and North East Somerset 026A,E01014469,1340,1326,14,6,3,3,2
2021,Bath and North East Somerset 026B,E01014470,1649,1602,47,20,23,4,0
2021,Bath and North East Somerset 026C,E01014471,1529,1489,40,21,16,3,0
2021,Bath and North East Somerset 026D,E01014472,1817,1781,36,23,7,6,0
2021,Bath and North East Somerset 013A,E01014473,1751,1642,109,71,31,6,1
2021,Bath and North East Somerset 013B,E01014474,1257,1191,66,41,19,6,0
2021,Bath and North East Somerset 013D,E01014476,1496,1430,66,43,16,5,2
2021,Bath and North East Somerset 005A,E01014477,1437,1382,55,34,17,3,1
2021,Bath and North East Somerset 005B,E01014478,1161,1104,57,28,19,9,1
2021,Bath and North East Somerset 005C,E01014479,1384,1270,114,62,44,8,0
2021,Bath and North East Somerset 005D,E01014480,1428,1234,194,115,61,18,0
2021,Bath and North East Somerset 012C,E01014481,1362,1218,144,100,33,11,0
2021,Bath and North East Somerset 012D,E01014482,1279,1226,53,36,16,1,0
2021,Bath and North East Somerset 012E,E01014483,1445,1285,160,96,47,17,0
2021,Bath and North East Somerset 012F,E01014484,1859,1619,240,147,84,8,1
2021,Bristol 058A,E01014485,1886,1700,186,83,69,30,4
2021,Bristol 058C,E01014486,2615,2196,419,165,155,78,21
2021,Bristol 020A,E01014487,1942,1833,109,81,17,8,3
2021,Bristol 058B,E01014488,1964,1776,188,93,61,32,2
2021,Bristol 059A,E01014489,2500,2296,204,110,70,18,6
2021,Bristol 020B,E01014491,2023,1906,117,71,32,12,2
2021,Bristol 008A,E01014492,1603,1434,169,67,74,26,2
2021,Bristol 008B,E01014493,1540,1385,155,77,63,14,1
2021,Bristol 008C,E01014494,1518,1435,83,41,30,10,2
2021,Bristol 008D,E01014495,1694,1563,131,58,56,15,2
2021,Bristol 008E,E01014496,1882,1417,465,131,227,99,8
2021,Bristol 003A,E01014497,1668,1386,282,114,117,46,5
2021,Bristol 003B,E01014498,1605,1394,211,89,88,30,4
2021,Bristol 008F,E01014499,1632,1489,143,47,62,30,4
2021,Bristol 039A,E01014500,1795,1631,164,99,46,18,1
2021,Bristol 041A,E01014501,2072,1972,100,61,29,7,3
2021,Bristol 039B,E01014502,1984,1799,185,72,77,34,2
2021,Bristol 041B,E01014504,1547,1501,46,30,15,1,0
2021,Bristol 041C,E01014505,1747,1652,95,61,23,9,2
2021,Bristol 041D,E01014506,1580,1536,44,30,11,2,1
2021,Bristol 016A,E01014507,1819,1759,60,32,25,3,0
2021,Bristol 016B,E01014508,1634,1539,95,51,27,14,3
2021,Bristol 016C,E01014509,2504,2298,206,134,58,14,0
2021,Bristol 010A,E01014510,2046,1928,118,71,39,7,1
2021,Bristol 016D,E01014511,1389,1353,36,26,9,1,0
2021,Bristol 016E,E01014512,1492,1408,84,38,33,10,3
2021,Bristol 016F,E01014513,1615,1548,67,41,20,5,1
2021,Bristol 016G,E01014514,2336,2181,155,90,49,16,0
2021,Bristol 050A,E01014515,1500,1435,65,30,25,8,2
2021,Bristol 050B,E01014516,1411,1320,91,39,38,11,3
2021,Bristol 050C,E01014517,1307,1248,59,33,24,2,0
2021,Bristol 046A,E01014518,1727,1636,91,46,33,12,0
2021,Bristol 046B,E01014519,1341,1296,45,17,16,10,2
2021,Bristol 046C,E01014520,1595,1568,27,16,9,0,2
2021,Bristol 046D,E01014521,1348,1287,61,40,11,10,0
2021,Bristol 050D,E01014522,1795,1708,87,48,27,10,2
2021,Bristol 038A,E01014523,1599,1510,89,46,34,9,0
2021,Bristol 038B,E01014524,1548,1445,103,41,46,15,1
2021,Bristol 038C,E01014525,1600,1487,113,58,34,17,4
2021,Bristol 038D,E01014526,1525,1411,114,55,38,20,1
2021,Bristol 038E,E01014527,1337,1223,114,48,48,15,3
2021,Bristol 035A,E01014528,1504,1371,133,68,44,19,2
2021,Bristol 035B,E01014529,1416,1284,132,62,55,11,4
2021,Bristol 035C,E01014530,1424,1277,147,63,62,19,3
2021,Bristol 035D,E01014531,2032,1854,178,107,54,11,6
2021,Bristol 035E,E01014532,1418,1343,75,44,20,11,0
2021,Bristol 043A,E01014533,1549,1457,92,52,24,15,1
2021,Bristol 043B,E01014534,1599,1483,116,54,37,23,2
2021,Bristol 043C,E01014535,1929,1830,99,35,44,17,3
2021,Bristol 043D,E01014536,1564,1463,101,47,40,11,3
2021,Bristol 035F,E01014537,1762,1646,116,47,50,17,2
2021,Bristol 060A,E01014538,1788,1521,267,162,96,7,2
2021,Bristol 025A,E01014539,1844,1700,144,101,38,3,2
2021,Bristol 030A,E01014544,1112,1022,90,55,25,10,0
2021,Bristol 030B,E01014545,1849,1721,128,87,40,1,0
2021,Bristol 030C,E01014546,1519,1371,148,110,27,9,2
2021,Bristol 030D,E01014547,1631,1534,97,69,22,5,1
2021,Bristol 034A,E01014548,1631,1490,141,106,29,5,1
2021,Bristol 034B,E01014549,1151,1042,109,67,32,8,2
2021,Bristol 034C,E01014550,2181,2044,137,111,21,4,1
2021,Bristol 026A,E01014551,1787,1642,145,95,42,8,0
2021,Bristol 026B,E01014552,1825,1701,124,96,20,8,0
2021,Bristol 026C,E01014553,1884,1735,149,104,33,10,2
2021,Bristol 026D,E01014554,1753,1467,286,132,98,48,8
2021,Bristol 034D,E01014555,1870,1678,192,127,59,6,0
2021,Bristol 026E,E01014556,1749,1610,139,99,29,9,2
2021,Bristol 022A,E01014557,1653,1560,93,67,19,5,2
2021,Bristol 022B,E01014558,1792,1643,149,100,42,6,1
2021,Bristol 022C,E01014559,1900,1778,122,84,26,12,0
2021,Bristol 022D,E01014560,1631,1514,117,82,28,7,0
2021,Bristol 025C,E01014561,1640,1538,102,79,19,4,0
2021,Bristol 022E,E01014562,1679,1590,89,65,17,5,2
2021,Bristol 025D,E01014563,1766,1639,127,97,23,6,1
2021,Bristol 055A,E01014564,1845,1582,263,100,100,52,11
2021,Bristol 029A,E01014565,1694,1478,216,101,75,36,4
2021,Bristol 029B,E01014566,1628,1397,231,92,98,32,9
2021,Bristol 029C,E01014567,1858,1562,296,129,116,38,13
2021,Bristol 057A,E01014568,2471,1942,529,149,210,144,26
2021,Bristol 057B,E01014569,2171,1874,297,110,114,62,11
2021,Bristol 057C,E01014570,1905,1720,185,75,64,41,5
2021,Bristol 012A,E01014571,1676,1525,151,81,49,21,0
2021,Bristol 019A,E01014572,1983,1682,301,138,105,51,7
2021,Bristol 019B,E01014573,1956,1721,235,109,80,40,6
2021,Bristol 057D,E01014574,2206,1631,575,190,233,128,24
2021,Bristol 019C,E01014575,1555,1311,244,78,101,55,10
2021,Bristol 019D,E01014576,2149,1867,282,132,104,38,8
2021,Bristol 012B,E01014577,1606,1458,148,70,59,15,4
2021,Bristol 044A,E01014578,1787,1612,175,81,61,28,5
2021,Bristol 045A,E01014579,1501,1384,117,66,37,10,4
2021,Bristol 045B,E01014580,1512,1378,134,61,44,22,7
2021,Bristol 045C,E01014581,1565,1409,156,79,59,17,1
2021,Bristol 045D,E01014582,1367,1228,139,51,56,30,2
2021,Bristol 044B,E01014583,1730,1574,156,86,45,22,3
2021,Bristol 045E,E01014584,1469,1356,113,47,45,21,0
2021,Bristol 044C,E01014585,1930,1689,241,121,87,29,4
2021,Bristol 012C,E01014586,1502,1384,118,60,37,20,1
2021,Bristol 012D,E01014587,1711,1467,244,98,107,34,5
2021,Bristol 013A,E01014588,2272,2014,258,127,93,35,3
2021,Bristol 013B,E01014589,1573,1323,250,108,105,31,6
2021,Bristol 013C,E01014590,2286,1981,305,125,126,43,11
2021,Bristol 013D,E01014591,1885,1718,167,80,58,25,4
2021,Bristol 013E,E01014592,1683,1523,160,69,60,24,7
2021,Bristol 051A,E01014593,1473,1409,64,33,23,8,0
2021,Bristol 048A,E01014594,1604,1499,105,38,49,16,2
2021,Bristol 051B,E01014595,1339,1276,63,30,26,6,1
2021,Bristol 051C,E01014596,1582,1443,139,63,56,18,2
2021,Bristol 051D,E01014597,1331,1262,69,28,23,18,0
2021,Bristol 048B,E01014598,2133,1996,137,74,41,18,4
2021,Bristol 048C,E01014599,1268,1236,32,19,9,4,0
2021,Bristol 048D,E01014600,1452,1406,46,19,19,7,1
2021,Bristol 001A,E01014601,1796,1551,245,145,63,36,1
2021,Bristol 001B,E01014602,1869,1645,224,104,87,29,4
2021,Bristol 001C,E01014603,2501,2173,328,161,131,34,2
2021,Bristol 001E,E01014605,1756,1467,289,124,102,53,10
2021,Bristol 047A,E01014607,1600,1531,69,44,20,4,1
2021,Bristol 047B,E01014608,1731,1624,107,47,36,21,3
2021,Bristol 047C,E01014609,1777,1684,93,34,34,19,6
2021,Bristol 047D,E01014610,1506,1410,96,47,39,8,2
2021,Bristol 052A,E01014611,1347,1322,25,8,10,6,1
2021,Bristol 052B,E01014612,1469,1420,49,18,24,7,0
2021,Bristol 047E,E01014613,1511,1401,110,46,38,22,4
2021,Bristol 047F,E01014614,1349,1285,64,27,26,10,1
2021,Bristol 011A,E01014615,1530,1456,74,51,12,8,3
2021,Bristol 006A,E01014616,1517,1447,70,37,27,5,1
2021,Bristol 011B,E01014617,1363,1318,45,29,11,5,0
2021,Bristol 011C,E01014618,1571,1525,46,21,12,11,2
2021,Bristol 017A,E01014619,1426,1360,66,54,10,2,0
2021,Bristol 011D,E01014620,1578,1516,62,40,18,1,3
2021,Bristol 017B,E01014621,1516,1443,73,44,19,9,1
2021,Bristol 021A,E01014622,1685,1404,281,104,110,60,7
2021,Bristol 021B,E01014623,1715,1505,210,88,77,39,6
2021,Bristol 018A,E01014624,1683,1473,210,104,69,27,10
2021,Bristol 021C,E01014626,2585,2153,432,195,146,86,5
2021,Bristol 021D,E01014627,2118,1882,236,113,81,35,7
2021,Bristol 018D,E01014629,1530,1321,209,96,71,39,3
2021,Bristol 005A,E01014630,2154,1905,249,119,88,36,6
2021,Bristol 004A,E01014631,1194,1049,145,90,42,11,2
2021,Bristol 004B,E01014632,2125,1846,279,159,92,24,4
2021,Bristol 004C,E01014633,1797,1630,167,84,66,14,3
2021,Bristol 005B,E01014634,1796,1572,224,119,72,31,2
2021,Bristol 010B,E01014635,1925,1755,170,93,55,18,4
2021,Bristol 004D,E01014636,1494,1313,181,83,62,35,1
2021,Bristol 010C,E01014637,1611,1537,74,42,23,9,0
2021,Bristol 003C,E01014638,1738,1525,213,87,84,37,5
2021,Bristol 003D,E01014639,1510,1337,173,59,63,43,8
2021,Bristol 003E,E01014640,1603,1402,201,82,80,36,3
2021,Bristol 007A,E01014641,1475,1404,71,43,18,9,1
2021,Bristol 007B,E01014642,1471,1372,99,47,33,18,1
2021,Bristol 007C,E01014643,1412,1345,67,32,24,9,2
2021,Bristol 007D,E01014644,1637,1535,102,53,29,16,4
2021,Bristol 042A,E01014645,1593,1473,120,51,37,28,4
2021,Bristol 042B,E01014646,1715,1587,128,61,48,14,5
2021,Bristol 044D,E01014647,1726,1583,143,67,50,23,3
2021,Bristol 042C,E01014648,1632,1499,133,56,41,36,0
2021,Bristol 042D,E01014649,1702,1610,92,38,36,16,2
2021,Bristol 044E,E01014650,1646,1565,81,45,27,7,2
2021,Bristol 042E,E01014651,1685,1634,51,33,17,0,1
2021,Bristol 055B,E01014653,2623,2009,614,182,272,141,19
2021,Bristol 056A,E01014654,2427,1823,604,201,261,123,19
2021,Bristol 055C,E01014655,2485,1941,544,186,214,120,24
2021,Bristol 056B,E01014658,2349,1790,559,175,235,128,21
2021,Bristol 005C,E01014659,2138,1822,316,155,108,40,13
2021,Bristol 014A,E01014660,2145,1905,240,124,76,39,1
2021,Bristol 005D,E01014661,1721,1498,223,105,83,26,9
2021,Bristol 010D,E01014662,1640,1486,154,72,61,19,2
2021,Bristol 014B,E01014663,1523,1330,193,86,70,26,11
2021,Bristol 014C,E01014664,1662,1491,171,73,66,26,6
2021,Bristol 014D,E01014665,2128,1821,307,116,111,75,5
2021,Bristol 017C,E01014666,1890,1811,79,47,24,6,2
2021,Bristol 017D,E01014667,1673,1569,104,60,34,8,2
2021,Bristol 020C,E01014668,1566,1482,84,57,24,2,1
2021,Bristol 020D,E01014669,1552,1435,117,74,37,6,0
2021,Bristol 020E,E01014670,1493,1411,82,50,25,7,0
2021,Bristol 020F,E01014671,1683,1601,82,50,24,8,0
2021,Bristol 017E,E01014672,2073,1921,152,106,34,11,1
2021,Bristol 027A,E01014673,1795,1582,213,94,73,31,15
2021,Bristol 027B,E01014674,1627,1420,207,112,69,24,2
2021,Bristol 027C,E01014675,1696,1486,210,97,80,28,5
2021,Bristol 027D,E01014676,1517,1422,95,58,24,10,3
2021,Bristol 033A,E01014677,1509,1412,97,51,26,18,2
2021,Bristol 033B,E01014678,1629,1509,120,56,51,13,0
2021,Bristol 033C,E01014679,1547,1441,106,43,40,22,1
2021,Bristol 033D,E01014680,1260,1202,58,31,20,5,2
2021,Bristol 029D,E01014681,2421,2154,267,129,109,26,3
2021,Bristol 028A,E01014682,1656,1493,163,80,56,26,1
2021,Bristol 028B,E01014683,1825,1608,217,106,69,36,6
2021,Bristol 029E,E01014684,1857,1634,223,102,85,35,1
2021,Bristol 028C,E01014685,1625,1423,202,68,81,44,9
2021,Bristol 028D,E01014686,1840,1648,192,91,70,28,3
2021,Bristol 028E,E01014687,1531,1378,153,73,59,21,0
2021,Bristol 002A,E01014688,1824,1492,332,140,144,42,6
2021,Bristol 002B,E01014689,1594,1286,308,119,119,63,7
2021,Bristol 002C,E01014690,2183,1693,490,224,209,52,5
2021,Bristol 002D,E01014691,1967,1726,241,123,75,35,8
2021,Bristol 002E,E01014692,1699,1400,299,139,110,43,7
2021,Bristol 002F,E01014693,1356,1214,142,77,50,13,2
2021,Bristol 002G,E01014694,1670,1436,234,103,104,23,4
2021,Bristol 036A,E01014695,2030,1911,119,71,34,11,3
2021,Bristol 036B,E01014696,1792,1711,81,51,28,2,0
2021,Bristol 036C,E01014698,1901,1788,113,71,29,11,2
2021,Bristol 036D,E01014699,1602,1498,104,63,31,10,0
2021,Bristol 036E,E01014700,1624,1537,87,57,24,5,1
2021,Bristol 036F,E01014701,1824,1679,145,88,43,12,2
2021,Bristol 049A,E01014702,1442,1409,33,16,11,6,0
2021,Bristol 049B,E01014703,1431,1345,86,39,35,11,1
2021,Bristol 049C,E01014704,1793,1700,93,48,30,13,2
2021,Bristol 049D,E01014705,1334,1301,33,14,10,9,0
2021,Bristol 049E,E01014706,1326,1241,85,47,28,9,1
2021,Bristol 049F,E01014707,1577,1537,40,19,12,9,0
2021,Bristol 049G,E01014708,1837,1734,103,54,32,14,3
2021,Bristol 015A,E01014709,1254,1172,82,44,27,9,2
2021,Bristol 015B,E01014710,1565,1475,90,58,24,8,0
2021,Bristol 015C,E01014711,1289,1234,55,34,15,6,0
2021,Bristol 015D,E01014712,1242,1189,53,33,15,4,1
2021,Bristol 015E,E01014713,1284,1204,80,60,16,3,1
2021,Bristol 015F,E01014714,3430,3301,129,94,26,8,1
2021,Bristol 009A,E01014715,1642,1563,79,57,17,4,1
2021,Bristol 009B,E01014716,1525,1483,42,24,12,4,2
2021,Bristol 009C,E01014717,1656,1539,117,77,33,7,0
2021,Bristol 009D,E01014718,1491,1406,85,52,27,6,0
2021,Bristol 006B,E01014719,1399,1326,73,40,22,9,2
2021,Bristol 006C,E01014720,1582,1502,80,44,23,8,5
2021,Bristol 006D,E01014721,1615,1552,63,37,21,4,1
2021,Bristol 052C,E01014722,1499,1457,42,19,16,6,1
2021,Bristol 052D,E01014723,1336,1276,60,24,25,10,1
2021,Bristol 052E,E01014725,1430,1402,28,17,9,2,0
2021,Bristol 053B,E01014726,1650,1557,93,30,45,14,4
2021,Bristol 053C,E01014727,1493,1435,58,27,20,11,0
2021,Bristol 040A,E01014729,1772,1522,250,133,71,40,6
2021,Bristol 037A,E01014730,1626,1466,160,80,55,22,3
2021,Bristol 037B,E01014731,1558,1390,168,93,48,23,4
2021,Bristol 037C,E01014732,1677,1529,148,68,60,17,3
2021,Bristol 040B,E01014733,1737,1614,123,76,40,6,1
2021,Bristol 040C,E01014734,1623,1532,91,59,25,7,0
2021,Bristol 037D,E01014735,1740,1631,109,71,26,9,3
2021,Bristol 040D,E01014736,2124,1900,224,110,76,35,3
2021,North Somerset 011A,E01014737,1578,1547,31,23,2,6,0
2021,North Somerset 011B,E01014738,1472,1437,35,22,5,7,1
2021,North Somerset 011C,E01014739,1553,1521,32,21,9,2,0
2021,North Somerset 011D,E01014740,1450,1438,12,11,1,0,0
2021,North Somerset 024A,E01014741,1480,1458,22,9,5,7,1
2021,North Somerset 024B,E01014742,1488,1448,40,22,13,5,0
2021,North Somerset 023A,E01014744,1434,1423,11,5,3,2,1
2021,North Somerset 024C,E01014745,1689,1672,17,8,6,2,1
2021,North Somerset 023B,E01014746,1528,1496,32,14,13,4,1
2021,North Somerset 024D,E01014747,1415,1394,21,16,3,2,0
2021,North Somerset 024E,E01014748,1355,1331,24,9,11,4,0
2021,North Somerset 024F,E01014749,1405,1367,38,27,5,4,2
2021,North Somerset 007A,E01014750,1658,1600,58,23,26,7,2
2021,North Somerset 007B,E01014751,1537,1509,28,16,9,3,0
2021,North Somerset 005A,E01014752,1568,1538,30,15,10,5,0
2021,North Somerset 007C,E01014753,1843,1793,50,26,17,5,2
2021,North Somerset 005B,E01014754,1304,1275,29,18,8,2,1
2021,North Somerset 007D,E01014755,1345,1302,43,35,4,3,1
2021,North Somerset 010A,E01014756,1490,1433,57,18,22,16,1
2021,North Somerset 010B,E01014757,1372,1338,34,20,8,6,0
2021,North Somerset 005C,E01014758,1256,1235,21,14,6,1,0
2021,North Somerset 005D,E01014759,1421,1410,11,10,0,1,0
2021,North Somerset 007E,E01014760,1423,1411,12,7,3,1,1
2021,North Somerset 010C,E01014761,1489,1457,32,11,16,4,1
2021,North Somerset 010D,E01014762,1434,1407,27,19,7,1,0
2021,North Somerset 010E,E01014763,1681,1596,85,35,35,13,2
2021,North Somerset 014A,E01014764,1787,1765,22,16,4,2,0
2021,North Somerset 014B,E01014765,1859,1828,31,16,7,2,6
2021,North Somerset 004A,E01014766,1402,1364,38,26,11,1,0
2021,North Somerset 004B,E01014767,1334,1297,37,26,9,2,0
2021,North Somerset 023D,E01014770,1326,1314,12,9,3,0,0
2021,North Somerset 023E,E01014771,1355,1334,21,10,9,2,0
2021,North Somerset 023F,E01014772,1401,1373,28,19,8,0,1
2021,North Somerset 014C,E01014773,1731,1704,27,19,8,0,0
2021,North Somerset 014D,E01014774,1836,1810,26,19,5,2,0
2021,North Somerset 009A,E01014775,1179,1169,10,6,3,0,1
2021,North Somerset 009B,E01014776,1186,1164,22,19,1,2,0
2021,North Somerset 009C,E01014777,1445,1394,51,35,11,5,0
2021,North Somerset 009D,E01014778,1259,1251,8,8,0,0,0
2021,North Somerset 009E,E01014779,1090,1065,25,14,9,2,0
2021,North Somerset 008A,E01014780,1579,1538,41,17,14,6,4
2021,North Somerset 008B,E01014781,1694,1668,26,15,6,4,1
2021,North Somerset 008C,E01014782,1318,1308,10,8,2,0,0
2021,North Somerset 008D,E01014783,1510,1478,32,13,10,9,0
2021,North Somerset 008E,E01014784,1589,1560,29,19,6,3,1
2021,North Somerset 008F,E01014785,1351,1329,22,10,11,1,0
2021,North Somerset 004C,E01014786,1626,1587,39,25,12,2,0
2021,North Somerset 004D,E01014787,1854,1795,59,36,20,2,1
2021,North Somerset 002A,E01014789,1344,1310,34,26,7,1,0
2021,North Somerset 001B,E01014790,1530,1503,27,17,6,4,0
2021,North Somerset 003B,E01014792,1775,1729,46,26,18,1,1
2021,North Somerset 002B,E01014793,1476,1449,27,16,10,1,0
2021,North Somerset 002C,E01014794,1735,1705,30,20,7,2,1
2021,North Somerset 001C,E01014795,1423,1374,49,24,14,10,1
2021,North Somerset 003C,E01014796,1750,1706,44,25,11,3,5
2021,North Somerset 001D,E01014797,1768,1713,55,27,22,4,2
2021,North Somerset 002D,E01014798,1448,1426,22,8,7,6,1
2021,North Somerset 020A,E01014799,1677,1384,293,106,127,50,10
2021,North Somerset 020B,E01014800,1736,1379,357,115,170,62,10
2021,North Somerset 020C,E01014801,1601,1386,215,71,102,39,3
2021,North Somerset 020D,E01014802,1610,1401,209,69,89,40,11
2021,North Somerset 025A,E01014803,1445,1391,54,34,18,1,1
2021,North Somerset 022A,E01014804,1425,1358,67,36,20,11,0
2021,North Somerset 025B,E01014805,1584,1544,40,30,8,2,0
2021,North Somerset 022B,E01014806,1651,1512,139,53,61,22,3
2021,North Somerset 022C,E01014807,1559,1405,154,49,74,26,5
2021,North Somerset 022D,E01014808,1361,1307,54,20,26,8,0
2021,North Somerset 020E,E01014809,1934,1712,222,81,114,24,3
2021,North Somerset 020F,E01014811,1730,1606,124,56,48,17,3
2021,North Somerset 017A,E01014812,1383,1346,37,23,12,2,0
2021,North Somerset 017B,E01014813,1758,1701,57,18,25,10,4
2021,North Somerset 017C,E01014815,1334,1273,61,33,24,4,0
2021,North Somerset 017D,E01014816,1451,1427,24,11,9,3,1
2021,North Somerset 016A,E01014817,1529,1493,36,13,18,5,0
2021,North Somerset 017E,E01014818,1714,1694,20,9,9,1,1
2021,North Somerset 017F,E01014819,1522,1490,32,18,9,4,1
2021,North Somerset 016B,E01014820,1442,1378,64,41,16,6,1
2021,North Somerset 015A,E01014821,1093,1043,50,26,18,5,1
2021,North Somerset 015B,E01014822,1367,1340,27,13,10,4,0
2021,North Somerset 015C,E01014823,1229,1206,23,14,5,4,0
2021,North Somerset 015D,E01014824,1398,1381,17,5,7,3,2
2021,North Somerset 015E,E01014825,1192,1177,15,5,5,5,0
2021,North Somerset 015F,E01014826,1428,1396,32,13,16,3,0
2021,North Somerset 015G,E01014827,1311,1252,59,22,24,12,1
2021,North Somerset 025C,E01014828,1433,1289,144,61,59,24,0
2021,North Somerset 021A,E01014829,1878,1718,160,70,63,19,8
2021,North Somerset 021B,E01014830,1442,1299,143,54,61,26,2
2021,North Somerset 021C,E01014831,1281,1212,69,22,37,8,2
2021,North Somerset 021D,E01014832,1455,1365,90,45,30,10,5
2021,North Somerset 021E,E01014833,1415,1343,72,28,28,15,1
2021,North Somerset 025D,E01014834,1319,1226,93,43,38,11,1
2021,North Somerset 016C,E01014835,1378,1340,38,14,15,8,1
2021,North Somerset 016D,E01014836,1405,1351,54,32,20,2,0
2021,North Somerset 016E,E01014838,1361,1303,58,36,16,5,1
2021,North Somerset 026A,E01014839,1533,1433,100,42,44,8,6
2021,North Somerset 016F,E01014840,1344,1286,58,24,28,6,0
2021,North Somerset 018A,E01014841,1721,1548,173,66,73,29,5
2021,North Somerset 018B,E01014842,1553,1425,128,50,58,20,0
2021,North Somerset 018C,E01014843,1436,1371,65,29,25,10,1
2021,North Somerset 018D,E01014844,1426,1246,180,77,67,34,2
2021,North Somerset 018E,E01014845,1273,1214,59,27,21,7,4
2021,North Somerset 018F,E01014846,1434,1366,68,35,27,4,2
2021,North Somerset 013A,E01014847,1761,1743,18,12,3,3,0
2021,North Somerset 013B,E01014848,1366,1356,10,6,2,1,1
2021,North Somerset 006B,E01014849,1755,1722,33,23,7,3,0
2021,North Somerset 006C,E01014850,2107,2076,31,17,10,3,1
2021,North Somerset 006D,E01014851,2585,2493,92,62,17,13,0
2021,North Somerset 006E,E01014852,1626,1602,24,13,5,5,1
2021,North Somerset 013C,E01014853,1670,1645,25,16,4,4,1
2021,North Somerset 013D,E01014854,1387,1369,18,11,4,3,0
2021,North Somerset 012A,E01014855,1425,1405,20,11,8,1,0
2021,North Somerset 012B,E01014856,2098,2063,35,23,11,1,0
2021,North Somerset 012C,E01014857,1463,1440,23,15,6,2,0
2021,North Somerset 012D,E01014858,1686,1656,30,18,11,1,0
2021,North Somerset 012E,E01014859,1469,1456,13,7,5,1,0
2021,North Somerset 012F,E01014860,1459,1443,16,14,2,0,0
2021,South Gloucestershire 005A,E01014861,2258,2128,130,65,45,18,2
2021,South Gloucestershire 005B,E01014862,2859,2774,85,51,25,6,3
2021,South Gloucestershire 004A,E01014863,1491,1480,11,7,3,1,0
2021,South Gloucestershire 004B,E01014864,1497,1469,28,17,8,3,0
2021,South Gloucestershire 024A,E01014865,2088,2054,34,18,12,4,0
2021,South Gloucestershire 032A,E01014866,1500,1489,11,9,2,0,0
2021,South Gloucestershire 019A,E01014867,1593,1532,61,20,29,10,2
2021,South Gloucestershire 024B,E01014869,1555,1537,18,13,4,0,1
2021,South Gloucestershire 024C,E01014870,1573,1547,26,17,7,2,0
2021,South Gloucestershire 024D,E01014871,1206,1190,16,10,4,2,0
2021,South Gloucestershire 009A,E01014872,1500,1255,245,129,84,27,5
2021,South Gloucestershire 012A,E01014873,1356,1307,49,39,10,0,0
2021,South Gloucestershire 009B,E01014874,1407,1246,161,90,62,8,1
2021,South Gloucestershire 012B,E01014875,1708,1306,402,188,148,57,9
2021,South Gloucestershire 009C,E01014876,1661,1375,286,141,106,33,6
2021,South Gloucestershire 009D,E01014877,1538,1338,200,110,73,14,3
2021,South Gloucestershire 012C,E01014878,2094,1798,296,162,103,28,3
2021,South Gloucestershire 009E,E01014879,1687,1490,197,104,65,26,2
2021,South Gloucestershire 012D,E01014880,1899,1669,230,119,79,29,3
2021,South Gloucestershire 009F,E01014881,1887,1666,221,132,71,16,2
2021,South Gloucestershire 012E,E01014882,2070,1811,259,145,76,33,5
2021,South Gloucestershire 012F,E01014883,1197,1050,147,73,48,20,6
2021,South Gloucestershire 003A,E01014884,2020,1974,46,18,24,4,0
2021,South Gloucestershire 003B,E01014885,2265,2239,26,17,3,4,2
2021,South Gloucestershire 008A,E01014886,1749,1696,53,18,19,14,2
2021,South Gloucestershire 008B,E01014887,1359,1346,13,12,0,1,0
2021,South Gloucestershire 008C,E01014888,1813,1794,19,14,5,0,0
2021,South Gloucestershire 008D,E01014889,1421,1417,4,2,0,2,0
2021,South Gloucestershire 024E,E01014890,2133,2119,14,9,3,2,0
2021,South Gloucestershire 024F,E01014891,1651,1629,22,9,12,1,0
2021,South Gloucestershire 014A,E01014892,1722,1621,101,42,39,17,3
2021,South Gloucestershire 014B,E01014893,1394,1348,46,17,19,8,2
2021,South Gloucestershire 014C,E01014894,1172,1133,39,21,12,6,0
2021,South Gloucestershire 014D,E01014895,1353,1322,31,8,18,4,1
2021,South Gloucestershire 014E,E01014896,1245,1213,32,16,13,3,0
2021,South Gloucestershire 022A,E01014897,1517,1485,32,20,9,3,0
2021,South Gloucestershire 022B,E01014898,1754,1697,57,33,19,5,0
2021,South Gloucestershire 022C,E01014899,1708,1628,80,38,20,21,1
2021,South Gloucestershire 022D,E01014900,1518,1429,89,35,41,12,1
2021,South Gloucestershire 020A,E01014901,1716,1674,42,22,16,3,1
2021,South Gloucestershire 020B,E01014902,1290,1247,43,22,13,8,0
2021,South Gloucestershire 020C,E01014903,1480,1435,45,29,9,7,0
2021,South Gloucestershire 018A,E01014904,1530,1368,162,76,58,21,7
2021,South Gloucestershire 018B,E01014905,1651,1435,216,107,84,24,1
2021,South Gloucestershire 018C,E01014906,1692,1518,174,86,57,26,5
2021,South Gloucestershire 018D,E01014907,1612,1402,210,94,81,32,3
2021,South Gloucestershire 018E,E01014908,1395,1296,99,58,34,5,2
2021,South Gloucestershire 018F,E01014909,1541,1310,231,113,74,40,4
2021,South Gloucestershire 018G,E01014910,1553,1362,191,105,66,16,4
2021,South Gloucestershire 013A,E01014911,1446,1422,24,11,10,3,0
2021,South Gloucestershire 013B,E01014912,1783,1743,40,16,14,5,5
2021,South Gloucestershire 013C,E01014913,1623,1605,18,8,7,2,1
2021,South Gloucestershire 013D,E01014914,2099,2036,63,35,18,8,2
2021,South Gloucestershire 028A,E01014915,1619,1555,64,32,21,10,1
2021,South Gloucestershire 031A,E01014916,1536,1467,69,30,28,8,3
2021,South Gloucestershire 031B,E01014917,1623,1580,43,30,9,3,1
2021,South Gloucestershire 031C,E01014918,1438,1408,30,13,10,7,0
2021,South Gloucestershire 031D,E01014919,1365,1340,25,10,6,6,3
2021,South Gloucestershire 031E,E01014920,1342,1322,20,13,1,6,0
2021,South Gloucestershire 031F,E01014921,1623,1590,33,25,6,1,1
2021,South Gloucestershire 026A,E01014922,1350,1295,55,30,19,5,1
2021,South Gloucestershire 026B,E01014923,1437,1386,51,24,21,6,0
2021,South Gloucestershire 026C,E01014924,1742,1560,182,85,67,28,2
2021,South Gloucestershire 027A,E01014925,1515,1463,52,22,24,5,1
2021,South Gloucestershire 027B,E01014926,1649,1568,81,36,29,13,3
2021,South Gloucestershire 027C,E01014927,1761,1585,176,73,72,26,5
2021,South Gloucestershire 027D,E01014928,1429,1362,67,28,27,10,2
2021,South Gloucestershire 003C,E01014929,2207,2172,35,16,14,4,1
2021,South Gloucestershire 003D,E01014930,2030,2003,27,16,8,3,0
2021,South Gloucestershire 032B,E01014931,1615,1571,44,23,14,4,3
2021,South Gloucestershire 032C,E01014932,1529,1508,21,13,5,3,0
2021,South Gloucestershire 032D,E01014933,1309,1299,10,5,4,1,0
2021,South Gloucestershire 032E,E01014934,1235,1227,8,5,2,1,0
2021,South Gloucestershire 032F,E01014935,1374,1329,45,25,19,1,0
2021,South Gloucestershire 030A,E01014936,1379,1362,17,10,6,1,0
2021,South Gloucestershire 032G,E01014937,1288,1274,14,8,1,4,1
2021,South Gloucestershire 030B,E01014938,1511,1499,12,8,2,1,1
2021,South Gloucestershire 030C,E01014939,1178,1139,39,16,17,5,1
2021,South Gloucestershire 030D,E01014940,1292,1279,13,5,6,2,0
2021,South Gloucestershire 030E,E01014941,1577,1532,45,17,19,8,1
2021,South Gloucestershire 030F,E01014942,1485,1429,56,31,20,4,1
2021,South Gloucestershire 029A,E01014943,1629,1570,59,26,26,6,1
2021,South Gloucestershire 029B,E01014944,1671,1629,42,20,15,6,1
2021,South Gloucestershire 030G,E01014945,1612,1576,36,17,15,4,0
2021,South Gloucestershire 033C,E01014946,1535,1354,181,84,71,26,0
2021,South Gloucestershire 033B,E01014947,1434,1381,53,30,15,7,1
2021,South Gloucestershire 033A,E01014948,1576,1393,183,79,72,27,5
2021,South Gloucestershire 033D,E01014950,1451,1241,210,87,82,40,1
2021,South Gloucestershire 034B,E01014951,1316,1126,190,82,66,36,6
2021,South Gloucestershire 005C,E01014953,2000,1938,62,35,25,2,0
2021,South Gloucestershire 005D,E01014954,1479,1372,107,35,52,18,2
2021,South Gloucestershire 025A,E01014955,1346,1299,47,29,16,2,0
2021,South Gloucestershire 025B,E01014956,1458,1414,44,20,19,5,0
2021,South Gloucestershire 025C,E01014957,1145,1103,42,18,7,11,6
2021,South Gloucestershire 027E,E01014958,1155,1083,72,36,25,10,1
2021,South Gloucestershire 023A,E01014959,1375,1330,45,25,13,7,0
2021,South Gloucestershire 023B,E01014960,1709,1642,67,33,23,8,3
2021,South Gloucestershire 023C,E01014961,1526,1472,54,26,21,5,2
2021,South Gloucestershire 004C,E01014962,1721,1692,29,22,6,0,1
2021,South Gloucestershire 004D,E01014963,1834,1806,28,22,6,0,0
2021,South Gloucestershire 021A,E01014964,1664,1590,74,39,25,8,2
2021,South Gloucestershire 020D,E01014965,1536,1498,38,20,11,6,1
2021,South Gloucestershire 021C,E01014967,2066,1975,91,53,24,12,2
2021,South Gloucestershire 023D,E01014968,1728,1643,85,35,33,12,5
2021,South Gloucestershire 021D,E01014969,1571,1526,45,22,18,4,1
2021,South Gloucestershire 029C,E01014972,1669,1653,16,10,3,1,2
2021,South Gloucestershire 026D,E01014973,1462,1401,61,27,29,5,0
2021,South Gloucestershire 025D,E01014974,1648,1600,48,25,17,6,0
2021,South Gloucestershire 026E,E01014975,1690,1533,157,68,52,29,8
2021,South Gloucestershire 026F,E01014976,1697,1563,134,56,49,28,1
2021,South Gloucestershire 025E,E01014977,1375,1267,108,36,54,18,0
2021,South Gloucestershire 036A,E01014978,1481,1368,113,60,27,19,7
2021,South Gloucestershire 015A,E01014979,1446,1327,119,68,29,21,1
2021,South Gloucestershire 015B,E01014980,1502,1443,59,35,13,9,2
2021,South Gloucestershire 015C,E01014982,1432,1376,56,25,25,5,1
2021,South Gloucestershire 015D,E01014983,1467,1349,118,64,38,15,1
2021,South Gloucestershire 015E,E01014984,1476,1376,100,39,40,17,4
2021,South Gloucestershire 001A,E01014985,1287,1263,24,11,6,7,0
2021,South Gloucestershire 001B,E01014986,1628,1558,70,38,23,7,2
2021,South Gloucestershire 001C,E01014987,2324,2228,96,60,30,3,3
2021,South Gloucestershire 001D,E01014988,1664,1636,28,17,8,2,1
2021,South Gloucestershire 001E,E01014989,2161,2093,68,39,16,12,1
2021,South Gloucestershire 002A,E01014990,1425,1414,11,5,5,1,0
2021,South Gloucestershire 002B,E01014991,2132,2049,83,36,34,12,1
2021,South Gloucestershire 002C,E01014992,1393,1357,36,23,11,2,0
2021,South Gloucestershire 002D,E01014993,1591,1568,23,8,13,2,0
2021,South Gloucestershire 019D,E01014994,1891,1864,27,17,9,1,0
2021,South Gloucestershire 019E,E01014995,1593,1564,29,23,6,0,0
2021,South Gloucestershire 036D,E01014996,1784,1713,71,36,22,13,0
2021,South Gloucestershire 016A,E01014998,1525,1497,28,18,6,3,1
2021,South Gloucestershire 016B,E01014999,1583,1561,22,10,7,2,3
2021,South Gloucestershire 016C,E01015000,1584,1522,62,35,19,7,1
2021,South Gloucestershire 016D,E01015001,1543,1505,38,23,12,3,0
2021,South Gloucestershire 029D,E01015002,1474,1409,65,28,22,12,3
2021,South Gloucestershire 028B,E01015003,1589,1539,50,24,16,10,0
2021,South Gloucestershire 029E,E01015004,1596,1517,79,42,28,9,0
2021,South Gloucestershire 028C,E01015005,2258,2077,181,100,54,24,3
2021,South Gloucestershire 029F,E01015006,1567,1502,65,25,27,13,0
2021,South Gloucestershire 028D,E01015007,1911,1737,174,94,64,15,1
2021,South Gloucestershire 028E,E01015008,1700,1638,62,35,24,3,0
2021,South Gloucestershire 010A,E01015009,1335,1290,45,29,13,3,0
2021,South Gloucestershire 010B,E01015010,1322,1283,39,21,16,2,0
2021,South Gloucestershire 010C,E01015011,1737,1697,40,19,15,2,4
2021,South Gloucestershire 010D,E01015012,1733,1659,74,38,26,7,3
2021,South Gloucestershire 010E,E01015013,1271,1213,58,28,20,9,1
2021,South Gloucestershire 006A,E01015014,2846,2752,94,41,39,13,1
2021,South Gloucestershire 006B,E01015015,1534,1479,55,23,23,8,1
2021,South Gloucestershire 006C,E01015016,1097,1086,11,2,3,3,3
2021,South Gloucestershire 006D,E01015017,1395,1343,52,27,19,6,0
2021,South Gloucestershire 006E,E01015018,1455,1434,21,14,6,1,0
2021,South Gloucestershire 007A,E01015019,1575,1491,84,41,32,10,1
2021,South Gloucestershire 007B,E01015020,1520,1464,56,16,31,6,3
2021,South Gloucestershire 007C,E01015021,1466,1443,23,15,7,0,1
2021,South Gloucestershire 007D,E01015022,1521,1465,56,29,18,8,1
2021,Plymouth 003A,E01015023,1724,1671,53,27,17,8,1
2021,Plymouth 004A,E01015024,1293,1268,25,15,6,3,1
2021,Plymouth 001A,E01015025,1693,1660,33,21,9,3,0
2021,Plymouth 003B,E01015026,1476,1434,42,11,17,10,4
2021,Plymouth 002A,E01015027,1576,1540,36,28,7,0,1
2021,Plymouth 003C,E01015028,1598,1501,97,40,45,12,0
2021,Plymouth 008A,E01015029,1876,1825,51,32,10,8,1
2021,Plymouth 007A,E01015030,1555,1508,47,27,18,0,2
2021,Plymouth 023A,E01015031,1464,1382,82,35,31,13,3
2021,Plymouth 023B,E01015032,1708,1535,173,85,62,23,3
2021,Plymouth 016A,E01015033,1527,1482,45,24,14,6,1
2021,Plymouth 016B,E01015034,1435,1390,45,30,10,3,2
2021,Plymouth 012A,E01015035,1401,1366,35,17,13,3,2
2021,Plymouth 016C,E01015036,1491,1445,46,27,8,10,1
2021,Plymouth 012B,E01015037,1290,1258,32,11,14,6,1
2021,Plymouth 016D,E01015038,1665,1605,60,31,22,6,1
2021,Plymouth 014A,E01015039,1000,939,61,35,18,8,0
2021,Plymouth 014B,E01015040,1470,1412,58,23,22,10,3
2021,Plymouth 014C,E01015041,1576,1514,62,32,20,10,0
2021,Plymouth 020A,E01015042,1394,1329,65,30,19,12,4
2021,Plymouth 026A,E01015043,1342,1256,86,22,45,17,2
2021,Plymouth 020B,E01015044,1413,1304,109,59,33,17,0
2021,Plymouth 026B,E01015045,1402,1264,138,56,57,20,5
2021,Plymouth 026C,E01015046,1835,1638,197,86,91,16,4
2021,Plymouth 026D,E01015047,1936,1779,157,68,60,29,0
2021,Plymouth 026E,E01015048,2264,1934,330,154,135,38,3
2021,Plymouth 023C,E01015049,1625,1491,134,62,41,22,9
2021,Plymouth 023D,E01015050,1803,1617,186,85,68,32,1
2021,Plymouth 023E,E01015051,1763,1629,134,73,41,15,5
2021,Plymouth 028A,E01015052,1824,1619,205,91,83,25,6
2021,Plymouth 027A,E01015053,1178,1017,161,75,56,24,6
2021,Plymouth 027B,E01015054,2705,2517,188,109,56,19,4
2021,Plymouth 021A,E01015055,1413,1394,19,10,6,3,0
2021,Plymouth 021B,E01015056,1600,1523,77,25,27,24,1
2021,Plymouth 021C,E01015057,1622,1552,70,39,18,10,3
2021,Plymouth 012C,E01015058,1531,1496,35,15,13,7,0
2021,Plymouth 021D,E01015059,1465,1407,58,27,22,9,0
2021,Plymouth 021E,E01015060,1442,1368,74,41,27,5,1
2021,Plymouth 025A,E01015061,1499,1359,140,67,51,18,4
2021,Plymouth 025B,E01015062,1759,1567,192,106,60,23,3
2021,Plymouth 010A,E01015063,1403,1366,37,16,16,5,0
2021,Plymouth 008B,E01015064,1576,1556,20,8,7,5,0
2021,Plymouth 008C,E01015065,1271,1250,21,16,5,0,0
2021,Plymouth 012D,E01015066,1328,1300,28,15,4,6,3
2021,Plymouth 012E,E01015067,1387,1379,8,4,4,0,0
2021,Plymouth 010B,E01015068,1542,1527,15,8,5,2,0
2021,Plymouth 010C,E01015069,1480,1434,46,19,19,7,1
2021,Plymouth 007B,E01015070,2644,2528,116,56,38,17,5
2021,Plymouth 008D,E01015071,1482,1434,48,20,18,8,2
2021,Plymouth 013A,E01015072,1305,1270,35,19,8,7,1
2021,Plymouth 013B,E01015073,1426,1397,29,9,17,3,0
2021,Plymouth 011A,E01015074,1454,1428,26,18,8,0,0
2021,Plymouth 014D,E01015075,1473,1441,32,9,14,7,2
2021,Plymouth 009A,E01015076,1361,1316,45,25,13,4,3
2021,Plymouth 011B,E01015077,2404,2297,107,51,39,14,3
2021,Plymouth 013C,E01015078,1408,1350,58,29,15,12,2
2021,Plymouth 011C,E01015079,1676,1624,52,28,18,5,1
2021,Plymouth 013D,E01015080,1387,1253,134,74,48,10,2
2021,Plymouth 007C,E01015081,1647,1603,44,16,20,8,0
2021,Plymouth 004B,E01015082,1572,1539,33,14,10,7,2
2021,Plymouth 004C,E01015083,1554,1527,27,7,8,8,4
2021,Plymouth 004D,E01015084,1435,1405,30,12,10,8,0
2021,Plymouth 006A,E01015085,1553,1511,42,15,10,16,1
2021,Plymouth 007D,E01015086,1335,1283,52,24,21,7,0
2021,Plymouth 006B,E01015087,1554,1513,41,19,17,3,2
2021,Plymouth 006C,E01015088,1525,1470,55,24,24,4,3
2021,Plymouth 007E,E01015089,1651,1602,49,21,23,5,0
2021,Plymouth 005A,E01015090,1298,1272,26,17,6,3,0
2021,Plymouth 005B,E01015091,1399,1394,5,5,0,0,0
2021,Plymouth 005C,E01015092,2719,2549,170,110,45,12,3
2021,Plymouth 005D,E01015093,1302,1258,44,21,18,3,2
2021,Plymouth 005E,E01015094,1484,1430,54,30,13,11,0
2021,Plymouth 010D,E01015095,1332,1315,17,10,4,3,0
2021,Plymouth 010E,E01015096,1336,1324,12,7,5,0,0
2021,Plymouth 001B,E01015097,2184,2136,48,26,16,5,1
2021,Plymouth 017A,E01015098,1565,1490,75,43,23,9,0
2021,Plymouth 017B,E01015099,1398,1318,80,55,19,5,1
2021,Plymouth 017C,E01015100,1433,1344,89,63,20,4,2
2021,Plymouth 016E,E01015101,1551,1507,44,32,5,6,1
2021,Plymouth 011D,E01015102,1587,1502,85,28,36,19,2
2021,Plymouth 017D,E01015103,1435,1390,45,23,18,3,1
2021,Plymouth 011E,E01015104,1467,1422,45,18,17,8,2
2021,Plymouth 017E,E01015105,1472,1416,56,35,14,6,1
2021,Plymouth 013E,E01015106,1174,1137,37,23,8,5,1
2021,Plymouth 018A,E01015107,1766,1736,30,21,6,2,1
2021,Plymouth 022A,E01015108,1758,1713,45,24,16,5,0
2021,Plymouth 022B,E01015109,1296,1279,17,7,5,5,0
2021,Plymouth 018B,E01015110,1464,1448,16,6,8,2,0
2021,Plymouth 018C,E01015111,1657,1620,37,16,18,3,0
2021,Plymouth 019A,E01015112,1603,1582,21,13,5,3,0
2021,Plymouth 019B,E01015113,1415,1400,15,12,0,2,1
2021,Plymouth 019C,E01015114,1428,1420,8,6,2,0,0
2021,Plymouth 022C,E01015115,1337,1332,5,1,1,2,1
2021,Plymouth 022D,E01015116,1386,1373,13,7,3,2,1
2021,Plymouth 022E,E01015117,1348,1335,13,6,5,2,0
2021,Plymouth 019D,E01015118,1591,1577,14,8,4,1,1
2021,Plymouth 018D,E01015119,1579,1564,15,6,6,3,0
2021,Plymouth 015A,E01015120,1547,1536,11,7,4,0,0
2021,Plymouth 015B,E01015121,1482,1473,9,7,2,0,0
2021,Plymouth 019E,E01015122,1555,1523,32,16,13,3,0
2021,Plymouth 015C,E01015123,1625,1604,21,13,5,3,0
2021,Plymouth 015D,E01015124,1499,1487,12,10,2,0,0
2021,Plymouth 015E,E01015125,1438,1434,4,4,0,0,0
2021,Plymouth 030A,E01015126,1505,1496,9,4,3,1,1
2021,Plymouth 030B,E01015127,1417,1406,11,6,2,2,1
2021,Plymouth 032A,E01015128,1519,1504,15,5,9,1,0
2021,Plymouth 032B,E01015129,1336,1303,33,23,7,3,0
2021,Plymouth 032C,E01015130,1483,1465,18,8,8,2,0
2021,Plymouth 030C,E01015131,2371,2352,19,9,7,3,0
2021,Plymouth 030D,E01015132,1464,1410,54,26,22,6,0
2021,Plymouth 030E,E01015133,1425,1414,11,10,1,0,0
2021,Plymouth 032D,E01015134,1497,1484,13,7,4,2,0
2021,Plymouth 031B,E01015136,1439,1423,16,9,7,0,0
2021,Plymouth 031C,E01015137,1737,1720,17,9,7,1,0
2021,Plymouth 031D,E01015138,1840,1814,26,18,6,2,0
2021,Plymouth 031E,E01015139,1402,1388,14,5,8,1,0
2021,Plymouth 032E,E01015140,1386,1365,21,14,6,1,0
2021,Plymouth 031F,E01015141,1730,1706,24,15,8,1,0
2021,Plymouth 009B,E01015142,1367,1326,41,19,18,4,0
2021,Plymouth 009C,E01015143,1261,1241,20,7,9,4,0
2021,Plymouth 009D,E01015144,1533,1490,43,20,18,5,0
2021,Plymouth 014E,E01015145,1282,1240,42,23,14,4,1
2021,Plymouth 009E,E01015146,1872,1787,85,33,40,11,1
2021,Plymouth 006D,E01015147,1231,1208,23,10,10,3,0
2021,Plymouth 006E,E01015148,1444,1392,52,23,19,9,1
2021,Plymouth 009F,E01015149,1439,1416,23,7,8,7,1
2021,Plymouth 009G,E01015150,1386,1336,50,25,19,6,0
2021,Plymouth 033A,E01015151,1780,1525,255,117,104,32,2
2021,Plymouth 027C,E01015152,2445,2057,388,173,156,53,6
2021,Plymouth 033C,E01015153,1760,1539,221,78,90,42,11
2021,Plymouth 034A,E01015155,1765,1469,296,111,124,54,7
2021,Plymouth 027E,E01015156,1985,1767,218,127,81,10,0
2021,Plymouth 002B,E01015159,1671,1628,43,22,18,2,1
2021,Plymouth 001C,E01015160,1414,1403,11,4,5,2,0
2021,Plymouth 002C,E01015161,1616,1578,38,21,10,7,0
2021,Plymouth 002D,E01015162,1446,1408,38,17,15,6,0
2021,Plymouth 003D,E01015163,1550,1532,18,9,5,3,1
2021,Plymouth 001D,E01015164,1829,1780,49,23,21,5,0
2021,Plymouth 003E,E01015165,1632,1598,34,20,11,3,0
2021,Plymouth 002E,E01015166,2113,2085,28,13,11,3,1
2021,Plymouth 020C,E01015167,1434,1374,60,39,17,2,2
2021,Plymouth 020D,E01015168,1765,1681,84,39,32,11,2
2021,Plymouth 024A,E01015169,1743,1594,149,74,55,18,2
2021,Plymouth 024B,E01015170,1505,1392,113,49,42,18,4
2021,Plymouth 020E,E01015171,1685,1596,89,51,27,11,0
2021,Plymouth 033B,E01015172,1681,1578,103,37,45,19,2
2021,Plymouth 024C,E01015173,1619,1524,95,47,32,11,5
2021,Plymouth 024D,E01015174,1623,1567,56,23,20,11,2
2021,Plymouth 025C,E01015175,1544,1431,113,58,43,10,2
2021,Plymouth 021F,E01015176,1364,1293,71,26,33,10,2
2021,Plymouth 025D,E01015177,1657,1567,90,45,31,13,1
2021,Plymouth 025E,E01015178,1868,1688,180,80,77,21,2
2021,Plymouth 028B,E01015179,1597,1435,162,66,60,27,9
2021,Plymouth 028C,E01015180,1664,1507,157,55,70,28,4
2021,Plymouth 028D,E01015181,2091,1788,303,115,123,56,9
2021,Plymouth 028E,E01015182,1896,1718,178,69,74,33,2
2021,Torbay 017A,E01015183,1342,1341,1,1,0,0,0
2021,Torbay 017B,E01015184,1246,1241,5,4,0,0,1
2021,Torbay 017C,E01015185,1289,1279,10,4,6,0,0
2021,Torbay 017D,E01015186,1273,1251,22,7,10,4,1
2021,Torbay 017E,E01015187,1670,1657,13,8,4,1,0
2021,Torbay 017F,E01015188,1488,1469,19,16,3,0,0
2021,Torbay 017G,E01015189,999,990,9,8,1,0,0
2021,Torbay 013A,E01015190,1944,1919,25,14,5,2,4
2021,Torbay 013B,E01015191,1563,1546,17,6,9,2,0
2021,Torbay 013C,E01015192,1523,1495,28,14,13,1,0
2021,Torbay 013D,E01015193,1311,1288,23,13,7,3,0
2021,Torbay 013E,E01015194,1370,1351,19,5,8,5,1
2021,Torbay 013G,E01015196,1726,1691,35,18,13,4,0
2021,Torbay 016A,E01015197,1366,1355,11,6,5,0,0
2021,Torbay 016B,E01015198,1539,1533,6,3,3,0,0
2021,Torbay 016C,E01015199,1350,1346,4,4,0,0,0
2021,Torbay 016D,E01015200,1039,1030,9,3,5,0,1
2021,Torbay 016E,E01015201,1224,1219,5,3,2,0,0
2021,Torbay 012A,E01015202,1465,1451,14,10,3,1,0
2021,Torbay 012B,E01015203,1222,1211,11,3,8,0,0
2021,Torbay 012C,E01015204,1465,1420,45,21,18,6,0
2021,Torbay 012D,E01015205,1441,1422,19,9,6,3,1
2021,Torbay 012E,E01015206,1518,1507,11,8,2,1,0
2021,Torbay 019E,E01015207,1521,1493,28,18,7,2,1
2021,Torbay 019F,E01015208,1961,1917,44,24,8,6,6
2021,Torbay 019A,E01015209,1490,1431,59,30,23,6,0
2021,Torbay 019B,E01015210,1653,1589,64,29,30,5,0
2021,Torbay 019G,E01015211,1466,1441,25,20,5,0,0
2021,Torbay 019C,E01015212,1457,1404,53,31,13,9,0
2021,Torbay 019D,E01015213,1467,1431,36,13,16,7,0
2021,Torbay 006A,E01015214,1505,1422,83,39,31,11,2
2021,Torbay 006B,E01015215,1399,1351,48,31,13,3,1
2021,Torbay 006C,E01015216,1421,1361,60,29,23,8,0
2021,Torbay 008A,E01015217,1615,1522,93,39,42,10,2
2021,Torbay 006D,E01015218,1497,1435,62,19,30,13,0
2021,Torbay 015A,E01015219,1357,1328,29,11,9,6,3
2021,Torbay 015B,E01015220,1392,1382,10,3,6,1,0
2021,Torbay 015C,E01015221,1461,1446,15,8,5,1,1
2021,Torbay 015D,E01015222,1545,1517,28,15,9,3,1
2021,Torbay 015E,E01015223,1245,1235,10,5,3,2,0
2021,Torbay 011A,E01015224,1581,1555,26,18,5,3,0
2021,Torbay 011B,E01015225,1419,1402,17,10,6,1,0
2021,Torbay 011C,E01015226,1380,1370,10,8,2,0,0
2021,Torbay 011D,E01015227,1562,1550,12,7,2,1,2
2021,Torbay 011E,E01015228,1520,1488,32,16,10,6,0
2021,Torbay 014A,E01015229,1469,1446,23,9,10,3,1
2021,Torbay 011F,E01015230,1365,1352,13,4,3,4,2
2021,Torbay 014B,E01015231,1729,1619,110,40,53,14,3
2021,Torbay 014C,E01015232,1906,1806,100,48,36,16,0
2021,Torbay 014D,E01015233,1473,1380,93,33,41,17,2
2021,Torbay 014E,E01015234,1311,1278,33,15,12,6,0
2021,Torbay 014F,E01015235,1757,1711,46,22,14,10,0
2021,Torbay 002A,E01015236,1451,1441,10,3,5,1,1
2021,Torbay 002B,E01015237,1313,1282,31,13,15,3,0
2021,Torbay 002C,E01015238,1326,1288,38,21,10,5,2
2021,Torbay 002D,E01015239,1655,1616,39,15,15,3,6
2021,Torbay 005A,E01015240,1514,1454,60,29,26,4,1
2021,Torbay 005B,E01015241,1557,1507,50,24,19,3,4
2021,Torbay 005C,E01015242,1298,1252,46,18,17,9,2
2021,Torbay 005D,E01015243,1260,1241,19,14,5,0,0
2021,Torbay 018A,E01015244,1385,1374,11,1,5,3,2
2021,Torbay 018B,E01015245,1231,1226,5,5,0,0,0
2021,Torbay 018C,E01015246,1418,1405,13,9,0,4,0
2021,Torbay 018D,E01015247,1778,1758,20,13,6,1,0
2021,Torbay 018E,E01015248,1400,1391,9,4,1,4,0
2021,Torbay 003A,E01015249,1455,1418,37,21,12,4,0
2021,Torbay 003B,E01015250,1471,1452,19,15,4,0,0
2021,Torbay 003C,E01015251,1207,1146,61,31,27,2,1
2021,Torbay 003E,E01015253,1927,1839,88,50,31,6,1
2021,Torbay 003F,E01015254,1396,1352,44,17,23,3,1
2021,Torbay 008B,E01015255,1773,1573,200,79,83,31,7
2021,Torbay 008C,E01015256,1940,1664,276,136,103,34,3
2021,Torbay 004A,E01015257,1418,1335,83,52,24,7,0
2021,Torbay 004B,E01015258,2009,1895,114,61,41,11,1
2021,Torbay 004C,E01015259,1536,1479,57,23,18,16,0
2021,Torbay 004D,E01015260,1651,1539,112,53,41,16,2
2021,Torbay 008D,E01015261,2214,1982,232,120,85,22,5
2021,Torbay 001A,E01015262,1334,1312,22,13,2,7,0
2021,Torbay 001B,E01015263,1563,1509,54,23,24,6,1
2021,Torbay 001C,E01015264,1302,1286,16,11,2,3,0
2021,Torbay 001D,E01015265,1340,1307,33,21,9,3,0
2021,Torbay 001E,E01015266,1535,1496,39,18,19,2,0
2021,Torbay 010A,E01015267,1670,1565,105,44,46,14,1
2021,Torbay 010B,E01015268,1670,1588,82,41,31,7,3
2021,Torbay 010C,E01015269,1533,1487,46,25,15,6,0
2021,Torbay 010D,E01015270,1671,1587,84,39,29,13,3
2021,Torbay 010E,E01015271,1481,1456,25,16,6,3,0
2021,"Bournemouth, Christchurch and Poole 035A",E01015272,1837,1647,190,88,81,15,6
2021,"Bournemouth, Christchurch and Poole 035B",E01015273,2090,1775,315,143,116,41,15
2021,"Bournemouth, Christchurch and Poole 036A",E01015274,1829,1686,143,82,50,10,1
2021,"Bournemouth, Christchurch and Poole 035C",E01015275,1633,1395,238,134,79,24,1
2021,"Bournemouth, Christchurch and Poole 035D",E01015276,1724,1571,153,71,64,16,2
2021,"Bournemouth, Christchurch and Poole 035E",E01015277,1933,1606,327,148,121,43,15
2021,"Bournemouth, Christchurch and Poole 037A",E01015279,1866,1342,524,240,214,62,8
2021,"Bournemouth, Christchurch and Poole 037B",E01015280,2057,1419,638,281,259,82,16
2021,"Bournemouth, Christchurch and Poole 037C",E01015281,1777,1353,424,161,166,86,11
2021,"Bournemouth, Christchurch and Poole 038A",E01015286,1967,1693,274,149,86,29,10
2021,"Bournemouth, Christchurch and Poole 041A",E01015288,1967,1389,578,283,197,87,11
2021,"Bournemouth, Christchurch and Poole 041B",E01015289,1942,1451,491,258,168,53,12
2021,"Bournemouth, Christchurch and Poole 041C",E01015290,2730,2135,595,286,232,66,11
2021,"Bournemouth, Christchurch and Poole 041D",E01015291,1855,1452,403,205,140,54,4
2021,"Bournemouth, Christchurch and Poole 025A",E01015292,1817,1451,366,157,161,44,4
2021,"Bournemouth, Christchurch and Poole 025B",E01015293,1554,1290,264,111,113,38,2
2021,"Bournemouth, Christchurch and Poole 025C",E01015294,2049,1485,564,256,224,69,15
2021,"Bournemouth, Christchurch and Poole 039A",E01015295,1481,1456,25,17,6,2,0
2021,"Bournemouth, Christchurch and Poole 039B",E01015296,1866,1739,127,75,36,15,1
2021,"Bournemouth, Christchurch and Poole 036B",E01015297,1490,1426,64,45,17,2,0
2021,"Bournemouth, Christchurch and Poole 039C",E01015298,1523,1491,32,19,8,5,0
2021,"Bournemouth, Christchurch and Poole 039D",E01015299,1755,1705,50,25,14,8,3
2021,"Bournemouth, Christchurch and Poole 039E",E01015300,1564,1525,39,25,13,1,0
2021,"Bournemouth, Christchurch and Poole 003A",E01015301,1557,1485,72,34,31,7,0
2021,"Bournemouth, Christchurch and Poole 005A",E01015302,1775,1728,47,28,17,2,0
2021,"Bournemouth, Christchurch and Poole 003B",E01015303,1578,1517,61,33,19,6,3
2021,"Bournemouth, Christchurch and Poole 005B",E01015304,1771,1693,78,41,28,7,2
2021,"Bournemouth, Christchurch and Poole 003C",E01015305,1530,1485,45,24,13,7,1
2021,"Bournemouth, Christchurch and Poole 003D",E01015306,1627,1586,41,16,17,8,0
2021,"Bournemouth, Christchurch and Poole 010A",E01015307,1447,1360,87,46,32,9,0
2021,"Bournemouth, Christchurch and Poole 005C",E01015308,1753,1638,115,68,40,6,1
2021,"Bournemouth, Christchurch and Poole 010B",E01015309,1419,1298,121,57,40,23,1
2021,"Bournemouth, Christchurch and Poole 011A",E01015310,1522,1388,134,64,51,17,2
2021,"Bournemouth, Christchurch and Poole 005D",E01015311,1355,1326,29,19,7,0,3
2021,"Bournemouth, Christchurch and Poole 010C",E01015312,1454,1377,77,35,28,11,3
2021,"Bournemouth, Christchurch and Poole 010D",E01015313,1320,1274,46,23,17,5,1
2021,"Bournemouth, Christchurch and Poole 020A",E01015314,1515,1468,47,27,14,6,0
2021,"Bournemouth, Christchurch and Poole 020B",E01015315,1852,1778,74,44,24,5,1
2021,"Bournemouth, Christchurch and Poole 026A",E01015316,1616,1529,87,34,33,17,3
2021,"Bournemouth, Christchurch and Poole 026B",E01015317,1625,1557,68,43,18,7,0
2021,"Bournemouth, Christchurch and Poole 020C",E01015318,1704,1530,174,77,70,26,1
2021,"Bournemouth, Christchurch and Poole 020D",E01015319,1325,1197,128,92,30,5,1
2021,"Bournemouth, Christchurch and Poole 009A",E01015320,1669,1586,83,33,35,13,2
2021,"Bournemouth, Christchurch and Poole 015A",E01015321,1856,1668,188,94,66,25,3
2021,"Bournemouth, Christchurch and Poole 017A",E01015322,1667,1537,130,70,40,16,4
2021,"Bournemouth, Christchurch and Poole 009B",E01015323,1620,1537,83,51,21,11,0
2021,"Bournemouth, Christchurch and Poole 009C",E01015324,1634,1509,125,60,40,24,1
2021,"Bournemouth, Christchurch and Poole 009D",E01015325,1738,1600,138,75,42,18,3
2021,"Bournemouth, Christchurch and Poole 027A",E01015326,1887,1518,369,180,143,37,9
2021,"Bournemouth, Christchurch and Poole 025D",E01015327,2048,1657,391,193,137,56,5
2021,"Bournemouth, Christchurch and Poole 038B",E01015328,1922,1547,375,187,126,53,9
2021,"Bournemouth, Christchurch and Poole 025E",E01015329,1639,1462,177,87,62,27,1
2021,"Bournemouth, Christchurch and Poole 017B",E01015330,1846,1676,170,97,56,16,1
2021,"Bournemouth, Christchurch and Poole 027B",E01015331,2298,1776,522,235,215,64,8
2021,"Bournemouth, Christchurch and Poole 006A",E01015332,1548,1463,85,41,36,7,1
2021,"Bournemouth, Christchurch and Poole 006B",E01015333,1520,1475,45,19,12,13,1
2021,"Bournemouth, Christchurch and Poole 006C",E01015334,1610,1559,51,22,22,6,1
2021,"Bournemouth, Christchurch and Poole 006D",E01015335,1617,1561,56,20,20,15,1
2021,"Bournemouth, Christchurch and Poole 011B",E01015336,1739,1652,87,47,31,9,0
2021,"Bournemouth, Christchurch and Poole 006E",E01015337,1794,1676,118,67,31,20,0
2021,"Bournemouth, Christchurch and Poole 012A",E01015338,1711,1538,173,78,65,30,0
2021,"Bournemouth, Christchurch and Poole 012B",E01015339,1566,1412,154,85,47,19,3
2021,"Bournemouth, Christchurch and Poole 012C",E01015340,1624,1514,110,63,33,9,5
2021,"Bournemouth, Christchurch and Poole 012D",E01015341,1401,1250,151,72,55,22,2
2021,"Bournemouth, Christchurch and Poole 017C",E01015342,1606,1483,123,79,35,7,2
2021,"Bournemouth, Christchurch and Poole 007A",E01015343,1613,1480,133,71,52,9,1
2021,"Bournemouth, Christchurch and Poole 028A",E01015344,1826,1653,173,82,72,15,4
2021,"Bournemouth, Christchurch and Poole 027C",E01015345,1850,1594,256,127,99,30,0
2021,"Bournemouth, Christchurch and Poole 028B",E01015346,1585,1439,146,86,40,18,2
2021,"Bournemouth, Christchurch and Poole 028C",E01015348,1832,1683,149,93,40,11,5
2021,"Bournemouth, Christchurch and Poole 007B",E01015349,1691,1553,138,88,34,12,4
2021,"Bournemouth, Christchurch and Poole 009E",E01015350,1520,1456,64,35,19,8,2
2021,"Bournemouth, Christchurch and Poole 007C",E01015351,1429,1357,72,47,21,4,0
2021,"Bournemouth, Christchurch and Poole 007D",E01015352,1574,1459,115,62,36,14,3
2021,"Bournemouth, Christchurch and Poole 007E",E01015353,1089,1046,43,26,13,3,1
2021,"Bournemouth, Christchurch and Poole 007F",E01015354,1727,1574,153,75,62,16,0
2021,"Bournemouth, Christchurch and Poole 011C",E01015355,1677,1587,90,48,27,13,2
2021,"Bournemouth, Christchurch and Poole 015B",E01015356,1753,1628,125,75,33,17,0
2021,"Bournemouth, Christchurch and Poole 011D",E01015357,1460,1375,85,39,33,11,2
2021,"Bournemouth, Christchurch and Poole 011E",E01015358,2114,2006,108,62,34,12,0
2021,"Bournemouth, Christchurch and Poole 010E",E01015359,1580,1474,106,55,41,8,2
2021,"Bournemouth, Christchurch and Poole 028D",E01015360,1961,1867,94,58,22,12,2
2021,"Bournemouth, Christchurch and Poole 026C",E01015361,1348,1274,74,53,16,5,0
2021,"Bournemouth, Christchurch and Poole 026D",E01015362,1137,1097,40,21,16,3,0
2021,"Bournemouth, Christchurch and Poole 026E",E01015363,1649,1571,78,46,23,8,1
2021,"Bournemouth, Christchurch and Poole 036C",E01015364,1649,1596,53,32,16,5,0
2021,"Bournemouth, Christchurch and Poole 036D",E01015365,1579,1459,120,78,32,10,0
2021,"Bournemouth, Christchurch and Poole 036E",E01015366,1770,1647,123,76,39,5,3
2021,"Bournemouth, Christchurch and Poole 045A",E01015367,2389,1568,821,390,304,118,9
2021,"Bournemouth, Christchurch and Poole 045B",E01015368,1715,1481,234,112,98,17,7
2021,"Bournemouth, Christchurch and Poole 045C",E01015369,1606,1450,156,87,52,12,5
2021,"Bournemouth, Christchurch and Poole 045D",E01015370,1585,1474,111,58,43,9,1
2021,"Bournemouth, Christchurch and Poole 040A",E01015371,1329,1089,240,122,83,32,3
2021,"Bournemouth, Christchurch and Poole 040B",E01015372,1981,1625,356,195,123,34,4
2021,"Bournemouth, Christchurch and Poole 017D",E01015373,1716,1535,181,93,63,18,7
2021,"Bournemouth, Christchurch and Poole 015C",E01015374,2476,2180,296,145,94,45,12
2021,"Bournemouth, Christchurch and Poole 015D",E01015375,2093,1769,324,180,110,26,8
2021,"Bournemouth, Christchurch and Poole 027D",E01015376,1801,1598,203,104,79,18,2
2021,"Bournemouth, Christchurch and Poole 015E",E01015377,1656,1510,146,75,37,26,8
2021,"Bournemouth, Christchurch and Poole 017E",E01015378,1773,1637,136,79,38,16,3
2021,"Bournemouth, Christchurch and Poole 008A",E01015379,1418,1339,79,45,25,7,2
2021,"Bournemouth, Christchurch and Poole 022A",E01015380,1757,1650,107,51,38,15,3
2021,"Bournemouth, Christchurch and Poole 022B",E01015381,1673,1581,92,49,31,10,2
2021,"Bournemouth, Christchurch and Poole 022C",E01015382,1846,1614,232,127,88,15,2
2021,"Bournemouth, Christchurch and Poole 022D",E01015383,1448,1350,98,55,33,7,3
2021,"Bournemouth, Christchurch and Poole 022E",E01015384,1581,1446,135,74,46,15,0
2021,"Bournemouth, Christchurch and Poole 022F",E01015385,1725,1585,140,79,44,14,3
2021,"Bournemouth, Christchurch and Poole 029A",E01015386,1620,1316,304,147,124,31,2
2021,"Bournemouth, Christchurch and Poole 029B",E01015387,1471,1373,98,56,25,13,4
2021,"Bournemouth, Christchurch and Poole 029C",E01015388,1439,1342,97,51,32,13,1
2021,"Bournemouth, Christchurch and Poole 029D",E01015389,1408,1308,100,54,37,8,1
2021,"Bournemouth, Christchurch and Poole 032A",E01015390,1654,1491,163,65,67,26,5
2021,"Bournemouth, Christchurch and Poole 032B",E01015391,1411,1313,98,48,36,11,3
2021,"Bournemouth, Christchurch and Poole 032C",E01015392,1427,1314,113,58,45,10,0
2021,"Bournemouth, Christchurch and Poole 032D",E01015393,1260,1172,88,54,25,9,0
2021,"Bournemouth, Christchurch and Poole 032E",E01015394,1605,1495,110,64,33,12,1
2021,"Bournemouth, Christchurch and Poole 004A",E01015395,1345,1311,34,11,12,11,0
2021,"Bournemouth, Christchurch and Poole 004B",E01015396,1562,1520,42,24,11,5,2
2021,"Bournemouth, Christchurch and Poole 004C",E01015397,1373,1352,21,17,4,0,0
2021,"Bournemouth, Christchurch and Poole 004D",E01015398,1293,1280,13,10,3,0,0
2021,"Bournemouth, Christchurch and Poole 004E",E01015399,1538,1512,26,15,8,3,0
2021,"Bournemouth, Christchurch and Poole 004F",E01015400,1594,1563,31,17,12,2,0
2021,"Bournemouth, Christchurch and Poole 004G",E01015401,1428,1408,20,10,4,5,1
2021,"Bournemouth, Christchurch and Poole 048A",E01015402,1805,1663,142,77,48,15,2
2021,"Bournemouth, Christchurch and Poole 048B",E01015403,1696,1587,109,57,41,8,3
2021,"Bournemouth, Christchurch and Poole 048C",E01015404,1745,1698,47,28,15,3,1
2021,"Bournemouth, Christchurch and Poole 048D",E01015405,1650,1605,45,35,9,1,0
2021,"Bournemouth, Christchurch and Poole 048E",E01015406,1500,1434,66,30,30,5,1
2021,"Bournemouth, Christchurch and Poole 016A",E01015407,1469,1397,72,33,31,8,0
2021,"Bournemouth, Christchurch and Poole 016B",E01015408,1697,1624,73,48,25,0,0
2021,"Bournemouth, Christchurch and Poole 016C",E01015409,1376,1328,48,22,20,6,0
2021,"Bournemouth, Christchurch and Poole 016D",E01015410,1447,1360,87,44,39,4,0
2021,"Bournemouth, Christchurch and Poole 016E",E01015411,1326,1291,35,17,17,1,0
2021,"Bournemouth, Christchurch and Poole 013A",E01015412,1276,1256,20,11,6,3,0
2021,"Bournemouth, Christchurch and Poole 013B",E01015413,1380,1336,44,21,16,7,0
2021,"Bournemouth, Christchurch and Poole 013C",E01015414,1522,1461,61,31,24,6,0
2021,"Bournemouth, Christchurch and Poole 013D",E01015415,1201,1133,68,30,31,7,0
2021,"Bournemouth, Christchurch and Poole 013E",E01015416,1258,1222,36,18,12,6,0
2021,"Bournemouth, Christchurch and Poole 021A",E01015417,1466,1426,40,19,16,5,0
2021,"Bournemouth, Christchurch and Poole 021B",E01015418,1484,1442,42,23,15,3,1
2021,"Bournemouth, Christchurch and Poole 021C",E01015419,1720,1663,57,29,26,2,0
2021,"Bournemouth, Christchurch and Poole 021D",E01015420,1598,1552,46,22,19,4,1
2021,"Bournemouth, Christchurch and Poole 021E",E01015421,1550,1497,53,24,19,10,0
2021,"Bournemouth, Christchurch and Poole 021F",E01015422,1350,1324,26,19,6,1,0
2021,"Bournemouth, Christchurch and Poole 046A",E01015424,1377,1326,51,22,26,3,0
2021,"Bournemouth, Christchurch and Poole 046B",E01015425,1269,1241,28,13,10,5,0
2021,"Bournemouth, Christchurch and Poole 046C",E01015426,1381,1333,48,23,21,4,0
2021,"Bournemouth, Christchurch and Poole 042A",E01015427,1623,1566,57,38,13,4,2
2021,"Bournemouth, Christchurch and Poole 042B",E01015428,2352,2249,103,54,35,13,1
2021,"Bournemouth, Christchurch and Poole 042C",E01015429,1719,1654,65,21,30,13,1
2021,"Bournemouth, Christchurch and Poole 042D",E01015430,1448,1382,66,33,18,14,1
2021,"Bournemouth, Christchurch and Poole 001A",E01015431,1445,1418,27,17,9,1,0
2021,"Bournemouth, Christchurch and Poole 001B",E01015432,1683,1659,24,15,6,3,0
2021,"Bournemouth, Christchurch and Poole 001C",E01015433,1497,1482,15,9,2,4,0
2021,"Bournemouth, Christchurch and Poole 001D",E01015434,1581,1553,28,21,6,1,0
2021,"Bournemouth, Christchurch and Poole 008B",E01015435,1781,1712,69,47,19,3,0
2021,"Bournemouth, Christchurch and Poole 008C",E01015436,1329,1311,18,6,10,2,0
2021,"Bournemouth, Christchurch and Poole 008D",E01015437,1214,1173,41,23,13,4,1
2021,"Bournemouth, Christchurch and Poole 023A",E01015438,1516,1408,108,60,38,8,2
2021,"Bournemouth, Christchurch and Poole 023B",E01015439,1769,1618,151,67,57,24,3
2021,"Bournemouth, Christchurch and Poole 030A",E01015440,2042,1895,147,72,57,16,2
2021,"Bournemouth, Christchurch and Poole 023C",E01015441,1905,1744,161,78,54,28,1
2021,"Bournemouth, Christchurch and Poole 023D",E01015442,1961,1775,186,74,83,26,3
2021,"Bournemouth, Christchurch and Poole 023E",E01015443,1898,1702,196,95,74,20,7
2021,"Bournemouth, Christchurch and Poole 023F",E01015444,1680,1588,92,50,35,7,0
2021,"Bournemouth, Christchurch and Poole 034A",E01015445,1854,1768,86,50,24,8,4
2021,"Bournemouth, Christchurch and Poole 034B",E01015446,1583,1507,76,38,28,7,3
2021,"Bournemouth, Christchurch and Poole 030B",E01015447,1679,1638,41,29,6,6,0
2021,"Bournemouth, Christchurch and Poole 034C",E01015448,1550,1445,105,55,40,5,5
2021,"Bournemouth, Christchurch and Poole 030C",E01015449,1721,1610,111,59,32,14,6
2021,"Bournemouth, Christchurch and Poole 034D",E01015450,1690,1607,83,48,24,8,3
2021,"Bournemouth, Christchurch and Poole 034E",E01015451,1537,1488,49,30,12,7,0
2021,"Bournemouth, Christchurch and Poole 047A",E01015452,2038,1971,67,34,23,9,1
2021,"Bournemouth, Christchurch and Poole 047B",E01015453,1872,1773,99,57,30,11,1
2021,"Bournemouth, Christchurch and Poole 047C",E01015454,2011,1886,125,62,50,11,2
2021,"Bournemouth, Christchurch and Poole 047D",E01015455,1875,1847,28,26,1,0,1
2021,"Bournemouth, Christchurch and Poole 030D",E01015456,1769,1683,86,49,26,10,1
2021,"Bournemouth, Christchurch and Poole 030E",E01015457,1820,1718,102,49,36,14,3
2021,"Bournemouth, Christchurch and Poole 043A",E01015458,1527,1502,25,17,8,0,0
2021,"Bournemouth, Christchurch and Poole 047E",E01015459,1750,1724,26,17,9,0,0
2021,"Bournemouth, Christchurch and Poole 043B",E01015460,1785,1593,192,101,72,17,2
2021,"Bournemouth, Christchurch and Poole 043C",E01015461,1594,1494,100,40,38,22,0
2021,"Bournemouth, Christchurch and Poole 043D",E01015462,1647,1515,132,54,65,13,0
2021,"Bournemouth, Christchurch and Poole 043E",E01015463,1626,1546,80,43,33,2,2
2021,"Bournemouth, Christchurch and Poole 043F",E01015464,1597,1564,33,17,11,5,0
2021,"Bournemouth, Christchurch and Poole 044A",E01015465,1685,1534,151,61,69,21,0
2021,"Bournemouth, Christchurch and Poole 044B",E01015466,1732,1580,152,80,54,16,2
2021,Swindon 028A,E01015471,2062,1904,158,95,44,16,3
2021,Swindon 008A,E01015473,1889,1838,51,21,18,11,1
2021,Swindon 015A,E01015475,2399,1875,524,187,225,88,24
2021,Swindon 015C,E01015477,1662,1251,411,160,154,75,22
2021,Swindon 021A,E01015478,1515,1303,212,101,66,40,5
2021,Swindon 017A,E01015479,2245,1850,395,160,161,57,17
2021,Swindon 015D,E01015480,3043,2285,758,248,351,125,34
2021,Swindon 013A,E01015481,1710,1595,115,54,32,22,7
2021,Swindon 013B,E01015482,1208,1157,51,25,14,8,4
2021,Swindon 013C,E01015483,1335,1308,27,17,8,1,1
2021,Swindon 013D,E01015484,1380,1296,84,31,30,12,11
2021,Swindon 013E,E01015485,1342,1276,66,39,22,5,0
2021,Swindon 013F,E01015486,1344,1258,86,36,33,14,3
2021,Swindon 023A,E01015487,1444,1334,110,66,28,11,5
2021,Swindon 023B,E01015488,1417,1315,102,46,38,17,1
2021,Swindon 023C,E01015489,1384,1228,156,90,44,15,7
2021,Swindon 023D,E01015490,1220,1112,108,62,35,9,2
2021,Swindon 023E,E01015491,1361,1277,84,38,35,11,0
2021,Swindon 023F,E01015492,1355,1221,134,48,56,23,7
2021,Swindon 017B,E01015493,2147,1644,503,216,179,86,22
2021,Swindon 019A,E01015494,2084,1559,525,210,215,92,8
2021,Swindon 019C,E01015496,1802,1493,309,131,117,54,7
2021,Swindon 019D,E01015497,1574,1399,175,68,76,25,6
2021,Swindon 021B,E01015498,1664,1514,150,64,59,23,4
2021,Swindon 018A,E01015499,1373,1274,99,53,21,23,2
2021,Swindon 018B,E01015500,1424,1275,149,56,61,23,9
2021,Swindon 022A,E01015501,1287,1143,144,51,52,34,7
2021,Swindon 022B,E01015502,1499,1305,194,79,75,38,2
2021,Swindon 022C,E01015503,1276,1091,185,68,74,35,8
2021,Swindon 018C,E01015504,1251,1192,59,33,14,11,1
2021,Swindon 018D,E01015505,1435,1267,168,67,59,36,6
2021,Swindon 007A,E01015506,1450,1304,146,50,60,28,8
2021,Swindon 007B,E01015507,1550,1434,116,44,54,13,5
2021,Swindon 010A,E01015508,1479,1333,146,60,52,25,9
2021,Swindon 010B,E01015509,1697,1470,227,89,98,31,9
2021,Swindon 010C,E01015510,2069,1630,439,140,198,79,22
2021,Swindon 010D,E01015511,1790,1491,299,107,134,48,10
2021,Swindon 028C,E01015512,1607,1482,125,70,38,11,6
2021,Swindon 004A,E01015513,1401,1283,118,53,55,7,3
2021,Swindon 004B,E01015514,1179,1143,36,13,16,7,0
2021,Swindon 004C,E01015515,1379,1333,46,26,17,3,0
2021,Swindon 004D,E01015516,1259,1186,73,32,24,10,7
2021,Swindon 004E,E01015517,1355,1328,27,17,9,0,1
2021,Swindon 028D,E01015518,1451,1324,127,63,42,19,3
2021,Swindon 001A,E01015519,1469,1439,30,19,5,5,1
2021,Swindon 001B,E01015520,1229,1187,42,23,9,9,1
2021,Swindon 001C,E01015521,1551,1519,32,21,10,1,0
2021,Swindon 001D,E01015522,1294,1263,31,22,5,4,0
2021,Swindon 001E,E01015523,1583,1562,21,11,7,3,0
2021,Swindon 001F,E01015524,1064,1035,29,13,14,2,0
2021,Swindon 026A,E01015525,1506,1436,70,39,23,6,2
2021,Swindon 006A,E01015526,1448,1363,85,37,35,12,1
2021,Swindon 007C,E01015527,1691,1602,89,36,27,21,5
2021,Swindon 006B,E01015528,2082,1917,165,75,54,33,3
2021,Swindon 006C,E01015529,1570,1463,107,44,44,18,1
2021,Swindon 006D,E01015530,2031,1828,203,100,65,29,9
2021,Swindon 021D,E01015532,1613,1482,131,59,53,16,3
2021,Swindon 024A,E01015533,1449,1388,61,48,8,3,2
2021,Swindon 024B,E01015534,2096,1865,231,140,66,24,1
2021,Swindon 024C,E01015535,2027,1877,150,89,47,13,1
2021,Swindon 020A,E01015537,1731,1482,249,114,88,41,6
2021,Swindon 016A,E01015538,1851,1560,291,109,113,54,15
2021,Swindon 020B,E01015539,1609,1384,225,93,75,50,7
2021,Swindon 020C,E01015540,1796,1482,314,126,130,46,12
2021,Swindon 020D,E01015541,1749,1438,311,110,113,63,25
2021,Swindon 020E,E01015542,1357,1216,141,43,55,39,4
2021,Swindon 003A,E01015543,1481,1379,102,47,43,9,3
2021,Swindon 003B,E01015544,1685,1601,84,32,42,8,2
2021,Swindon 003C,E01015545,1577,1501,76,37,32,7,0
2021,Swindon 003D,E01015546,1745,1630,115,52,37,19,7
2021,Swindon 008C,E01015547,1800,1749,51,35,10,5,1
2021,Swindon 008D,E01015548,1529,1505,24,17,4,0,3
2021,Swindon 009A,E01015549,1606,1516,90,37,37,13,3
2021,Swindon 009B,E01015550,1797,1670,127,63,48,13,3
2021,Swindon 009C,E01015551,1615,1553,62,34,25,3,0
2021,Swindon 009D,E01015552,2167,2048,119,51,48,14,6
2021,Swindon 009E,E01015553,1466,1391,75,32,25,18,0
2021,Swindon 009F,E01015554,1346,1322,24,14,5,3,2
2021,Swindon 005A,E01015555,1451,1388,63,29,22,10,2
2021,Swindon 005B,E01015556,1462,1402,60,24,30,5,1
2021,Swindon 005C,E01015557,1745,1653,92,53,31,7,1
2021,Swindon 005D,E01015558,1510,1426,84,44,21,18,1
2021,Swindon 005E,E01015559,1449,1357,92,37,37,15,3
2021,Swindon 005F,E01015560,2026,1820,206,112,70,23,1
2021,Swindon 014A,E01015561,1534,1339,195,104,68,19,4
2021,Swindon 011A,E01015562,1447,1362,85,38,28,16,3
2021,Swindon 011B,E01015563,1444,1371,73,38,30,3,2
2021,Swindon 014B,E01015564,1485,1395,90,54,21,12,3
2021,Swindon 011C,E01015565,1424,1324,100,41,37,20,2
2021,Swindon 011D,E01015566,1516,1385,131,72,40,18,1
2021,Swindon 014C,E01015567,1572,1353,219,108,82,26,3
2021,Swindon 014D,E01015568,1629,1332,297,133,95,57,12
2021,Swindon 022D,E01015569,1468,1335,133,58,52,20,3
2021,Swindon 022E,E01015570,1424,1246,178,67,73,31,7
2021,Swindon 022F,E01015571,1498,1317,181,71,70,32,8
2021,Swindon 016B,E01015572,1332,1159,173,66,74,25,8
2021,Swindon 016C,E01015573,2216,1906,310,134,116,49,11
2021,Swindon 017C,E01015574,1573,1432,141,52,60,23,6
2021,Swindon 016D,E01015575,1349,1167,182,64,75,39,4
2021,Swindon 017D,E01015576,1536,1350,186,78,69,28,11
2021,Swindon 012B,E01015578,2082,1694,388,175,134,72,7
2021,Swindon 012C,E01015579,1599,1389,210,75,99,30,6
2021,Swindon 007D,E01015580,1668,1611,57,19,24,9,5
2021,Swindon 012D,E01015581,1590,1499,91,56,24,9,2
2021,Swindon 012E,E01015582,2085,1723,362,214,108,36,4
2021,Swindon 025B,E01015584,1403,1387,16,9,6,1,0
2021,Swindon 025C,E01015585,1929,1851,78,50,19,8,1
2021,Swindon 025D,E01015586,1340,1319,21,9,8,4,0
2021,Swindon 025E,E01015587,1810,1771,39,20,8,7,4
2021,Swindon 025F,E01015588,1737,1704,33,19,11,2,1
2021,Peterborough 004A,E01015589,1956,1941,15,11,3,0,1
2021,Peterborough 004B,E01015590,1480,1443,37,14,17,6,0
2021,Peterborough 011A,E01015591,1479,1255,224,88,94,39,3
2021,Peterborough 011B,E01015592,1525,1144,381,140,157,71,13
2021,Peterborough 009A,E01015593,1591,1243,348,130,133,75,10
2021,Peterborough 011C,E01015594,2291,1740,551,241,226,70,14
2021,Peterborough 011D,E01015595,1563,1201,362,154,148,54,6
2021,Peterborough 009B,E01015596,1693,1252,441,155,185,84,17
2021,Peterborough 011E,E01015597,1697,1306,391,157,143,73,18
2021,Peterborough 015A,E01015598,1465,1263,202,111,65,20,6
2021,Peterborough 014A,E01015599,2547,1396,1151,348,454,291,58
2021,Peterborough 014B,E01015600,1834,1014,820,166,351,257,46
2021,Peterborough 012A,E01015601,2185,1269,916,204,379,297,36
2021,Peterborough 010A,E01015603,2402,1280,1122,246,470,339,67
2021,Peterborough 010B,E01015604,1889,949,940,246,342,298,54
2021,Peterborough 008A,E01015605,1702,1321,381,112,184,78,7
2021,Peterborough 013A,E01015606,1805,1387,418,141,194,71,12
2021,Peterborough 007A,E01015607,1706,1278,428,174,161,80,13
2021,Peterborough 008B,E01015608,1684,1260,424,157,181,79,7
2021,Peterborough 007B,E01015609,1801,1168,633,231,264,119,19
2021,Peterborough 008C,E01015610,1875,1423,452,171,193,75,13
2021,Peterborough 014D,E01015612,2406,1367,1039,280,433,277,49
2021,Peterborough 013C,E01015613,1521,1173,348,127,160,57,4
2021,Peterborough 013D,E01015614,2054,1461,593,236,269,75,13
2021,Peterborough 013E,E01015615,1866,1347,519,185,226,93,15
2021,Peterborough 013F,E01015616,2117,1357,760,246,309,180,25
2021,Peterborough 005A,E01015617,1401,1368,33,23,7,2,1
2021,Peterborough 005B,E01015618,1277,1225,52,18,28,5,1
2021,Peterborough 005C,E01015619,2168,2039,129,44,47,35,3
2021,Peterborough 005D,E01015620,2096,2044,52,30,16,5,1
2021,Peterborough 016A,E01015622,2519,1929,590,259,232,92,7
2021,Peterborough 017B,E01015623,1748,1476,272,87,119,52,14
2021,Peterborough 017C,E01015624,1666,1348,318,123,130,61,4
2021,Peterborough 004C,E01015626,1291,1242,49,26,18,4,1
2021,Peterborough 018A,E01015627,1757,1723,34,17,11,5,1
2021,Peterborough 004D,E01015628,1956,1912,44,17,19,7,1
2021,Peterborough 001A,E01015629,1709,1674,35,18,9,3,5
2021,Peterborough 003A,E01015630,1937,1850,87,44,29,13,1
2021,Peterborough 003B,E01015631,1432,1396,36,15,12,8,1
2021,Peterborough 010C,E01015632,1913,1166,747,220,326,174,27
2021,Peterborough 008D,E01015633,2334,1826,508,167,240,92,9
2021,Peterborough 008E,E01015634,1990,1310,680,211,287,164,18
2021,Peterborough 001B,E01015635,1566,1550,16,10,6,0,0
2021,Peterborough 001C,E01015636,1095,1084,11,5,3,2,1
2021,Peterborough 021A,E01015637,1559,1253,306,113,128,53,12
2021,Peterborough 022A,E01015638,1588,1458,130,60,47,17,6
2021,Peterborough 021B,E01015639,1671,1280,391,147,174,62,8
2021,Peterborough 021C,E01015640,1471,1176,295,136,117,37,5
2021,Peterborough 021D,E01015641,1338,1099,239,81,109,43,6
2021,Peterborough 021E,E01015642,1617,1193,424,151,202,58,13
2021,Peterborough 023A,E01015643,1399,1205,194,79,80,33,2
2021,Peterborough 018B,E01015644,2468,2192,276,129,93,46,8
2021,Peterborough 018C,E01015645,1635,1491,144,57,60,24,3
2021,Peterborough 018D,E01015646,1817,1739,78,40,28,9,1
2021,Peterborough 021F,E01015647,1598,1243,355,151,133,58,13
2021,Peterborough 018E,E01015648,1312,1277,35,21,12,1,1
2021,Peterborough 022B,E01015650,1951,1760,191,79,78,30,4
2021,Peterborough 012B,E01015651,2184,1538,646,194,283,136,33
2021,Peterborough 012C,E01015652,2193,1386,807,202,350,217,38
2021,Peterborough 012D,E01015653,1876,1452,424,139,165,102,18
2021,Peterborough 012E,E01015654,2666,1540,1126,267,500,314,45
2021,Peterborough 014E,E01015655,2107,1375,732,227,297,183,25
2021,Peterborough 007C,E01015656,1557,1324,233,92,88,40,13
2021,Peterborough 007E,E01015658,1616,1257,359,118,139,84,18
2021,Peterborough 003C,E01015659,1846,1643,203,93,83,25,2
2021,Peterborough 007F,E01015660,1556,1400,156,54,69,28,5
2021,Peterborough 010D,E01015661,2246,1685,561,174,268,105,14
2021,Peterborough 009C,E01015662,1447,963,484,195,198,82,9
2021,Peterborough 009D,E01015663,1544,1083,461,158,206,85,12
2021,Peterborough 009E,E01015664,1652,1219,433,147,178,96,12
2021,Peterborough 016C,E01015665,1756,1174,582,178,253,119,32
2021,Peterborough 017D,E01015666,1395,1262,133,35,69,26,3
2021,Peterborough 019A,E01015667,1397,1218,179,79,75,25,0
2021,Peterborough 017E,E01015668,2001,1563,438,156,197,78,7
2021,Peterborough 019B,E01015669,1439,1279,160,74,59,24,3
2021,Peterborough 019C,E01015670,1396,1247,149,66,59,22,2
2021,Peterborough 019E,E01015672,1473,1336,137,60,51,20,6
2021,Peterborough 019F,E01015673,1469,1318,151,57,63,20,11
2021,Peterborough 006A,E01015674,1502,1317,185,79,79,26,1
2021,Peterborough 006B,E01015675,1569,1422,147,58,51,29,9
2021,Peterborough 006C,E01015676,1926,1611,315,117,147,40,11
2021,Peterborough 010E,E01015677,1145,883,262,92,103,53,14
2021,Peterborough 002A,E01015678,1295,1183,112,53,43,14,2
2021,Peterborough 001D,E01015679,1670,1534,136,63,58,12,3
2021,Peterborough 002B,E01015680,1457,1290,167,63,71,28,5
2021,Peterborough 002C,E01015681,1442,1367,75,43,18,13,1
2021,Peterborough 002D,E01015682,1392,1293,99,49,40,8,2
2021,Peterborough 006D,E01015683,1746,1686,60,25,24,8,3
2021,Peterborough 003D,E01015684,1381,1325,56,21,23,12,0
2021,Peterborough 003E,E01015685,1498,1439,59,20,28,10,1
2021,Peterborough 006E,E01015686,1452,1403,49,17,26,4,2
2021,Peterborough 015B,E01015687,1607,1329,278,150,80,38,10
2021,Peterborough 016D,E01015688,2403,1848,555,276,199,72,8
2021,Peterborough 015C,E01015689,1457,1359,98,49,27,17,5
2021,Peterborough 015D,E01015690,1237,1105,132,61,46,22,3
2021,Peterborough 015E,E01015691,1962,1538,424,221,144,48,11
2021,Peterborough 016E,E01015692,1604,1048,556,155,241,129,31
2021,Luton 007A,E01015693,1689,1517,172,72,61,35,4
2021,Luton 007B,E01015694,1526,1262,264,63,128,61,12
2021,Luton 007C,E01015695,1700,1485,215,77,81,51,6
2021,Luton 007D,E01015696,1303,1124,179,82,75,18,4
2021,Luton 007E,E01015697,1669,1484,185,76,74,29,6
2021,Luton 017A,E01015698,1689,1048,641,129,272,200,40
2021,Luton 017B,E01015699,1865,1148,717,176,296,203,42
2021,Luton 010A,E01015700,2706,2026,680,239,277,141,23
2021,Luton 010B,E01015701,2140,1497,643,140,264,208,31
2021,Luton 017C,E01015702,1834,1309,525,135,186,177,27
2021,Luton 015A,E01015703,2037,1422,615,160,204,212,39
2021,Luton 010C,E01015704,2034,1193,841,194,317,269,61
2021,Luton 017D,E01015705,1542,895,647,162,269,185,31
2021,Luton 001A,E01015706,1362,1212,150,75,55,16,4
2021,Luton 001B,E01015707,1430,1289,141,74,42,18,7
2021,Luton 001C,E01015708,1344,1235,109,47,45,13,4
2021,Luton 001D,E01015709,1460,1297,163,73,70,20,0
2021,Luton 001E,E01015710,1440,1272,168,74,59,25,10
2021,Luton 011A,E01015711,1910,1367,543,162,235,126,20
2021,Luton 011B,E01015712,1990,1532,458,139,191,112,16
2021,Luton 013A,E01015713,1576,1151,425,198,143,70,14
2021,Luton 013B,E01015714,1878,1391,487,226,176,72,13
2021,Luton 011C,E01015715,2108,1592,516,165,207,125,19
2021,Luton 011D,E01015716,2113,1657,456,155,157,115,29
2021,Luton 011E,E01015717,1639,1210,429,133,193,82,21
2021,Luton 013C,E01015718,1536,1225,311,166,104,37,4
2021,Luton 016A,E01015719,2020,1625,395,194,141,43,17
2021,Luton 016B,E01015720,1641,1298,343,104,164,66,9
2021,Luton 014A,E01015721,1627,1324,303,134,130,34,5
2021,Luton 014B,E01015722,1383,1146,237,102,101,31,3
2021,Luton 016C,E01015723,1379,1121,258,110,105,38,5
2021,Luton 019A,E01015724,2443,1637,806,212,371,203,20
2021,Luton 017E,E01015725,1723,979,744,143,277,261,63
2021,Luton 015B,E01015726,2295,1577,718,163,282,222,51
2021,Luton 017F,E01015727,2282,1489,793,212,301,225,55
2021,Luton 019B,E01015728,1703,1105,598,195,252,121,30
2021,Luton 019C,E01015729,2180,1288,892,178,358,286,70
2021,Luton 019D,E01015730,2352,1266,1086,303,444,286,53
2021,Luton 015C,E01015731,2060,1484,576,160,224,167,25
2021,Luton 020A,E01015732,1798,1515,283,91,122,62,8
2021,Luton 020B,E01015733,2057,1630,427,155,166,93,13
2021,Luton 020C,E01015734,1962,1464,498,204,217,67,10
2021,Luton 020D,E01015735,1828,1043,785,214,401,138,32
2021,Luton 020E,E01015736,1965,1525,440,150,180,96,14
2021,Luton 020F,E01015737,1556,1218,338,124,142,64,8
2021,Luton 021A,E01015738,1936,1290,646,273,259,101,13
2021,Luton 022A,E01015739,2055,1214,841,315,372,133,21
2021,Luton 012A,E01015740,1571,1205,366,128,148,80,10
2021,Luton 022B,E01015742,1922,1305,617,237,275,92,13
2021,Luton 022E,E01015743,1708,1185,523,196,207,106,14
2021,Luton 004A,E01015744,1522,1257,265,103,102,55,5
2021,Luton 007F,E01015745,1602,1324,278,122,101,51,4
2021,Luton 004B,E01015746,1565,1402,163,66,66,24,7
2021,Luton 004C,E01015747,1416,1249,167,86,54,23,4
2021,Luton 004D,E01015748,1736,1559,177,65,65,42,5
2021,Luton 005A,E01015749,2187,1809,378,147,117,96,18
2021,Luton 011F,E01015750,2557,1804,753,310,274,149,20
2021,Luton 005B,E01015751,2004,1668,336,129,150,47,10
2021,Luton 005C,E01015752,1386,1131,255,97,103,48,7
2021,Luton 005D,E01015753,1532,1271,261,101,113,42,5
2021,Luton 005E,E01015754,1841,1497,344,116,138,76,14
2021,Luton 005F,E01015755,1815,1514,301,130,107,58,6
2021,Luton 009A,E01015756,1740,1455,285,144,91,44,6
2021,Luton 009B,E01015757,1624,1366,258,99,104,48,7
2021,Luton 009C,E01015758,1510,1237,273,109,120,36,8
2021,Luton 009D,E01015759,1669,1301,368,188,130,46,4
2021,Luton 009E,E01015760,1429,1178,251,113,90,40,8
2021,Luton 009F,E01015761,1751,1410,341,139,144,50,8
2021,Luton 013D,E01015762,1881,1438,443,204,174,51,14
2021,Luton 013E,E01015763,1595,1287,308,146,108,39,15
2021,Luton 006A,E01015764,1611,1376,235,93,95,44,3
2021,Luton 006B,E01015765,1797,1369,428,160,173,83,12
2021,Luton 006C,E01015766,1678,1400,278,119,106,48,5
2021,Luton 006D,E01015767,1594,1320,274,106,119,42,7
2021,Luton 006E,E01015768,1574,1386,188,70,71,40,7
2021,Luton 003A,E01015769,1231,1033,198,87,82,26,3
2021,Luton 001F,E01015770,1309,1131,178,84,63,28,3
2021,Luton 003B,E01015771,1537,1278,259,86,96,73,4
2021,Luton 003C,E01015772,1542,1255,287,93,119,62,13
2021,Luton 003D,E01015773,1238,1035,203,61,90,42,10
2021,Luton 003E,E01015774,1398,1126,272,101,118,40,13
2021,Luton 012B,E01015775,1807,1574,233,132,75,24,2
2021,Luton 012C,E01015776,1921,1643,278,107,133,31,7
2021,Luton 012D,E01015777,1835,1479,356,142,138,66,10
2021,Luton 012E,E01015778,1766,1462,304,109,150,44,1
2021,Luton 016D,E01015779,1506,1289,217,83,85,43,6
2021,Luton 016E,E01015780,1733,1468,265,108,107,44,6
2021,Luton 016F,E01015781,1605,1335,270,98,113,52,7
2021,Luton 010D,E01015782,2354,1775,579,155,265,139,20
2021,Luton 006F,E01015783,1728,1288,440,146,181,103,10
2021,Luton 010E,E01015784,2473,1875,598,155,267,145,31
2021,Luton 006G,E01015785,2462,1896,566,176,257,116,17
2021,Luton 010F,E01015786,2302,1691,611,159,259,160,33
2021,Luton 015D,E01015787,2354,1707,647,206,254,154,33
2021,Luton 015E,E01015788,2015,1334,681,157,245,232,47
2021,Luton 023D,E01015789,2272,1598,674,269,285,104,16
2021,Luton 021B,E01015790,1565,1171,394,141,160,85,8
2021,Luton 021D,E01015792,1844,1100,744,289,349,97,9
2021,Luton 021E,E01015793,1712,1367,345,136,152,46,11
2021,Luton 021F,E01015795,2560,1498,1062,402,460,179,21
2021,Luton 012F,E01015796,1427,1316,111,53,38,19,1
2021,Luton 008A,E01015797,1264,1214,50,28,17,5,0
2021,Luton 008B,E01015798,1324,1208,116,53,39,20,4
2021,Luton 008C,E01015799,1354,1237,117,50,49,18,0
2021,Luton 008D,E01015800,1392,1227,165,91,60,11,3
2021,Luton 002A,E01015801,1827,1503,324,132,114,67,11
2021,Luton 003F,E01015802,1568,1364,204,92,83,28,1
2021,Luton 002B,E01015803,1552,1364,188,76,71,35,6
2021,Luton 002C,E01015804,1878,1620,258,111,97,46,4
2021,Luton 002D,E01015805,1249,1067,182,92,63,23,4
2021,Luton 014C,E01015806,1328,1148,180,94,72,9,5
2021,Luton 016G,E01015807,1648,1380,268,116,109,41,2
2021,Luton 014D,E01015808,1388,1215,173,75,75,17,6
2021,Luton 014E,E01015809,1388,1269,119,48,53,13,5
2021,Luton 014F,E01015810,1334,1218,116,56,43,15,2
2021,Luton 014G,E01015811,1401,1228,173,84,67,16,6
2021,Luton 008E,E01015812,1303,1188,115,57,36,18,4
2021,Luton 008F,E01015813,1310,1121,189,86,74,25,4
2021,Southend-on-Sea 003A,E01015814,1347,1321,26,15,3,4,4
2021,Southend-on-Sea 003B,E01015815,1604,1577,27,16,9,2,0
2021,Southend-on-Sea 003C,E01015816,1540,1513,27,14,8,4,1
2021,Southend-on-Sea 003D,E01015817,1625,1599,26,15,10,1,0
2021,Southend-on-Sea 003E,E01015818,1663,1619,44,22,15,5,2
2021,Southend-on-Sea 003F,E01015819,1432,1389,43,17,14,10,2
2021,Southend-on-Sea 005A,E01015820,1637,1560,77,41,29,6,1
2021,Southend-on-Sea 005B,E01015821,1609,1580,29,16,11,2,0
2021,Southend-on-Sea 005C,E01015822,1227,1191,36,16,16,2,2
2021,Southend-on-Sea 005D,E01015823,1664,1622,42,22,15,5,0
2021,Southend-on-Sea 005E,E01015824,1521,1437,84,39,36,7,2
2021,Southend-on-Sea 005F,E01015825,1588,1526,62,35,20,7,0
2021,Southend-on-Sea 005G,E01015826,1375,1338,37,20,15,1,1
2021,Southend-on-Sea 012A,E01015827,1676,1607,69,34,19,10,6
2021,Southend-on-Sea 012B,E01015828,1704,1578,126,55,56,13,2
2021,Southend-on-Sea 012C,E01015829,1520,1474,46,21,18,5,2
2021,Southend-on-Sea 012D,E01015830,1505,1470,35,27,5,3,0
2021,Southend-on-Sea 012E,E01015831,1663,1440,223,102,81,36,4
2021,Southend-on-Sea 012F,E01015832,1583,1503,80,32,34,10,4
2021,Southend-on-Sea 001A,E01015833,1528,1505,23,13,7,2,1
2021,Southend-on-Sea 001B,E01015834,1400,1366,34,17,10,4,3
2021,Southend-on-Sea 001C,E01015835,1691,1655,36,25,8,3,0
2021,Southend-on-Sea 001D,E01015836,1485,1454,31,18,8,4,1
2021,Southend-on-Sea 001E,E01015837,1676,1650,26,8,10,5,3
2021,Southend-on-Sea 001F,E01015838,1431,1416,15,13,1,1,0
2021,Southend-on-Sea 014A,E01015839,1810,1629,181,86,60,31,4
2021,Southend-on-Sea 014B,E01015840,1734,1530,204,89,88,24,3
2021,Southend-on-Sea 014C,E01015841,2438,2054,384,138,136,95,15
2021,Southend-on-Sea 014D,E01015842,1908,1769,139,42,56,38,3
2021,Southend-on-Sea 014E,E01015843,1617,1475,142,64,56,19,3
2021,Southend-on-Sea 014F,E01015844,2045,1819,226,93,96,34,3
2021,Southend-on-Sea 011A,E01015845,1550,1524,26,17,7,1,1
2021,Southend-on-Sea 011B,E01015846,1692,1651,41,29,10,2,0
2021,Southend-on-Sea 011C,E01015847,1553,1501,52,26,23,2,1
2021,Southend-on-Sea 011D,E01015848,1620,1570,50,34,10,5,1
2021,Southend-on-Sea 011E,E01015849,1638,1590,48,27,15,5,1
2021,Southend-on-Sea 011F,E01015850,1526,1488,38,23,7,8,0
2021,Southend-on-Sea 015A,E01015851,1610,1487,123,56,40,21,6
2021,Southend-on-Sea 015B,E01015852,2036,1661,375,172,141,55,7
2021,Southend-on-Sea 015C,E01015853,1775,1652,123,61,52,9,1
2021,Southend-on-Sea 015D,E01015854,2093,1771,322,154,136,28,4
2021,Southend-on-Sea 015E,E01015855,1988,1704,284,114,117,44,9
2021,Southend-on-Sea 015F,E01015856,1784,1643,141,73,44,22,2
2021,Southend-on-Sea 004A,E01015857,1595,1555,40,27,11,2,0
2021,Southend-on-Sea 004B,E01015858,1786,1663,123,78,30,12,3
2021,Southend-on-Sea 004C,E01015859,1873,1697,176,107,49,19,1
2021,Southend-on-Sea 004D,E01015860,1529,1467,62,35,14,13,0
2021,Southend-on-Sea 004E,E01015861,1899,1730,169,84,58,22,5
2021,Southend-on-Sea 004F,E01015862,1653,1462,191,95,74,17,5
2021,Southend-on-Sea 002A,E01015863,2302,2250,52,34,15,3,0
2021,Southend-on-Sea 002B,E01015864,1406,1360,46,26,15,2,3
2021,Southend-on-Sea 002C,E01015865,1421,1372,49,27,12,8,2
2021,Southend-on-Sea 002D,E01015866,2056,1924,132,92,31,8,1
2021,Southend-on-Sea 002E,E01015867,1410,1361,49,33,12,4,0
2021,Southend-on-Sea 002F,E01015868,1641,1544,97,45,32,17,3
2021,Southend-on-Sea 006A,E01015869,1594,1497,97,51,34,11,1
2021,Southend-on-Sea 006B,E01015870,1566,1487,79,41,30,7,1
2021,Southend-on-Sea 006C,E01015871,1587,1484,103,48,37,17,1
2021,Southend-on-Sea 006D,E01015872,1588,1499,89,43,34,10,2
2021,Southend-on-Sea 006E,E01015873,1210,1168,42,17,16,9,0
2021,Southend-on-Sea 006F,E01015874,1675,1541,134,62,57,15,0
2021,Southend-on-Sea 006G,E01015875,1579,1479,100,44,35,21,0
2021,Southend-on-Sea 013A,E01015876,2424,2385,39,27,9,3,0
2021,Southend-on-Sea 013B,E01015877,1848,1798,50,26,12,8,4
2021,Southend-on-Sea 013C,E01015878,1224,1193,31,12,10,7,2
2021,Southend-on-Sea 013D,E01015879,1324,1285,39,20,12,4,3
2021,Southend-on-Sea 013E,E01015880,1474,1422,52,23,14,15,0
2021,Southend-on-Sea 013F,E01015881,1348,1315,33,23,8,2,0
2021,Southend-on-Sea 013G,E01015882,1709,1640,69,36,16,14,3
2021,Southend-on-Sea 009A,E01015883,1412,1353,59,37,15,5,2
2021,Southend-on-Sea 009B,E01015884,2262,2128,134,65,50,17,2
2021,Southend-on-Sea 009C,E01015885,1693,1620,73,44,19,7,3
2021,Southend-on-Sea 009D,E01015886,1471,1414,57,27,21,7,2
2021,Southend-on-Sea 009E,E01015887,1550,1479,71,36,23,10,2
2021,Southend-on-Sea 009F,E01015888,1470,1426,44,27,11,6,0
2021,Southend-on-Sea 016A,E01015889,1361,1328,33,18,8,7,0
2021,Southend-on-Sea 016B,E01015890,1505,1446,59,41,12,6,0
2021,Southend-on-Sea 016C,E01015891,1411,1333,78,30,38,9,1
2021,Southend-on-Sea 016D,E01015892,1634,1580,54,31,16,7,0
2021,Southend-on-Sea 016E,E01015893,1491,1457,34,17,13,4,0
2021,Southend-on-Sea 016F,E01015894,1483,1452,31,18,11,2,0
2021,Southend-on-Sea 010B,E01015896,1866,1590,276,137,91,47,1
2021,Southend-on-Sea 010C,E01015897,1974,1813,161,56,68,33,4
2021,Southend-on-Sea 010D,E01015898,1845,1641,204,82,82,37,3
2021,Southend-on-Sea 010E,E01015899,2015,1778,237,90,97,46,4
2021,Southend-on-Sea 010F,E01015900,1671,1411,260,119,97,41,3
2021,Southend-on-Sea 007A,E01015901,1545,1395,150,67,55,18,10
2021,Southend-on-Sea 007B,E01015902,1592,1372,220,96,83,37,4
2021,Southend-on-Sea 007C,E01015903,1555,1448,107,51,40,13,3
2021,Southend-on-Sea 007D,E01015904,1695,1546,149,90,43,13,3
2021,Southend-on-Sea 007E,E01015905,1429,1317,112,65,40,7,0
2021,Southend-on-Sea 007F,E01015906,1472,1316,156,85,47,19,5
2021,Southend-on-Sea 007G,E01015907,1526,1335,191,104,59,19,9
2021,Southend-on-Sea 008A,E01015908,1571,1560,11,9,2,0,0
2021,Southend-on-Sea 008B,E01015909,1492,1436,56,38,15,3,0
2021,Southend-on-Sea 008C,E01015910,1517,1487,30,17,6,6,1
2021,Southend-on-Sea 008D,E01015911,1246,1221,25,15,8,2,0
2021,Southend-on-Sea 008E,E01015912,1544,1526,18,12,5,1,0
2021,Southend-on-Sea 008F,E01015913,1678,1621,57,26,18,11,2
2021,Southend-on-Sea 017A,E01015914,1279,1229,50,29,14,5,2
2021,Southend-on-Sea 017B,E01015915,1395,1353,42,27,10,4,1
2021,Southend-on-Sea 017C,E01015916,1354,1292,62,29,24,9,0
2021,Southend-on-Sea 017D,E01015917,1596,1510,86,31,34,15,6
2021,Southend-on-Sea 017E,E01015918,1367,1330,37,21,12,3,1
2021,Southend-on-Sea 017F,E01015919,1322,1277,45,28,9,7,1
2021,Southend-on-Sea 017G,E01015920,1515,1483,32,12,14,4,2
2021,Thurrock 021A,E01015921,1238,1035,203,94,76,30,3
2021,Thurrock 008A,E01015922,1557,1460,97,29,45,19,4
2021,Thurrock 008B,E01015923,2208,1958,250,122,98,27,3
2021,Thurrock 008C,E01015924,1558,1412,146,77,52,16,1
2021,Thurrock 008D,E01015925,1726,1546,180,89,63,26,2
2021,Thurrock 008E,E01015926,2055,1848,207,106,76,21,4
2021,Thurrock 007A,E01015927,1846,1642,204,79,89,34,2
2021,Thurrock 007B,E01015928,1718,1579,139,45,56,22,16
2021,Thurrock 007C,E01015929,1488,1341,147,61,55,22,9
2021,Thurrock 007D,E01015930,1768,1585,183,80,72,30,1
2021,Thurrock 007E,E01015931,1455,1244,211,82,91,36,2
2021,Thurrock 006A,E01015932,1800,1637,163,71,69,18,5
2021,Thurrock 012A,E01015933,1730,1552,178,67,73,27,11
2021,Thurrock 012B,E01015934,1459,1353,106,45,45,14,2
2021,Thurrock 012C,E01015935,1794,1631,163,60,65,32,6
2021,Thurrock 012D,E01015936,1858,1738,120,45,54,18,3
2021,Thurrock 012E,E01015937,1543,1453,90,40,37,11,2
2021,Thurrock 012F,E01015938,1796,1654,142,55,57,26,4
2021,Thurrock 020A,E01015939,1485,1342,143,57,62,22,2
2021,Thurrock 020B,E01015941,1411,1214,197,70,96,28,3
2021,Thurrock 020C,E01015942,1491,1394,97,48,35,13,1
2021,Thurrock 001A,E01015943,1492,1470,22,10,9,3,0
2021,Thurrock 001B,E01015944,1255,1247,8,4,1,3,0
2021,Thurrock 002A,E01015945,1262,1237,25,11,9,4,1
2021,Thurrock 001C,E01015946,1540,1516,24,8,10,4,2
2021,Thurrock 013A,E01015947,1426,1329,97,52,32,12,1
2021,Thurrock 013B,E01015948,2484,2264,220,104,75,37,4
2021,Thurrock 013C,E01015949,1718,1601,117,55,40,17,5
2021,Thurrock 013D,E01015950,1729,1650,79,38,29,11,1
2021,Thurrock 017A,E01015951,1671,1264,407,156,183,55,13
2021,Thurrock 017B,E01015952,2225,1600,625,227,287,101,10
2021,Thurrock 017C,E01015953,2531,1732,799,301,374,109,15
2021,Thurrock 017D,E01015954,2422,1852,570,213,268,81,8
2021,Thurrock 016A,E01015955,1638,1318,320,137,142,35,6
2021,Thurrock 016B,E01015956,2063,1438,625,243,272,86,24
2021,Thurrock 009A,E01015957,1479,1329,150,58,71,18,3
2021,Thurrock 009B,E01015958,1314,1160,154,64,58,28,4
2021,Thurrock 016C,E01015959,1871,1435,436,154,189,76,17
2021,Thurrock 014A,E01015960,1464,1314,150,70,53,20,7
2021,Thurrock 016D,E01015961,1590,1155,435,158,195,64,18
2021,Thurrock 016E,E01015962,1767,1259,508,163,249,87,9
2021,Thurrock 010A,E01015963,1131,1062,69,25,30,11,3
2021,Thurrock 010B,E01015964,1574,1473,101,50,37,12,2
2021,Thurrock 010C,E01015965,2523,2221,302,169,98,27,8
2021,Thurrock 010D,E01015966,1596,1510,86,51,26,7,2
2021,Thurrock 014B,E01015967,1530,1376,154,52,76,18,8
2021,Thurrock 014C,E01015968,1399,1211,188,80,75,32,1
2021,Thurrock 014D,E01015969,1769,1489,280,122,121,32,5
2021,Thurrock 014E,E01015970,1365,1238,127,49,52,20,6
2021,Thurrock 006B,E01015971,1527,1358,169,67,70,26,6
2021,Thurrock 006C,E01015972,1849,1656,193,88,68,28,9
2021,Thurrock 006E,E01015974,1397,1327,70,34,29,5,2
2021,Thurrock 006F,E01015975,1538,1394,144,59,59,15,11
2021,Thurrock 007F,E01015976,1724,1550,174,79,65,25,5
2021,Thurrock 004A,E01015977,1875,1796,79,41,29,7,2
2021,Thurrock 004B,E01015978,1469,1436,33,16,11,1,5
2021,Thurrock 004C,E01015979,1424,1362,62,41,15,6,0
2021,Thurrock 004D,E01015980,1476,1461,15,8,4,2,1
2021,Thurrock 019A,E01015982,2542,2205,337,172,113,48,4
2021,Thurrock 002B,E01015983,1420,1381,39,15,18,5,1
2021,Thurrock 003A,E01015984,1237,1204,33,10,19,4,0
2021,Thurrock 003B,E01015985,1319,1300,19,15,4,0,0
2021,Thurrock 003C,E01015986,1482,1432,50,24,20,5,1
2021,Thurrock 002C,E01015987,1509,1454,55,28,24,3,0
2021,Thurrock 002D,E01015988,1402,1370,32,17,8,4,3
2021,Thurrock 005A,E01015989,1442,1371,71,42,20,9,0
2021,Thurrock 003D,E01015990,1483,1448,35,15,14,6,0
2021,Thurrock 005B,E01015991,1697,1645,52,25,22,5,0
2021,Thurrock 005C,E01015992,2706,2572,134,76,42,16,0
2021,Thurrock 009C,E01015993,1594,1528,66,27,23,13,3
2021,Thurrock 009D,E01015994,1662,1555,107,44,39,21,3
2021,Thurrock 009E,E01015995,1631,1552,79,43,29,5,2
2021,Thurrock 009F,E01015996,1694,1539,155,77,55,17,6
2021,Thurrock 001D,E01015997,1338,1309,29,16,8,3,2
2021,Thurrock 002E,E01015998,1481,1459,22,9,11,2,0
2021,Thurrock 001E,E01015999,1271,1236,35,19,9,6,1
2021,Thurrock 005D,E01016000,1430,1393,37,24,7,6,0
2021,Thurrock 003E,E01016001,1360,1328,32,14,10,6,2
2021,Thurrock 005E,E01016002,1302,1282,20,14,5,1,0
2021,Thurrock 018A,E01016003,2303,1851,452,171,191,82,8
2021,Thurrock 018B,E01016004,1868,1629,239,98,98,42,1
2021,Thurrock 018C,E01016005,1604,1431,173,78,74,21,0
2021,Thurrock 018D,E01016006,1795,1640,155,54,64,34,3
2021,Thurrock 018E,E01016007,1917,1680,237,96,94,39,8
2021,Thurrock 018F,E01016008,1488,1282,206,86,96,23,1
2021,Thurrock 018G,E01016009,1673,1517,156,54,79,21,2
2021,Thurrock 018H,E01016010,1477,1321,156,70,62,21,3
2021,Thurrock 022A,E01016011,1695,1268,427,166,193,62,6
2021,Thurrock 021C,E01016013,2396,1856,540,190,262,76,12
2021,Thurrock 021B,E01016014,2710,2283,427,182,174,62,9
2021,Thurrock 022B,E01016015,2559,1915,644,272,278,87,7
2021,Medway 015A,E01016016,1449,1209,240,103,88,45,4
2021,Medway 015B,E01016017,1624,1321,303,106,130,59,8
2021,Medway 022A,E01016018,1849,1541,308,143,116,42,7
2021,Medway 015C,E01016019,1745,1364,381,125,158,84,14
2021,Medway 021A,E01016020,1245,1055,190,88,60,37,5
2021,Medway 021B,E01016021,1561,1315,246,100,97,44,5
2021,Medway 021C,E01016022,1399,1131,268,86,130,47,5
2021,Medway 022B,E01016023,1715,1588,127,51,42,32,2
2021,Medway 022C,E01016024,1910,1603,307,107,140,48,12
2021,Medway 027A,E01016025,1574,1471,103,32,58,11,2
2021,Medway 028A,E01016026,1274,1260,14,9,5,0,0
2021,Medway 028B,E01016027,1474,1451,23,18,4,1,0
2021,Medway 028C,E01016028,1497,1472,25,13,6,6,0
2021,Medway 028D,E01016029,2143,2077,66,28,30,8,0
2021,Medway 010A,E01016030,1807,1716,91,52,29,8,2
2021,Medway 012A,E01016031,1710,1449,261,106,116,33,6
2021,Medway 010B,E01016032,1309,1239,70,29,33,5,3
2021,Medway 009A,E01016033,1207,1102,105,48,40,17,0
2021,Medway 010C,E01016034,2439,2330,109,60,30,15,4
2021,Medway 007A,E01016035,1855,1632,223,110,82,27,4
2021,Medway 009C,E01016037,1636,1397,239,100,83,50,6
2021,Medway 010D,E01016038,1556,1425,131,59,58,13,1
2021,Medway 009D,E01016039,1619,1441,178,82,66,23,7
2021,Medway 013A,E01016040,1733,1490,243,114,85,40,4
2021,Medway 012B,E01016041,1697,1452,245,113,81,39,12
2021,Medway 013B,E01016042,1406,1202,204,81,81,35,7
2021,Medway 013C,E01016043,1402,1294,108,57,34,15,2
2021,Medway 016A,E01016044,1703,1477,226,104,71,49,2
2021,Medway 012C,E01016045,1623,1374,249,112,89,40,8
2021,Medway 016B,E01016046,1536,1343,193,89,70,30,4
2021,Medway 016C,E01016047,1708,1422,286,111,117,48,10
2021,Medway 016D,E01016048,1662,1451,211,99,81,27,4
2021,Medway 012D,E01016049,1991,1613,378,154,122,89,13
2021,Medway 035A,E01016050,1635,1590,45,26,13,6,0
2021,Medway 035B,E01016051,1510,1457,53,30,12,11,0
2021,Medway 035C,E01016052,1616,1551,65,43,16,6,0
2021,Medway 035D,E01016053,1557,1518,39,16,16,5,2
2021,Medway 035E,E01016054,1563,1518,45,32,7,6,0
2021,Medway 038A,E01016055,1486,1451,35,14,14,6,1
2021,Medway 038B,E01016056,1387,1330,57,24,19,13,1
2021,Medway 038C,E01016057,1660,1628,32,20,8,4,0
2021,Medway 031A,E01016058,1393,1340,53,32,17,3,1
2021,Medway 031B,E01016059,1255,1216,39,21,12,6,0
2021,Medway 038D,E01016060,1557,1535,22,13,8,1,0
2021,Medway 020A,E01016061,1600,1372,228,91,85,46,6
2021,Medway 022D,E01016062,1541,1346,195,75,84,35,1
2021,Medway 020B,E01016063,1553,1278,275,99,104,61,11
2021,Medway 020C,E01016064,1641,1504,137,53,46,33,5
2021,Medway 027B,E01016065,1337,1289,48,19,18,9,2
2021,Medway 027C,E01016066,1629,1568,61,26,26,5,4
2021,Medway 027D,E01016067,1591,1534,57,22,22,11,2
2021,Medway 027E,E01016068,1676,1599,77,41,24,12,0
2021,Medway 020D,E01016069,1667,1287,380,126,158,83,13
2021,Medway 001A,E01016070,1631,1615,16,9,4,2,1
2021,Medway 001B,E01016071,1665,1638,27,13,12,0,2
2021,Medway 001C,E01016072,1269,1229,40,21,16,3,0
2021,Medway 003A,E01016073,2189,2139,50,16,20,12,2
2021,Medway 001D,E01016074,1990,1959,31,17,12,2,0
2021,Medway 003B,E01016075,1661,1634,27,11,12,4,0
2021,Medway 003D,E01016077,1555,1498,57,25,17,9,6
2021,Medway 034A,E01016078,1403,1337,66,38,23,5,0
2021,Medway 031C,E01016079,1256,1208,48,30,13,3,2
2021,Medway 034B,E01016080,1401,1364,37,23,14,0,0
2021,Medway 034C,E01016081,1583,1530,53,32,13,6,2
2021,Medway 034D,E01016082,1462,1420,42,21,12,4,5
2021,Medway 031D,E01016083,1254,1200,54,26,24,4,0
2021,Medway 031E,E01016084,1428,1347,81,31,37,13,0
2021,Medway 030A,E01016085,1598,1578,20,10,6,4,0
2021,Medway 030B,E01016086,1299,1275,24,14,5,5,0
2021,Medway 029A,E01016087,1729,1684,45,24,13,6,2
2021,Medway 029B,E01016088,1512,1438,74,36,30,8,0
2021,Medway 029C,E01016089,1505,1476,29,13,6,8,2
2021,Medway 029D,E01016090,1490,1466,24,15,7,0,2
2021,Medway 030C,E01016091,1502,1469,33,22,7,0,4
2021,Medway 036A,E01016092,1459,1434,25,19,3,3,0
2021,Medway 023A,E01016093,1759,1736,23,11,8,4,0
2021,Medway 025A,E01016094,1532,1498,34,24,5,2,3
2021,Medway 025B,E01016095,1299,1267,32,15,12,5,0
2021,Medway 023B,E01016096,1485,1446,39,23,12,3,1
2021,Medway 025C,E01016097,1426,1384,42,19,15,7,1
2021,Medway 025D,E01016098,1393,1293,100,39,43,16,2
2021,Medway 036B,E01016099,1485,1464,21,11,5,4,1
2021,Medway 036C,E01016100,1470,1441,29,13,9,5,2
2021,Medway 032A,E01016101,1399,1367,32,18,12,2,0
2021,Medway 025E,E01016102,1393,1349,44,22,15,7,0
2021,Medway 032B,E01016103,1826,1775,51,30,16,5,0
2021,Medway 032C,E01016104,1351,1318,33,24,8,1,0
2021,Medway 036D,E01016105,1359,1325,34,13,9,10,2
2021,Medway 036E,E01016106,1394,1364,30,13,13,4,0
2021,Medway 032D,E01016107,1434,1402,32,18,11,3,0
2021,Medway 015E,E01016111,1658,1402,256,104,114,33,5
2021,Medway 017A,E01016113,1440,1318,122,65,42,10,5
2021,Medway 017B,E01016114,1498,1415,83,49,24,9,1
2021,Medway 017C,E01016115,1907,1803,104,48,38,18,0
2021,Medway 024A,E01016116,1837,1707,130,56,48,26,0
2021,Medway 014A,E01016117,1853,1640,213,94,78,39,2
2021,Medway 017D,E01016118,1680,1517,163,74,56,31,2
2021,Medway 026A,E01016119,1479,1362,117,52,37,23,5
2021,Medway 026B,E01016120,1399,1324,75,37,21,15,2
2021,Medway 033A,E01016121,1455,1391,64,33,24,7,0
2021,Medway 033B,E01016122,2271,2105,166,96,46,20,4
2021,Medway 033C,E01016123,1477,1429,48,19,17,12,0
2021,Medway 026C,E01016124,1729,1595,134,69,48,15,2
2021,Medway 021D,E01016125,1743,1552,191,82,83,24,2
2021,Medway 026D,E01016126,1668,1537,131,72,32,22,5
2021,Medway 024B,E01016127,1459,1390,69,42,17,9,1
2021,Medway 024C,E01016128,2180,2094,86,32,37,11,6
2021,Medway 014B,E01016129,1884,1785,99,57,33,9,0
2021,Medway 014C,E01016130,1780,1660,120,65,42,11,2
2021,Medway 014D,E01016131,1658,1576,82,54,23,5,0
2021,Medway 024D,E01016132,1718,1651,67,33,27,5,2
2021,Medway 005A,E01016133,1342,1268,74,38,25,10,1
2021,Medway 005B,E01016134,1366,1293,73,37,25,9,2
2021,Medway 006A,E01016135,1550,1486,64,18,26,20,0
2021,Medway 006B,E01016136,1657,1519,138,39,64,34,1
2021,Medway 006C,E01016137,1514,1390,124,53,50,16,5
2021,Medway 005C,E01016138,1447,1389,58,26,19,12,1
2021,Medway 005D,E01016139,1637,1546,91,48,23,19,1
2021,Medway 006D,E01016140,1459,1321,138,58,62,17,1
2021,Medway 006E,E01016141,1728,1489,239,114,87,36,2
2021,Medway 002A,E01016142,1305,1290,15,8,7,0,0
2021,Medway 003E,E01016143,2868,2788,80,48,25,5,2
2021,Medway 002B,E01016144,1435,1410,25,9,11,4,1
2021,Medway 002C,E01016145,1328,1313,15,6,7,2,0
2021,Medway 004B,E01016147,1886,1810,76,37,27,5,7
2021,Medway 004C,E01016148,2115,2047,68,40,20,5,3
2021,Medway 002D,E01016149,1488,1469,19,10,5,3,1
2021,Medway 011A,E01016150,1717,1608,109,55,38,12,4
2021,Medway 008A,E01016151,1656,1548,108,59,28,18,3
2021,Medway 008B,E01016152,1515,1439,76,26,35,12,3
2021,Medway 008C,E01016153,1478,1394,84,27,44,11,2
2021,Medway 011B,E01016154,1668,1533,135,66,44,22,3
2021,Medway 008D,E01016155,1616,1550,66,28,31,6,1
2021,Medway 011C,E01016156,1628,1508,120,54,46,20,0
2021,Medway 011D,E01016157,2299,2163,136,69,51,15,1
2021,Medway 011E,E01016158,2313,2198,115,67,39,7,2
2021,Medway 019A,E01016159,1465,1390,75,37,26,9,3
2021,Medway 018A,E01016160,1477,1437,40,26,10,4,0
2021,Medway 018B,E01016161,1530,1495,35,15,9,7,4
2021,Medway 018C,E01016162,1602,1537,65,28,26,9,2
2021,Medway 018D,E01016163,1292,1253,39,25,9,5,0
2021,Medway 018E,E01016164,1429,1392,37,16,16,3,2
2021,Medway 018F,E01016165,1234,1197,37,21,9,6,1
2021,Medway 023C,E01016166,1518,1473,45,19,15,10,1
2021,Medway 023D,E01016167,1407,1366,41,20,15,6,0
2021,Medway 037A,E01016168,1612,1559,53,28,15,9,1
2021,Medway 037B,E01016169,1619,1565,54,26,16,10,2
2021,Medway 038E,E01016170,1537,1484,53,28,21,4,0
2021,Medway 037C,E01016171,1616,1567,49,23,19,7,0
2021,Medway 037D,E01016172,1423,1387,36,13,15,8,0
2021,Medway 033D,E01016173,1669,1606,63,26,28,9,0
2021,Medway 019B,E01016174,1454,1345,109,35,42,28,4
2021,Medway 019C,E01016175,1917,1779,138,75,40,21,2
2021,Medway 030D,E01016176,1461,1373,88,48,31,8,1
2021,Medway 013D,E01016177,1487,1401,86,42,28,10,6
2021,Medway 013E,E01016178,1442,1365,77,38,26,13,0
2021,Medway 019D,E01016179,1302,1230,72,38,21,11,2
2021,Bracknell Forest 005A,E01016180,1249,1182,67,45,20,2,0
2021,Bracknell Forest 005B,E01016181,1724,1610,114,75,28,8,3
2021,Bracknell Forest 005C,E01016182,1461,1411,50,32,16,1,1
2021,Bracknell Forest 005D,E01016183,1318,1207,111,79,23,9,0
2021,Bracknell Forest 002B,E01016185,1391,1230,161,82,54,18,7
2021,Bracknell Forest 002D,E01016187,1582,1541,41,32,8,1,0
2021,Bracknell Forest 002E,E01016188,1850,1780,70,41,24,5,0
2021,Bracknell Forest 003A,E01016190,1565,1452,113,61,32,19,1
2021,Bracknell Forest 006B,E01016191,1635,1534,101,59,31,10,1
2021,Bracknell Forest 014A,E01016192,1350,1288,62,29,17,10,6
2021,Bracknell Forest 015A,E01016193,1230,1093,137,47,49,31,10
2021,Bracknell Forest 014B,E01016194,1222,1198,24,13,6,5,0
2021,Bracknell Forest 014C,E01016195,1154,1080,74,30,22,12,10
2021,Bracknell Forest 015B,E01016196,2073,1558,515,271,212,26,6
2021,Bracknell Forest 015C,E01016197,1372,1245,127,50,47,23,7
2021,Bracknell Forest 015D,E01016198,1125,1051,74,30,25,15,4
2021,Bracknell Forest 015E,E01016199,1136,1056,80,40,26,9,5
2021,Bracknell Forest 008A,E01016200,1265,1149,116,57,41,14,4
2021,Bracknell Forest 008B,E01016201,1246,1170,76,39,32,4,1
2021,Bracknell Forest 008C,E01016202,1151,1025,126,56,49,21,0
2021,Bracknell Forest 008D,E01016203,1260,1167,93,44,34,10,5
2021,Bracknell Forest 008E,E01016204,1152,1083,69,31,28,4,6
2021,Bracknell Forest 010A,E01016205,1241,1159,82,48,27,7,0
2021,Bracknell Forest 012A,E01016206,1904,1832,72,44,20,4,4
2021,Bracknell Forest 013A,E01016207,1959,1866,93,57,29,6,1
2021,Bracknell Forest 012B,E01016208,2053,1968,85,50,32,2,1
2021,Bracknell Forest 009A,E01016209,1451,1345,106,44,36,21,5
2021,Bracknell Forest 009B,E01016210,1235,1080,155,95,44,14,2
2021,Bracknell Forest 011A,E01016212,1289,1144,145,67,52,25,1
2021,Bracknell Forest 009D,E01016213,1065,1027,38,20,14,3,1
2021,Bracknell Forest 009E,E01016214,1293,1240,53,36,12,4,1
2021,Bracknell Forest 009F,E01016215,1181,1080,101,48,41,11,1
2021,Bracknell Forest 011B,E01016216,1298,1193,105,44,43,16,2
2021,Bracknell Forest 010B,E01016217,1330,1227,103,47,42,13,1
2021,Bracknell Forest 010C,E01016218,1345,1240,105,45,41,15,4
2021,Bracknell Forest 011C,E01016219,1295,1211,84,40,33,9,2
2021,Bracknell Forest 011D,E01016220,1350,1204,146,73,51,20,2
2021,Bracknell Forest 011E,E01016221,1236,1153,83,50,28,5,0
2021,Bracknell Forest 005E,E01016222,1200,1117,83,48,27,7,1
2021,Bracknell Forest 006C,E01016223,1208,1098,110,47,48,10,5
2021,Bracknell Forest 006D,E01016224,2081,1878,203,119,63,15,6
2021,Bracknell Forest 006E,E01016226,1415,1255,160,79,61,16,4
2021,Bracknell Forest 014D,E01016227,1296,1267,29,18,9,1,1
2021,Bracknell Forest 014E,E01016228,1748,1700,48,33,13,2,0
2021,Bracknell Forest 012C,E01016229,1107,1096,11,7,4,0,0
2021,Bracknell Forest 012D,E01016230,1879,1808,71,47,21,2,1
2021,Bracknell Forest 010D,E01016231,1878,1738,140,77,46,15,2
2021,Bracknell Forest 010E,E01016232,1392,1299,93,50,29,12,2
2021,Bracknell Forest 007B,E01016233,2500,2274,226,103,87,32,4
2021,Bracknell Forest 013B,E01016234,1075,1033,42,29,8,3,2
2021,Bracknell Forest 013C,E01016235,1210,1169,41,23,16,2,0
2021,Bracknell Forest 013D,E01016236,1467,1313,154,75,50,18,11
2021,Bracknell Forest 013E,E01016237,1102,1044,58,29,19,8,2
2021,Bracknell Forest 003B,E01016238,1573,1426,147,105,30,10,2
2021,Bracknell Forest 004A,E01016239,1506,1437,69,33,30,6,0
2021,Bracknell Forest 004B,E01016240,1600,1447,153,83,46,24,0
2021,Bracknell Forest 004C,E01016241,1589,1488,101,59,34,7,1
2021,Bracknell Forest 004D,E01016242,2001,1793,208,122,64,18,4
2021,Bracknell Forest 003C,E01016243,1359,1293,66,42,20,2,2
2021,Bracknell Forest 003D,E01016245,2249,2109,140,91,30,18,1
2021,Bracknell Forest 003E,E01016246,1511,1434,77,54,18,4,1
2021,Bracknell Forest 003F,E01016247,1686,1580,106,62,35,6,3
2021,Bracknell Forest 007C,E01016248,1492,1333,159,86,55,13,5
2021,Bracknell Forest 007E,E01016250,1705,1537,168,77,68,23,0
2021,Bracknell Forest 001C,E01016252,1471,1423,48,29,14,3,2
2021,Bracknell Forest 001D,E01016253,1380,1327,53,26,20,7,0
2021,West Berkshire 011A,E01016254,1445,1412,33,21,10,2,0
2021,West Berkshire 011B,E01016255,1430,1390,40,18,15,6,1
2021,West Berkshire 003A,E01016256,1728,1696,32,28,3,1,0
2021,West Berkshire 003B,E01016257,1326,1303,23,9,10,4,0
2021,West Berkshire 005A,E01016258,1522,1487,35,18,12,3,2
2021,West Berkshire 006A,E01016259,1501,1436,65,36,16,10,3
2021,West Berkshire 006B,E01016260,1644,1579,65,42,15,6,2
2021,West Berkshire 005B,E01016261,1581,1537,44,33,7,4,0
2021,West Berkshire 006C,E01016262,1320,1283,37,25,11,1,0
2021,West Berkshire 007A,E01016263,2342,2299,43,33,10,0,0
2021,West Berkshire 011C,E01016264,1689,1644,45,32,11,2,0
2021,West Berkshire 011D,E01016265,1517,1488,29,11,12,3,3
2021,West Berkshire 011E,E01016266,1304,1282,22,14,7,1,0
2021,West Berkshire 015A,E01016267,1452,1420,32,22,6,4,0
2021,West Berkshire 015B,E01016268,1670,1622,48,29,14,4,1
2021,West Berkshire 015C,E01016269,1402,1358,44,26,17,1,0
2021,West Berkshire 015D,E01016270,1408,1372,36,24,10,1,1
2021,West Berkshire 008A,E01016271,1431,1325,106,67,22,15,2
2021,West Berkshire 006D,E01016272,1487,1377,110,67,36,5,2
2021,West Berkshire 006E,E01016273,1667,1574,93,50,36,7,0
2021,West Berkshire 008B,E01016274,1413,1294,119,54,44,13,8
2021,West Berkshire 008C,E01016275,1401,1283,118,81,23,14,0
2021,West Berkshire 008D,E01016276,1420,1342,78,43,23,10,2
2021,West Berkshire 001A,E01016277,1570,1490,80,22,22,23,13
2021,West Berkshire 013A,E01016279,2133,1783,350,179,120,42,9
2021,West Berkshire 013B,E01016280,1780,1527,253,113,96,38,6
2021,West Berkshire 013C,E01016281,1376,1316,60,41,13,6,0
2021,West Berkshire 013D,E01016282,1429,1317,112,48,49,15,0
2021,West Berkshire 007D,E01016284,1344,1308,36,18,12,2,4
2021,West Berkshire 007E,E01016285,1578,1539,39,25,11,3,0
2021,West Berkshire 001B,E01016286,1729,1696,33,18,8,6,1
2021,West Berkshire 001C,E01016287,1398,1371,27,18,8,1,0
2021,West Berkshire 001D,E01016288,1693,1667,26,14,8,4,0
2021,West Berkshire 021A,E01016289,1395,1379,16,14,1,1,0
2021,West Berkshire 021B,E01016290,1510,1459,51,30,16,5,0
2021,West Berkshire 021C,E01016291,1844,1752,92,49,33,10,0
2021,West Berkshire 021D,E01016292,1584,1504,80,46,24,8,2
2021,West Berkshire 020A,E01016294,1476,1350,126,69,37,18,2
2021,West Berkshire 020B,E01016295,1427,1346,81,49,22,10,0
2021,West Berkshire 010A,E01016296,1506,1461,45,28,17,0,0
2021,West Berkshire 010B,E01016297,1591,1580,11,8,2,1,0
2021,West Berkshire 010C,E01016298,1144,1094,50,24,17,9,0
2021,West Berkshire 010D,E01016299,1455,1403,52,19,28,4,1
2021,West Berkshire 018A,E01016300,1409,1384,25,16,7,2,0
2021,West Berkshire 018B,E01016301,1997,1955,42,23,11,6,2
2021,West Berkshire 018C,E01016302,1553,1522,31,15,7,7,2
2021,West Berkshire 002A,E01016303,1438,1407,31,16,12,3,0
2021,West Berkshire 002B,E01016304,1561,1486,75,44,18,8,5
2021,West Berkshire 002C,E01016305,1226,1181,45,18,23,4,0
2021,West Berkshire 002D,E01016306,1321,1310,11,6,2,3,0
2021,West Berkshire 022A,E01016307,1659,1603,56,32,14,9,1
2021,West Berkshire 022B,E01016308,1884,1856,28,17,8,3,0
2021,West Berkshire 022C,E01016309,2345,2236,109,70,28,9,2
2021,West Berkshire 012A,E01016310,1927,1771,156,89,51,13,3
2021,West Berkshire 012B,E01016311,1647,1479,168,78,67,22,1
2021,West Berkshire 020C,E01016312,1957,1773,184,100,55,26,3
2021,West Berkshire 003C,E01016313,1636,1612,24,16,6,2,0
2021,West Berkshire 003D,E01016314,1550,1481,69,46,20,3,0
2021,West Berkshire 004A,E01016315,1588,1531,57,39,14,3,1
2021,West Berkshire 004B,E01016316,2024,1949,75,49,13,9,4
2021,West Berkshire 004C,E01016317,1498,1429,69,46,21,1,1
2021,West Berkshire 004D,E01016318,1452,1397,55,32,16,7,0
2021,West Berkshire 020D,E01016319,1780,1677,103,68,22,10,3
2021,West Berkshire 020E,E01016320,1403,1314,89,38,37,13,1
2021,West Berkshire 021E,E01016321,1592,1463,129,70,45,11,3
2021,West Berkshire 021F,E01016322,1409,1382,27,21,6,0,0
2021,West Berkshire 012C,E01016323,1354,1282,72,33,27,11,1
2021,West Berkshire 012D,E01016324,1368,1322,46,37,0,9,0
2021,West Berkshire 012E,E01016325,1495,1365,130,62,46,20,2
2021,West Berkshire 018D,E01016326,1364,1331,33,16,16,1,0
2021,West Berkshire 009A,E01016327,1187,1160,27,19,6,2,0
2021,West Berkshire 009B,E01016328,1853,1779,74,46,18,9,1
2021,West Berkshire 014A,E01016329,1370,1324,46,22,23,1,0
2021,West Berkshire 016A,E01016330,1352,1300,52,26,19,5,2
2021,West Berkshire 016B,E01016331,1480,1424,56,25,25,6,0
2021,West Berkshire 016C,E01016332,1512,1432,80,29,35,13,3
2021,West Berkshire 017A,E01016333,1230,1191,39,25,10,3,1
2021,West Berkshire 016D,E01016334,1667,1581,86,47,28,11,0
2021,West Berkshire 017B,E01016335,1468,1416,52,24,19,8,1
2021,West Berkshire 016E,E01016336,1269,1221,48,19,23,5,1
2021,West Berkshire 017C,E01016337,2293,2189,104,56,29,13,6
2021,West Berkshire 017D,E01016338,1719,1665,54,31,18,5,0
2021,West Berkshire 011F,E01016339,2754,2641,113,65,37,9,2
2021,West Berkshire 014B,E01016340,1868,1798,70,39,25,6,0
2021,West Berkshire 014C,E01016341,1314,1278,36,26,8,2,0
2021,West Berkshire 014D,E01016342,1938,1817,121,74,34,12,1
2021,West Berkshire 014E,E01016343,1374,1354,20,16,1,3,0
2021,West Berkshire 009C,E01016344,1525,1459,66,26,32,7,1
2021,West Berkshire 009D,E01016345,1445,1385,60,35,17,5,3
2021,West Berkshire 019B,E01016346,1417,1222,195,100,70,22,3
2021,West Berkshire 019D,E01016348,2294,1983,311,158,108,44,1
2021,West Berkshire 005C,E01016349,1234,1197,37,23,7,5,2
2021,West Berkshire 005D,E01016350,1458,1413,45,18,20,5,2
2021,Reading 019C,E01016353,2017,1210,807,316,305,147,39
2021,Reading 007A,E01016355,1840,1396,444,233,140,64,7
2021,Reading 008A,E01016356,1557,1127,430,168,178,73,11
2021,Reading 008B,E01016357,1725,1264,461,200,182,62,17
2021,Reading 007B,E01016358,1832,1235,597,221,249,92,35
2021,Reading 007C,E01016359,2671,1830,841,352,345,122,22
2021,Reading 007D,E01016360,2449,1481,968,326,435,174,33
2021,Reading 007E,E01016361,2017,1322,695,253,314,105,23
2021,Reading 004A,E01016362,1739,1478,261,173,70,16,2
2021,Reading 004B,E01016363,1862,1672,190,92,72,19,7
2021,Reading 003A,E01016364,1394,1315,79,59,15,5,0
2021,Reading 004C,E01016365,1624,1364,260,179,61,17,3
2021,Reading 004D,E01016366,1534,1413,121,69,34,17,1
2021,Reading 004E,E01016367,1597,1381,216,128,64,23,1
2021,Reading 017A,E01016368,1529,1295,234,79,112,32,11
2021,Reading 018A,E01016369,1723,1431,292,125,100,53,14
2021,Reading 016A,E01016370,3506,2952,554,302,208,42,2
2021,Reading 016B,E01016371,1669,1379,290,151,96,38,5
2021,Reading 017B,E01016372,1363,1084,279,93,127,45,14
2021,Reading 016C,E01016373,1579,1344,235,116,76,31,12
2021,Reading 014A,E01016374,1706,1180,526,251,176,86,13
2021,Reading 014B,E01016375,1237,847,390,158,153,64,15
2021,Reading 014C,E01016376,1826,1300,526,221,206,73,26
2021,Reading 017C,E01016377,1715,1195,520,188,242,77,13
2021,Reading 014D,E01016379,2059,1451,608,289,223,82,14
2021,Reading 005A,E01016380,1682,1590,92,55,34,2,1
2021,Reading 006A,E01016381,1482,1248,234,109,89,32,4
2021,Reading 006B,E01016382,1858,1501,357,140,143,59,15
2021,Reading 005B,E01016383,1506,1403,103,48,39,15,1
2021,Reading 005C,E01016384,1627,1536,91,51,29,8,3
2021,Reading 006C,E01016385,1618,1437,181,104,59,16,2
2021,Reading 002A,E01016386,1490,1423,67,46,13,6,2
2021,Reading 002B,E01016387,1543,1450,93,61,23,7,2
2021,Reading 013A,E01016388,1430,1145,285,136,109,30,10
2021,Reading 013B,E01016389,1772,1491,281,133,97,48,3
2021,Reading 013C,E01016390,1549,1179,370,181,126,51,12
2021,Reading 020E,E01016391,2005,1456,549,309,182,47,11
2021,Reading 013D,E01016392,2164,1671,493,250,170,65,8
2021,Reading 013E,E01016393,1895,1505,390,252,93,40,5
2021,Reading 009A,E01016394,1467,1337,130,69,38,19,4
2021,Reading 008C,E01016395,1378,1222,156,80,51,21,4
2021,Reading 006D,E01016396,1612,1378,234,113,87,29,5
2021,Reading 006E,E01016397,1720,1434,286,145,104,30,7
2021,Reading 008D,E01016398,1701,1344,357,141,152,60,4
2021,Reading 008E,E01016399,1464,1254,210,98,89,19,4
2021,Reading 008F,E01016400,1624,1170,454,176,189,71,18
2021,Reading 012A,E01016401,1408,1187,221,113,71,32,5
2021,Reading 010B,E01016402,1839,1362,477,196,178,87,16
2021,Reading 012B,E01016403,2074,1762,312,176,95,39,2
2021,Reading 010C,E01016404,2110,1431,679,270,249,122,38
2021,Reading 010D,E01016405,2094,1197,897,309,357,162,69
2021,Reading 010E,E01016406,1550,1216,334,149,130,45,10
2021,Reading 001A,E01016407,1525,1432,93,46,34,12,1
2021,Reading 001B,E01016408,1413,1302,111,67,30,13,1
2021,Reading 003B,E01016409,1811,1632,179,111,44,19,5
2021,Reading 001C,E01016410,1730,1556,174,102,40,24,8
2021,Reading 001D,E01016411,1618,1551,67,45,14,7,1
2021,Reading 001E,E01016412,1491,1343,148,80,50,17,1
2021,Reading 014E,E01016413,1741,1387,354,208,115,25,6
2021,Reading 014F,E01016414,1784,1398,386,240,100,36,10
2021,Reading 016D,E01016415,1666,1278,388,142,176,53,17
2021,Reading 012C,E01016416,1978,1513,465,234,150,55,26
2021,Reading 012D,E01016417,1718,1492,226,118,68,29,11
2021,Reading 012E,E01016418,1581,1351,230,138,67,25,0
2021,Reading 015A,E01016419,2025,1690,335,188,104,39,4
2021,Reading 015B,E01016420,1500,1263,237,106,86,43,2
2021,Reading 015C,E01016421,1255,1166,89,39,41,9,0
2021,Reading 015D,E01016422,1374,1220,154,64,55,27,8
2021,Reading 015E,E01016423,1536,1377,159,87,51,15,6
2021,Reading 015F,E01016424,1381,1210,171,97,56,15,3
2021,Reading 002C,E01016425,1707,1604,103,67,23,8,5
2021,Reading 002D,E01016426,1426,1374,52,36,11,2,3
2021,Reading 003C,E01016427,1657,1514,143,96,36,8,3
2021,Reading 003D,E01016428,1863,1701,162,105,39,17,1
2021,Reading 003E,E01016429,1611,1530,81,43,32,5,1
2021,Reading 002E,E01016430,1417,1321,96,78,6,7,5
2021,Reading 005D,E01016431,1631,1565,66,39,18,6,3
2021,Reading 005E,E01016432,1446,1401,45,27,15,3,0
2021,Reading 009B,E01016433,1426,1365,61,34,19,8,0
2021,Reading 009C,E01016434,1994,1734,260,123,85,45,7
2021,Reading 009D,E01016435,1493,1386,107,51,34,16,6
2021,Reading 009E,E01016436,1544,1492,52,32,16,4,0
2021,Reading 018B,E01016437,1385,1182,203,91,78,28,6
2021,Reading 017D,E01016438,1379,1203,176,63,80,24,9
2021,Reading 018C,E01016439,1892,1560,332,167,128,30,7
2021,Reading 018D,E01016440,1471,1269,202,77,79,36,10
2021,Reading 018E,E01016441,1480,1322,158,81,46,26,5
2021,Reading 017F,E01016443,1565,1317,248,99,106,30,13
2021,Slough 004A,E01016444,1706,1220,486,178,209,81,18
2021,Slough 004B,E01016445,1840,1357,483,170,194,95,24
2021,Slough 004C,E01016446,1669,1183,486,143,186,133,24
2021,Slough 004D,E01016447,1807,1183,624,221,284,104,15
2021,Slough 004E,E01016448,2335,1482,853,278,345,190,40
2021,Slough 004F,E01016449,2393,1672,721,232,270,183,36
2021,Slough 001A,E01016450,1548,1238,310,111,129,51,19
2021,Slough 001B,E01016451,1792,1444,348,173,122,49,4
2021,Slough 001C,E01016452,1902,1529,373,166,142,59,6
2021,Slough 001D,E01016453,1644,1426,218,109,74,32,3
2021,Slough 001E,E01016454,1605,1354,251,118,94,34,5
2021,Slough 001F,E01016455,2020,1630,390,195,149,41,5
2021,Slough 016D,E01016456,2135,1338,797,235,346,191,25
2021,Slough 016C,E01016457,1979,1292,687,249,284,133,21
2021,Slough 015A,E01016458,1792,1335,457,153,172,116,16
2021,Slough 016A,E01016460,2019,1235,784,289,339,144,12
2021,Slough 009A,E01016462,2455,1537,918,335,387,157,39
2021,Slough 009B,E01016463,1933,1311,622,215,253,123,31
2021,Slough 009C,E01016464,2116,1395,721,188,286,209,38
2021,Slough 009D,E01016465,2750,1749,1001,399,384,185,33
2021,Slough 006A,E01016467,1504,1113,391,167,148,54,22
2021,Slough 006B,E01016468,1909,1639,270,138,97,32,3
2021,Slough 006C,E01016469,1750,1405,345,175,118,46,6
2021,Slough 006D,E01016470,1699,1342,357,181,123,43,10
2021,Slough 006E,E01016471,1430,1202,228,108,77,35,8
2021,Slough 006F,E01016472,1727,1452,275,123,100,43,9
2021,Slough 008A,E01016473,2621,2012,609,316,213,76,4
2021,Slough 008B,E01016474,2004,1455,549,218,218,86,27
2021,Slough 008C,E01016475,2147,1428,719,244,302,154,19
2021,Slough 008D,E01016476,1722,1351,371,187,138,39,7
2021,Slough 008E,E01016477,2673,2041,632,308,237,80,7
2021,Slough 008F,E01016478,1887,1430,457,176,198,70,13
2021,Slough 014A,E01016479,1611,1178,433,185,170,69,9
2021,Slough 014B,E01016480,1401,1124,277,117,132,27,1
2021,Slough 014C,E01016481,1451,1119,332,149,138,43,2
2021,Slough 014D,E01016482,1659,1192,467,191,188,79,9
2021,Slough 002A,E01016483,2007,1232,775,230,350,165,30
2021,Slough 002B,E01016484,1752,1147,605,198,250,127,30
2021,Slough 002C,E01016485,1799,1161,638,265,249,108,16
2021,Slough 002D,E01016486,1626,1213,413,152,170,79,12
2021,Slough 002E,E01016487,1756,1102,654,221,257,155,21
2021,Slough 002F,E01016488,1851,1221,630,251,270,101,8
2021,Slough 013B,E01016490,1949,1549,400,175,168,45,12
2021,Slough 013C,E01016491,1751,1369,382,207,122,43,10
2021,Slough 013D,E01016492,1731,1367,364,211,116,33,4
2021,Slough 003A,E01016493,1210,1066,144,76,46,12,10
2021,Slough 003B,E01016494,1809,1426,383,180,153,47,3
2021,Slough 003C,E01016495,1411,1143,268,132,95,33,8
2021,Slough 003D,E01016496,1309,1124,185,87,73,20,5
2021,Slough 003E,E01016497,1384,1151,233,150,50,20,13
2021,Slough 003F,E01016498,1587,1304,283,125,115,37,6
2021,Slough 003G,E01016499,1318,1054,264,106,111,44,3
2021,Slough 012A,E01016500,1895,1408,487,258,164,57,8
2021,Slough 012B,E01016501,1729,1432,297,149,104,34,10
2021,Slough 012C,E01016502,1543,1118,425,223,143,53,6
2021,Slough 012D,E01016503,1614,1174,440,247,144,40,9
2021,Slough 012E,E01016504,1448,1095,353,187,121,40,5
2021,Slough 012F,E01016505,1765,1314,451,228,165,46,12
2021,Slough 010A,E01016506,1769,1343,426,200,147,66,13
2021,Slough 010B,E01016507,1839,1379,460,227,169,56,8
2021,Slough 010C,E01016508,2135,1536,599,367,166,53,13
2021,Slough 010D,E01016509,1611,1270,341,213,103,24,1
2021,Slough 010E,E01016510,2061,1536,525,320,140,59,6
2021,Slough 011A,E01016511,2276,1533,743,288,310,127,18
2021,Slough 011D,E01016514,1935,1361,574,255,215,96,8
2021,Slough 011E,E01016515,2031,1488,543,307,158,69,9
2021,Slough 005A,E01016516,1876,1286,590,202,261,113,14
2021,Slough 005B,E01016517,1648,1147,501,176,219,95,11
2021,Slough 005C,E01016518,1851,1187,664,239,269,144,12
2021,Slough 005D,E01016519,2851,2061,790,385,265,116,24
2021,Slough 005E,E01016520,1707,1244,463,164,194,82,23
2021,Slough 005F,E01016521,2025,1481,544,212,222,91,19
2021,Windsor and Maidenhead 017A,E01016522,1853,1782,71,34,26,11,0
2021,Windsor and Maidenhead 017B,E01016523,1544,1423,121,84,30,7,0
2021,Windsor and Maidenhead 017C,E01016524,2068,1950,118,86,27,5,0
2021,Windsor and Maidenhead 005A,E01016525,1724,1573,151,109,36,6,0
2021,Windsor and Maidenhead 006A,E01016526,1751,1618,133,79,40,12,2
2021,Windsor and Maidenhead 006B,E01016527,1551,1401,150,101,35,14,0
2021,Windsor and Maidenhead 005B,E01016528,1641,1396,245,141,64,35,5
2021,Windsor and Maidenhead 005C,E01016529,2066,1664,402,202,124,67,9
2021,Windsor and Maidenhead 002A,E01016530,1544,1505,39,25,13,1,0
2021,Windsor and Maidenhead 002B,E01016531,1395,1368,27,17,4,6,0
2021,Windsor and Maidenhead 002C,E01016532,1873,1813,60,29,20,11,0
2021,Windsor and Maidenhead 002D,E01016533,1847,1812,35,19,10,2,4
2021,Windsor and Maidenhead 006C,E01016534,1588,1485,103,73,16,13,1
2021,Windsor and Maidenhead 007A,E01016535,1307,1096,211,124,58,23,6
2021,Windsor and Maidenhead 005D,E01016536,1853,1564,289,167,76,40,6
2021,Windsor and Maidenhead 007B,E01016537,1749,1439,310,129,121,56,4
2021,Windsor and Maidenhead 007C,E01016538,1519,1317,202,108,61,29,4
2021,Windsor and Maidenhead 009A,E01016539,1577,1478,99,62,24,11,2
2021,Windsor and Maidenhead 009B,E01016540,1583,1497,86,57,23,6,0
2021,Windsor and Maidenhead 009C,E01016541,1311,1226,85,45,30,10,0
2021,Windsor and Maidenhead 009D,E01016542,1186,1122,64,33,24,7,0
2021,Windsor and Maidenhead 009E,E01016543,1901,1832,69,45,19,5,0
2021,Windsor and Maidenhead 010A,E01016544,1955,1707,248,151,57,31,9
2021,Windsor and Maidenhead 012A,E01016545,2054,1768,286,166,102,17,1
2021,Windsor and Maidenhead 015A,E01016546,1572,1389,183,140,31,12,0
2021,Windsor and Maidenhead 012B,E01016547,1678,1515,163,108,39,15,1
2021,Windsor and Maidenhead 014A,E01016548,1838,1687,151,99,41,11,0
2021,Windsor and Maidenhead 014B,E01016549,1955,1807,148,97,37,14,0
2021,Windsor and Maidenhead 012C,E01016550,1441,1329,112,60,43,7,2
2021,Windsor and Maidenhead 013A,E01016551,1533,1421,112,70,31,8,3
2021,Windsor and Maidenhead 012D,E01016552,1695,1571,124,79,34,10,1
2021,Windsor and Maidenhead 013B,E01016553,1460,1376,84,55,18,7,4
2021,Windsor and Maidenhead 014C,E01016554,1709,1565,144,76,50,16,2
2021,Windsor and Maidenhead 014D,E01016555,1585,1434,151,85,59,6,1
2021,Windsor and Maidenhead 014E,E01016556,1799,1634,165,106,46,11,2
2021,Windsor and Maidenhead 013C,E01016557,1874,1703,171,107,45,17,2
2021,Windsor and Maidenhead 013D,E01016558,1343,1258,85,46,31,7,1
2021,Windsor and Maidenhead 008A,E01016559,1447,1344,103,77,17,8,1
2021,Windsor and Maidenhead 008B,E01016560,1506,1395,111,56,31,21,3
2021,Windsor and Maidenhead 008C,E01016561,1766,1635,131,86,37,7,1
2021,Windsor and Maidenhead 008D,E01016562,1343,1272,71,46,21,4,0
2021,Windsor and Maidenhead 008E,E01016563,1326,1222,104,75,25,4,0
2021,Windsor and Maidenhead 011A,E01016564,1708,1552,156,87,57,10,2
2021,Windsor and Maidenhead 011B,E01016565,1634,1495,139,99,33,7,0
2021,Windsor and Maidenhead 011C,E01016566,1651,1445,206,101,71,26,8
2021,Windsor and Maidenhead 010B,E01016567,3118,2946,172,112,43,15,2
2021,Windsor and Maidenhead 010C,E01016568,1243,1190,53,32,13,5,3
2021,Windsor and Maidenhead 010D,E01016569,1014,978,36,26,9,1,0
2021,Windsor and Maidenhead 001A,E01016570,1533,1435,98,63,28,7,0
2021,Windsor and Maidenhead 003A,E01016571,1760,1623,137,97,26,14,0
2021,Windsor and Maidenhead 001B,E01016572,1335,1268,67,42,21,4,0
2021,Windsor and Maidenhead 003B,E01016573,1460,1328,132,56,50,21,5
2021,Windsor and Maidenhead 003C,E01016574,1537,1307,230,99,91,33,7
2021,Windsor and Maidenhead 016A,E01016575,1845,1636,209,132,50,20,7
2021,Windsor and Maidenhead 016B,E01016576,1773,1660,113,60,46,6,1
2021,Windsor and Maidenhead 011D,E01016577,1798,1591,207,117,68,18,4
2021,Windsor and Maidenhead 002E,E01016578,1688,1597,91,68,17,2,4
2021,Windsor and Maidenhead 002F,E01016579,1761,1698,63,30,27,5,1
2021,Windsor and Maidenhead 008F,E01016580,1507,1441,66,41,17,7,1
2021,Windsor and Maidenhead 002G,E01016581,1421,1390,31,21,7,3,0
2021,Windsor and Maidenhead 001C,E01016582,1562,1302,260,94,107,48,11
2021,Windsor and Maidenhead 004A,E01016583,1838,1626,212,153,45,10,4
2021,Windsor and Maidenhead 005E,E01016584,2242,1856,386,215,110,60,1
2021,Windsor and Maidenhead 004B,E01016585,1637,1428,209,121,59,26,3
2021,Windsor and Maidenhead 004C,E01016586,1315,1233,82,61,16,5,0
2021,Windsor and Maidenhead 016C,E01016587,1704,1611,93,59,26,6,2
2021,Windsor and Maidenhead 016D,E01016588,1778,1724,54,33,15,6,0
2021,Windsor and Maidenhead 016E,E01016589,1708,1618,90,64,17,8,1
2021,Windsor and Maidenhead 004D,E01016591,2242,1935,307,237,52,15,3
2021,Windsor and Maidenhead 004E,E01016592,1980,1687,293,178,85,25,5
2021,Windsor and Maidenhead 007D,E01016593,1754,1577,177,94,62,16,5
2021,Windsor and Maidenhead 007E,E01016594,1510,1358,152,94,43,13,2
2021,Windsor and Maidenhead 015B,E01016595,1756,1604,152,93,39,19,1
2021,Windsor and Maidenhead 015C,E01016596,1907,1736,171,113,45,13,0
2021,Windsor and Maidenhead 015D,E01016597,1683,1559,124,86,27,9,2
2021,Windsor and Maidenhead 006D,E01016598,1406,1332,74,51,16,7,0
2021,Windsor and Maidenhead 003D,E01016599,1620,1484,136,77,36,19,4
2021,Windsor and Maidenhead 001D,E01016600,1091,1059,32,21,6,4,1
2021,Windsor and Maidenhead 006E,E01016601,1602,1495,107,79,19,8,1
2021,Windsor and Maidenhead 006F,E01016602,1621,1554,67,41,14,11,1
2021,Windsor and Maidenhead 018A,E01016603,1748,1594,154,106,37,11,0
2021,Windsor and Maidenhead 018B,E01016604,2213,2054,159,112,33,14,0
2021,Windsor and Maidenhead 018C,E01016605,1567,1492,75,46,23,5,1
2021,Windsor and Maidenhead 018D,E01016606,1642,1526,116,79,24,12,1
2021,Windsor and Maidenhead 018E,E01016607,1949,1828,121,86,32,3,0
2021,Windsor and Maidenhead 018F,E01016608,1905,1779,126,69,39,17,1
2021,Windsor and Maidenhead 017D,E01016609,1803,1636,167,110,34,20,3
2021,Wokingham 018B,E01016611,1823,1675,148,93,43,11,1
2021,Wokingham 015A,E01016612,2607,2532,75,50,18,6,1
2021,Wokingham 006A,E01016613,1485,1194,291,151,99,33,8
2021,Wokingham 006B,E01016614,1496,1276,220,93,74,44,9
2021,Wokingham 005A,E01016615,1476,1320,156,84,53,19,0
2021,Wokingham 005B,E01016616,1597,1426,171,81,47,34,9
2021,Wokingham 005C,E01016617,1998,1825,173,115,45,12,1
2021,Wokingham 006C,E01016618,1288,1122,166,89,61,12,4
2021,Wokingham 002A,E01016619,1604,1545,59,36,15,7,1
2021,Wokingham 002B,E01016620,1475,1422,53,33,14,5,1
2021,Wokingham 003A,E01016621,1500,1419,81,47,20,13,1
2021,Wokingham 004A,E01016622,1138,1101,37,20,13,3,1
2021,Wokingham 003B,E01016623,1470,1399,71,40,20,7,4
2021,Wokingham 003C,E01016624,1370,1301,69,46,14,9,0
2021,Wokingham 016A,E01016625,1707,1596,111,71,30,9,1
2021,Wokingham 013A,E01016626,2050,1852,198,127,49,21,1
2021,Wokingham 010A,E01016627,2010,1913,97,65,26,6,0
2021,Wokingham 010B,E01016628,2470,2290,180,137,29,11,3
2021,Wokingham 015B,E01016629,1368,1317,51,43,4,1,3
2021,Wokingham 015C,E01016630,1470,1388,82,54,19,7,2
2021,Wokingham 016B,E01016631,1302,1195,107,64,29,12,2
2021,Wokingham 016C,E01016632,1815,1676,139,89,37,11,2
2021,Wokingham 019A,E01016633,1337,1296,41,29,9,3,0
2021,Wokingham 016D,E01016634,1952,1814,138,93,28,17,0
2021,Wokingham 015D,E01016635,1374,1258,116,79,28,8,1
2021,Wokingham 019B,E01016636,1445,1392,53,38,11,3,1
2021,Wokingham 019C,E01016637,1117,1070,47,25,14,7,1
2021,Wokingham 019D,E01016638,1252,1216,36,28,8,0,0
2021,Wokingham 019E,E01016639,1550,1488,62,47,12,3,0
2021,Wokingham 019F,E01016640,1561,1507,54,33,13,8,0
2021,Wokingham 019G,E01016643,1368,1343,25,17,5,2,1
2021,Wokingham 011A,E01016644,1404,1163,241,167,64,10,0
2021,Wokingham 011B,E01016645,1488,1253,235,150,65,17,3
2021,Wokingham 011C,E01016646,1572,1418,154,106,37,10,1
2021,Wokingham 009A,E01016647,1792,1576,216,161,38,14,3
2021,Wokingham 011D,E01016648,1423,1220,203,146,42,12,3
2021,Wokingham 011E,E01016649,1402,1241,161,109,41,11,0
2021,Wokingham 012A,E01016651,1427,1227,200,109,66,24,1
2021,Wokingham 008B,E01016652,1211,1067,144,103,37,3,1
2021,Wokingham 008C,E01016653,1368,1207,161,123,28,10,0
2021,Wokingham 012B,E01016654,1335,1166,169,111,43,15,0
2021,Wokingham 012C,E01016655,1258,1069,189,130,36,20,3
2021,Wokingham 010C,E01016656,1447,1405,42,29,7,6,0
2021,Wokingham 004B,E01016657,1411,1374,37,27,10,0,0
2021,Wokingham 004C,E01016658,2594,2338,256,167,64,22,3
2021,Wokingham 004D,E01016659,1348,1261,87,48,32,5,2
2021,Wokingham 004E,E01016660,1638,1528,110,65,37,7,1
2021,Wokingham 007A,E01016661,1268,1208,60,36,14,6,4
2021,Wokingham 005D,E01016662,1702,1595,107,63,29,12,3
2021,Wokingham 007B,E01016663,1561,1434,127,83,26,11,7
2021,Wokingham 006D,E01016664,1284,1066,218,146,59,10,3
2021,Wokingham 008D,E01016665,1534,1306,228,165,51,10,2
2021,Wokingham 008E,E01016666,1373,1196,177,136,34,5,2
2021,Wokingham 006E,E01016668,1665,1398,267,156,82,24,5
2021,Wokingham 006F,E01016669,1906,1668,238,154,66,16,2
2021,Wokingham 014A,E01016670,2677,2515,162,126,26,8,2
2021,Wokingham 013B,E01016671,2057,1919,138,74,42,20,2
2021,Wokingham 014B,E01016672,2659,2489,170,112,44,11,3
2021,Wokingham 013C,E01016673,1772,1630,142,70,48,22,2
2021,Wokingham 013D,E01016674,1766,1642,124,87,28,9,0
2021,Wokingham 001B,E01016676,1540,1504,36,23,9,3,1
2021,Wokingham 001D,E01016678,1409,1323,86,18,28,17,23
2021,Wokingham 012D,E01016679,2194,1841,353,216,96,33,8
2021,Wokingham 012E,E01016680,1312,1106,206,104,78,21,3
2021,Wokingham 003D,E01016684,1548,1437,111,67,33,8,3
2021,Wokingham 003E,E01016685,1575,1498,77,50,19,6,2
2021,Wokingham 007C,E01016686,1100,1009,91,64,20,6,1
2021,Wokingham 007D,E01016687,1198,1092,106,60,31,13,2
2021,Wokingham 007E,E01016688,2015,1683,332,229,66,27,10
2021,Wokingham 007F,E01016689,1343,1284,59,32,23,4,0
2021,Wokingham 017C,E01016690,2130,2044,86,61,15,8,2
2021,Wokingham 017D,E01016691,1257,1227,30,19,9,2,0
2021,Wokingham 002C,E01016692,1501,1448,53,40,9,4,0
2021,Wokingham 002D,E01016693,1329,1280,49,29,15,4,1
2021,Wokingham 002E,E01016694,1542,1486,56,35,14,7,0
2021,Wokingham 002F,E01016695,1556,1513,43,28,13,1,1
2021,Wokingham 013E,E01016696,1757,1571,186,87,59,33,7
2021,Wokingham 016E,E01016699,1720,1636,84,49,18,16,1
2021,Wokingham 010D,E01016700,1936,1785,151,113,26,8,4
2021,Wokingham 009B,E01016701,1968,1880,88,63,21,4,0
2021,Wokingham 009C,E01016702,1773,1629,144,93,36,14,1
2021,Wokingham 009D,E01016703,2597,2327,270,196,57,13,4
2021,Wokingham 009E,E01016704,2224,2029,195,118,58,15,4
2021,Wokingham 020A,E01016705,1597,1396,201,60,71,48,22
2021,Wokingham 020B,E01016706,1647,1603,44,26,17,0,1
2021,Wokingham 020C,E01016707,1738,1685,53,39,8,5,1
2021,Wokingham 020D,E01016708,1582,1505,77,61,14,2,0
2021,Wokingham 020E,E01016709,1624,1590,34,24,6,4,0
2021,Milton Keynes 030A,E01016710,1938,1732,206,92,66,40,8
2021,Milton Keynes 031A,E01016711,2799,2561,238,121,82,28,7
2021,Milton Keynes 031B,E01016713,1683,1537,146,76,47,20,3
2021,Milton Keynes 030B,E01016714,2148,1619,529,178,206,121,24
2021,Milton Keynes 031C,E01016715,1705,1592,113,55,36,20,2
2021,Milton Keynes 030C,E01016716,2468,2031,437,195,176,63,3
2021,Milton Keynes 013A,E01016717,1602,1326,276,121,114,30,11
2021,Milton Keynes 014A,E01016718,1839,1338,501,167,258,70,6
2021,Milton Keynes 011A,E01016719,1391,1251,140,76,48,13,3
2021,Milton Keynes 013B,E01016720,1535,1335,200,79,91,26,4
2021,Milton Keynes 009A,E01016721,1678,1153,525,177,254,84,10
2021,Milton Keynes 011B,E01016722,1556,1409,147,88,37,19,3
2021,Milton Keynes 013C,E01016723,1540,1264,276,150,95,27,4
2021,Milton Keynes 013D,E01016724,1737,1310,427,175,193,52,7
2021,Milton Keynes 021A,E01016725,1586,1210,376,171,161,42,2
2021,Milton Keynes 018A,E01016726,1755,1348,407,152,190,54,11
2021,Milton Keynes 021B,E01016727,1718,1320,398,158,170,58,12
2021,Milton Keynes 021C,E01016728,2013,1328,685,307,276,85,17
2021,Milton Keynes 014B,E01016729,2214,1573,641,222,285,127,7
2021,Milton Keynes 016A,E01016731,1531,1244,287,108,131,42,6
2021,Milton Keynes 016B,E01016732,1368,1149,219,94,87,36,2
2021,Milton Keynes 018B,E01016733,1731,1222,509,187,236,79,7
2021,Milton Keynes 024A,E01016734,1643,1561,82,53,15,14,0
2021,Milton Keynes 024C,E01016736,1392,1352,40,23,15,2,0
2021,Milton Keynes 027A,E01016737,1662,1520,142,59,51,29,3
2021,Milton Keynes 027B,E01016738,1883,1730,153,66,59,27,1
2021,Milton Keynes 027C,E01016739,1422,1300,122,73,42,7,0
2021,Milton Keynes 027D,E01016740,1383,1278,105,49,40,15,1
2021,Milton Keynes 027E,E01016741,1599,1426,173,77,71,24,1
2021,Milton Keynes 032A,E01016742,1936,1646,290,117,110,54,9
2021,Milton Keynes 032C,E01016744,1738,1483,255,105,103,41,6
2021,Milton Keynes 030D,E01016745,1600,1459,141,50,57,30,4
2021,Milton Keynes 032D,E01016746,1759,1538,221,87,88,38,8
2021,Milton Keynes 028A,E01016748,2053,1773,280,128,115,34,3
2021,Milton Keynes 028C,E01016750,1569,1390,179,104,55,16,4
2021,Milton Keynes 028D,E01016751,1582,1423,159,78,59,20,2
2021,Milton Keynes 025B,E01016752,1647,1499,148,86,46,15,1
2021,Milton Keynes 025C,E01016753,2156,1865,291,159,96,30,6
2021,Milton Keynes 026A,E01016754,1605,1441,164,78,51,32,3
2021,Milton Keynes 025D,E01016755,1780,1539,241,153,62,25,1
2021,Milton Keynes 026B,E01016756,2204,1943,261,144,89,25,3
2021,Milton Keynes 026C,E01016757,1484,1257,227,87,102,28,10
2021,Milton Keynes 026D,E01016758,1633,1409,224,122,78,20,4
2021,Milton Keynes 002A,E01016759,1587,1566,21,11,7,2,1
2021,Milton Keynes 002C,E01016761,1470,1441,29,17,10,2,0
2021,Milton Keynes 005A,E01016762,1294,1207,87,45,30,10,2
2021,Milton Keynes 007A,E01016763,1296,1204,92,43,33,16,0
2021,Milton Keynes 005B,E01016764,1396,1274,122,67,37,15,3
2021,Milton Keynes 009B,E01016765,1589,1489,100,53,34,13,0
2021,Milton Keynes 005C,E01016766,1341,1169,172,81,69,20,2
2021,Milton Keynes 005D,E01016767,1266,1186,80,31,35,11,3
2021,Milton Keynes 014D,E01016768,2415,1811,604,319,220,57,8
2021,Milton Keynes 007B,E01016769,1300,1196,104,63,27,11,3
2021,Milton Keynes 007C,E01016770,1500,1313,187,92,64,26,5
2021,Milton Keynes 005E,E01016771,1317,1083,234,99,103,28,4
2021,Milton Keynes 009C,E01016772,1317,1038,279,102,127,45,5
2021,Milton Keynes 007D,E01016773,1831,1598,233,120,82,25,6
2021,Milton Keynes 020A,E01016774,1722,1517,205,122,57,19,7
2021,Milton Keynes 020B,E01016775,1641,1446,195,118,59,16,2
2021,Milton Keynes 015A,E01016776,1349,1157,192,112,59,18,3
2021,Milton Keynes 020C,E01016777,1577,1355,222,130,67,23,2
2021,Milton Keynes 020D,E01016778,1686,1426,260,154,76,27,3
2021,Milton Keynes 037C,E01016780,1645,1407,238,145,69,21,3
2021,Milton Keynes 037D,E01016781,1448,1281,167,104,47,9,7
2021,Milton Keynes 035A,E01016783,1857,1506,351,167,125,48,11
2021,Milton Keynes 016D,E01016784,1727,1484,243,114,88,40,1
2021,Milton Keynes 003A,E01016786,1409,1372,37,16,15,6,0
2021,Milton Keynes 003B,E01016787,1636,1578,58,30,20,8,0
2021,Milton Keynes 003C,E01016788,1527,1486,41,25,9,6,1
2021,Milton Keynes 003D,E01016789,1308,1267,41,18,17,5,1
2021,Milton Keynes 003E,E01016790,1413,1388,25,15,4,6,0
2021,Milton Keynes 004A,E01016791,1400,1346,54,26,19,9,0
2021,Milton Keynes 004B,E01016792,1196,1137,59,35,16,8,0
2021,Milton Keynes 004C,E01016793,2051,1958,93,58,26,9,0
2021,Milton Keynes 004D,E01016794,1649,1578,71,42,23,5,1
2021,Milton Keynes 004E,E01016795,1519,1423,96,49,38,9,0
2021,Milton Keynes 001A,E01016796,1651,1611,40,20,20,0,0
2021,Milton Keynes 001B,E01016797,1704,1664,40,20,15,5,0
2021,Milton Keynes 001C,E01016798,1823,1793,30,19,9,2,0
2021,Milton Keynes 001D,E01016799,1864,1845,19,12,5,1,1
2021,Milton Keynes 001E,E01016800,1760,1740,20,10,4,5,1
2021,Milton Keynes 002D,E01016801,1288,1276,12,6,4,2,0
2021,Milton Keynes 002E,E01016802,1417,1397,20,10,7,2,1
2021,Milton Keynes 002F,E01016803,1330,1309,21,11,7,3,0
2021,Milton Keynes 009D,E01016804,1772,1490,282,116,129,34,3
2021,Milton Keynes 011C,E01016805,1242,1151,91,42,39,8,2
2021,Milton Keynes 006A,E01016806,1940,1742,198,87,86,23,2
2021,Milton Keynes 006B,E01016807,1747,1485,262,115,113,33,1
2021,Milton Keynes 011D,E01016808,1366,1204,162,77,61,24,0
2021,Milton Keynes 006C,E01016809,1362,1136,226,95,95,29,7
2021,Milton Keynes 012A,E01016810,1476,1279,197,75,80,31,11
2021,Milton Keynes 012B,E01016811,1507,1332,175,71,82,22,0
2021,Milton Keynes 010A,E01016812,1523,1366,157,61,58,30,8
2021,Milton Keynes 015B,E01016813,1316,1077,239,151,68,18,2
2021,Milton Keynes 015C,E01016815,1274,1071,203,107,61,30,5
2021,Milton Keynes 015D,E01016816,1500,1263,237,154,62,18,3
2021,Milton Keynes 010B,E01016817,1493,1426,67,30,23,11,3
2021,Milton Keynes 010C,E01016818,1736,1673,63,27,21,14,1
2021,Milton Keynes 012C,E01016819,1202,998,204,68,92,37,7
2021,Milton Keynes 035D,E01016820,1901,1686,215,118,73,21,3
2021,Milton Keynes 035B,E01016821,1498,1291,207,116,71,17,3
2021,Milton Keynes 022A,E01016822,1504,1361,143,68,51,23,1
2021,Milton Keynes 035C,E01016823,1617,1271,346,153,156,31,6
2021,Milton Keynes 022B,E01016824,1595,1488,107,47,52,6,2
2021,Milton Keynes 022C,E01016825,1433,1230,203,107,75,19,2
2021,Milton Keynes 024D,E01016826,1403,1320,83,50,27,5,1
2021,Milton Keynes 022D,E01016827,1663,1448,215,111,78,24,2
2021,Milton Keynes 022E,E01016828,1682,1552,130,85,37,8,0
2021,Milton Keynes 029A,E01016829,1652,1532,120,61,50,9,0
2021,Milton Keynes 031D,E01016830,1181,1098,83,46,31,6,0
2021,Milton Keynes 029B,E01016831,1513,1427,86,40,37,9,0
2021,Milton Keynes 029C,E01016832,1196,1112,84,40,33,8,3
2021,Milton Keynes 029D,E01016833,1224,1118,106,62,25,15,4
2021,Milton Keynes 029E,E01016834,1599,1474,125,50,53,16,6
2021,Milton Keynes 006D,E01016835,1764,1619,145,59,66,19,1
2021,Milton Keynes 008A,E01016836,1641,1441,200,86,73,33,8
2021,Milton Keynes 008B,E01016837,1877,1622,255,80,110,58,7
2021,Milton Keynes 008C,E01016838,1608,1460,148,43,69,33,3
2021,Milton Keynes 012D,E01016839,1755,1531,224,83,106,32,3
2021,Milton Keynes 008D,E01016841,2347,2098,249,132,82,32,3
2021,Milton Keynes 023B,E01016842,1487,1277,210,81,94,31,4
2021,Milton Keynes 023C,E01016843,1616,1376,240,97,112,29,2
2021,Milton Keynes 023D,E01016844,1619,1469,150,44,75,24,7
2021,Milton Keynes 018C,E01016845,1787,1581,206,99,76,28,3
2021,Milton Keynes 018D,E01016846,1594,1179,415,168,181,61,5
2021,Milton Keynes 021D,E01016847,2105,1783,322,128,128,44,22
2021,Milton Keynes 018E,E01016848,1601,1292,309,156,104,42,7
2021,Brighton and Hove 026A,E01016849,1501,1296,205,121,58,21,5
2021,Brighton and Hove 029A,E01016850,1581,1386,195,112,57,21,5
2021,Brighton and Hove 029B,E01016851,1694,1434,260,145,94,18,3
2021,Brighton and Hove 026B,E01016852,1561,1299,262,164,65,26,7
2021,Brighton and Hove 026C,E01016853,1827,1551,276,170,72,28,6
2021,Brighton and Hove 029C,E01016854,1567,1374,193,118,58,17,0
2021,Brighton and Hove 026D,E01016855,1545,1372,173,118,41,14,0
2021,Brighton and Hove 026E,E01016856,1590,1333,257,149,85,21,2
2021,Brighton and Hove 028A,E01016857,1547,1344,203,102,67,29,5
2021,Brighton and Hove 028B,E01016858,1432,1302,130,79,37,14,0
2021,Brighton and Hove 028C,E01016859,1364,1213,151,88,46,16,1
2021,Brighton and Hove 019A,E01016860,1646,1386,260,165,71,20,4
2021,Brighton and Hove 031A,E01016861,1541,1382,159,115,37,6,1
2021,Brighton and Hove 031B,E01016862,1516,1334,182,124,45,12,1
2021,Brighton and Hove 032A,E01016863,1634,1350,284,142,97,39,6
2021,Brighton and Hove 025A,E01016864,1444,1339,105,51,34,19,1
2021,Brighton and Hove 025B,E01016865,1451,1348,103,41,38,23,1
2021,Brighton and Hove 025C,E01016866,1470,1340,130,61,45,18,6
2021,Brighton and Hove 025D,E01016867,1317,1175,142,68,53,19,2
2021,Brighton and Hove 025E,E01016868,1568,1403,165,68,59,30,8
2021,Brighton and Hove 032B,E01016869,1883,1650,233,144,69,17,3
2021,Brighton and Hove 020A,E01016870,1569,1394,175,94,53,22,6
2021,Brighton and Hove 019B,E01016871,1725,1409,316,187,86,38,5
2021,Brighton and Hove 019C,E01016872,1728,1556,172,103,51,17,1
2021,Brighton and Hove 019D,E01016873,1750,1476,274,135,94,41,4
2021,Brighton and Hove 020B,E01016874,1836,1495,341,195,102,43,1
2021,Brighton and Hove 020C,E01016875,1502,1408,94,59,28,7,0
2021,Brighton and Hove 020D,E01016876,1742,1482,260,175,59,23,3
2021,Brighton and Hove 020E,E01016877,1766,1501,265,153,76,28,8
2021,Brighton and Hove 019E,E01016878,1802,1640,162,83,55,23,1
2021,Brighton and Hove 013A,E01016879,1489,1417,72,34,22,14,2
2021,Brighton and Hove 013B,E01016880,1346,1182,164,70,63,26,5
2021,Brighton and Hove 013C,E01016881,1508,1366,142,61,46,28,7
2021,Brighton and Hove 006A,E01016882,1496,1337,159,59,61,34,5
2021,Brighton and Hove 006B,E01016883,1470,1382,88,56,24,6,2
2021,Brighton and Hove 006C,E01016884,1644,1465,179,76,62,33,8
2021,Brighton and Hove 006D,E01016885,1357,1164,193,74,73,40,6
2021,Brighton and Hove 006E,E01016886,1549,1427,122,53,47,21,1
2021,Brighton and Hove 013D,E01016887,1428,1288,140,71,37,29,3
2021,Brighton and Hove 013E,E01016888,1482,1400,82,39,27,16,0
2021,Brighton and Hove 022A,E01016889,1732,1602,130,86,28,14,2
2021,Brighton and Hove 015A,E01016890,1870,1657,213,137,60,14,2
2021,Brighton and Hove 022B,E01016891,1828,1688,140,92,38,9,1
2021,Brighton and Hove 018A,E01016892,1639,1556,83,48,26,9,0
2021,Brighton and Hove 018B,E01016893,1773,1678,95,70,15,10,0
2021,Brighton and Hove 022C,E01016894,1877,1729,148,94,41,11,2
2021,Brighton and Hove 025F,E01016895,1578,1450,128,62,47,18,1
2021,Brighton and Hove 022D,E01016896,1637,1513,124,84,32,7,1
2021,Brighton and Hove 022E,E01016897,1647,1539,108,78,22,6,2
2021,Brighton and Hove 002A,E01016898,2289,2144,145,76,48,17,4
2021,Brighton and Hove 002B,E01016899,4140,3561,579,371,179,27,2
2021,Brighton and Hove 008A,E01016900,1582,1439,143,58,63,21,1
2021,Brighton and Hove 010A,E01016901,1659,1580,79,42,18,12,7
2021,Brighton and Hove 008B,E01016902,1541,1438,103,53,27,20,3
2021,Brighton and Hove 010B,E01016903,1818,1710,108,66,34,7,1
2021,Brighton and Hove 008C,E01016904,1836,1625,211,106,75,28,2
2021,Brighton and Hove 008D,E01016905,1653,1526,127,70,36,20,1
2021,Brighton and Hove 009A,E01016906,1603,1521,82,46,21,10,5
2021,Brighton and Hove 009B,E01016907,1742,1619,123,68,35,15,5
2021,Brighton and Hove 009C,E01016908,1485,1375,110,45,36,25,4
2021,Brighton and Hove 008E,E01016909,1696,1545,151,89,44,15,3
2021,Brighton and Hove 009D,E01016910,1360,1278,82,48,18,14,2
2021,Brighton and Hove 009E,E01016911,1457,1344,113,58,44,7,4
2021,Brighton and Hove 018C,E01016912,1894,1707,187,112,52,22,1
2021,Brighton and Hove 018D,E01016913,1711,1585,126,87,33,6,0
2021,Brighton and Hove 002C,E01016914,2110,1951,159,95,48,15,1
2021,Brighton and Hove 002D,E01016915,1452,1364,88,43,32,12,1
2021,Brighton and Hove 005A,E01016916,1394,1359,35,22,10,3,0
2021,Brighton and Hove 005B,E01016917,1360,1324,36,19,15,2,0
2021,Brighton and Hove 005C,E01016918,1376,1330,46,18,18,9,1
2021,Brighton and Hove 005D,E01016919,1269,1202,67,37,25,4,1
2021,Brighton and Hove 005E,E01016920,1509,1420,89,50,31,7,1
2021,Brighton and Hove 012A,E01016921,1607,1532,75,42,24,7,2
2021,Brighton and Hove 012B,E01016922,1272,1188,84,38,27,18,1
2021,Brighton and Hove 003A,E01016923,1555,1487,68,29,24,13,2
2021,Brighton and Hove 001A,E01016924,1418,1379,39,21,13,5,0
2021,Brighton and Hove 004A,E01016925,1503,1419,84,45,25,14,0
2021,Brighton and Hove 001B,E01016926,1527,1425,102,51,40,10,1
2021,Brighton and Hove 001C,E01016927,1539,1470,69,34,26,7,2
2021,Brighton and Hove 003B,E01016928,1621,1551,70,33,20,14,3
2021,Brighton and Hove 001D,E01016929,1514,1442,72,37,29,4,2
2021,Brighton and Hove 004B,E01016930,1873,1813,60,35,21,4,0
2021,Brighton and Hove 001E,E01016931,1582,1551,31,18,11,2,0
2021,Brighton and Hove 014A,E01016932,1564,1488,76,54,22,0,0
2021,Brighton and Hove 014B,E01016933,1370,1290,80,54,18,7,1
2021,Brighton and Hove 010C,E01016934,1296,1249,47,29,15,2,1
2021,Brighton and Hove 014C,E01016935,1555,1385,170,103,48,13,6
2021,Brighton and Hove 014D,E01016936,1765,1612,153,96,46,10,1
2021,Brighton and Hove 014E,E01016937,2092,1874,218,146,50,22,0
2021,Brighton and Hove 024A,E01016938,1868,1592,276,154,90,26,6
2021,Brighton and Hove 010D,E01016939,1549,1484,65,40,21,3,1
2021,Brighton and Hove 010E,E01016940,1534,1473,61,43,12,4,2
2021,Brighton and Hove 030A,E01016941,1919,1571,348,196,121,28,3
2021,Brighton and Hove 031C,E01016942,1862,1685,177,82,65,25,5
2021,Brighton and Hove 031D,E01016943,1444,1363,81,47,27,7,0
2021,Brighton and Hove 031E,E01016944,1592,1430,162,107,46,9,0
2021,Brighton and Hove 030B,E01016945,1551,1329,222,148,55,16,3
2021,Brighton and Hove 018E,E01016946,1469,1366,103,69,23,11,0
2021,Brighton and Hove 030C,E01016947,2062,1623,439,207,161,61,10
2021,Brighton and Hove 030D,E01016948,1727,1590,137,86,39,11,1
2021,Brighton and Hove 030E,E01016949,1708,1492,216,112,76,22,6
2021,Brighton and Hove 024B,E01016950,1727,1550,177,124,49,4,0
2021,Brighton and Hove 024C,E01016951,1522,1267,255,155,80,18,2
2021,Brighton and Hove 027A,E01016952,1737,1340,397,232,130,34,1
2021,Brighton and Hove 027B,E01016953,1517,1342,175,122,41,11,1
2021,Brighton and Hove 029D,E01016954,1653,1365,288,162,85,38,3
2021,Brighton and Hove 029E,E01016955,1593,1274,319,161,108,45,5
2021,Brighton and Hove 033A,E01016956,1510,1474,36,22,12,2,0
2021,Brighton and Hove 032C,E01016957,2170,1818,352,210,103,36,3
2021,Brighton and Hove 033B,E01016958,1757,1677,80,40,31,8,1
2021,Brighton and Hove 033C,E01016959,1452,1408,44,26,14,4,0
2021,Brighton and Hove 033D,E01016960,1694,1614,80,40,29,7,4
2021,Brighton and Hove 033E,E01016961,1926,1833,93,58,24,8,3
2021,Brighton and Hove 033F,E01016962,1618,1536,82,59,16,6,1
2021,Brighton and Hove 032D,E01016963,1891,1688,203,116,69,16,2
2021,Brighton and Hove 027C,E01016964,2390,1987,403,224,138,39,2
2021,Brighton and Hove 015B,E01016966,1697,1518,179,113,48,15,3
2021,Brighton and Hove 024D,E01016967,1745,1520,225,152,54,18,1
2021,Brighton and Hove 024E,E01016968,1391,1197,194,142,39,11,2
2021,Brighton and Hove 027E,E01016969,1807,1552,255,167,66,21,1
2021,Brighton and Hove 015C,E01016970,1569,1457,112,71,35,5,1
2021,Brighton and Hove 015D,E01016971,1924,1690,234,132,71,30,1
2021,Brighton and Hove 015E,E01016972,1719,1584,135,88,41,5,1
2021,Brighton and Hove 012C,E01016973,1480,1399,81,41,25,12,3
2021,Brighton and Hove 021A,E01016974,1759,1603,156,79,52,24,1
2021,Brighton and Hove 021B,E01016975,1565,1459,106,52,34,17,3
2021,Brighton and Hove 013F,E01016976,1562,1476,86,42,23,12,9
2021,Brighton and Hove 012D,E01016977,1537,1475,62,35,18,9,0
2021,Brighton and Hove 012E,E01016978,1646,1555,91,45,35,10,1
2021,Brighton and Hove 016A,E01016979,1793,1697,96,57,26,9,4
2021,Brighton and Hove 007A,E01016980,1633,1485,148,76,48,23,1
2021,Brighton and Hove 011A,E01016981,1629,1540,89,61,19,7,2
2021,Brighton and Hove 007B,E01016982,1277,1199,78,46,22,7,3
2021,Brighton and Hove 007C,E01016983,1468,1370,98,58,21,17,2
2021,Brighton and Hove 007D,E01016984,1485,1393,92,60,17,11,4
2021,Brighton and Hove 007E,E01016985,1542,1421,121,62,44,14,1
2021,Brighton and Hove 028D,E01016986,1591,1428,163,93,38,25,7
2021,Brighton and Hove 023A,E01016987,1688,1545,143,71,54,15,3
2021,Brighton and Hove 028E,E01016988,1486,1344,142,65,49,25,3
2021,Brighton and Hove 023B,E01016989,1468,1350,118,74,32,9,3
2021,Brighton and Hove 016B,E01016990,1627,1518,109,58,34,17,0
2021,Brighton and Hove 016C,E01016991,1665,1522,143,68,40,32,3
2021,Brighton and Hove 021C,E01016992,1718,1626,92,50,29,12,1
2021,Brighton and Hove 023C,E01016993,1480,1266,214,64,87,54,9
2021,Brighton and Hove 021D,E01016994,1662,1471,191,78,70,42,1
2021,Brighton and Hove 023D,E01016995,1693,1623,70,44,13,13,0
2021,Brighton and Hove 016D,E01016996,1813,1664,149,88,40,18,3
2021,Brighton and Hove 021E,E01016997,1620,1500,120,72,27,18,3
2021,Brighton and Hove 003C,E01016998,1470,1394,76,50,18,6,2
2021,Brighton and Hove 003D,E01016999,1459,1395,64,45,13,5,1
2021,Brighton and Hove 003E,E01017000,1771,1639,132,72,40,19,1
2021,Brighton and Hove 004C,E01017001,1534,1472,62,37,17,8,0
2021,Brighton and Hove 011B,E01017002,1639,1479,160,84,53,19,4
2021,Brighton and Hove 004D,E01017003,1590,1525,65,45,13,7,0
2021,Brighton and Hove 011C,E01017004,1646,1500,146,92,38,12,4
2021,Brighton and Hove 011D,E01017005,1661,1571,90,60,21,9,0
2021,Brighton and Hove 011E,E01017006,1608,1449,159,79,61,14,5
2021,Brighton and Hove 017A,E01017007,1517,1432,85,45,23,16,1
2021,Brighton and Hove 017B,E01017008,1686,1621,65,32,19,9,5
2021,Brighton and Hove 017C,E01017009,1464,1421,43,20,17,5,1
2021,Brighton and Hove 017D,E01017010,1747,1688,59,36,15,7,1
2021,Brighton and Hove 017E,E01017011,1339,1288,51,26,20,5,0
2021,Brighton and Hove 017F,E01017012,1754,1679,75,41,25,8,1
2021,Portsmouth 012A,E01017013,1705,1622,83,41,29,11,2
2021,Portsmouth 008A,E01017014,1499,1461,38,19,10,6,3
2021,Portsmouth 014A,E01017015,1427,1375,52,34,15,2,1
2021,Portsmouth 014B,E01017016,1541,1486,55,30,14,4,7
2021,Portsmouth 014C,E01017017,1407,1357,50,28,13,6,3
2021,Portsmouth 014D,E01017018,1549,1507,42,26,12,4,0
2021,Portsmouth 014E,E01017019,1714,1589,125,55,48,17,5
2021,Portsmouth 014F,E01017020,2276,2131,145,72,54,16,3
2021,Portsmouth 017A,E01017021,1393,1341,52,15,26,10,1
2021,Portsmouth 020A,E01017022,1361,1244,117,66,39,11,1
2021,Portsmouth 019A,E01017023,1592,1471,121,55,50,13,3
2021,Portsmouth 020B,E01017024,1819,1586,233,117,78,32,6
2021,Portsmouth 019B,E01017025,1905,1642,263,142,87,32,2
2021,Portsmouth 019C,E01017026,1683,1550,133,82,38,13,0
2021,Portsmouth 020C,E01017027,1652,1477,175,94,50,24,7
2021,Portsmouth 020D,E01017028,2119,1801,318,148,108,53,9
2021,Portsmouth 019D,E01017029,1609,1486,123,66,38,12,7
2021,Portsmouth 019E,E01017030,1781,1569,212,109,67,31,5
2021,Portsmouth 028A,E01017031,1884,1610,274,91,108,63,12
2021,Portsmouth 027C,E01017032,4874,4206,668,422,186,60,0
2021,Portsmouth 027A,E01017034,2531,2239,292,137,128,22,5
2021,Portsmouth 018A,E01017035,1670,1301,369,161,154,46,8
2021,Portsmouth 013A,E01017036,1465,1316,149,58,62,26,3
2021,Portsmouth 013B,E01017037,1574,1347,227,74,98,49,6
2021,Portsmouth 013C,E01017038,1699,1469,230,95,83,48,4
2021,Portsmouth 028C,E01017039,1791,1469,322,115,135,64,8
2021,Portsmouth 028B,E01017040,1435,1224,211,69,87,47,8
2021,Portsmouth 011A,E01017041,1383,1324,59,29,22,8,0
2021,Portsmouth 012B,E01017042,1421,1333,88,37,33,18,0
2021,Portsmouth 011B,E01017043,1301,1216,85,42,31,12,0
2021,Portsmouth 011C,E01017044,1443,1332,111,54,47,10,0
2021,Portsmouth 012C,E01017045,1217,1094,123,48,49,22,4
2021,Portsmouth 008B,E01017046,1579,1496,83,33,33,16,1
2021,Portsmouth 008C,E01017047,1607,1553,54,23,25,4,2
2021,Portsmouth 008D,E01017048,1455,1417,38,14,19,5,0
2021,Portsmouth 011D,E01017049,1477,1423,54,27,17,5,5
2021,Portsmouth 003A,E01017050,1683,1590,93,56,28,8,1
2021,Portsmouth 002A,E01017051,2038,1772,266,132,102,26,6
2021,Portsmouth 002B,E01017052,1427,1324,103,64,34,4,1
2021,Portsmouth 002C,E01017053,1253,1183,70,36,22,11,1
2021,Portsmouth 004A,E01017054,1375,1293,82,49,27,6,0
2021,Portsmouth 006A,E01017055,1565,1439,126,69,40,14,3
2021,Portsmouth 006B,E01017056,1321,1283,38,21,12,5,0
2021,Portsmouth 006C,E01017057,1455,1399,56,30,22,3,1
2021,Portsmouth 006D,E01017058,1843,1744,99,49,35,13,2
2021,Portsmouth 026A,E01017059,1554,1521,33,17,10,6,0
2021,Portsmouth 006E,E01017060,1885,1831,54,32,19,3,0
2021,Portsmouth 003B,E01017061,1660,1620,40,24,12,4,0
2021,Portsmouth 026B,E01017062,1621,1577,44,21,11,11,1
2021,Portsmouth 003C,E01017063,1531,1478,53,17,23,9,4
2021,Portsmouth 003D,E01017064,1802,1738,64,28,22,10,4
2021,Portsmouth 026C,E01017066,1818,1771,47,30,16,1,0
2021,Portsmouth 023A,E01017067,1392,1315,77,45,25,6,1
2021,Portsmouth 023B,E01017068,1653,1510,143,72,44,20,7
2021,Portsmouth 023C,E01017069,1448,1399,49,29,16,4,0
2021,Portsmouth 023D,E01017070,1446,1307,139,84,40,13,2
2021,Portsmouth 025A,E01017071,1383,1225,158,94,44,20,0
2021,Portsmouth 025B,E01017072,1380,1265,115,62,35,17,1
2021,Portsmouth 024A,E01017073,1784,1533,251,136,77,32,6
2021,Portsmouth 023E,E01017074,1729,1476,253,103,111,32,7
2021,Portsmouth 012D,E01017075,1522,1343,179,59,71,45,4
2021,Portsmouth 015A,E01017076,1658,1457,201,89,79,32,1
2021,Portsmouth 015B,E01017077,1718,1428,290,103,124,56,7
2021,Portsmouth 015C,E01017078,1506,1305,201,79,80,37,5
2021,Portsmouth 015D,E01017079,1504,1231,273,112,113,41,7
2021,Portsmouth 015E,E01017080,1960,1576,384,166,146,66,6
2021,Portsmouth 015F,E01017081,1571,1346,225,111,79,32,3
2021,Portsmouth 012E,E01017082,1720,1482,238,79,105,40,14
2021,Portsmouth 012F,E01017083,1688,1537,151,67,53,28,3
2021,Portsmouth 009A,E01017084,1379,1257,122,45,44,29,4
2021,Portsmouth 008E,E01017085,1368,1297,71,33,17,19,2
2021,Portsmouth 007A,E01017086,1311,1274,37,9,17,9,2
2021,Portsmouth 009B,E01017087,1361,1236,125,53,49,21,2
2021,Portsmouth 009C,E01017088,1763,1610,153,74,46,29,4
2021,Portsmouth 007B,E01017089,1531,1475,56,30,20,4,2
2021,Portsmouth 007C,E01017090,1714,1573,141,67,52,22,0
2021,Portsmouth 007D,E01017091,1586,1502,84,36,30,16,2
2021,Portsmouth 007E,E01017092,1456,1368,88,53,28,7,0
2021,Portsmouth 017B,E01017093,1079,1027,52,25,17,10,0
2021,Portsmouth 021A,E01017094,1428,1376,52,27,22,3,0
2021,Portsmouth 021B,E01017095,1748,1607,141,73,51,12,5
2021,Portsmouth 017C,E01017096,1333,1270,63,32,16,14,1
2021,Portsmouth 021C,E01017097,1505,1391,114,69,38,7,0
2021,Portsmouth 021D,E01017098,1420,1287,133,78,38,16,1
2021,Portsmouth 017D,E01017099,2540,2236,304,151,102,44,7
2021,Portsmouth 017E,E01017100,1317,1260,57,26,18,13,0
2021,Portsmouth 017F,E01017101,1460,1389,71,35,22,12,2
2021,Portsmouth 013D,E01017102,1674,1399,275,105,108,53,9
2021,Portsmouth 013E,E01017103,1231,1085,146,51,54,37,4
2021,Portsmouth 010A,E01017104,1154,1063,91,30,32,26,3
2021,Portsmouth 009D,E01017105,1520,1355,165,59,67,37,2
2021,Portsmouth 010B,E01017106,1463,1337,126,49,49,24,4
2021,Portsmouth 009E,E01017107,1572,1396,176,79,63,32,2
2021,Portsmouth 010C,E01017108,1546,1378,168,65,64,30,9
2021,Portsmouth 010D,E01017109,1377,1219,158,62,67,20,9
2021,Portsmouth 011E,E01017110,1406,1254,152,72,61,17,2
2021,Portsmouth 011F,E01017111,1560,1323,237,90,98,47,2
2021,Portsmouth 001A,E01017112,1790,1691,99,44,36,16,3
2021,Portsmouth 004B,E01017113,1606,1534,72,36,24,8,4
2021,Portsmouth 004C,E01017114,1436,1365,71,38,26,5,2
2021,Portsmouth 001B,E01017115,1353,1307,46,19,20,5,2
2021,Portsmouth 004D,E01017116,1734,1664,70,44,17,8,1
2021,Portsmouth 001C,E01017117,1483,1430,53,29,21,3,0
2021,Portsmouth 002D,E01017118,1463,1365,98,58,31,7,2
2021,Portsmouth 001D,E01017119,1632,1585,47,22,19,6,0
2021,Portsmouth 001E,E01017120,1622,1569,53,27,16,8,2
2021,Portsmouth 025C,E01017121,1584,1380,204,124,51,23,6
2021,Portsmouth 022A,E01017122,1643,1441,202,116,55,24,7
2021,Portsmouth 024B,E01017123,1912,1636,276,156,92,25,3
2021,Portsmouth 020E,E01017124,1562,1366,196,85,75,26,10
2021,Portsmouth 022B,E01017125,1613,1380,233,90,83,52,8
2021,Portsmouth 025D,E01017126,1649,1475,174,97,58,13,6
2021,Portsmouth 022C,E01017127,1774,1520,254,150,70,31,3
2021,Portsmouth 018B,E01017128,1684,1472,212,113,65,30,4
2021,Portsmouth 018C,E01017129,1869,1619,250,132,85,30,3
2021,Portsmouth 018D,E01017130,2192,1745,447,155,188,89,15
2021,Portsmouth 024C,E01017131,1780,1580,200,108,67,22,3
2021,Portsmouth 018E,E01017132,1565,1315,250,130,74,43,3
2021,Portsmouth 018F,E01017133,1627,1424,203,80,86,34,3
2021,Portsmouth 022D,E01017135,1580,1408,172,99,51,21,1
2021,Southampton 023A,E01017136,1931,1317,614,257,258,92,7
2021,Southampton 023B,E01017137,1464,1120,344,163,127,50,4
2021,Southampton 023C,E01017138,2121,1684,437,267,135,32,3
2021,Southampton 033B,E01017139,2721,1807,914,364,354,170,26
2021,Southampton 001A,E01017144,1042,846,196,90,81,20,5
2021,Southampton 001B,E01017145,1491,1286,205,106,72,24,3
2021,Southampton 001C,E01017146,2677,2392,285,159,99,23,4
2021,Southampton 006A,E01017147,1342,1167,175,96,55,22,2
2021,Southampton 001D,E01017148,1702,1486,216,110,89,15,2
2021,Southampton 001E,E01017149,1406,1048,358,134,155,64,5
2021,Southampton 006B,E01017150,1483,1262,221,113,67,39,2
2021,Southampton 006C,E01017151,1541,1320,221,122,83,14,2
2021,Southampton 006D,E01017152,1524,1244,280,160,88,25,7
2021,Southampton 022A,E01017153,1800,1119,681,204,288,170,19
2021,Southampton 022B,E01017154,2447,1667,780,309,296,153,22
2021,Southampton 022C,E01017155,1745,985,760,274,274,183,29
2021,Southampton 022D,E01017156,1734,1037,697,218,282,167,30
2021,Southampton 017A,E01017157,1620,1314,306,134,115,48,9
2021,Southampton 017B,E01017158,2059,1577,482,201,183,83,15
2021,Southampton 017C,E01017159,1434,1023,411,158,164,78,11
2021,Southampton 017D,E01017160,1462,1104,358,160,126,58,14
2021,Southampton 025A,E01017162,1395,1337,58,29,25,2,2
2021,Southampton 025B,E01017163,1480,1358,122,55,47,19,1
2021,Southampton 025C,E01017164,1540,1448,92,36,43,10,3
2021,Southampton 025D,E01017165,1506,1416,90,41,38,9,2
2021,Southampton 025E,E01017166,1688,1525,163,63,73,23,4
2021,Southampton 027A,E01017167,1570,1446,124,50,54,19,1
2021,Southampton 027B,E01017168,1611,1491,120,57,49,8,6
2021,Southampton 027C,E01017169,1534,1471,63,23,26,12,2
2021,Southampton 027D,E01017170,1532,1436,96,49,32,11,4
2021,Southampton 014A,E01017171,1787,1528,259,115,105,38,1
2021,Southampton 014B,E01017172,1775,1447,328,178,109,35,6
2021,Southampton 014C,E01017173,1467,1325,142,63,55,21,3
2021,Southampton 008A,E01017174,1381,1319,62,26,22,9,5
2021,Southampton 008B,E01017175,1452,1340,112,56,44,10,2
2021,Southampton 008C,E01017176,1514,1397,117,56,35,25,1
2021,Southampton 014D,E01017177,1537,1396,141,63,61,16,1
2021,Southampton 014E,E01017178,1453,1374,79,49,22,7,1
2021,Southampton 008D,E01017179,1213,1119,94,39,40,13,2
2021,Southampton 002A,E01017180,1392,1278,114,61,42,10,1
2021,Southampton 002B,E01017181,1356,1257,99,49,27,20,3
2021,Southampton 004A,E01017182,1335,1259,76,28,24,19,5
2021,Southampton 002C,E01017183,1569,1483,86,43,26,15,2
2021,Southampton 004B,E01017184,1373,1251,122,65,38,17,2
2021,Southampton 002D,E01017185,1653,1447,206,114,70,19,3
2021,Southampton 004C,E01017186,1654,1464,190,89,77,23,1
2021,Southampton 002E,E01017187,1642,1396,246,161,69,14,2
2021,Southampton 004D,E01017188,1605,1366,239,126,80,29,4
2021,Southampton 020A,E01017189,1434,1043,391,161,179,50,1
2021,Southampton 020B,E01017190,1563,1324,239,142,79,18,0
2021,Southampton 020C,E01017191,1634,1093,541,226,223,79,13
2021,Southampton 021A,E01017192,1970,1472,498,222,189,75,12
2021,Southampton 021B,E01017193,1694,1333,361,144,151,59,7
2021,Southampton 021C,E01017194,2008,1408,600,245,234,104,17
2021,Southampton 021D,E01017195,1877,1481,396,183,166,44,3
2021,Southampton 020D,E01017196,2021,1545,476,267,151,52,6
2021,Southampton 020E,E01017197,1362,1169,193,88,73,31,1
2021,Southampton 018A,E01017198,1437,1300,137,60,50,24,3
2021,Southampton 018B,E01017199,1549,1433,116,53,52,11,0
2021,Southampton 016A,E01017200,1792,1659,133,71,39,20,3
2021,Southampton 016B,E01017201,1215,1104,111,48,47,12,4
2021,Southampton 016C,E01017202,1656,1442,214,77,103,32,2
2021,Southampton 016D,E01017203,1604,1460,144,65,60,15,4
2021,Southampton 016E,E01017204,1511,1425,86,43,27,15,1
2021,Southampton 018C,E01017205,1579,1427,152,62,64,25,1
2021,Southampton 018D,E01017206,1626,1540,86,51,25,7,3
2021,Southampton 015A,E01017207,1584,1380,204,95,71,35,3
2021,Southampton 019A,E01017208,1452,1315,137,58,53,24,2
2021,Southampton 015B,E01017209,1353,1142,211,105,76,30,0
2021,Southampton 019B,E01017210,1729,1480,249,98,104,39,8
2021,Southampton 015C,E01017211,1648,1388,260,113,107,35,5
2021,Southampton 015D,E01017212,1407,1258,149,60,60,20,9
2021,Southampton 015E,E01017213,1725,1403,322,140,128,49,5
2021,Southampton 019C,E01017214,1484,1281,203,99,73,29,2
2021,Southampton 019D,E01017215,1739,1539,200,84,86,28,2
2021,Southampton 019E,E01017216,1371,1152,219,86,87,40,6
2021,Southampton 024A,E01017217,1541,1424,117,52,37,24,4
2021,Southampton 028A,E01017218,1297,1206,91,38,32,20,1
2021,Southampton 028B,E01017219,1766,1583,183,75,70,35,3
2021,Southampton 028C,E01017220,1756,1635,121,68,42,6,5
2021,Southampton 028D,E01017221,1588,1457,131,62,50,16,3
2021,Southampton 028E,E01017222,1433,1357,76,35,32,9,0
2021,Southampton 024B,E01017223,1613,1500,113,40,49,20,4
2021,Southampton 024C,E01017224,1324,1242,82,27,35,17,3
2021,Southampton 024D,E01017225,1498,1396,102,52,38,11,1
2021,Southampton 009A,E01017226,1568,1276,292,152,98,31,11
2021,Southampton 013A,E01017227,1145,898,247,108,97,40,2
2021,Southampton 013B,E01017228,1421,1161,260,115,86,53,6
2021,Southampton 009D,E01017231,1703,1403,300,131,115,45,9
2021,Southampton 009E,E01017232,1217,1055,162,100,44,15,3
2021,Southampton 013C,E01017233,1555,1325,230,99,75,49,7
2021,Southampton 013D,E01017234,2068,1449,619,211,290,110,8
2021,Southampton 013E,E01017235,1488,1149,339,143,130,61,5
2021,Southampton 012A,E01017236,1389,1283,106,41,47,17,1
2021,Southampton 012B,E01017237,1534,1379,155,67,60,23,5
2021,Southampton 007A,E01017238,1951,1687,264,121,104,33,6
2021,Southampton 012C,E01017239,1450,1287,163,47,87,27,2
2021,Southampton 012D,E01017240,1302,1233,69,23,38,6,2
2021,Southampton 007B,E01017241,1396,1272,124,48,52,21,3
2021,Southampton 007C,E01017242,1929,1687,242,123,79,31,9
2021,Southampton 007D,E01017243,1663,1504,159,87,56,15,1
2021,Southampton 007E,E01017244,1413,1282,131,61,53,17,0
2021,Southampton 012E,E01017245,1492,1354,138,57,60,17,4
2021,Southampton 010A,E01017246,2100,1552,548,307,157,67,17
2021,Southampton 011A,E01017247,1602,1399,203,81,93,27,2
2021,Southampton 011B,E01017248,1525,1366,159,92,55,10,2
2021,Southampton 011C,E01017249,1290,1189,101,50,35,15,1
2021,Southampton 010B,E01017250,1591,1310,281,100,136,36,9
2021,Southampton 010C,E01017251,1556,1169,387,171,150,60,6
2021,Southampton 011D,E01017252,1525,1376,149,84,41,17,7
2021,Southampton 010D,E01017253,1720,1381,339,173,127,36,3
2021,Southampton 011E,E01017254,1641,1362,279,166,76,28,9
2021,Southampton 030A,E01017255,1553,1449,104,41,53,10,0
2021,Southampton 026A,E01017256,2020,1914,106,59,27,18,2
2021,Southampton 026B,E01017257,1513,1400,113,55,49,7,2
2021,Southampton 030B,E01017258,1462,1392,70,30,30,10,0
2021,Southampton 026C,E01017259,1322,1231,91,47,32,11,1
2021,Southampton 026D,E01017260,1313,1268,45,23,10,10,2
2021,Southampton 030C,E01017261,1629,1547,82,46,20,13,3
2021,Southampton 026E,E01017262,1259,1205,54,30,16,8,0
2021,Southampton 030D,E01017263,1501,1400,101,37,48,12,4
2021,Southampton 003A,E01017264,2380,1936,444,197,175,62,10
2021,Southampton 003B,E01017265,1560,1447,113,54,41,16,2
2021,Southampton 005A,E01017266,1401,1105,296,118,135,38,5
2021,Southampton 005B,E01017267,1247,992,255,106,97,50,2
2021,Southampton 003C,E01017270,1303,1112,191,84,73,31,3
2021,Southampton 003D,E01017271,1073,932,141,64,37,29,11
2021,Southampton 005E,E01017272,1386,1144,242,96,98,41,7
2021,Southampton 031A,E01017273,1491,1410,81,37,26,13,5
2021,Southampton 032A,E01017274,1416,1305,111,51,37,20,3
2021,Southampton 031B,E01017275,1639,1531,108,54,37,17,0
2021,Southampton 031C,E01017276,1802,1548,254,103,94,48,9
2021,Southampton 032B,E01017277,1442,1344,98,48,36,12,2
2021,Southampton 031E,E01017279,1572,1443,129,63,42,19,5
2021,Southampton 032C,E01017280,1624,1423,201,81,79,35,6
2021,Southampton 032D,E01017281,1424,1267,157,82,49,23,3
2021,Isle of Wight 006A,E01017282,1332,1321,11,7,3,0,1
2021,Isle of Wight 006B,E01017283,1639,1626,13,8,4,1,0
2021,Isle of Wight 010A,E01017284,1563,1541,22,15,6,1,0
2021,Isle of Wight 010B,E01017285,1942,1924,18,14,3,1,0
2021,Isle of Wight 005A,E01017286,1578,1562,16,8,6,2,0
2021,Isle of Wight 005B,E01017287,1579,1565,14,6,4,2,2
2021,Isle of Wight 010C,E01017288,1223,1208,15,6,8,1,0
2021,Isle of Wight 014A,E01017289,2125,2103,22,10,10,1,1
2021,Isle of Wight 013A,E01017290,1219,1213,6,5,0,1,0
2021,Isle of Wight 013B,E01017291,1173,1169,4,4,0,0,0
2021,Isle of Wight 011A,E01017292,1731,1701,30,19,11,0,0
2021,Isle of Wight 011B,E01017293,1887,1849,38,22,10,5,1
2021,Isle of Wight 013C,E01017294,1568,1544,24,16,5,3,0
2021,Isle of Wight 009A,E01017295,1311,1297,14,8,5,1,0
2021,Isle of Wight 011C,E01017296,1299,1239,60,8,20,22,10
2021,Isle of Wight 017A,E01017297,1419,1404,15,11,3,1,0
2021,Isle of Wight 017B,E01017298,1509,1496,13,11,1,0,1
2021,Isle of Wight 017C,E01017299,1223,1211,12,9,3,0,0
2021,Isle of Wight 001A,E01017300,2110,2037,73,41,18,14,0
2021,Isle of Wight 002A,E01017301,1053,1041,12,6,4,2,0
2021,Isle of Wight 002B,E01017302,1702,1656,46,33,8,5,0
2021,Isle of Wight 001B,E01017303,1152,1103,49,32,14,3,0
2021,Isle of Wight 002C,E01017304,1353,1314,39,21,10,4,4
2021,Isle of Wight 001C,E01017305,1479,1402,77,55,15,7,0
2021,Isle of Wight 001D,E01017306,1320,1298,22,9,7,3,3
2021,Isle of Wight 003A,E01017307,2311,2277,34,19,9,5,1
2021,Isle of Wight 003B,E01017308,1680,1660,20,13,5,1,1
2021,Isle of Wight 001E,E01017309,1503,1486,17,10,6,0,1
2021,Isle of Wight 008A,E01017310,1469,1448,21,17,4,0,0
2021,Isle of Wight 008B,E01017311,1500,1479,21,12,5,4,0
2021,Isle of Wight 012A,E01017312,1757,1741,16,8,6,2,0
2021,Isle of Wight 012D,E01017315,1485,1470,15,9,6,0,0
2021,Isle of Wight 002D,E01017316,2039,2019,20,16,4,0,0
2021,Isle of Wight 015A,E01017317,1415,1404,11,7,3,1,0
2021,Isle of Wight 016A,E01017318,1136,1117,19,6,4,7,2
2021,Isle of Wight 016B,E01017319,1256,1232,24,9,10,4,1
2021,Isle of Wight 015B,E01017320,1070,1060,10,4,4,2,0
2021,Isle of Wight 011D,E01017321,1380,1348,32,17,10,5,0
2021,Isle of Wight 011E,E01017322,1405,1383,22,13,7,2,0
2021,Isle of Wight 015C,E01017323,1146,1138,8,6,1,1,0
2021,Isle of Wight 015D,E01017324,1438,1425,13,9,1,2,1
2021,Isle of Wight 009B,E01017325,1210,1184,26,19,7,0,0
2021,Isle of Wight 009C,E01017326,1556,1448,108,62,30,13,3
2021,Isle of Wight 011F,E01017327,1487,1462,25,15,4,6,0
2021,Isle of Wight 009D,E01017328,1372,1326,46,21,20,3,2
2021,Isle of Wight 002E,E01017329,2254,2227,27,19,7,1,0
2021,Isle of Wight 008C,E01017331,2177,2117,60,45,9,6,0
2021,Isle of Wight 008D,E01017332,1891,1849,42,31,6,3,2
2021,Isle of Wight 009E,E01017333,1717,1674,43,30,8,5,0
2021,Isle of Wight 008E,E01017334,1953,1860,93,32,39,18,4
2021,Isle of Wight 004A,E01017335,1483,1443,40,21,16,3,0
2021,Isle of Wight 004B,E01017336,1566,1523,43,20,16,7,0
2021,Isle of Wight 004C,E01017337,1586,1499,87,43,25,13,6
2021,Isle of Wight 006C,E01017338,1373,1353,20,8,5,3,4
2021,Isle of Wight 007A,E01017339,1764,1718,46,20,16,6,4
2021,Isle of Wight 007B,E01017340,1765,1719,46,17,25,4,0
2021,Isle of Wight 006D,E01017341,1578,1542,36,23,11,2,0
2021,Isle of Wight 006E,E01017342,1589,1554,35,25,6,4,0
2021,Isle of Wight 007C,E01017343,1302,1280,22,12,7,3,0
2021,Isle of Wight 007D,E01017344,1655,1641,14,11,2,1,0
2021,Isle of Wight 007E,E01017345,1802,1743,59,24,22,11,2
2021,Isle of Wight 004D,E01017346,1344,1314,30,17,11,1,1
2021,Isle of Wight 014B,E01017347,1727,1688,39,20,15,4,0
2021,Isle of Wight 014C,E01017348,1402,1375,27,12,12,3,0
2021,Isle of Wight 014D,E01017349,2050,1983,67,28,19,16,4
2021,Isle of Wight 014E,E01017350,1791,1769,22,12,8,2,0
2021,Isle of Wight 010D,E01017351,1396,1375,21,12,9,0,0
2021,Isle of Wight 010E,E01017352,1101,1088,13,10,2,1,0
2021,Isle of Wight 013D,E01017353,1241,1234,7,7,0,0,0
2021,Isle of Wight 012E,E01017354,1073,1062,11,6,2,0,3
2021,Isle of Wight 015E,E01017355,1535,1502,33,14,10,8,1
2021,Isle of Wight 016C,E01017356,1505,1472,33,10,17,4,2
2021,Isle of Wight 016D,E01017357,1455,1427,28,7,16,5,0
2021,Isle of Wight 015F,E01017358,1270,1265,5,0,3,2,0
2021,Isle of Wight 016E,E01017359,1481,1463,18,9,6,3,0
2021,Isle of Wight 016F,E01017360,1700,1642,58,30,21,7,0
2021,Isle of Wight 012F,E01017361,1422,1395,27,18,9,0,0
2021,Isle of Wight 012G,E01017362,1481,1458,23,12,8,3,0
2021,Isle of Wight 018A,E01017363,1369,1335,34,14,12,5,3
2021,Isle of Wight 018B,E01017364,1318,1302,16,9,6,1,0
2021,Isle of Wight 018C,E01017365,1363,1338,25,10,12,3,0
2021,Isle of Wight 018D,E01017366,1417,1412,5,5,0,0,0
2021,Isle of Wight 005C,E01017367,1852,1819,33,19,10,4,0
2021,Isle of Wight 005D,E01017368,1478,1456,22,15,4,2,1
2021,Isle of Wight 017D,E01017369,1457,1449,8,1,5,1,1
2021,Isle of Wight 018E,E01017370,1690,1683,7,2,5,0,0
2021,Central Bedfordshire 012A,E01017371,1719,1691,28,12,11,5,0
2021,Central Bedfordshire 012B,E01017372,1768,1739,29,15,8,1,5
2021,Central Bedfordshire 012C,E01017373,2264,2238,26,14,9,3,0
2021,Central Bedfordshire 012D,E01017374,1500,1490,10,6,4,0,0
2021,Central Bedfordshire 012E,E01017375,1440,1415,25,13,9,3,0
2021,Central Bedfordshire 010A,E01017376,1980,1911,69,31,27,9,2
2021,Central Bedfordshire 010B,E01017377,1857,1809,48,28,12,5,3
2021,Central Bedfordshire 010C,E01017378,1953,1900,53,24,28,1,0
2021,Central Bedfordshire 007A,E01017379,1173,1150,23,17,5,1,0
2021,Central Bedfordshire 007B,E01017380,1236,1206,30,16,8,6,0
2021,Central Bedfordshire 006A,E01017381,1394,1360,34,23,8,2,1
2021,Central Bedfordshire 006B,E01017382,1472,1425,47,24,14,7,2
2021,Central Bedfordshire 005A,E01017383,1868,1777,91,50,34,6,1
2021,Central Bedfordshire 005B,E01017384,1566,1526,40,23,12,5,0
2021,Central Bedfordshire 005C,E01017385,1825,1730,95,35,45,12,3
2021,Central Bedfordshire 005D,E01017386,1700,1642,58,33,13,9,3
2021,Central Bedfordshire 005E,E01017387,1224,1206,18,6,8,4,0
2021,Central Bedfordshire 005F,E01017388,2651,2566,85,53,24,6,2
2021,Central Bedfordshire 013A,E01017391,1488,1459,29,13,13,3,0
2021,Central Bedfordshire 013B,E01017392,1823,1783,40,25,9,3,3
2021,Central Bedfordshire 013C,E01017393,1980,1944,36,25,8,1,2
2021,Central Bedfordshire 007C,E01017394,1422,1341,81,58,17,5,1
2021,Central Bedfordshire 007F,E01017397,1725,1599,126,74,39,12,1
2021,Central Bedfordshire 017A,E01017398,2473,2440,33,21,7,4,1
2021,Central Bedfordshire 015A,E01017399,1404,1367,37,28,6,3,0
2021,Central Bedfordshire 015B,E01017400,1493,1460,33,19,7,5,2
2021,Central Bedfordshire 015C,E01017401,1170,1129,41,26,9,4,2
2021,Central Bedfordshire 015D,E01017402,1495,1468,27,19,8,0,0
2021,Central Bedfordshire 016A,E01017403,1389,1341,48,27,14,6,1
2021,Central Bedfordshire 016B,E01017404,1232,1221,11,9,2,0,0
2021,Central Bedfordshire 016C,E01017405,1324,1279,45,20,22,3,0
2021,Central Bedfordshire 016D,E01017406,2439,2351,88,57,23,6,2
2021,Central Bedfordshire 016E,E01017407,1451,1398,53,34,13,4,2
2021,Central Bedfordshire 017B,E01017408,1047,1018,29,17,10,2,0
2021,Central Bedfordshire 017C,E01017409,1194,1168,26,19,5,2,0
2021,Central Bedfordshire 008A,E01017410,1158,1141,17,9,5,2,1
2021,Central Bedfordshire 004A,E01017412,1473,1458,15,7,5,2,1
2021,Central Bedfordshire 010D,E01017413,2175,2154,21,17,4,0,0
2021,Central Bedfordshire 010E,E01017414,1826,1813,13,7,3,0,3
2021,Central Bedfordshire 010F,E01017415,1975,1943,32,17,13,1,1
2021,Central Bedfordshire 009C,E01017418,1441,1417,24,13,8,3,0
2021,Central Bedfordshire 008C,E01017419,1614,1595,19,12,7,0,0
2021,Central Bedfordshire 008D,E01017420,1626,1612,14,10,4,0,0
2021,Central Bedfordshire 008E,E01017421,1785,1764,21,9,7,5,0
2021,Central Bedfordshire 004B,E01017422,1610,1578,32,23,8,1,0
2021,Central Bedfordshire 004C,E01017423,1922,1891,31,12,10,8,1
2021,Central Bedfordshire 004D,E01017424,1372,1357,15,9,3,2,1
2021,Central Bedfordshire 003A,E01017425,1135,1119,16,10,4,2,0
2021,Central Bedfordshire 003B,E01017426,1374,1360,14,10,4,0,0
2021,Central Bedfordshire 003C,E01017427,1937,1907,30,21,9,0,0
2021,Central Bedfordshire 003D,E01017428,1600,1571,29,11,9,7,2
2021,Central Bedfordshire 003E,E01017429,1852,1797,55,29,16,10,0
2021,Central Bedfordshire 002A,E01017430,1436,1386,50,22,20,8,0
2021,Central Bedfordshire 002B,E01017431,1593,1562,31,14,11,4,2
2021,Central Bedfordshire 002C,E01017432,1455,1434,21,14,5,2,0
2021,Central Bedfordshire 001A,E01017433,1562,1494,68,21,26,20,1
2021,Central Bedfordshire 001B,E01017434,1600,1542,58,32,20,6,0
2021,Central Bedfordshire 002D,E01017435,1764,1714,50,17,17,12,4
2021,Central Bedfordshire 001C,E01017436,2389,2333,56,37,14,2,3
2021,Central Bedfordshire 011A,E01017437,1838,1789,49,22,21,6,0
2021,Central Bedfordshire 011B,E01017438,1628,1614,14,8,0,3,3
2021,Central Bedfordshire 011C,E01017439,2004,1959,45,27,13,5,0
2021,Central Bedfordshire 011D,E01017440,1874,1848,26,15,7,4,0
2021,Central Bedfordshire 011E,E01017441,2057,2008,49,26,22,1,0
2021,Central Bedfordshire 013D,E01017442,2684,2602,82,44,32,3,3
2021,Central Bedfordshire 013E,E01017443,1561,1533,28,18,9,1,0
2021,Central Bedfordshire 011F,E01017444,2025,1994,31,19,10,0,2
2021,Central Bedfordshire 014A,E01017446,1722,1695,27,8,8,9,2
2021,Central Bedfordshire 014B,E01017447,2470,2430,40,20,14,5,1
2021,Central Bedfordshire 014D,E01017449,2060,2015,45,25,16,4,0
2021,Central Bedfordshire 017E,E01017450,2192,2156,36,24,7,5,0
2021,Central Bedfordshire 009D,E01017451,1382,1359,23,15,5,3,0
2021,Central Bedfordshire 009E,E01017452,1219,1190,29,17,9,3,0
2021,Bedford 005A,E01017453,1322,1201,121,51,51,18,1
2021,Bedford 005B,E01017454,1422,1324,98,46,32,20,0
2021,Bedford 005C,E01017455,1377,1271,106,45,40,18,3
2021,Bedford 005D,E01017456,1442,1370,72,33,22,16,1
2021,Bedford 005E,E01017457,1178,1092,86,43,26,15,2
2021,Bedford 005F,E01017458,1194,1103,91,47,31,13,0
2021,Bedford 008A,E01017459,1612,1575,37,23,10,4,0
2021,Bedford 008B,E01017460,2278,2137,141,78,43,17,3
2021,Bedford 008D,E01017462,1544,1520,24,12,11,1,0
2021,Bedford 008E,E01017463,1322,1272,50,25,23,1,1
2021,Bedford 002A,E01017464,1385,1366,19,13,5,1,0
2021,Bedford 002B,E01017465,1479,1462,17,9,7,1,0
2021,Bedford 012A,E01017466,2215,1349,866,285,348,205,28
2021,Bedford 012B,E01017467,1322,1221,101,59,17,25,0
2021,Bedford 012C,E01017468,1342,1224,118,54,43,18,3
2021,Bedford 012E,E01017470,1264,1171,93,40,34,17,2
2021,Bedford 012F,E01017471,1782,1269,513,157,230,108,18
2021,Bedford 015A,E01017472,1486,1090,396,121,169,91,15
2021,Bedford 015C,E01017474,1798,1195,603,196,234,152,21
2021,Bedford 015D,E01017475,1579,1102,477,168,199,97,13
2021,Bedford 015E,E01017476,1468,1070,398,116,170,101,11
2021,Bedford 015F,E01017477,1300,1054,246,74,101,55,16
2021,Bedford 003A,E01017478,1702,1657,45,20,16,8,1
2021,Bedford 003B,E01017479,1308,1258,50,23,20,5,2
2021,Bedford 003C,E01017480,1915,1831,84,40,26,18,0
2021,Bedford 003D,E01017481,1167,1091,76,35,30,11,0
2021,Bedford 009A,E01017482,1378,1247,131,63,49,15,4
2021,Bedford 009B,E01017483,1699,1478,221,102,80,37,2
2021,Bedford 009C,E01017484,1380,1176,204,92,85,24,3
2021,Bedford 009D,E01017485,1325,1135,190,84,79,25,2
2021,Bedford 021B,E01017487,1866,1693,173,81,63,25,4
2021,Bedford 007A,E01017488,1515,1414,101,50,29,19,3
2021,Bedford 007B,E01017489,1548,1345,203,93,79,28,3
2021,Bedford 007C,E01017490,1323,1149,174,77,66,26,5
2021,Bedford 007D,E01017491,1505,1354,151,68,55,26,2
2021,Bedford 007E,E01017492,1426,1209,217,79,81,48,9
2021,Bedford 007F,E01017493,1592,1455,137,59,56,18,4
2021,Bedford 004B,E01017495,2177,2125,52,25,18,6,3
2021,Bedford 004C,E01017496,1549,1514,35,14,18,3,0
2021,Bedford 010A,E01017497,1307,1094,213,78,83,47,5
2021,Bedford 010B,E01017498,1160,1030,130,69,48,10,3
2021,Bedford 010C,E01017499,1338,1098,240,112,72,43,13
2021,Bedford 010D,E01017500,1156,955,201,79,81,36,5
2021,Bedford 010E,E01017501,1809,1431,378,164,132,72,10
2021,Bedford 010F,E01017502,1815,1347,468,121,193,131,23
2021,Bedford 002C,E01017503,1338,1291,47,28,16,3,0
2021,Bedford 002D,E01017504,1913,1881,32,24,3,3,2
2021,Bedford 017A,E01017505,1493,1276,217,98,71,41,7
2021,Bedford 017B,E01017506,1501,1200,301,89,153,49,10
2021,Bedford 017C,E01017507,1354,1132,222,81,97,40,4
2021,Bedford 017D,E01017508,1638,1430,208,73,88,43,4
2021,Bedford 016A,E01017509,1188,1069,119,46,44,27,2
2021,Bedford 016B,E01017510,1545,1414,131,55,54,19,3
2021,Bedford 016C,E01017511,1159,1020,139,61,58,16,4
2021,Bedford 016D,E01017512,1456,1144,312,126,112,61,13
2021,Bedford 018A,E01017513,1417,1179,238,83,110,43,2
2021,Bedford 018B,E01017514,1676,1404,272,97,112,51,12
2021,Bedford 018C,E01017515,1600,1427,173,60,72,32,9
2021,Bedford 018E,E01017517,1521,1304,217,89,83,40,5
2021,Bedford 014A,E01017518,1666,1294,372,130,165,65,12
2021,Bedford 014B,E01017519,1580,1278,302,102,123,63,14
2021,Bedford 014C,E01017520,1760,1476,284,115,103,48,18
2021,Bedford 014D,E01017521,1593,1279,314,116,121,64,13
2021,Bedford 014E,E01017522,2016,1447,569,174,257,123,15
2021,Bedford 014F,E01017523,1671,1262,409,152,172,73,12
2021,Bedford 011A,E01017524,1651,1524,127,55,51,19,2
2021,Bedford 011B,E01017525,1195,1077,118,50,43,23,2
2021,Bedford 011C,E01017526,1447,1290,157,85,58,13,1
2021,Bedford 011D,E01017527,1160,1071,89,44,35,9,1
2021,Bedford 003E,E01017528,2455,2394,61,39,16,4,2
2021,Bedford 006A,E01017529,1250,1168,82,47,21,13,1
2021,Bedford 006B,E01017530,1407,1349,58,26,20,12,0
2021,Bedford 006C,E01017531,1312,1201,111,57,37,13,4
2021,Bedford 006D,E01017532,1264,1201,63,38,20,5,0
2021,Bedford 006E,E01017533,1137,1056,81,46,27,4,4
2021,Bedford 006F,E01017534,1509,1396,113,53,43,16,1
2021,Bedford 013A,E01017535,2095,1677,418,154,144,100,20
2021,Bedford 013B,E01017536,2423,1488,935,260,340,288,47
2021,Bedford 013C,E01017537,1421,1058,363,78,152,107,26
2021,Bedford 013D,E01017538,1788,1184,604,147,255,166,36
2021,Bedford 013E,E01017539,1573,1102,471,119,200,130,22
2021,Bedford 001A,E01017540,1430,1421,9,5,3,0,1
2021,Bedford 001B,E01017541,1294,1267,27,13,9,4,1
2021,Bedford 004D,E01017542,1395,1368,27,15,9,2,1
2021,Bedford 004E,E01017543,1567,1552,15,6,9,0,0
2021,Bedford 001C,E01017544,1412,1391,21,10,9,2,0
2021,Bedford 001D,E01017545,1433,1408,25,20,3,1,1
2021,Bedford 002E,E01017546,1167,1145,22,15,6,1,0
2021,Bedford 002F,E01017547,1564,1513,51,27,16,8,0
2021,Bedford 021F,E01017549,1476,1438,38,24,10,4,0
2021,Bedford 020B,E01017552,2584,2439,145,80,47,16,2
2021,Bedford 020C,E01017553,1322,1293,29,17,9,3,0
2021,Bedford 020D,E01017554,1904,1846,58,38,13,6,1
2021,Central Bedfordshire 021A,E01017555,1999,1834,165,77,66,16,6
2021,Central Bedfordshire 021B,E01017556,1589,1523,66,40,19,7,0
2021,Central Bedfordshire 021C,E01017557,1836,1760,76,44,22,8,2
2021,Central Bedfordshire 018A,E01017558,1729,1684,45,21,15,8,1
2021,Central Bedfordshire 018B,E01017559,1635,1615,20,8,4,6,2
2021,Central Bedfordshire 018C,E01017560,1474,1449,25,12,9,2,2
2021,Central Bedfordshire 033A,E01017561,1443,1424,19,15,4,0,0
2021,Central Bedfordshire 033B,E01017562,2354,2218,136,84,34,16,2
2021,Central Bedfordshire 033C,E01017563,1547,1503,44,18,16,9,1
2021,Central Bedfordshire 033D,E01017564,1413,1359,54,24,19,11,0
2021,Central Bedfordshire 029A,E01017565,1476,1409,67,36,22,5,4
2021,Central Bedfordshire 028A,E01017566,1433,1383,50,22,13,11,4
2021,Central Bedfordshire 029B,E01017567,1611,1454,157,56,72,25,4
2021,Central Bedfordshire 029C,E01017568,2152,1755,397,131,207,53,6
2021,Central Bedfordshire 029D,E01017569,1765,1533,232,85,117,29,1
2021,Central Bedfordshire 032A,E01017571,1217,1191,26,11,9,5,1
2021,Central Bedfordshire 032B,E01017572,1355,1318,37,17,16,3,1
2021,Central Bedfordshire 024A,E01017573,1352,1306,46,16,21,8,1
2021,Central Bedfordshire 024D,E01017576,1314,1294,20,11,5,4,0
2021,Central Bedfordshire 019A,E01017577,2440,2389,51,31,9,10,1
2021,Central Bedfordshire 026A,E01017578,2276,2051,225,106,78,35,6
2021,Central Bedfordshire 026B,E01017579,1920,1702,218,88,92,31,7
2021,Central Bedfordshire 026C,E01017580,2376,2046,330,138,155,27,10
2021,Central Bedfordshire 026D,E01017581,1786,1583,203,88,78,33,4
2021,Central Bedfordshire 027A,E01017582,1475,1297,178,97,59,21,1
2021,Central Bedfordshire 027B,E01017583,1902,1670,232,100,113,18,1
2021,Central Bedfordshire 027C,E01017584,2038,1743,295,108,145,38,4
2021,Central Bedfordshire 027D,E01017585,1359,1242,117,50,48,16,3
2021,Central Bedfordshire 032C,E01017586,1475,1435,40,26,5,7,2
2021,Central Bedfordshire 032D,E01017587,1607,1582,25,21,1,3,0
2021,Central Bedfordshire 032E,E01017588,1175,1164,11,7,2,2,0
2021,Central Bedfordshire 022A,E01017589,1602,1490,112,66,27,17,2
2021,Central Bedfordshire 022B,E01017590,1505,1463,42,22,14,6,0
2021,Central Bedfordshire 022C,E01017591,1685,1623,62,32,24,6,0
2021,Central Bedfordshire 030A,E01017592,1633,1429,204,81,81,36,6
2021,Central Bedfordshire 030B,E01017593,1463,1362,101,45,43,11,2
2021,Central Bedfordshire 030C,E01017594,2210,1898,312,146,115,43,8
2021,Central Bedfordshire 028B,E01017595,1160,1121,39,21,18,0,0
2021,Central Bedfordshire 028C,E01017596,1604,1469,135,63,51,17,4
2021,Central Bedfordshire 028D,E01017597,1525,1409,116,49,58,9,0
2021,Central Bedfordshire 028E,E01017598,1596,1435,161,78,58,21,4
2021,Central Bedfordshire 025A,E01017600,1958,1593,365,160,160,40,5
2021,Central Bedfordshire 025B,E01017601,1463,1264,199,86,82,25,6
2021,Central Bedfordshire 025C,E01017602,1484,1292,192,77,73,34,8
2021,Central Bedfordshire 020A,E01017603,1421,1349,72,37,24,7,4
2021,Central Bedfordshire 020B,E01017604,1523,1490,33,21,11,1,0
2021,Central Bedfordshire 020C,E01017605,1363,1326,37,19,11,6,1
2021,Central Bedfordshire 020D,E01017606,1724,1696,28,20,7,1,0
2021,Central Bedfordshire 020E,E01017607,1413,1393,20,11,6,3,0
2021,Central Bedfordshire 021D,E01017608,1739,1687,52,25,17,9,1
2021,Central Bedfordshire 021E,E01017609,2055,1985,70,35,27,7,1
2021,Central Bedfordshire 022D,E01017610,1072,1056,16,11,4,1,0
2021,Central Bedfordshire 023A,E01017611,1184,1160,24,15,7,2,0
2021,Central Bedfordshire 023B,E01017612,1242,1214,28,18,7,3,0
2021,Central Bedfordshire 023C,E01017613,1350,1306,44,27,15,1,1
2021,Central Bedfordshire 023D,E01017614,1413,1385,28,20,7,1,0
2021,Central Bedfordshire 018D,E01017616,2269,2107,162,84,57,18,3
2021,Central Bedfordshire 026E,E01017617,1282,1152,130,51,52,26,1
2021,Central Bedfordshire 025D,E01017618,2137,1811,326,148,141,34,3
2021,Central Bedfordshire 025E,E01017619,2168,1874,294,144,108,34,8
2021,Central Bedfordshire 019C,E01017620,1814,1769,45,28,14,1,2
2021,Central Bedfordshire 019D,E01017621,1471,1450,21,12,5,4,0
2021,Central Bedfordshire 019E,E01017622,1646,1597,49,20,19,7,3
2021,Central Bedfordshire 031A,E01017623,1632,1427,205,94,86,24,1
2021,Central Bedfordshire 031B,E01017624,1720,1596,124,57,57,9,1
2021,Central Bedfordshire 031C,E01017625,1505,1463,42,24,13,5,0
2021,Central Bedfordshire 031D,E01017626,1538,1498,40,13,21,6,0
2021,Buckinghamshire 021A,E01017627,1732,1709,23,16,3,4,0
2021,Buckinghamshire 021B,E01017628,1735,1681,54,37,13,3,1
2021,Buckinghamshire 021C,E01017629,1674,1645,29,21,3,5,0
2021,Buckinghamshire 021D,E01017630,1550,1529,21,10,4,5,2
2021,Buckinghamshire 021E,E01017631,2323,2206,117,77,29,7,4
2021,Buckinghamshire 015A,E01017634,1575,1312,263,117,94,41,11
2021,Buckinghamshire 018A,E01017635,1471,1371,100,56,30,11,3
2021,Buckinghamshire 018B,E01017636,1498,1406,92,55,33,4,0
2021,Buckinghamshire 018C,E01017637,1229,1147,82,44,30,7,1
2021,Buckinghamshire 018D,E01017638,1244,1164,80,50,16,10,4
2021,Buckinghamshire 018E,E01017639,1478,1402,76,50,23,3,0
2021,Buckinghamshire 018F,E01017640,1631,1547,84,54,25,5,0
2021,Buckinghamshire 010A,E01017642,1257,1240,17,14,3,0,0
2021,Buckinghamshire 010B,E01017643,1378,1360,18,12,6,0,0
2021,Buckinghamshire 002A,E01017644,1420,1359,61,39,16,6,0
2021,Buckinghamshire 002B,E01017645,1392,1284,108,77,20,10,1
2021,Buckinghamshire 002C,E01017646,2251,2160,91,58,24,9,0
2021,Buckinghamshire 002D,E01017647,1511,1470,41,31,5,4,1
2021,Buckinghamshire 001A,E01017648,1620,1581,39,26,12,0,1
2021,Buckinghamshire 001B,E01017649,2421,2299,122,81,28,10,3
2021,Buckinghamshire 008A,E01017651,1559,1539,20,10,7,3,0
2021,Buckinghamshire 008B,E01017652,1643,1627,16,7,6,2,1
2021,Buckinghamshire 016A,E01017653,1412,1232,180,75,66,32,7
2021,Buckinghamshire 016B,E01017654,1600,1297,303,131,113,45,14
2021,Buckinghamshire 016C,E01017655,1760,1594,166,85,57,20,4
2021,Buckinghamshire 008C,E01017657,1535,1511,24,15,9,0,0
2021,Buckinghamshire 008D,E01017658,1585,1556,29,20,5,4,0
2021,Buckinghamshire 012A,E01017659,1582,1294,288,124,104,54,6
2021,Buckinghamshire 012B,E01017660,1515,1376,139,85,44,9,1
2021,Buckinghamshire 012C,E01017661,1544,1314,230,90,96,37,7
2021,Buckinghamshire 015B,E01017662,1398,1188,210,89,72,40,9
2021,Buckinghamshire 015C,E01017663,1635,1199,436,125,192,105,14
2021,Buckinghamshire 012D,E01017664,1341,1267,74,48,19,7,0
2021,Buckinghamshire 013A,E01017665,2582,2128,454,225,170,54,5
2021,Buckinghamshire 013B,E01017666,2241,1835,406,149,181,63,13
2021,Buckinghamshire 013C,E01017667,1411,1219,192,72,85,31,4
2021,Buckinghamshire 013D,E01017668,1537,1333,204,94,77,24,9
2021,Buckinghamshire 006A,E01017669,2474,2376,98,57,25,14,2
2021,Buckinghamshire 006B,E01017670,1790,1768,22,10,8,4,0
2021,Buckinghamshire 003A,E01017671,1572,1550,22,17,3,2,0
2021,Buckinghamshire 003B,E01017672,1551,1523,28,18,6,3,1
2021,Buckinghamshire 010C,E01017673,1356,1337,19,14,3,0,2
2021,Buckinghamshire 010D,E01017674,1763,1722,41,25,11,4,1
2021,Buckinghamshire 022A,E01017675,1713,1647,66,35,22,8,1
2021,Buckinghamshire 022B,E01017676,1433,1403,30,14,10,5,1
2021,Buckinghamshire 022C,E01017677,1881,1833,48,37,7,4,0
2021,Buckinghamshire 022D,E01017678,1391,1344,47,28,15,4,0
2021,Buckinghamshire 022E,E01017679,1560,1524,36,27,7,2,0
2021,Buckinghamshire 022F,E01017680,1182,1163,19,9,9,1,0
2021,Buckinghamshire 023A,E01017681,1331,1305,26,18,6,2,0
2021,Buckinghamshire 023B,E01017682,1230,1198,32,18,12,2,0
2021,Buckinghamshire 023C,E01017683,1751,1732,19,16,2,1,0
2021,Buckinghamshire 023D,E01017684,1113,1102,11,7,3,1,0
2021,Buckinghamshire 019A,E01017687,2504,2197,307,182,92,30,3
2021,Buckinghamshire 019B,E01017688,1125,1019,106,45,47,12,2
2021,Buckinghamshire 019C,E01017689,1275,1185,90,59,19,12,0
2021,Buckinghamshire 019D,E01017690,1132,1036,96,60,22,11,3
2021,Buckinghamshire 019E,E01017691,1304,1272,32,23,8,1,0
2021,Buckinghamshire 019F,E01017692,1511,1275,236,104,97,34,1
2021,Buckinghamshire 004A,E01017693,1092,1080,12,11,1,0,0
2021,Buckinghamshire 004B,E01017694,2403,2365,38,25,7,6,0
2021,Buckinghamshire 003C,E01017695,1189,1166,23,16,7,0,0
2021,Buckinghamshire 003D,E01017696,1365,1344,21,13,2,5,1
2021,Buckinghamshire 014A,E01017697,1292,1187,105,62,39,3,1
2021,Buckinghamshire 014B,E01017698,1365,1250,115,39,49,20,7
2021,Buckinghamshire 014C,E01017699,1709,1545,164,86,57,17,4
2021,Buckinghamshire 014D,E01017700,1588,1494,94,58,28,8,0
2021,Buckinghamshire 008E,E01017701,2722,2687,35,18,13,4,0
2021,Buckinghamshire 008F,E01017702,1466,1440,26,14,9,3,0
2021,Buckinghamshire 009A,E01017703,1297,1273,24,16,4,1,3
2021,Buckinghamshire 009B,E01017704,1272,1264,8,4,3,0,1
2021,Buckinghamshire 011A,E01017706,1405,1256,149,76,50,21,2
2021,Buckinghamshire 011B,E01017707,1289,1098,191,61,88,38,4
2021,Buckinghamshire 011C,E01017708,1515,1286,229,99,75,47,8
2021,Buckinghamshire 017A,E01017709,1668,1370,298,105,109,69,15
2021,Buckinghamshire 017B,E01017710,1572,1365,207,100,71,29,7
2021,Buckinghamshire 017C,E01017711,1633,1381,252,84,122,39,7
2021,Buckinghamshire 017D,E01017712,2267,1804,463,166,184,88,25
2021,Buckinghamshire 004C,E01017713,1385,1371,14,10,4,0,0
2021,Buckinghamshire 004D,E01017714,1608,1572,36,21,10,5,0
2021,Buckinghamshire 006C,E01017715,1185,1171,14,6,6,2,0
2021,Buckinghamshire 006D,E01017716,1825,1804,21,15,6,0,0
2021,Buckinghamshire 004E,E01017717,1736,1705,31,11,14,6,0
2021,Buckinghamshire 004F,E01017718,1851,1832,19,11,5,3,0
2021,Buckinghamshire 009C,E01017719,1212,1192,20,13,4,3,0
2021,Buckinghamshire 009D,E01017720,1279,1246,33,22,8,2,1
2021,Buckinghamshire 020A,E01017721,1613,1442,171,73,77,12,9
2021,Buckinghamshire 020B,E01017722,1402,1305,97,52,38,5,2
2021,Buckinghamshire 020C,E01017723,1283,1099,184,68,79,34,3
2021,Buckinghamshire 020D,E01017724,1425,1199,226,102,81,36,7
2021,Buckinghamshire 024A,E01017726,1150,1129,21,10,9,2,0
2021,Buckinghamshire 024B,E01017727,1788,1762,26,18,7,1,0
2021,Buckinghamshire 024C,E01017729,1596,1570,26,15,6,2,3
2021,Buckinghamshire 024D,E01017730,1540,1495,45,27,6,12,0
2021,Buckinghamshire 007A,E01017731,1299,1274,25,18,7,0,0
2021,Buckinghamshire 007B,E01017732,1609,1580,29,15,12,1,1
2021,Buckinghamshire 007C,E01017733,1281,1265,16,8,8,0,0
2021,Buckinghamshire 007D,E01017734,1494,1472,22,17,4,0,1
2021,Buckinghamshire 005A,E01017735,1368,1352,16,13,2,0,1
2021,Buckinghamshire 005B,E01017736,1483,1459,24,18,5,1,0
2021,Buckinghamshire 005C,E01017737,1269,1252,17,11,5,1,0
2021,Buckinghamshire 005D,E01017738,2324,2269,55,35,12,6,2
2021,Buckinghamshire 034A,E01017739,1243,1149,94,75,10,8,1
2021,Buckinghamshire 034B,E01017740,1427,1230,197,142,41,11,3
2021,Buckinghamshire 032A,E01017741,1621,1502,119,77,36,6,0
2021,Buckinghamshire 032B,E01017742,1714,1601,113,79,21,13,0
2021,Buckinghamshire 032C,E01017743,1869,1670,199,119,65,12,3
2021,Buckinghamshire 034C,E01017744,1477,1420,57,43,8,5,1
2021,Buckinghamshire 034D,E01017745,1669,1579,90,46,36,8,0
2021,Buckinghamshire 034E,E01017746,1549,1451,98,67,26,4,1
2021,Buckinghamshire 027A,E01017747,1459,1312,147,66,48,27,6
2021,Buckinghamshire 027B,E01017748,1803,1638,165,62,63,34,6
2021,Buckinghamshire 027C,E01017749,1790,1713,77,54,15,6,2
2021,Buckinghamshire 029A,E01017750,2192,2142,50,31,14,4,1
2021,Buckinghamshire 054A,E01017751,2088,2032,56,45,10,1,0
2021,Buckinghamshire 029B,E01017752,2229,2193,36,29,2,4,1
2021,Buckinghamshire 054B,E01017753,1235,1178,57,40,10,1,6
2021,Buckinghamshire 050A,E01017754,1505,1465,40,35,4,1,0
2021,Buckinghamshire 050B,E01017755,1910,1779,131,60,40,31,0
2021,Buckinghamshire 050C,E01017756,1471,1409,62,46,14,2,0
2021,Buckinghamshire 050D,E01017757,1151,1126,25,18,7,0,0
2021,Buckinghamshire 050E,E01017758,1334,1274,60,43,16,1,0
2021,Buckinghamshire 047A,E01017759,1780,1734,46,29,15,2,0
2021,Buckinghamshire 047B,E01017760,1680,1634,46,28,12,6,0
2021,Buckinghamshire 047C,E01017761,2081,2038,43,27,10,6,0
2021,Buckinghamshire 035A,E01017762,1380,1318,62,39,13,7,3
2021,Buckinghamshire 032D,E01017763,1721,1571,150,89,52,6,3
2021,Buckinghamshire 032E,E01017764,1648,1582,66,57,8,1,0
2021,Buckinghamshire 032F,E01017765,1678,1632,46,33,7,6,0
2021,Buckinghamshire 029C,E01017766,2269,2234,35,17,10,6,2
2021,Buckinghamshire 054C,E01017767,2296,2212,84,58,21,3,2
2021,Buckinghamshire 031A,E01017768,2263,2194,69,51,13,4,1
2021,Buckinghamshire 028A,E01017769,1591,1500,91,57,26,6,2
2021,Buckinghamshire 030A,E01017770,1601,1367,234,89,94,47,4
2021,Buckinghamshire 028B,E01017771,1451,1402,49,28,14,6,1
2021,Buckinghamshire 039A,E01017773,1490,1472,18,12,5,1,0
2021,Buckinghamshire 039B,E01017774,1296,1270,26,14,9,2,1
2021,Buckinghamshire 035B,E01017775,1636,1520,116,78,33,5,0
2021,Buckinghamshire 035C,E01017776,2178,1938,240,152,67,20,1
2021,Buckinghamshire 035D,E01017777,1757,1615,142,125,13,3,1
2021,Buckinghamshire 029D,E01017778,1293,1267,26,18,6,2,0
2021,Buckinghamshire 031B,E01017779,1097,1082,15,12,2,1,0
2021,Buckinghamshire 028C,E01017780,1398,1315,83,46,23,12,2
2021,Buckinghamshire 028D,E01017781,1203,993,210,81,78,46,5
2021,Buckinghamshire 039C,E01017782,1506,1464,42,31,6,4,1
2021,Buckinghamshire 039D,E01017783,1517,1486,31,18,12,0,1
2021,Buckinghamshire 039E,E01017784,1619,1578,41,29,11,0,1
2021,Buckinghamshire 031C,E01017785,1560,1538,22,18,2,1,1
2021,Buckinghamshire 031D,E01017786,1501,1466,35,21,12,2,0
2021,Buckinghamshire 031E,E01017787,1567,1537,30,22,8,0,0
2021,Buckinghamshire 031F,E01017788,1619,1572,47,25,18,3,1
2021,Buckinghamshire 027D,E01017789,1297,1121,176,40,89,45,2
2021,Buckinghamshire 027E,E01017790,1476,1338,138,54,50,28,6
2021,Buckinghamshire 030B,E01017791,1454,1372,82,55,18,7,2
2021,Buckinghamshire 030C,E01017792,2141,1912,229,121,82,24,2
2021,Buckinghamshire 030D,E01017793,1394,1354,40,27,7,5,1
2021,Buckinghamshire 047D,E01017794,2243,2198,45,33,10,0,2
2021,Buckinghamshire 027F,E01017795,2184,2011,173,79,55,37,2
2021,Buckinghamshire 053A,E01017796,1782,1651,131,71,45,12,3
2021,Buckinghamshire 053B,E01017797,1349,1305,44,32,6,6,0
2021,Buckinghamshire 053C,E01017798,1782,1721,61,42,16,3,0
2021,Buckinghamshire 053D,E01017799,2115,2019,96,64,23,7,2
2021,Buckinghamshire 053E,E01017800,1646,1501,145,89,31,23,2
2021,Buckinghamshire 053F,E01017801,1632,1529,103,73,21,9,0
2021,Buckinghamshire 053G,E01017802,1593,1518,75,32,32,11,0
2021,Buckinghamshire 065A,E01017803,1363,1279,84,51,24,6,3
2021,Buckinghamshire 066A,E01017804,1595,1507,88,44,31,10,3
2021,Buckinghamshire 066B,E01017805,1873,1779,94,47,39,7,1
2021,Buckinghamshire 065B,E01017806,1699,1632,67,38,20,6,3
2021,Buckinghamshire 066C,E01017807,1526,1354,172,103,50,16,3
2021,Buckinghamshire 066D,E01017808,1592,1472,120,66,38,13,3
2021,Buckinghamshire 066E,E01017809,1591,1465,126,81,37,8,0
2021,Buckinghamshire 059A,E01017810,2197,2005,192,118,60,11,3
2021,Buckinghamshire 059B,E01017811,1198,1119,79,55,15,8,1
2021,Buckinghamshire 059C,E01017812,1830,1648,182,93,60,22,7
2021,Buckinghamshire 059D,E01017813,1960,1767,193,99,72,15,7
2021,Buckinghamshire 065C,E01017814,1655,1494,161,95,48,15,3
2021,Buckinghamshire 063A,E01017815,1881,1791,90,61,20,9,0
2021,Buckinghamshire 063B,E01017816,1698,1618,80,55,21,4,0
2021,Buckinghamshire 063C,E01017817,2103,1954,149,83,47,17,2
2021,Buckinghamshire 058A,E01017818,2030,1835,195,107,60,25,3
2021,Buckinghamshire 058B,E01017819,1631,1528,103,70,25,7,1
2021,Buckinghamshire 058C,E01017820,1729,1578,151,94,39,15,3
2021,Buckinghamshire 058D,E01017821,1561,1425,136,88,33,13,2
2021,Buckinghamshire 058E,E01017822,2063,1866,197,132,45,14,6
2021,Buckinghamshire 063D,E01017823,1400,1335,65,39,19,6,1
2021,Buckinghamshire 067A,E01017824,1639,1515,124,74,35,14,1
2021,Buckinghamshire 067B,E01017825,1663,1562,101,57,29,12,3
2021,Buckinghamshire 067C,E01017826,1559,1466,93,52,29,9,3
2021,Buckinghamshire 067D,E01017827,1970,1793,177,98,62,15,2
2021,Buckinghamshire 067E,E01017828,1483,1409,74,36,30,7,1
2021,Buckinghamshire 067F,E01017829,2120,1772,348,215,99,25,9
2021,Buckinghamshire 064A,E01017830,1912,1797,115,60,46,9,0
2021,Buckinghamshire 064B,E01017831,1687,1528,159,103,42,10,4
2021,Buckinghamshire 064C,E01017832,1813,1595,218,127,61,22,8
2021,Buckinghamshire 065D,E01017833,2300,2185,115,77,31,6,1
2021,Buckinghamshire 064D,E01017834,1619,1410,209,104,70,25,10
2021,Buckinghamshire 064E,E01017835,1618,1518,100,47,32,17,4
2021,Buckinghamshire 049A,E01017836,1661,1299,362,108,135,96,23
2021,Buckinghamshire 049B,E01017837,2470,1736,734,331,276,104,23
2021,Buckinghamshire 049C,E01017838,1587,1213,374,122,158,82,12
2021,Buckinghamshire 049D,E01017839,2300,1825,475,237,173,59,6
2021,Buckinghamshire 049E,E01017840,1938,1621,317,149,114,47,7
2021,Buckinghamshire 049F,E01017841,2494,2211,283,181,69,26,7
2021,Buckinghamshire 052A,E01017843,1544,1449,95,52,33,9,1
2021,Buckinghamshire 052B,E01017844,1715,1492,223,101,88,28,6
2021,Buckinghamshire 052C,E01017845,1593,1378,215,106,68,35,6
2021,Buckinghamshire 060A,E01017846,1419,1361,58,30,21,6,1
2021,Buckinghamshire 060B,E01017847,1632,1592,40,20,15,5,0
2021,Buckinghamshire 060C,E01017848,1224,1209,15,10,4,1,0
2021,Buckinghamshire 060D,E01017849,1411,1344,67,39,15,13,0
2021,Buckinghamshire 042A,E01017850,1369,1115,254,88,100,50,16
2021,Buckinghamshire 042B,E01017851,1652,1402,250,102,91,50,7
2021,Buckinghamshire 042C,E01017852,2485,1918,567,203,218,118,28
2021,Buckinghamshire 040A,E01017853,1294,1208,86,49,25,10,2
2021,Buckinghamshire 040B,E01017854,1155,1139,16,14,1,1,0
2021,Buckinghamshire 052D,E01017855,1578,1522,56,38,12,6,0
2021,Buckinghamshire 052E,E01017856,1476,1432,44,20,16,6,2
2021,Buckinghamshire 038A,E01017857,1424,1153,271,83,119,61,8
2021,Buckinghamshire 038B,E01017858,2404,2126,278,137,102,37,2
2021,Buckinghamshire 038C,E01017859,1651,1448,203,86,89,26,2
2021,Buckinghamshire 038D,E01017860,1420,1254,166,67,64,33,2
2021,Buckinghamshire 038E,E01017861,1523,1444,79,52,21,4,2
2021,Buckinghamshire 038F,E01017862,1802,1705,97,51,32,12,2
2021,Buckinghamshire 038G,E01017863,1695,1588,107,48,39,16,4
2021,Buckinghamshire 055A,E01017864,1254,1236,18,10,5,3,0
2021,Buckinghamshire 055B,E01017865,1483,1458,25,17,4,4,0
2021,Buckinghamshire 057A,E01017866,1437,1399,38,28,7,3,0
2021,Buckinghamshire 055C,E01017867,1489,1437,52,25,20,7,0
2021,Buckinghamshire 055D,E01017868,1530,1501,29,16,13,0,0
2021,Buckinghamshire 033A,E01017869,1272,1249,23,14,5,2,2
2021,Buckinghamshire 033B,E01017870,1151,1134,17,13,3,0,1
2021,Buckinghamshire 033C,E01017871,1476,1460,16,8,7,1,0
2021,Buckinghamshire 033D,E01017872,1532,1511,21,18,3,0,0
2021,Buckinghamshire 033E,E01017873,1326,1319,7,7,0,0,0
2021,Buckinghamshire 033F,E01017874,1317,1166,151,94,45,10,2
2021,Buckinghamshire 057B,E01017875,1437,1413,24,16,4,2,2
2021,Buckinghamshire 057C,E01017876,2015,1973,42,33,8,1,0
2021,Buckinghamshire 057D,E01017877,1540,1496,44,29,13,0,2
2021,Buckinghamshire 040C,E01017878,2363,2299,64,37,24,3,0
2021,Buckinghamshire 036A,E01017880,1358,1331,27,19,6,1,1
2021,Buckinghamshire 036B,E01017881,1890,1820,70,39,24,6,1
2021,Buckinghamshire 036C,E01017882,1566,1512,54,27,23,4,0
2021,Buckinghamshire 036D,E01017883,1594,1543,51,36,11,3,1
2021,Buckinghamshire 036E,E01017884,1359,1320,39,22,9,7,1
2021,Buckinghamshire 025A,E01017885,2063,2022,41,26,11,2,2
2021,Buckinghamshire 025B,E01017886,1462,1437,25,17,7,1,0
2021,Buckinghamshire 025C,E01017887,1112,1098,14,10,3,1,0
2021,Buckinghamshire 025D,E01017888,1485,1457,28,14,11,3,0
2021,Buckinghamshire 062A,E01017889,1441,1289,152,74,74,4,0
2021,Buckinghamshire 062B,E01017890,1290,1255,35,31,4,0,0
2021,Buckinghamshire 062C,E01017891,1400,1344,56,39,12,5,0
2021,Buckinghamshire 062D,E01017892,1516,1488,28,24,3,1,0
2021,Buckinghamshire 062E,E01017893,1709,1640,69,38,27,3,1
2021,Buckinghamshire 062F,E01017894,1555,1490,65,42,16,7,0
2021,Buckinghamshire 061A,E01017895,1278,1208,70,39,22,7,2
2021,Buckinghamshire 061B,E01017896,1374,1330,44,25,15,2,2
2021,Buckinghamshire 061C,E01017897,1647,1599,48,24,17,5,2
2021,Buckinghamshire 061D,E01017898,1199,1094,105,49,41,12,3
2021,Buckinghamshire 048A,E01017899,1674,1441,233,99,88,34,12
2021,Buckinghamshire 048B,E01017900,1139,1016,123,61,41,17,4
2021,Buckinghamshire 048C,E01017901,1167,1039,128,61,50,16,1
2021,Buckinghamshire 048D,E01017902,1552,1361,191,83,75,30,3
2021,Buckinghamshire 046A,E01017903,1680,1240,440,105,186,127,22
2021,Buckinghamshire 046B,E01017904,1871,1306,565,180,236,127,22
2021,Buckinghamshire 046C,E01017905,2203,1496,707,225,281,178,23
2021,Buckinghamshire 046D,E01017906,1856,1417,439,122,184,120,13
2021,Buckinghamshire 046E,E01017907,1751,1304,447,121,169,136,21
2021,Buckinghamshire 051A,E01017910,2458,2146,312,187,92,24,9
2021,Buckinghamshire 044A,E01017911,1634,1432,202,74,95,30,3
2021,Buckinghamshire 044B,E01017912,1451,1243,208,81,80,41,6
2021,Buckinghamshire 044C,E01017913,2038,1511,527,193,211,98,25
2021,Buckinghamshire 044D,E01017914,1336,1215,121,57,38,25,1
2021,Buckinghamshire 037A,E01017915,1405,1360,45,33,8,3,1
2021,Buckinghamshire 037B,E01017916,1155,1137,18,14,4,0,0
2021,Buckinghamshire 037C,E01017917,1620,1574,46,31,13,2,0
2021,Buckinghamshire 037D,E01017918,1499,1462,37,21,12,4,0
2021,Buckinghamshire 042D,E01017919,1295,1087,208,92,82,31,3
2021,Buckinghamshire 041A,E01017920,1455,1342,113,55,41,13,4
2021,Buckinghamshire 041B,E01017921,1689,1419,270,127,92,43,8
2021,Buckinghamshire 041C,E01017922,2317,2042,275,147,84,40,4
2021,Buckinghamshire 041D,E01017923,1598,1198,400,167,155,70,8
2021,Buckinghamshire 041E,E01017924,1569,1443,126,67,45,13,1
2021,Buckinghamshire 043A,E01017925,2023,1739,284,135,114,29,6
2021,Buckinghamshire 043B,E01017926,1395,1214,181,97,63,20,1
2021,Buckinghamshire 043C,E01017927,1690,1490,200,92,72,25,11
2021,Buckinghamshire 043D,E01017928,1422,1247,175,96,49,26,4
2021,Buckinghamshire 026A,E01017929,1676,1611,65,32,24,9,0
2021,Buckinghamshire 026B,E01017930,1814,1778,36,22,9,3,2
2021,Buckinghamshire 026C,E01017931,1432,1394,38,21,13,3,1
2021,Buckinghamshire 026D,E01017932,1560,1539,21,15,3,3,0
2021,Buckinghamshire 026E,E01017933,1828,1767,61,30,29,2,0
2021,Buckinghamshire 056A,E01017934,1781,1704,77,42,26,9,0
2021,Buckinghamshire 056B,E01017935,1945,1881,64,37,19,7,1
2021,Buckinghamshire 056C,E01017936,1440,1402,38,22,12,4,0
2021,Buckinghamshire 045A,E01017937,1394,1373,21,13,7,1,0
2021,Buckinghamshire 045B,E01017938,1264,1231,33,26,6,1,0
2021,Buckinghamshire 056D,E01017939,1360,1283,77,46,23,8,0
2021,Buckinghamshire 045C,E01017940,1521,1428,93,41,39,11,2
2021,Buckinghamshire 051B,E01017941,1365,1287,78,37,33,8,0
2021,Buckinghamshire 045D,E01017942,1443,1410,33,23,7,3,0
2021,Cambridge 006A,E01017943,2127,1588,539,366,133,31,9
2021,Cambridge 006B,E01017944,1397,1204,193,100,64,27,2
2021,Cambridge 006C,E01017945,1694,1351,343,214,92,34,3
2021,Cambridge 006D,E01017946,1529,1249,280,131,117,31,1
2021,Cambridge 006E,E01017947,1680,1375,305,158,112,29,6
2021,Cambridge 006F,E01017948,1607,1349,258,143,79,30,6
2021,Cambridge 002A,E01017949,1567,1257,310,197,81,29,3
2021,Cambridge 002B,E01017950,1269,1066,203,156,34,13,0
2021,Cambridge 002C,E01017951,1463,1159,304,155,107,37,5
2021,Cambridge 002D,E01017952,1564,1239,325,164,111,46,4
2021,Cambridge 002E,E01017953,2042,1654,388,163,145,71,9
2021,Cambridge 002F,E01017954,1485,1187,298,151,106,40,1
2021,Cambridge 005A,E01017955,1430,1161,269,181,68,17,3
2021,Cambridge 011A,E01017959,1730,1385,345,228,91,24,2
2021,Cambridge 011B,E01017960,1390,1084,306,177,89,38,2
2021,Cambridge 011C,E01017961,1177,906,271,136,96,35,4
2021,Cambridge 011D,E01017962,1837,1508,329,200,97,29,3
2021,Cambridge 011E,E01017963,1567,1205,362,214,110,30,8
2021,Cambridge 011F,E01017964,1330,1102,228,151,56,19,2
2021,Cambridge 010A,E01017965,1688,1402,286,190,71,23,2
2021,Cambridge 010C,E01017967,1697,1331,366,216,104,39,7
2021,Cambridge 010D,E01017968,1547,1233,314,206,94,14,0
2021,Cambridge 010E,E01017969,1727,1384,343,238,88,17,0
2021,Cambridge 003B,E01017971,1609,1328,281,127,110,34,10
2021,Cambridge 003C,E01017972,1680,1423,257,159,72,21,5
2021,Cambridge 003D,E01017973,1938,1647,291,144,105,37,5
2021,Cambridge 003E,E01017974,1689,1299,390,198,135,51,6
2021,Cambridge 001A,E01017975,2201,1858,343,158,136,42,7
2021,Cambridge 001B,E01017976,1681,1363,318,188,100,25,5
2021,Cambridge 001C,E01017977,1686,1319,367,189,127,33,18
2021,Cambridge 001D,E01017978,1449,1077,372,182,150,37,3
2021,Cambridge 001E,E01017979,1497,1221,276,118,115,35,8
2021,Cambridge 001F,E01017980,1407,932,475,208,196,70,1
2021,Cambridge 007C,E01017983,2697,2149,548,436,87,22,3
2021,Cambridge 007E,E01017985,1846,1574,272,211,55,3,3
2021,Cambridge 008A,E01017987,1949,1593,356,265,85,6,0
2021,Cambridge 008B,E01017988,1732,1359,373,286,81,6,0
2021,Cambridge 008C,E01017989,1880,1463,417,301,97,19,0
2021,Cambridge 008D,E01017990,1167,954,213,170,37,6,0
2021,Cambridge 008E,E01017991,1354,1063,291,182,88,20,1
2021,Cambridge 013A,E01017992,2050,1628,422,186,165,63,8
2021,Cambridge 013C,E01017994,1856,1592,264,143,94,24,3
2021,Cambridge 013D,E01017995,2076,1729,347,265,61,16,5
2021,Cambridge 013E,E01017996,2028,1712,316,234,67,12,3
2021,Cambridge 009A,E01017997,2561,1977,584,355,156,51,22
2021,Cambridge 009B,E01017998,1853,1286,567,256,281,27,3
2021,Cambridge 009C,E01017999,2141,1632,509,313,159,31,6
2021,Cambridge 009D,E01018000,1757,1437,320,211,84,21,4
2021,Cambridge 009E,E01018001,1585,1268,317,251,52,10,4
2021,Cambridge 014A,E01018005,1787,1465,322,210,92,20,0
2021,Cambridge 004A,E01018006,1507,1223,284,179,89,15,1
2021,Cambridge 004B,E01018007,1502,1344,158,110,31,12,5
2021,Cambridge 004C,E01018008,1556,1278,278,194,65,17,2
2021,Cambridge 004D,E01018009,2117,1713,404,275,105,22,2
2021,Cambridge 004E,E01018010,1610,1309,301,209,71,20,1
2021,East Cambridgeshire 009A,E01018011,2536,2444,92,64,18,10,0
2021,East Cambridgeshire 009B,E01018012,1581,1496,85,50,29,6,0
2021,East Cambridgeshire 008A,E01018013,1814,1776,38,26,12,0,0
2021,East Cambridgeshire 008B,E01018014,1717,1674,43,29,9,5,0
2021,East Cambridgeshire 008C,E01018015,1326,1307,19,16,3,0,0
2021,East Cambridgeshire 008D,E01018016,1387,1360,27,12,12,3,0
2021,East Cambridgeshire 011A,E01018017,1266,1239,27,15,7,5,0
2021,East Cambridgeshire 011B,E01018019,1040,1004,36,24,9,3,0
2021,East Cambridgeshire 002A,E01018020,1523,1511,12,11,1,0,0
2021,East Cambridgeshire 002B,E01018021,1425,1390,35,11,8,15,1
2021,East Cambridgeshire 002C,E01018022,1377,1356,21,14,5,2,0
2021,East Cambridgeshire 011C,E01018023,2086,2042,44,29,12,3,0
2021,East Cambridgeshire 004A,E01018024,1189,1139,50,25,11,14,0
2021,East Cambridgeshire 004B,E01018025,1475,1307,168,92,49,24,3
2021,East Cambridgeshire 004C,E01018026,1434,1320,114,48,40,22,4
2021,East Cambridgeshire 003A,E01018027,1729,1609,120,61,42,15,2
2021,East Cambridgeshire 003D,E01018032,2422,2316,106,65,30,9,2
2021,East Cambridgeshire 003E,E01018033,1853,1718,135,52,48,31,4
2021,East Cambridgeshire 007A,E01018034,1694,1649,45,23,10,9,3
2021,East Cambridgeshire 007B,E01018035,2117,2056,61,30,19,9,3
2021,East Cambridgeshire 005A,E01018036,1627,1587,40,22,10,6,2
2021,East Cambridgeshire 005B,E01018037,1427,1408,19,7,6,5,1
2021,East Cambridgeshire 005C,E01018038,1536,1493,43,19,15,9,0
2021,East Cambridgeshire 005D,E01018039,1267,1240,27,16,5,5,1
2021,East Cambridgeshire 007C,E01018040,1267,1244,23,13,8,2,0
2021,East Cambridgeshire 007D,E01018041,1126,1105,21,13,6,2,0
2021,East Cambridgeshire 001A,E01018042,1361,1280,81,32,28,20,1
2021,East Cambridgeshire 001B,E01018043,2221,2101,120,39,56,17,8
2021,East Cambridgeshire 001C,E01018044,1713,1572,141,51,53,36,1
2021,East Cambridgeshire 001D,E01018045,1329,1234,95,44,43,8,0
2021,East Cambridgeshire 006A,E01018047,1999,1873,126,57,51,17,1
2021,East Cambridgeshire 006C,E01018049,1942,1838,104,41,41,20,2
2021,East Cambridgeshire 006D,E01018050,1442,1298,144,56,68,18,2
2021,East Cambridgeshire 006E,E01018051,2344,2203,141,61,49,26,5
2021,East Cambridgeshire 006F,E01018052,1841,1555,286,82,122,74,8
2021,East Cambridgeshire 005E,E01018053,1761,1744,17,5,7,5,0
2021,East Cambridgeshire 005F,E01018054,2385,2293,92,37,40,13,2
2021,East Cambridgeshire 002D,E01018055,1959,1908,51,28,17,5,1
2021,East Cambridgeshire 002E,E01018056,1935,1885,50,21,23,4,2
2021,East Cambridgeshire 009C,E01018057,2019,1983,36,24,9,3,0
2021,Fenland 008A,E01018058,1411,1390,21,12,7,2,0
2021,Fenland 008B,E01018059,1464,1434,30,10,10,5,5
2021,Fenland 008C,E01018060,1854,1805,49,27,15,7,0
2021,Fenland 008D,E01018061,1248,1218,30,9,10,4,7
2021,Fenland 011A,E01018062,2570,2453,117,46,48,18,5
2021,Fenland 002A,E01018063,2673,1745,928,212,401,272,43
2021,Fenland 006A,E01018064,2382,2293,89,53,22,13,1
2021,Fenland 010A,E01018065,2470,2419,51,24,19,7,1
2021,Fenland 004A,E01018066,1452,1418,34,11,19,4,0
2021,Fenland 004B,E01018067,1803,1754,49,18,14,13,4
2021,Fenland 004C,E01018068,1531,1497,34,12,13,7,2
2021,Fenland 003A,E01018069,1693,1472,221,67,95,53,6
2021,Fenland 003B,E01018070,1928,1245,683,161,290,203,29
2021,Fenland 003C,E01018071,1902,1451,451,127,169,136,19
2021,Fenland 006B,E01018072,2301,2236,65,29,18,15,3
2021,Fenland 002B,E01018073,2536,2095,441,137,177,105,22
2021,Fenland 006C,E01018074,1193,1183,10,3,6,0,1
2021,Fenland 006D,E01018075,1166,1121,45,23,17,4,1
2021,Fenland 010B,E01018076,2537,2504,33,13,12,8,0
2021,Fenland 007A,E01018077,1801,1652,149,32,63,52,2
2021,Fenland 007B,E01018078,1692,1597,95,33,33,26,3
2021,Fenland 007C,E01018079,1647,1564,83,30,32,16,5
2021,Fenland 007D,E01018080,2273,2166,107,35,37,30,5
2021,Fenland 005A,E01018081,1935,1822,113,38,46,27,2
2021,Fenland 005B,E01018082,1897,1813,84,29,31,22,2
2021,Fenland 005C,E01018083,1815,1684,131,55,51,19,6
2021,Fenland 005D,E01018084,1977,1916,61,27,26,8,0
2021,Fenland 009A,E01018085,1596,1553,43,14,17,8,4
2021,Fenland 009B,E01018086,2014,1934,80,28,38,11,3
2021,Fenland 009C,E01018087,2183,2094,89,32,33,21,3
2021,Fenland 009D,E01018088,1501,1438,63,30,24,9,0
2021,Fenland 004D,E01018090,1968,1932,36,16,16,3,1
2021,Fenland 004E,E01018091,1479,1426,53,24,20,8,1
2021,Fenland 004F,E01018092,1840,1794,46,20,16,7,3
2021,Fenland 003E,E01018093,2396,2102,294,84,130,70,10
2021,Fenland 001A,E01018094,1796,1726,70,31,27,10,2
2021,Fenland 001B,E01018095,1689,1656,33,17,10,4,2
2021,Fenland 001C,E01018096,1641,1520,121,28,67,25,1
2021,Fenland 001D,E01018097,1520,1488,32,9,12,7,4
2021,Fenland 006E,E01018098,1240,1219,21,12,5,3,1
2021,Fenland 006F,E01018099,1190,1167,23,6,11,5,1
2021,Fenland 006G,E01018100,1392,1314,78,24,29,21,4
2021,Fenland 006H,E01018101,1437,1386,51,24,20,7,0
2021,Fenland 003F,E01018103,1177,901,276,82,121,59,14
2021,Fenland 003G,E01018104,1135,1036,99,35,42,20,2
2021,Fenland 011C,E01018105,1159,1105,54,20,25,8,1
2021,Fenland 011D,E01018106,1536,1423,113,48,43,17,5
2021,Fenland 002C,E01018107,1696,1240,456,137,202,105,12
2021,Fenland 002D,E01018108,1934,1313,621,187,275,148,11
2021,Fenland 002E,E01018109,1863,1460,403,98,197,92,16
2021,Fenland 011E,E01018110,2626,2495,131,52,55,21,3
2021,Fenland 010C,E01018111,2301,2250,51,18,23,7,3
2021,Huntingdonshire 010B,E01018113,1449,1428,21,14,5,1,1
2021,Huntingdonshire 017A,E01018115,2318,2202,116,36,53,21,6
2021,Huntingdonshire 010D,E01018116,2637,2492,145,79,40,23,3
2021,Huntingdonshire 010E,E01018117,1697,1627,70,32,27,11,0
2021,Huntingdonshire 010F,E01018118,1970,1892,78,45,24,8,1
2021,Huntingdonshire 017B,E01018119,1522,1485,37,20,8,7,2
2021,Huntingdonshire 017C,E01018120,1783,1766,17,12,4,1,0
2021,Huntingdonshire 007A,E01018121,1256,1236,20,10,10,0,0
2021,Huntingdonshire 007B,E01018122,1043,1036,7,4,3,0,0
2021,Huntingdonshire 007C,E01018123,1601,1553,48,29,13,4,2
2021,Huntingdonshire 007D,E01018124,1834,1825,9,6,1,1,1
2021,Huntingdonshire 015A,E01018125,1495,1473,22,11,7,3,1
2021,Huntingdonshire 015B,E01018126,1648,1630,18,13,2,3,0
2021,Huntingdonshire 002A,E01018127,1438,1413,25,16,8,1,0
2021,Huntingdonshire 002B,E01018128,1132,1093,39,24,8,7,0
2021,Huntingdonshire 016A,E01018129,1598,1532,66,29,35,2,0
2021,Huntingdonshire 016B,E01018130,1872,1834,38,23,11,4,0
2021,Huntingdonshire 014A,E01018131,1473,1403,70,27,26,15,2
2021,Huntingdonshire 014C,E01018133,1606,1557,49,23,18,8,0
2021,Huntingdonshire 014D,E01018134,1801,1701,100,57,28,13,2
2021,Huntingdonshire 018B,E01018136,1645,1625,20,13,5,2,0
2021,Huntingdonshire 017D,E01018137,1676,1656,20,14,2,2,2
2021,Huntingdonshire 012A,E01018138,2040,1753,287,127,108,43,9
2021,Huntingdonshire 009A,E01018139,1586,1409,177,79,66,29,3
2021,Huntingdonshire 009B,E01018140,1224,1048,176,62,77,33,4
2021,Huntingdonshire 009C,E01018141,1565,1487,78,45,16,12,5
2021,Huntingdonshire 009D,E01018142,1459,1324,135,56,44,32,3
2021,Huntingdonshire 008A,E01018143,2068,1757,311,143,112,49,7
2021,Huntingdonshire 008B,E01018144,1720,1272,448,169,182,89,8
2021,Huntingdonshire 008C,E01018145,1306,976,330,96,153,69,12
2021,Huntingdonshire 008D,E01018146,2027,1685,342,114,155,63,10
2021,Huntingdonshire 008E,E01018147,1621,1201,420,159,170,79,12
2021,Huntingdonshire 012B,E01018148,2673,2353,320,182,103,33,2
2021,Huntingdonshire 012C,E01018149,1405,1272,133,74,48,8,3
2021,Huntingdonshire 012D,E01018150,1556,1328,228,109,92,24,3
2021,Huntingdonshire 015C,E01018152,1397,1386,11,7,3,1,0
2021,Huntingdonshire 015D,E01018153,1693,1675,18,13,4,0,1
2021,Huntingdonshire 018C,E01018154,2385,2293,92,64,19,8,1
2021,Huntingdonshire 018D,E01018155,1535,1507,28,16,10,2,0
2021,Huntingdonshire 003A,E01018156,1572,1552,20,7,8,5,0
2021,Huntingdonshire 003B,E01018157,2051,2023,28,13,13,2,0
2021,Huntingdonshire 003C,E01018158,1588,1488,100,39,43,16,2
2021,Huntingdonshire 003D,E01018159,1558,1513,45,26,12,5,2
2021,Huntingdonshire 003E,E01018160,1563,1492,71,26,28,14,3
2021,Huntingdonshire 011A,E01018161,1308,1212,96,52,35,9,0
2021,Huntingdonshire 011B,E01018162,1410,1343,67,24,28,13,2
2021,Huntingdonshire 011C,E01018163,1284,1158,126,53,53,19,1
2021,Huntingdonshire 011D,E01018164,1208,1119,89,47,30,10,2
2021,Huntingdonshire 011E,E01018165,1193,1087,106,42,49,13,2
2021,Huntingdonshire 013A,E01018166,1474,1374,100,40,41,18,1
2021,Huntingdonshire 013B,E01018167,1399,1330,69,31,34,3,1
2021,Huntingdonshire 013C,E01018168,1991,1790,201,91,67,37,6
2021,Huntingdonshire 013D,E01018169,2180,2054,126,58,42,22,4
2021,Huntingdonshire 011F,E01018170,1305,1214,91,44,38,8,1
2021,Huntingdonshire 011G,E01018171,1586,1554,32,20,10,2,0
2021,Huntingdonshire 020A,E01018172,1385,1328,57,34,17,6,0
2021,Huntingdonshire 020B,E01018173,1119,1050,69,23,27,16,3
2021,Huntingdonshire 020C,E01018174,1465,1416,49,23,19,6,1
2021,Huntingdonshire 020D,E01018175,1321,1276,45,22,19,3,1
2021,Huntingdonshire 020E,E01018176,1254,1226,28,14,11,3,0
2021,Huntingdonshire 022A,E01018177,1370,1338,32,22,8,1,1
2021,Huntingdonshire 022B,E01018178,1628,1588,40,30,10,0,0
2021,Huntingdonshire 022C,E01018179,1369,1276,93,45,34,13,1
2021,Huntingdonshire 022D,E01018180,1194,1140,54,26,22,5,1
2021,Huntingdonshire 021B,E01018182,1381,1318,63,25,31,4,3
2021,Huntingdonshire 021C,E01018183,1349,1275,74,24,32,15,3
2021,Huntingdonshire 021D,E01018184,1159,1096,63,28,22,10,3
2021,Huntingdonshire 021E,E01018185,1516,1468,48,18,23,7,0
2021,Huntingdonshire 021F,E01018186,1637,1564,73,28,29,11,5
2021,Huntingdonshire 019A,E01018187,1984,1795,189,79,65,39,6
2021,Huntingdonshire 019B,E01018188,1370,1313,57,27,23,6,1
2021,Huntingdonshire 019C,E01018189,1244,1230,14,11,1,2,0
2021,Huntingdonshire 019D,E01018190,1513,1446,67,33,25,6,3
2021,Huntingdonshire 004A,E01018191,1302,1268,34,17,13,3,1
2021,Huntingdonshire 004B,E01018192,1791,1753,38,21,11,6,0
2021,Huntingdonshire 004C,E01018193,1231,1210,21,10,10,1,0
2021,Huntingdonshire 004D,E01018194,1308,1284,24,6,12,5,1
2021,Huntingdonshire 004E,E01018195,1245,1205,40,14,18,7,1
2021,Huntingdonshire 006A,E01018196,1263,1241,22,13,8,1,0
2021,Huntingdonshire 006B,E01018197,1342,1303,39,19,16,2,2
2021,Huntingdonshire 006C,E01018198,1575,1558,17,8,5,4,0
2021,Huntingdonshire 006D,E01018199,1530,1513,17,11,3,0,3
2021,Huntingdonshire 002C,E01018200,1614,1593,21,7,10,3,1
2021,Huntingdonshire 002D,E01018201,1342,1325,17,15,1,1,0
2021,Huntingdonshire 016C,E01018202,1430,1411,19,13,4,2,0
2021,Huntingdonshire 016D,E01018203,1793,1747,46,25,17,4,0
2021,Huntingdonshire 016E,E01018204,1368,1341,27,16,3,5,3
2021,Huntingdonshire 016F,E01018205,1713,1691,22,12,8,2,0
2021,Huntingdonshire 006E,E01018206,2138,2056,82,51,28,3,0
2021,Huntingdonshire 006F,E01018207,1514,1484,30,17,9,4,0
2021,Huntingdonshire 005A,E01018208,2038,1995,43,18,16,8,1
2021,Huntingdonshire 005B,E01018209,1498,1456,42,24,15,3,0
2021,Huntingdonshire 005C,E01018210,1275,1258,17,13,2,2,0
2021,Huntingdonshire 005D,E01018211,1886,1868,18,8,7,3,0
2021,Huntingdonshire 001A,E01018212,1558,1506,52,15,24,10,3
2021,Huntingdonshire 001B,E01018213,1893,1820,73,30,34,7,2
2021,Huntingdonshire 001C,E01018214,1910,1832,78,29,31,17,1
2021,Huntingdonshire 001D,E01018215,1441,1369,72,38,25,6,3
2021,Huntingdonshire 001E,E01018216,2460,2386,74,40,27,7,0
2021,Huntingdonshire 001F,E01018217,1555,1521,34,17,11,6,0
2021,South Cambridgeshire 016A,E01018218,1665,1638,27,22,4,0,1
2021,South Cambridgeshire 016B,E01018219,1392,1371,21,14,2,4,1
2021,South Cambridgeshire 016C,E01018220,1376,1355,21,18,3,0,0
2021,South Cambridgeshire 022A,E01018221,1562,1323,239,145,65,23,6
2021,South Cambridgeshire 022B,E01018222,1372,1275,97,52,34,10,1
2021,South Cambridgeshire 022C,E01018223,1888,1709,179,98,57,18,6
2021,South Cambridgeshire 022F,E01018224,1430,1370,60,43,15,2,0
2021,South Cambridgeshire 022G,E01018225,1023,977,46,29,13,3,1
2021,South Cambridgeshire 019A,E01018226,1180,1122,58,38,16,4,0
2021,South Cambridgeshire 019B,E01018227,1866,1821,45,35,5,5,0
2021,South Cambridgeshire 019C,E01018228,1589,1571,18,13,5,0,0
2021,South Cambridgeshire 010A,E01018231,2800,2629,171,103,50,12,6
2021,South Cambridgeshire 010B,E01018232,2208,2092,116,73,32,10,1
2021,South Cambridgeshire 002A,E01018233,1499,1435,64,33,24,6,1
2021,South Cambridgeshire 002B,E01018234,1523,1443,80,54,24,2,0
2021,South Cambridgeshire 002C,E01018235,1586,1516,70,44,16,9,1
2021,South Cambridgeshire 002D,E01018236,1975,1857,118,74,30,9,5
2021,South Cambridgeshire 003A,E01018237,1458,1401,57,38,18,1,0
2021,South Cambridgeshire 017A,E01018238,1423,1363,60,33,20,4,3
2021,South Cambridgeshire 017B,E01018239,1457,1401,56,41,8,6,1
2021,South Cambridgeshire 014A,E01018240,1241,1198,43,30,9,3,1
2021,South Cambridgeshire 018A,E01018241,1260,1239,21,14,7,0,0
2021,South Cambridgeshire 011A,E01018242,1634,1480,154,102,37,13,2
2021,South Cambridgeshire 011B,E01018243,1585,1296,289,194,72,21,2
2021,South Cambridgeshire 011C,E01018244,1603,1516,87,69,13,4,1
2021,South Cambridgeshire 013A,E01018245,1641,1627,14,13,1,0,0
2021,South Cambridgeshire 013B,E01018246,1503,1480,23,13,4,6,0
2021,South Cambridgeshire 013C,E01018247,1734,1705,29,13,12,4,0
2021,South Cambridgeshire 022E,E01018248,2174,1994,180,148,26,6,0
2021,South Cambridgeshire 010C,E01018251,1107,1022,85,48,28,7,2
2021,South Cambridgeshire 010D,E01018252,1487,1391,96,72,17,6,1
2021,South Cambridgeshire 014B,E01018253,1136,1089,47,36,10,1,0
2021,South Cambridgeshire 014C,E01018254,1912,1754,158,114,35,8,1
2021,South Cambridgeshire 010E,E01018255,1091,1077,14,9,2,2,1
2021,South Cambridgeshire 014D,E01018256,2438,2172,266,160,77,27,2
2021,South Cambridgeshire 006A,E01018257,1433,1351,82,53,22,7,0
2021,South Cambridgeshire 006B,E01018258,1605,1549,56,38,12,6,0
2021,South Cambridgeshire 006C,E01018259,1395,1274,121,78,29,13,1
2021,South Cambridgeshire 006D,E01018260,1875,1781,94,60,29,3,2
2021,South Cambridgeshire 006F,E01018262,1347,1292,55,41,11,3,0
2021,South Cambridgeshire 016D,E01018263,1446,1389,57,47,6,4,0
2021,South Cambridgeshire 016E,E01018264,1558,1528,30,14,15,1,0
2021,South Cambridgeshire 016F,E01018265,1660,1614,46,37,6,1,2
2021,South Cambridgeshire 018B,E01018267,2237,2182,55,31,20,2,2
2021,South Cambridgeshire 018C,E01018268,1909,1863,46,35,8,3,0
2021,South Cambridgeshire 018D,E01018269,1452,1412,40,28,7,4,1
2021,South Cambridgeshire 018E,E01018270,1083,1068,15,10,3,2,0
2021,South Cambridgeshire 018F,E01018271,1641,1599,42,22,14,5,1
2021,South Cambridgeshire 007A,E01018272,1469,1359,110,80,21,9,0
2021,South Cambridgeshire 007B,E01018273,1326,1148,178,100,63,12,3
2021,South Cambridgeshire 007C,E01018274,1472,1235,237,154,64,18,1
2021,South Cambridgeshire 013D,E01018275,2547,2506,41,27,12,1,1
2021,South Cambridgeshire 021A,E01018276,1465,1359,106,62,35,6,3
2021,South Cambridgeshire 021B,E01018277,1767,1731,36,17,13,5,1
2021,South Cambridgeshire 021C,E01018278,2496,2353,143,109,26,8,0
2021,South Cambridgeshire 015A,E01018279,1581,1472,109,78,22,9,0
2021,South Cambridgeshire 015B,E01018280,1430,1301,129,79,38,10,2
2021,South Cambridgeshire 015C,E01018281,1527,1420,107,59,39,7,2
2021,South Cambridgeshire 015D,E01018282,1271,1193,78,56,19,2,1
2021,South Cambridgeshire 015E,E01018283,1221,1077,144,100,35,7,2
2021,South Cambridgeshire 003C,E01018284,1333,1290,43,31,5,7,0
2021,South Cambridgeshire 003D,E01018285,1335,1260,75,51,18,5,1
2021,South Cambridgeshire 011D,E01018286,1532,1316,216,135,65,9,7
2021,South Cambridgeshire 011E,E01018287,1215,875,340,222,99,18,1
2021,South Cambridgeshire 017C,E01018288,1255,1215,40,22,15,3,0
2021,South Cambridgeshire 017D,E01018289,1239,1135,104,59,33,11,1
2021,South Cambridgeshire 019D,E01018290,2399,2369,30,25,4,1,0
2021,South Cambridgeshire 014E,E01018291,1110,1081,29,21,5,3,0
2021,South Cambridgeshire 012A,E01018292,1502,1365,137,87,37,11,2
2021,South Cambridgeshire 012B,E01018293,1532,1475,57,41,14,2,0
2021,South Cambridgeshire 012C,E01018294,1674,1506,168,125,35,5,3
2021,South Cambridgeshire 012D,E01018295,1631,1564,67,50,9,8,0
2021,South Cambridgeshire 011F,E01018296,1015,976,39,27,11,1,0
2021,South Cambridgeshire 007D,E01018297,1650,1531,119,78,20,20,1
2021,South Cambridgeshire 004A,E01018298,1499,1274,225,145,66,11,3
2021,South Cambridgeshire 004B,E01018299,2211,2058,153,95,40,15,3
2021,South Cambridgeshire 004C,E01018300,1215,1156,59,29,22,8,0
2021,South Cambridgeshire 004D,E01018301,1319,1233,86,58,22,5,1
2021,South Cambridgeshire 017E,E01018302,1457,1392,65,41,18,5,1
2021,South Cambridgeshire 017F,E01018303,1216,1188,28,23,3,2,0
2021,South Cambridgeshire 001A,E01018304,2011,1949,62,40,19,3,0
2021,South Cambridgeshire 001B,E01018305,1263,1232,31,17,8,5,1
2021,South Cambridgeshire 001C,E01018306,1555,1532,23,15,8,0,0
2021,South Cambridgeshire 001D,E01018307,2184,2115,69,36,25,8,0
2021,Cheshire West and Chester 022A,E01018308,1962,1943,19,14,2,3,0
2021,Cheshire West and Chester 029A,E01018309,1574,1489,85,31,30,22,2
2021,Cheshire West and Chester 029B,E01018310,1624,1560,64,23,23,15,3
2021,Cheshire West and Chester 029C,E01018311,1372,1270,102,42,42,18,0
2021,Cheshire West and Chester 029D,E01018312,1470,1388,82,43,24,14,1
2021,Cheshire West and Chester 031A,E01018313,1357,1316,41,15,12,14,0
2021,Cheshire West and Chester 031B,E01018314,1607,1486,121,60,45,15,1
2021,Cheshire West and Chester 031C,E01018315,1193,1160,33,18,10,4,1
2021,Cheshire West and Chester 031D,E01018316,1392,1307,85,34,33,12,6
2021,Cheshire West and Chester 031E,E01018317,1500,1354,146,59,62,22,3
2021,Cheshire West and Chester 036A,E01018319,2146,1962,184,89,69,25,1
2021,Cheshire West and Chester 041A,E01018320,1436,1395,41,23,9,8,1
2021,Cheshire West and Chester 041B,E01018321,1250,1206,44,31,10,3,0
2021,Cheshire West and Chester 041C,E01018322,1089,1059,30,22,5,3,0
2021,Cheshire West and Chester 039A,E01018323,1466,1428,38,28,7,3,0
2021,Cheshire West and Chester 039B,E01018324,1335,1308,27,13,8,6,0
2021,Cheshire West and Chester 039C,E01018325,1441,1428,13,7,3,3,0
2021,Cheshire West and Chester 034B,E01018328,1506,1346,160,99,41,19,1
2021,Cheshire West and Chester 034D,E01018330,1339,1278,61,38,13,8,2
2021,Cheshire West and Chester 034E,E01018331,1561,1377,184,94,62,26,2
2021,Cheshire West and Chester 043A,E01018332,1041,1004,37,24,8,4,1
2021,Cheshire West and Chester 043B,E01018333,1528,1463,65,39,15,10,1
2021,Cheshire West and Chester 043C,E01018334,1590,1482,108,69,20,17,2
2021,Cheshire West and Chester 046A,E01018335,2152,2081,71,42,21,7,1
2021,Cheshire West and Chester 022B,E01018336,1183,1157,26,12,14,0,0
2021,Cheshire West and Chester 022C,E01018337,1251,1230,21,13,6,2,0
2021,Cheshire West and Chester 022D,E01018338,1720,1671,49,23,16,5,5
2021,Cheshire West and Chester 047A,E01018339,2547,2520,27,15,10,2,0
2021,Cheshire West and Chester 043D,E01018340,1605,1521,84,44,24,12,4
2021,Cheshire West and Chester 043E,E01018341,1089,1032,57,36,12,6,3
2021,Cheshire West and Chester 043F,E01018342,1795,1688,107,63,32,9,3
2021,Cheshire West and Chester 033C,E01018343,1506,1362,144,71,52,19,2
2021,Cheshire West and Chester 036B,E01018344,1772,1663,109,73,31,5,0
2021,Cheshire West and Chester 032A,E01018345,1290,1230,60,26,21,9,4
2021,Cheshire West and Chester 032B,E01018346,1430,1404,26,21,3,2,0
2021,Cheshire West and Chester 032C,E01018347,1349,1277,72,29,25,17,1
2021,Cheshire West and Chester 030A,E01018349,1722,1707,15,7,1,2,5
2021,Cheshire West and Chester 030B,E01018350,2140,2129,11,8,2,1,0
2021,Cheshire West and Chester 044A,E01018351,1415,1329,86,39,34,12,1
2021,Cheshire West and Chester 044B,E01018352,1844,1650,194,83,67,43,1
2021,Cheshire West and Chester 044C,E01018353,1474,1426,48,28,15,5,0
2021,Cheshire West and Chester 044D,E01018354,1558,1476,82,56,20,5,1
2021,Cheshire West and Chester 047B,E01018355,1329,1309,20,9,7,2,2
2021,Cheshire West and Chester 047C,E01018356,1632,1624,8,7,1,0,0
2021,Cheshire West and Chester 047D,E01018357,1881,1868,13,9,3,1,0
2021,Cheshire West and Chester 022E,E01018358,1277,1255,22,17,4,1,0
2021,Cheshire West and Chester 022F,E01018359,1049,1039,10,6,3,1,0
2021,Cheshire West and Chester 025A,E01018360,2701,2610,91,37,40,10,4
2021,Cheshire West and Chester 033D,E01018361,1402,1316,86,54,24,6,2
2021,Cheshire West and Chester 028A,E01018362,1497,1453,44,23,10,10,1
2021,Cheshire West and Chester 028B,E01018363,986,975,11,5,5,1,0
2021,Cheshire West and Chester 027A,E01018364,1478,1340,138,56,47,29,6
2021,Cheshire West and Chester 027B,E01018365,1943,1883,60,36,14,10,0
2021,Cheshire West and Chester 025B,E01018366,1442,1432,10,4,3,2,1
2021,Cheshire West and Chester 025C,E01018367,2049,2019,30,14,9,7,0
2021,Cheshire West and Chester 030C,E01018368,1492,1470,22,12,6,2,2
2021,Cheshire West and Chester 046B,E01018369,1666,1650,16,11,1,2,2
2021,Cheshire West and Chester 030D,E01018370,1593,1581,12,7,4,1,0
2021,Cheshire West and Chester 046C,E01018371,2075,2006,69,45,22,2,0
2021,Cheshire West and Chester 046D,E01018372,2117,2100,17,8,9,0,0
2021,Cheshire West and Chester 047E,E01018373,2159,2149,10,9,1,0,0
2021,Cheshire West and Chester 028C,E01018374,1740,1629,111,78,22,11,0
2021,Cheshire West and Chester 028D,E01018375,1733,1543,190,110,52,25,3
2021,Cheshire West and Chester 028E,E01018376,1708,1676,32,25,6,1,0
2021,Cheshire West and Chester 028F,E01018377,2074,2008,66,42,12,11,1
2021,Cheshire West and Chester 027C,E01018378,1217,1132,85,36,29,18,2
2021,Cheshire West and Chester 027D,E01018379,1344,1308,36,20,8,8,0
2021,Cheshire West and Chester 027E,E01018380,1101,1040,61,35,19,7,0
2021,Cheshire West and Chester 036C,E01018381,1199,1161,38,20,13,4,1
2021,Cheshire West and Chester 036D,E01018382,1579,1502,77,42,20,15,0
2021,Cheshire West and Chester 032D,E01018383,1431,1399,32,23,8,0,1
2021,Cheshire West and Chester 032E,E01018384,1420,1392,28,21,6,0,1
2021,Cheshire West and Chester 039D,E01018385,1960,1938,22,15,5,1,1
2021,Cheshire East 042A,E01018386,2095,2072,23,18,3,2,0
2021,Cheshire East 040A,E01018387,1843,1835,8,6,2,0,0
2021,Cheshire East 040B,E01018388,1650,1604,46,18,18,8,2
2021,Cheshire East 040C,E01018389,1648,1625,23,9,4,9,1
2021,Cheshire East 040D,E01018390,1569,1552,17,11,5,0,1
2021,Cheshire East 042B,E01018391,2421,2371,50,32,14,3,1
2021,Cheshire East 042C,E01018392,1792,1786,6,4,2,0,0
2021,Cheshire East 026A,E01018395,1889,1866,23,15,7,1,0
2021,Cheshire East 026B,E01018396,1404,1392,12,6,3,3,0
2021,Cheshire East 028A,E01018397,1983,1971,12,10,1,1,0
2021,Cheshire East 027A,E01018398,1407,1390,17,11,6,0,0
2021,Cheshire East 027B,E01018399,1710,1689,21,13,5,3,0
2021,Cheshire East 026C,E01018400,2400,2359,41,21,8,9,3
2021,Cheshire East 026D,E01018401,1588,1566,22,10,3,6,3
2021,Cheshire East 027C,E01018402,1834,1779,55,26,15,11,3
2021,Cheshire East 027D,E01018403,2361,2326,35,21,9,5,0
2021,Cheshire East 029A,E01018404,1407,1396,11,2,5,4,0
2021,Cheshire East 029B,E01018405,1297,1277,20,12,5,3,0
2021,Cheshire East 029C,E01018406,1379,1367,12,9,3,0,0
2021,Cheshire East 029D,E01018407,1480,1473,7,7,0,0,0
2021,Cheshire East 028B,E01018408,1824,1810,14,10,3,1,0
2021,Cheshire East 028C,E01018409,1895,1881,14,9,3,2,0
2021,Cheshire East 028D,E01018410,1798,1776,22,10,10,2,0
2021,Cheshire East 022B,E01018411,2344,2331,13,8,3,1,1
2021,Cheshire East 022C,E01018412,1572,1555,17,13,2,2,0
2021,Cheshire East 023A,E01018413,1475,1465,10,6,0,2,2
2021,Cheshire East 023B,E01018414,1548,1534,14,9,4,1,0
2021,Cheshire East 023C,E01018415,1689,1661,28,16,5,6,1
2021,Cheshire East 023D,E01018416,1765,1732,33,24,9,0,0
2021,Cheshire East 033B,E01018417,1606,1594,12,7,4,1,0
2021,Cheshire East 033C,E01018418,1464,1456,8,8,0,0,0
2021,Cheshire East 025A,E01018419,2242,2187,55,29,17,9,0
2021,Cheshire East 025B,E01018420,1867,1823,44,19,19,6,0
2021,Cheshire East 025C,E01018421,1230,1203,27,11,13,3,0
2021,Cheshire East 025D,E01018422,1312,1286,26,13,9,4,0
2021,Cheshire East 025E,E01018423,1447,1411,36,25,11,0,0
2021,Cheshire East 024A,E01018424,1647,1603,44,11,25,6,2
2021,Cheshire East 024B,E01018425,1606,1546,60,27,23,10,0
2021,Cheshire East 024C,E01018426,1459,1440,19,12,7,0,0
2021,Cheshire East 024D,E01018427,1190,1184,6,4,2,0,0
2021,Cheshire East 033D,E01018428,1259,1255,4,2,1,1,0
2021,Cheshire East 033E,E01018429,1498,1488,10,5,4,1,0
2021,Cheshire East 033F,E01018430,1268,1261,7,4,1,1,1
2021,Cheshire East 033G,E01018431,1214,1209,5,2,1,2,0
2021,Cheshire East 032A,E01018432,1317,1292,25,14,7,3,1
2021,Cheshire East 032B,E01018433,1390,1378,12,10,2,0,0
2021,Cheshire East 032C,E01018434,1320,1305,15,8,3,1,3
2021,Cheshire East 032D,E01018435,1418,1396,22,10,9,3,0
2021,Cheshire East 030A,E01018436,1604,1586,18,13,5,0,0
2021,Cheshire East 030B,E01018437,1524,1482,42,21,12,7,2
2021,Cheshire East 030C,E01018438,1263,1256,7,7,0,0,0
2021,Cheshire East 030D,E01018439,1995,1980,15,11,3,1,0
2021,Cheshire East 031A,E01018440,2531,2475,56,31,19,5,1
2021,Cheshire East 031B,E01018441,1984,1952,32,21,6,5,0
2021,Cheshire East 031D,E01018443,2092,2064,28,15,5,7,1
2021,Cheshire East 045A,E01018445,1852,1355,497,157,214,104,22
2021,Cheshire East 045B,E01018446,1431,1287,144,54,65,18,7
2021,Cheshire East 045C,E01018447,1894,1227,667,155,325,158,29
2021,Cheshire East 045D,E01018448,1647,1486,161,40,97,14,10
2021,Cheshire East 051A,E01018449,1710,1690,20,13,3,4,0
2021,Cheshire East 051B,E01018450,2610,2575,35,17,10,7,1
2021,Cheshire East 047A,E01018451,1281,1266,15,5,7,1,2
2021,Cheshire East 050A,E01018452,1064,1051,13,9,3,0,1
2021,Cheshire East 047B,E01018454,1517,1456,61,35,18,6,2
2021,Cheshire East 047C,E01018455,1308,1286,22,12,7,2,1
2021,Cheshire East 047D,E01018456,1277,1265,12,8,1,3,0
2021,Cheshire East 047E,E01018457,1432,1403,29,17,8,4,0
2021,Cheshire East 051C,E01018458,2245,2236,9,7,2,0,0
2021,Cheshire East 036A,E01018459,1385,1146,239,94,104,33,8
2021,Cheshire East 036B,E01018460,1359,1278,81,34,25,22,0
2021,Cheshire East 036C,E01018461,1467,1335,132,51,55,24,2
2021,Cheshire East 039A,E01018462,1857,1378,479,167,174,127,11
2021,Cheshire East 035A,E01018463,1390,1173,217,49,101,60,7
2021,Cheshire East 039B,E01018464,1502,1210,292,88,142,56,6
2021,Cheshire East 036D,E01018466,2212,1733,479,154,185,121,19
2021,Cheshire East 041B,E01018468,1470,1444,26,13,7,3,3
2021,Cheshire East 041C,E01018469,1711,1698,13,9,0,2,2
2021,Cheshire East 041D,E01018470,1860,1838,22,13,4,5,0
2021,Cheshire East 041E,E01018471,1360,1353,7,2,3,2,0
2021,Cheshire East 034A,E01018472,1306,1245,61,21,28,10,2
2021,Cheshire East 034B,E01018473,1500,1466,34,19,11,4,0
2021,Cheshire East 034C,E01018474,1708,1597,111,60,31,16,4
2021,Cheshire East 034D,E01018475,1638,1611,27,15,9,3,0
2021,Cheshire East 035B,E01018476,1519,1361,158,83,58,11,6
2021,Cheshire East 035C,E01018477,1674,1550,124,47,54,19,4
2021,Cheshire East 035D,E01018478,1666,1543,123,55,49,18,1
2021,Cheshire East 035E,E01018479,2249,2174,75,32,30,11,2
2021,Cheshire East 051D,E01018481,1982,1972,10,7,1,2,0
2021,Cheshire East 037A,E01018482,1325,1195,130,63,47,19,1
2021,Cheshire East 037B,E01018483,1327,1212,115,49,34,23,9
2021,Cheshire East 037C,E01018484,2147,1732,415,162,184,63,6
2021,Cheshire East 037D,E01018485,1482,1246,236,67,121,48,0
2021,Cheshire East 043A,E01018486,1544,895,649,109,369,155,16
2021,Cheshire East 043B,E01018487,1692,1008,684,148,279,194,63
2021,Cheshire East 043C,E01018488,1568,1489,79,40,32,6,1
2021,Cheshire East 043D,E01018489,1580,946,634,107,297,216,14
2021,Cheshire East 046A,E01018490,1695,1674,21,16,3,0,2
2021,Cheshire East 046B,E01018491,1585,1568,17,10,6,0,1
2021,Cheshire East 046C,E01018492,1043,1023,20,11,3,2,4
2021,Cheshire East 048A,E01018493,1321,1307,14,11,1,2,0
2021,Cheshire East 048B,E01018494,2585,2510,75,49,18,7,1
2021,Cheshire East 048C,E01018495,1486,1472,14,8,6,0,0
2021,Cheshire East 039C,E01018496,1563,1371,192,86,66,34,6
2021,Cheshire East 039D,E01018497,1172,829,343,86,136,102,19
2021,Cheshire East 039E,E01018498,1619,1362,257,102,113,38,4
2021,Cheshire East 038A,E01018499,1445,1394,51,26,17,6,2
2021,Cheshire East 038B,E01018500,1117,1076,41,21,15,4,1
2021,Cheshire East 038C,E01018501,1478,1377,101,33,47,17,4
2021,Cheshire East 038D,E01018502,1407,1199,208,128,75,5,0
2021,Cheshire East 050C,E01018503,1689,1672,17,5,5,5,2
2021,Cheshire East 050D,E01018504,1614,1579,35,21,9,4,1
2021,Cheshire East 046D,E01018505,1224,1208,16,14,0,2,0
2021,Cheshire East 046E,E01018506,1282,1249,33,12,10,9,2
2021,Cheshire East 046F,E01018507,1297,1280,17,15,1,1,0
2021,Cheshire East 048D,E01018508,1384,1371,13,11,2,0,0
2021,Cheshire East 048E,E01018509,1132,1119,13,5,5,3,0
2021,Cheshire East 044A,E01018510,1644,1588,56,35,16,5,0
2021,Cheshire East 044B,E01018511,1363,1286,77,38,26,13,0
2021,Cheshire East 044C,E01018512,1629,1493,136,59,57,12,8
2021,Cheshire East 044D,E01018513,1513,1451,62,29,25,6,2
2021,Cheshire East 051E,E01018514,2057,2039,18,3,14,0,1
2021,Cheshire East 053F,E01018515,2288,2253,35,16,17,2,0
2021,Cheshire East 053C,E01018516,1534,1519,15,7,7,1,0
2021,Cheshire West and Chester 004A,E01018518,1538,1524,14,9,2,3,0
2021,Cheshire West and Chester 007A,E01018519,1356,1111,245,70,112,57,6
2021,Cheshire West and Chester 007B,E01018520,1846,1635,211,87,78,39,7
2021,Cheshire West and Chester 011A,E01018521,1334,1263,71,28,24,17,2
2021,Cheshire West and Chester 010A,E01018522,1415,1370,45,18,16,10,1
2021,Cheshire West and Chester 008A,E01018523,1312,1263,49,25,13,9,2
2021,Cheshire West and Chester 008B,E01018524,1448,1416,32,11,12,8,1
2021,Cheshire West and Chester 007C,E01018525,1675,1555,120,47,43,29,1
2021,Cheshire West and Chester 016A,E01018526,1562,1533,29,16,9,4,0
2021,Cheshire West and Chester 016B,E01018527,1556,1537,19,7,5,3,4
2021,Cheshire West and Chester 009A,E01018528,1637,1611,26,15,7,4,0
2021,Cheshire West and Chester 009B,E01018529,1338,1328,10,7,2,1,0
2021,Cheshire West and Chester 009C,E01018530,1425,1412,13,12,0,1,0
2021,Cheshire West and Chester 009D,E01018531,1538,1528,10,4,3,3,0
2021,Cheshire West and Chester 006A,E01018532,1847,1820,27,22,3,2,0
2021,Cheshire West and Chester 006B,E01018533,1435,1430,5,4,1,0,0
2021,Cheshire West and Chester 001A,E01018534,2418,2367,51,32,13,5,1
2021,Cheshire West and Chester 001B,E01018535,1627,1601,26,15,7,3,1
2021,Cheshire West and Chester 001C,E01018536,1686,1673,13,12,1,0,0
2021,Cheshire West and Chester 001D,E01018537,2012,1999,13,9,3,1,0
2021,Cheshire West and Chester 010B,E01018538,1179,1156,23,9,10,2,2
2021,Cheshire West and Chester 010C,E01018539,1159,1102,57,23,17,14,3
2021,Cheshire West and Chester 010D,E01018540,1385,1351,34,19,11,2,2
2021,Cheshire West and Chester 008C,E01018541,1331,1308,23,10,13,0,0
2021,Cheshire West and Chester 008D,E01018542,1282,1242,40,20,12,6,2
2021,Cheshire West and Chester 008E,E01018543,1240,1188,52,17,27,6,2
2021,Cheshire West and Chester 006C,E01018544,1392,1382,10,6,1,3,0
2021,Cheshire West and Chester 006D,E01018545,1825,1809,16,11,3,2,0
2021,Cheshire West and Chester 005A,E01018546,1520,1470,50,21,15,9,5
2021,Cheshire West and Chester 005B,E01018547,1290,1274,16,6,6,4,0
2021,Cheshire West and Chester 005C,E01018548,2057,2022,35,15,13,5,2
2021,Cheshire West and Chester 005D,E01018549,1409,1392,17,4,9,4,0
2021,Cheshire West and Chester 011B,E01018550,1078,1014,64,22,26,16,0
2021,Cheshire West and Chester 011C,E01018551,1491,1406,85,26,34,23,2
2021,Cheshire West and Chester 011D,E01018552,2467,2318,149,60,68,17,4
2021,Cheshire West and Chester 011E,E01018553,1721,1595,126,61,47,15,3
2021,Cheshire West and Chester 016C,E01018554,2146,2113,33,14,10,7,2
2021,Cheshire West and Chester 016D,E01018555,1083,1070,13,7,3,3,0
2021,Cheshire West and Chester 013A,E01018556,1385,1364,21,15,6,0,0
2021,Cheshire West and Chester 013B,E01018557,1368,1332,36,19,12,2,3
2021,Cheshire West and Chester 013C,E01018558,1117,1111,6,4,1,1,0
2021,Cheshire West and Chester 013D,E01018559,1090,1075,15,11,2,2,0
2021,Cheshire West and Chester 009E,E01018560,1104,1094,10,4,3,3,0
2021,Cheshire West and Chester 009F,E01018561,1164,1146,18,9,7,2,0
2021,Cheshire West and Chester 009G,E01018562,1351,1332,19,14,3,2,0
2021,Cheshire West and Chester 014A,E01018565,1568,1554,14,7,3,3,1
2021,Cheshire West and Chester 014B,E01018566,1243,1218,25,13,7,3,2
2021,Cheshire West and Chester 014C,E01018567,1402,1376,26,15,9,2,0
2021,Cheshire West and Chester 014D,E01018568,1445,1393,52,26,19,7,0
2021,Cheshire West and Chester 004B,E01018569,1292,1285,7,6,1,0,0
2021,Cheshire West and Chester 004C,E01018570,1368,1353,15,10,3,1,1
2021,Cheshire West and Chester 004D,E01018571,1319,1310,9,6,3,0,0
2021,Cheshire East 012A,E01018572,1758,1718,40,22,9,9,0
2021,Cheshire East 012B,E01018573,1445,1414,31,18,7,5,1
2021,Cheshire East 012C,E01018574,1954,1854,100,46,51,3,0
2021,Cheshire East 013A,E01018575,1269,1249,20,14,5,1,0
2021,Cheshire East 013B,E01018576,1757,1727,30,23,6,1,0
2021,Cheshire East 013C,E01018577,2315,2287,28,18,5,3,2
2021,Cheshire East 013D,E01018578,1192,1176,16,11,4,0,1
2021,Cheshire East 013E,E01018579,1212,1182,30,14,10,6,0
2021,Cheshire East 012D,E01018580,1748,1727,21,18,2,1,0
2021,Cheshire East 012E,E01018581,1483,1463,20,15,2,2,1
2021,Cheshire East 004A,E01018582,2287,2145,142,84,39,16,3
2021,Cheshire East 005A,E01018583,1815,1731,84,48,14,21,1
2021,Cheshire East 005B,E01018584,1897,1788,109,54,30,20,5
2021,Cheshire East 001A,E01018585,1342,1324,18,11,5,2,0
2021,Cheshire East 001B,E01018586,1893,1871,22,13,3,6,0
2021,Cheshire East 001C,E01018587,1569,1546,23,12,7,1,3
2021,Cheshire East 008A,E01018588,1484,1450,34,24,6,4,0
2021,Cheshire East 008B,E01018589,1561,1522,39,17,14,8,0
2021,Cheshire East 008C,E01018590,1911,1868,43,25,14,4,0
2021,Cheshire East 020A,E01018591,2339,2329,10,6,2,2,0
2021,Cheshire East 004B,E01018592,1729,1660,69,40,16,11,2
2021,Cheshire East 004C,E01018593,1741,1605,136,74,47,13,2
2021,Cheshire East 004D,E01018594,1706,1603,103,58,35,6,4
2021,Cheshire East 004E,E01018595,1646,1563,83,35,37,11,0
2021,Cheshire East 004F,E01018596,1966,1824,142,87,41,13,1
2021,Cheshire East 007A,E01018598,1873,1863,10,8,1,1,0
2021,Cheshire East 007B,E01018599,1121,1105,16,12,3,0,1
2021,Cheshire East 006A,E01018600,1675,1611,64,44,14,5,1
2021,Cheshire East 006B,E01018601,1775,1688,87,56,21,9,1
2021,Cheshire East 006C,E01018602,1747,1644,103,69,19,13,2
2021,Cheshire East 010A,E01018603,1313,1291,22,14,5,3,0
2021,Cheshire East 010B,E01018604,1334,1305,29,18,8,3,0
2021,Cheshire East 009A,E01018605,1080,1065,15,13,1,1,0
2021,Cheshire East 010C,E01018606,1442,1393,49,27,14,8,0
2021,Cheshire East 010D,E01018607,1256,1235,21,13,6,2,0
2021,Cheshire East 010E,E01018608,1321,1295,26,17,5,2,2
2021,Cheshire East 009B,E01018609,1671,1643,28,18,5,4,1
2021,Cheshire East 009C,E01018610,1887,1830,57,36,17,4,0
2021,Cheshire East 009D,E01018611,1601,1523,78,46,26,6,0
2021,Cheshire East 005C,E01018612,1328,1260,68,40,17,11,0
2021,Cheshire East 005D,E01018613,1537,1468,69,41,23,4,1
2021,Cheshire East 015A,E01018614,1769,1718,51,28,14,5,4
2021,Cheshire East 017A,E01018615,1180,1121,59,38,15,6,0
2021,Cheshire East 017B,E01018616,1499,1444,55,34,16,5,0
2021,Cheshire East 017C,E01018617,1324,1276,48,31,15,1,1
2021,Cheshire East 015B,E01018618,1478,1396,82,36,36,9,1
2021,Cheshire East 015C,E01018619,1468,1447,21,16,3,2,0
2021,Cheshire East 015D,E01018620,1427,1378,49,33,9,5,2
2021,Cheshire East 015E,E01018621,1318,1297,21,13,5,3,0
2021,Cheshire East 018A,E01018622,1284,1185,99,44,42,13,0
2021,Cheshire East 018B,E01018623,1385,1343,42,28,11,2,1
2021,Cheshire East 018C,E01018624,1927,1706,221,141,60,20,0
2021,Cheshire East 018D,E01018625,1398,1327,71,47,18,3,3
2021,Cheshire East 018E,E01018627,1651,1572,79,38,32,9,0
2021,Cheshire East 016B,E01018628,1508,1474,34,15,10,9,0
2021,Cheshire East 016C,E01018629,1817,1688,129,45,72,12,0
2021,Cheshire East 016D,E01018630,1248,1205,43,31,8,4,0
2021,Cheshire East 016E,E01018631,1309,1276,33,16,14,2,1
2021,Cheshire East 017D,E01018632,1680,1627,53,39,11,3,0
2021,Cheshire East 017E,E01018633,1456,1439,17,9,7,1,0
2021,Cheshire East 019A,E01018634,1788,1764,24,12,10,2,0
2021,Cheshire East 018F,E01018635,1148,1102,46,32,9,5,0
2021,Cheshire East 018G,E01018636,1333,1311,22,11,9,2,0
2021,Cheshire East 021A,E01018637,1790,1727,63,24,28,11,0
2021,Cheshire East 021B,E01018638,1492,1462,30,10,17,1,2
2021,Cheshire East 021C,E01018639,1503,1415,88,37,32,18,1
2021,Cheshire East 021D,E01018640,1222,1158,64,32,19,13,0
2021,Cheshire East 014A,E01018641,1520,1497,23,8,9,5,1
2021,Cheshire East 014B,E01018642,1287,1262,25,16,8,1,0
2021,Cheshire East 014C,E01018643,1961,1916,45,38,3,4,0
2021,Cheshire East 014D,E01018644,1331,1291,40,23,13,3,1
2021,Cheshire East 019B,E01018645,1711,1656,55,31,16,8,0
2021,Cheshire East 019C,E01018646,1674,1642,32,16,8,7,1
2021,Cheshire East 019D,E01018647,1466,1430,36,21,12,3,0
2021,Cheshire East 007C,E01018648,2266,2206,60,39,15,6,0
2021,Cheshire East 007D,E01018649,1364,1347,17,6,6,4,1
2021,Cheshire East 007E,E01018650,1675,1634,41,26,9,5,1
2021,Cheshire East 007F,E01018651,1526,1484,42,16,22,4,0
2021,Cheshire East 006D,E01018652,1520,1483,37,18,12,6,1
2021,Cheshire East 008D,E01018653,2116,2043,73,33,33,5,2
2021,Cheshire East 007G,E01018654,2348,2323,25,13,7,4,1
2021,Cheshire East 003A,E01018655,1528,1500,28,16,10,2,0
2021,Cheshire East 002A,E01018657,1103,1091,12,10,2,0,0
2021,Cheshire East 003C,E01018658,1149,1135,14,5,5,3,1
2021,Cheshire East 003D,E01018659,1200,1192,8,7,1,0,0
2021,Cheshire East 001D,E01018661,1176,1171,5,4,1,0,0
2021,Cheshire East 002B,E01018662,1177,1154,23,12,8,3,0
2021,Cheshire East 002C,E01018663,1528,1493,35,20,10,5,0
2021,Cheshire East 002D,E01018664,1334,1328,6,4,0,1,1
2021,Cheshire East 002E,E01018665,1116,1096,20,11,6,3,0
2021,Cheshire East 011A,E01018666,1777,1747,30,19,9,1,1
2021,Cheshire East 011B,E01018667,1598,1583,15,7,4,3,1
2021,Cheshire East 011C,E01018668,1801,1791,10,7,3,0,0
2021,Cheshire East 020C,E01018669,2488,2455,33,26,4,2,1
2021,Cheshire East 020D,E01018670,2288,2267,21,9,7,3,2
2021,Cheshire West and Chester 012A,E01018671,1194,1180,14,6,6,1,1
2021,Cheshire West and Chester 012B,E01018672,1673,1635,38,16,15,7,0
2021,Cheshire West and Chester 012C,E01018673,1125,1117,8,7,0,1,0
2021,Cheshire West and Chester 012D,E01018674,1512,1488,24,10,7,5,2
2021,Cheshire West and Chester 003A,E01018675,1990,1975,15,10,5,0,0
2021,Cheshire West and Chester 024A,E01018676,1804,1791,13,6,5,2,0
2021,Cheshire West and Chester 024B,E01018677,1627,1610,17,9,7,1,0
2021,Cheshire West and Chester 024C,E01018678,1243,1230,13,9,0,4,0
2021,Cheshire West and Chester 024D,E01018679,2097,2058,39,24,10,5,0
2021,Cheshire West and Chester 026A,E01018680,1668,1651,17,8,4,5,0
2021,Cheshire West and Chester 026B,E01018681,1611,1597,14,6,7,0,1
2021,Cheshire West and Chester 026C,E01018682,1275,1265,10,4,3,3,0
2021,Cheshire West and Chester 026D,E01018683,1734,1708,26,13,8,3,2
2021,Cheshire West and Chester 015A,E01018684,2289,2275,14,10,3,1,0
2021,Cheshire West and Chester 002A,E01018685,1271,1240,31,22,5,2,2
2021,Cheshire West and Chester 002B,E01018686,1435,1421,14,9,5,0,0
2021,Cheshire West and Chester 002C,E01018687,1277,1269,8,5,3,0,0
2021,Cheshire West and Chester 002D,E01018688,1526,1508,18,9,4,5,0
2021,Cheshire West and Chester 002E,E01018689,1360,1345,15,12,1,2,0
2021,Cheshire West and Chester 002F,E01018690,2085,2065,20,15,2,2,1
2021,Cheshire West and Chester 023A,E01018691,1609,1572,37,19,12,5,1
2021,Cheshire West and Chester 024E,E01018692,1909,1874,35,30,4,1,0
2021,Cheshire West and Chester 023B,E01018693,2003,1975,28,20,7,1,0
2021,Cheshire West and Chester 023C,E01018694,2153,2112,41,25,9,6,1
2021,Cheshire West and Chester 015B,E01018695,1935,1899,36,25,10,1,0
2021,Cheshire West and Chester 015C,E01018696,1451,1440,11,5,3,3,0
2021,Cheshire West and Chester 015D,E01018697,1739,1717,22,15,2,4,1
2021,Cheshire West and Chester 015E,E01018698,1956,1939,17,10,5,2,0
2021,Cheshire West and Chester 021A,E01018699,1503,1466,37,11,19,6,1
2021,Cheshire West and Chester 023D,E01018700,1835,1785,50,28,20,2,0
2021,Cheshire West and Chester 021B,E01018701,1394,1338,56,31,18,6,1
2021,Cheshire West and Chester 023E,E01018702,1440,1423,17,9,5,2,1
2021,Cheshire West and Chester 023F,E01018703,1945,1899,46,24,13,5,4
2021,Cheshire West and Chester 017A,E01018704,1354,1335,19,9,7,3,0
2021,Cheshire West and Chester 017B,E01018705,1428,1416,12,10,1,0,1
2021,Cheshire West and Chester 017C,E01018706,1852,1789,63,44,16,3,0
2021,Cheshire West and Chester 045A,E01018707,1727,1707,20,12,7,1,0
2021,Cheshire West and Chester 003B,E01018708,2099,2081,18,10,5,2,1
2021,Cheshire West and Chester 020A,E01018709,1407,1328,79,34,34,7,4
2021,Cheshire West and Chester 020B,E01018710,1394,1311,83,31,34,15,3
2021,Cheshire West and Chester 020C,E01018711,1440,1409,31,20,8,2,1
2021,Cheshire West and Chester 020D,E01018712,1446,1402,44,18,18,7,1
2021,Cheshire West and Chester 018B,E01018714,1896,1740,156,56,50,31,19
2021,Cheshire West and Chester 018C,E01018715,1616,1489,127,39,68,19,1
2021,Cheshire West and Chester 021C,E01018716,1512,1406,106,51,35,18,2
2021,Cheshire West and Chester 021D,E01018717,1668,1479,189,50,100,36,3
2021,Cheshire West and Chester 017D,E01018718,1797,1742,55,23,23,8,1
2021,Cheshire West and Chester 021E,E01018719,1426,1390,36,18,17,1,0
2021,Cheshire West and Chester 021F,E01018720,1689,1634,55,26,23,5,1
2021,Cheshire West and Chester 003C,E01018721,2212,2201,11,5,2,1,3
2021,Cheshire West and Chester 017E,E01018722,2579,2555,24,14,7,3,0
2021,Cheshire West and Chester 045B,E01018723,1416,1395,21,14,3,3,1
2021,Cheshire West and Chester 045C,E01018724,1734,1702,32,26,5,1,0
2021,Cheshire West and Chester 045D,E01018725,1443,1425,18,10,5,3,0
2021,Cheshire West and Chester 019A,E01018726,1493,1484,9,3,5,1,0
2021,Cheshire West and Chester 019B,E01018727,1726,1715,11,7,3,1,0
2021,Cheshire West and Chester 019C,E01018728,1552,1524,28,10,12,4,2
2021,Cheshire West and Chester 019D,E01018729,1611,1575,36,18,9,8,1
2021,Cheshire West and Chester 040A,E01018730,1429,1413,16,4,7,3,2
2021,Cheshire West and Chester 042A,E01018731,1900,1826,74,26,35,11,2
2021,Cheshire West and Chester 038A,E01018732,1290,1267,23,15,6,2,0
2021,Cheshire West and Chester 035A,E01018733,1357,1339,18,8,5,3,2
2021,Cheshire West and Chester 035B,E01018734,1202,1173,29,11,17,1,0
2021,Cheshire West and Chester 042B,E01018735,1195,1158,37,15,15,7,0
2021,Cheshire West and Chester 037A,E01018736,1699,1632,67,40,15,7,5
2021,Cheshire West and Chester 037B,E01018737,2071,2038,33,20,12,1,0
2021,Cheshire West and Chester 040B,E01018738,1729,1688,41,11,22,7,1
2021,Cheshire West and Chester 040C,E01018739,1895,1847,48,17,20,10,1
2021,Cheshire West and Chester 042C,E01018740,1440,1404,36,18,12,6,0
2021,Cheshire West and Chester 040D,E01018741,1160,1137,23,10,6,7,0
2021,Cheshire West and Chester 042D,E01018742,2269,2256,13,10,3,0,0
2021,Cheshire West and Chester 037C,E01018743,1311,1302,9,8,0,1,0
2021,Cheshire West and Chester 037D,E01018744,1630,1588,42,16,15,10,1
2021,Cheshire West and Chester 038B,E01018745,1517,1475,42,17,14,9,2
2021,Cheshire West and Chester 038C,E01018746,1830,1787,43,12,21,9,1
2021,Cheshire West and Chester 038D,E01018747,1641,1492,149,72,50,26,1
2021,Cheshire West and Chester 035C,E01018748,1376,1209,167,40,89,29,9
2021,Cheshire West and Chester 035D,E01018749,2420,2315,105,29,47,27,2
2021,Cornwall 013A,E01018750,2219,2174,45,16,23,6,0
2021,Cornwall 013B,E01018751,1529,1437,92,25,49,15,3
2021,Cornwall 013C,E01018752,2079,2025,54,31,19,4,0
2021,Cornwall 010A,E01018753,1733,1722,11,9,2,0,0
2021,Cornwall 010B,E01018754,1832,1819,13,11,1,0,1
2021,Cornwall 010C,E01018755,1423,1418,5,2,3,0,0
2021,Cornwall 010D,E01018756,1533,1519,14,13,1,0,0
2021,Cornwall 023A,E01018757,2153,2123,30,23,4,3,0
2021,Cornwall 028A,E01018759,1511,1508,3,3,0,0,0
2021,Cornwall 028B,E01018760,1306,1298,8,4,0,3,1
2021,Cornwall 028C,E01018761,1812,1804,8,6,1,1,0
2021,Cornwall 037A,E01018762,1182,1168,14,11,3,0,0
2021,Cornwall 023B,E01018763,1085,1084,1,1,0,0,0
2021,Cornwall 022A,E01018764,1450,1444,6,5,1,0,0
2021,Cornwall 023C,E01018765,1472,1455,17,9,2,2,4
2021,Cornwall 028D,E01018766,1662,1631,31,18,9,4,0
2021,Cornwall 017A,E01018767,1426,1397,29,12,14,3,0
2021,Cornwall 016B,E01018768,2022,1972,50,26,22,1,1
2021,Cornwall 017B,E01018770,1276,1262,14,10,4,0,0
2021,Cornwall 017C,E01018771,1285,1256,29,9,14,6,0
2021,Cornwall 017D,E01018772,1802,1789,13,13,0,0,0
2021,Cornwall 037B,E01018773,1509,1496,13,9,2,2,0
2021,Cornwall 028E,E01018774,1840,1816,24,21,3,0,0
2021,Cornwall 012A,E01018777,2043,2035,8,7,0,1,0
2021,Cornwall 016D,E01018778,1726,1723,3,3,0,0,0
2021,Cornwall 013D,E01018779,2243,2236,7,7,0,0,0
2021,Cornwall 034A,E01018780,2263,2238,25,14,5,5,1
2021,Cornwall 034B,E01018781,1712,1695,17,12,5,0,0
2021,Cornwall 012B,E01018782,1445,1436,9,4,2,2,1
2021,Cornwall 012C,E01018783,1457,1449,8,8,0,0,0
2021,Cornwall 012D,E01018784,1511,1502,9,8,1,0,0
2021,Cornwall 023D,E01018785,1893,1882,11,6,3,1,1
2021,Cornwall 025A,E01018786,1220,1217,3,2,1,0,0
2021,Cornwall 022B,E01018787,1497,1487,10,6,2,2,0
2021,Cornwall 025B,E01018788,1376,1367,9,4,4,0,1
2021,Cornwall 026A,E01018789,1363,1353,10,5,4,1,0
2021,Cornwall 025C,E01018790,1174,1154,20,4,8,8,0
2021,Cornwall 026B,E01018791,1252,1238,14,5,4,2,3
2021,Cornwall 026C,E01018792,2660,2627,33,15,12,4,2
2021,Cornwall 026D,E01018793,1654,1622,32,17,10,4,1
2021,Cornwall 025D,E01018794,1390,1386,4,3,1,0,0
2021,Cornwall 022C,E01018795,1204,1198,6,4,1,1,0
2021,Cornwall 022D,E01018796,1141,1127,14,8,2,3,1
2021,Cornwall 029A,E01018797,1085,1068,17,6,5,6,0
2021,Cornwall 029B,E01018798,1483,1459,24,14,8,1,1
2021,Cornwall 029C,E01018799,1136,1121,15,4,6,1,4
2021,Cornwall 029D,E01018800,1436,1420,16,8,6,1,1
2021,Cornwall 063A,E01018803,1928,1865,63,39,15,8,1
2021,Cornwall 063B,E01018804,1929,1836,93,60,32,1,0
2021,Cornwall 063C,E01018805,1523,1504,19,13,5,1,0
2021,Cornwall 063D,E01018806,1598,1543,55,43,7,5,0
2021,Cornwall 044A,E01018807,1870,1785,85,52,25,7,1
2021,Cornwall 044B,E01018808,1482,1433,49,33,5,8,3
2021,Cornwall 044D,E01018810,1340,1317,23,18,5,0,0
2021,Cornwall 064A,E01018811,1571,1551,20,14,4,2,0
2021,Cornwall 064B,E01018812,1712,1674,38,19,15,4,0
2021,Cornwall 064C,E01018813,1601,1562,39,20,10,9,0
2021,Cornwall 064D,E01018814,1472,1459,13,11,2,0,0
2021,Cornwall 032A,E01018815,2386,2370,16,10,4,0,2
2021,Cornwall 047A,E01018816,1570,1557,13,8,2,1,2
2021,Cornwall 047B,E01018817,2050,2041,9,8,1,0,0
2021,Cornwall 047C,E01018818,1759,1744,15,10,2,1,2
2021,Cornwall 043A,E01018819,1419,1381,38,27,8,3,0
2021,Cornwall 047D,E01018820,1819,1797,22,14,6,2,0
2021,Cornwall 047E,E01018821,1692,1672,20,15,5,0,0
2021,Cornwall 043B,E01018822,1372,1343,29,19,5,5,0
2021,Cornwall 042A,E01018823,1494,1465,29,17,6,6,0
2021,Cornwall 042B,E01018824,2604,2562,42,25,15,1,1
2021,Cornwall 040A,E01018825,1684,1662,22,16,3,0,3
2021,Cornwall 040B,E01018826,2315,2289,26,19,6,1,0
2021,Cornwall 056A,E01018827,1488,1476,12,8,4,0,0
2021,Cornwall 056B,E01018828,1435,1422,13,4,5,3,1
2021,Cornwall 056C,E01018829,1316,1298,18,10,3,4,1
2021,Cornwall 056D,E01018830,1564,1554,10,9,1,0,0
2021,Cornwall 032B,E01018831,1506,1496,10,9,1,0,0
2021,Cornwall 032C,E01018832,1301,1290,11,11,0,0,0
2021,Cornwall 033A,E01018833,1912,1881,31,26,2,2,1
2021,Cornwall 060A,E01018834,1943,1900,43,32,8,2,1
2021,Cornwall 060B,E01018835,2113,2035,78,54,23,1,0
2021,Cornwall 060C,E01018836,1721,1678,43,32,7,4,0
2021,Cornwall 060D,E01018837,2465,2402,63,45,16,2,0
2021,Cornwall 062A,E01018838,1571,1487,84,60,12,11,1
2021,Cornwall 062B,E01018839,1158,1127,31,20,6,1,4
2021,Cornwall 062C,E01018840,1876,1785,91,62,26,2,1
2021,Cornwall 062D,E01018841,1669,1614,55,38,11,6,0
2021,Cornwall 033B,E01018842,1689,1668,21,14,5,1,1
2021,Cornwall 033C,E01018843,1406,1391,15,12,1,2,0
2021,Cornwall 033D,E01018844,1257,1239,18,9,2,1,6
2021,Cornwall 048A,E01018845,1819,1801,18,13,5,0,0
2021,Cornwall 048B,E01018846,1428,1409,19,12,6,1,0
2021,Cornwall 032D,E01018847,1762,1746,16,14,2,0,0
2021,Cornwall 048C,E01018848,1684,1678,6,5,1,0,0
2021,Cornwall 048D,E01018849,1804,1750,54,40,14,0,0
2021,Cornwall 048E,E01018850,1296,1282,14,10,4,0,0
2021,Cornwall 040C,E01018851,1282,1272,10,7,3,0,0
2021,Cornwall 042C,E01018853,2773,2687,86,45,28,12,1
2021,Cornwall 042D,E01018854,1378,1341,37,18,17,2,0
2021,Cornwall 043D,E01018856,1275,1230,45,35,7,3,0
2021,Cornwall 043E,E01018857,1376,1356,20,9,10,1,0
2021,Cornwall 043F,E01018858,1426,1410,16,11,4,0,1
2021,Cornwall 064E,E01018859,1737,1702,35,19,10,5,1
2021,Cornwall 062E,E01018860,1833,1790,43,20,17,4,2
2021,Cornwall 072A,E01018861,1506,1494,12,4,3,5,0
2021,Cornwall 072B,E01018862,1435,1426,9,7,2,0,0
2021,Cornwall 059A,E01018863,1683,1661,22,11,10,1,0
2021,Cornwall 059B,E01018864,1721,1680,41,14,17,6,4
2021,Cornwall 052A,E01018865,2192,2088,104,45,34,24,1
2021,Cornwall 052B,E01018866,2127,2094,33,14,15,4,0
2021,Cornwall 052D,E01018868,1879,1771,108,30,60,14,4
2021,Cornwall 055A,E01018869,1725,1667,58,16,24,14,4
2021,Cornwall 055B,E01018870,1262,1228,34,15,11,5,3
2021,Cornwall 055C,E01018871,1654,1635,19,7,6,6,0
2021,Cornwall 055D,E01018872,1234,1212,22,7,7,8,0
2021,Cornwall 055E,E01018873,1190,1188,2,2,0,0,0
2021,Cornwall 053A,E01018874,1285,1264,21,6,6,6,3
2021,Cornwall 053B,E01018875,1286,1255,31,9,12,9,1
2021,Cornwall 053C,E01018876,1449,1424,25,8,11,6,0
2021,Cornwall 053D,E01018877,1537,1519,18,11,2,5,0
2021,Cornwall 053E,E01018878,1619,1536,83,32,39,11,1
2021,Cornwall 066A,E01018879,1896,1879,17,13,4,0,0
2021,Cornwall 066B,E01018880,2223,2197,26,16,8,2,0
2021,Cornwall 073A,E01018881,2086,2068,18,12,4,2,0
2021,Cornwall 071A,E01018882,1454,1446,8,4,3,1,0
2021,Cornwall 071B,E01018883,1587,1577,10,5,3,2,0
2021,Cornwall 071C,E01018884,1582,1570,12,7,0,2,3
2021,Cornwall 071D,E01018885,1426,1407,19,13,3,3,0
2021,Cornwall 071E,E01018886,1647,1624,23,13,5,5,0
2021,Cornwall 071F,E01018887,1847,1811,36,16,16,4,0
2021,Cornwall 071G,E01018888,2190,2170,20,15,4,1,0
2021,Cornwall 045A,E01018889,1240,1226,14,6,5,3,0
2021,Cornwall 045B,E01018890,1598,1581,17,10,5,1,1
2021,Cornwall 045C,E01018891,1249,1228,21,9,8,4,0
2021,Cornwall 045D,E01018892,1624,1596,28,19,4,3,2
2021,Cornwall 045E,E01018893,1287,1274,13,9,4,0,0
2021,Cornwall 051A,E01018894,1933,1907,26,18,6,1,1
2021,Cornwall 051B,E01018895,1907,1845,62,23,23,15,1
2021,Cornwall 051C,E01018896,1381,1331,50,14,23,11,2
2021,Cornwall 051D,E01018897,2263,2099,164,61,57,38,8
2021,Cornwall 051E,E01018898,1232,1202,30,8,15,7,0
2021,Cornwall 066C,E01018899,2877,2771,106,69,26,11,0
2021,Cornwall 066D,E01018900,1959,1933,26,12,11,3,0
2021,Cornwall 066E,E01018901,1510,1501,9,7,2,0,0
2021,Cornwall 073B,E01018902,1177,1169,8,4,2,2,0
2021,Cornwall 073C,E01018903,1170,1159,11,6,1,4,0
2021,Cornwall 073D,E01018904,2266,2246,20,13,7,0,0
2021,Cornwall 072C,E01018905,1423,1421,2,2,0,0,0
2021,Cornwall 072D,E01018906,1067,1059,8,6,1,1,0
2021,Cornwall 072E,E01018907,1304,1297,7,4,2,1,0
2021,Cornwall 046A,E01018908,1796,1775,21,15,4,2,0
2021,Cornwall 046B,E01018909,1641,1604,37,17,14,6,0
2021,Cornwall 046C,E01018910,1982,1916,66,32,23,10,1
2021,Cornwall 046D,E01018911,1685,1626,59,27,18,13,1
2021,Cornwall 049A,E01018912,1880,1848,32,20,9,3,0
2021,Cornwall 049B,E01018913,1854,1775,79,39,33,7,0
2021,Cornwall 049C,E01018914,2101,2036,65,25,23,15,2
2021,Cornwall 049D,E01018915,2141,2085,56,28,22,6,0
2021,Cornwall 050A,E01018916,1377,1355,22,14,2,3,3
2021,Cornwall 050B,E01018917,1403,1395,8,6,2,0,0
2021,Cornwall 050C,E01018918,1877,1845,32,22,3,7,0
2021,Cornwall 050D,E01018919,1484,1474,10,3,4,2,1
2021,Cornwall 073E,E01018920,2040,2030,10,10,0,0,0
2021,Cornwall 059C,E01018921,2194,2175,19,15,3,1,0
2021,Cornwall 059D,E01018922,2526,2506,20,16,1,3,0
2021,Cornwall 011A,E01018923,1366,1360,6,5,0,1,0
2021,Cornwall 007A,E01018924,1264,1256,8,3,3,2,0
2021,Cornwall 006A,E01018925,2205,2179,26,17,5,3,1
2021,Cornwall 011B,E01018926,2455,2437,18,8,3,4,3
2021,Cornwall 015A,E01018927,1652,1596,56,27,22,6,1
2021,Cornwall 015B,E01018928,1634,1524,110,42,46,21,1
2021,Cornwall 015C,E01018929,1815,1757,58,25,25,6,2
2021,Cornwall 015D,E01018930,1501,1414,87,29,42,13,3
2021,Cornwall 015E,E01018931,1073,1054,19,11,5,3,0
2021,Cornwall 014A,E01018932,1625,1561,64,18,20,24,2
2021,Cornwall 014B,E01018933,1874,1676,198,51,97,47,3
2021,Cornwall 014C,E01018934,2579,2485,94,59,26,9,0
2021,Cornwall 014D,E01018935,2569,2469,100,39,43,14,4
2021,Cornwall 001A,E01018936,1551,1526,25,9,7,9,0
2021,Cornwall 001B,E01018937,2024,1997,27,14,12,1,0
2021,Cornwall 001C,E01018938,1621,1611,10,6,4,0,0
2021,Cornwall 003A,E01018940,1593,1580,13,8,2,1,2
2021,Cornwall 003B,E01018941,1610,1602,8,6,2,0,0
2021,Cornwall 003C,E01018942,1469,1454,15,12,1,1,1
2021,Cornwall 002A,E01018943,2327,2323,4,3,1,0,0
2021,Cornwall 011C,E01018944,1104,1094,10,9,0,1,0
2021,Cornwall 011D,E01018945,1329,1323,6,4,2,0,0
2021,Cornwall 005A,E01018946,1462,1425,37,23,9,5,0
2021,Cornwall 005C,E01018948,1672,1608,64,26,27,8,3
2021,Cornwall 005D,E01018949,1343,1307,36,16,16,2,2
2021,Cornwall 005E,E01018950,1644,1496,148,52,56,37,3
2021,Cornwall 002B,E01018951,2381,2366,15,10,4,1,0
2021,Cornwall 006B,E01018952,1217,1203,14,6,6,2,0
2021,Cornwall 004B,E01018953,1257,1243,14,11,2,0,1
2021,Cornwall 008A,E01018954,1530,1495,35,16,15,4,0
2021,Cornwall 008B,E01018955,1539,1516,23,12,8,1,2
2021,Cornwall 008C,E01018956,1048,1043,5,5,0,0,0
2021,Cornwall 008D,E01018957,1467,1448,19,12,4,3,0
2021,Cornwall 008E,E01018958,990,969,21,14,7,0,0
2021,Cornwall 001D,E01018959,1410,1395,15,8,5,2,0
2021,Cornwall 001E,E01018960,2358,2342,16,12,4,0,0
2021,Cornwall 001F,E01018961,1384,1366,18,7,7,2,2
2021,Cornwall 007B,E01018962,1896,1879,17,6,10,0,1
2021,Cornwall 006C,E01018965,2402,2389,13,8,4,0,1
2021,Cornwall 006D,E01018966,1072,1064,8,3,3,0,2
2021,Cornwall 006E,E01018967,1306,1301,5,5,0,0,0
2021,Cornwall 004C,E01018968,2485,2474,11,6,4,1,0
2021,Cornwall 003D,E01018969,2216,2185,31,26,3,2,0
2021,Cornwall 009A,E01018970,1594,1584,10,4,4,2,0
2021,Cornwall 009B,E01018971,1867,1843,24,15,7,2,0
2021,Cornwall 009C,E01018972,1715,1694,21,7,12,2,0
2021,Cornwall 009D,E01018973,1477,1453,24,14,3,4,3
2021,Cornwall 002C,E01018974,2637,2623,14,5,6,2,1
2021,Cornwall 061A,E01018975,2070,2058,12,7,4,0,1
2021,Cornwall 067A,E01018976,2048,2035,13,6,4,3,0
2021,Cornwall 067B,E01018977,1282,1264,18,10,6,2,0
2021,Cornwall 057A,E01018978,1492,1474,18,11,5,1,1
2021,Cornwall 061B,E01018979,1449,1435,14,9,5,0,0
2021,Cornwall 061C,E01018980,1592,1581,11,7,0,3,1
2021,Cornwall 057B,E01018981,2006,1980,26,11,7,7,1
2021,Cornwall 057C,E01018982,2015,1984,31,17,10,4,0
2021,Cornwall 057D,E01018983,1521,1490,31,17,9,4,1
2021,Cornwall 058A,E01018985,2302,2265,37,15,13,9,0
2021,Cornwall 058B,E01018986,1484,1452,32,17,13,2,0
2021,Cornwall 058C,E01018987,2005,1991,14,11,2,1,0
2021,Cornwall 065A,E01018988,1588,1559,29,9,16,1,3
2021,Cornwall 065B,E01018989,1799,1778,21,9,3,6,3
2021,Cornwall 061D,E01018990,1815,1792,23,12,9,2,0
2021,Cornwall 065C,E01018991,1505,1491,14,10,2,2,0
2021,Cornwall 069A,E01018992,1710,1687,23,16,5,1,1
2021,Cornwall 069B,E01018993,1465,1440,25,17,3,2,3
2021,Cornwall 067C,E01018994,1893,1867,26,12,11,3,0
2021,Cornwall 068A,E01018995,2028,1984,44,18,17,8,1
2021,Cornwall 067D,E01018996,1469,1426,43,21,18,4,0
2021,Cornwall 067E,E01018997,1422,1405,17,8,7,2,0
2021,Cornwall 068B,E01018998,1326,1286,40,15,19,5,1
2021,Cornwall 068C,E01018999,1539,1494,45,17,22,4,2
2021,Cornwall 070A,E01019000,1409,1391,18,12,5,1,0
2021,Cornwall 068D,E01019001,1483,1440,43,19,19,5,0
2021,Cornwall 070B,E01019002,1191,1183,8,7,0,1,0
2021,Cornwall 070C,E01019003,1676,1649,27,12,11,3,1
2021,Cornwall 070D,E01019004,1432,1409,23,13,7,1,2
2021,Cornwall 069C,E01019005,2110,2099,11,4,5,2,0
2021,Cornwall 065D,E01019006,1500,1484,16,11,4,1,0
2021,Cornwall 061E,E01019007,2291,2279,12,8,2,0,2
2021,Cornwall 054A,E01019008,1290,1273,17,12,3,2,0
2021,Cornwall 054B,E01019009,1522,1501,21,16,3,2,0
2021,Cornwall 054C,E01019010,1166,1138,28,16,7,5,0
2021,Cornwall 054D,E01019011,1565,1550,15,10,3,1,1
2021,Cornwall 054E,E01019012,1218,1172,46,30,14,2,0
2021,Cornwall 036A,E01019013,2050,2023,27,16,8,3,0
2021,Cornwall 036B,E01019014,1462,1455,7,4,3,0,0
2021,Cornwall 036C,E01019015,1318,1313,5,4,1,0,0
2021,Cornwall 036D,E01019016,1790,1778,12,2,5,5,0
2021,Cornwall 021A,E01019018,1551,1538,13,8,4,1,0
2021,Cornwall 021B,E01019019,1772,1708,64,35,24,5,0
2021,Cornwall 021C,E01019020,1568,1443,125,61,37,24,3
2021,Cornwall 021D,E01019021,1557,1523,34,16,14,4,0
2021,Cornwall 021E,E01019022,1758,1708,50,18,22,9,1
2021,Cornwall 021F,E01019023,1610,1541,69,44,20,5,0
2021,Cornwall 035A,E01019024,1481,1467,14,11,1,1,1
2021,Cornwall 035B,E01019025,1487,1473,14,11,2,1,0
2021,Cornwall 035C,E01019026,1397,1388,9,6,2,0,1
2021,Cornwall 035D,E01019027,1230,1212,18,10,5,3,0
2021,Cornwall 020A,E01019028,2094,2011,83,42,30,11,0
2021,Cornwall 020B,E01019029,1641,1554,87,51,32,3,1
2021,Cornwall 020C,E01019030,2029,1963,66,46,15,5,0
2021,Cornwall 020D,E01019031,1662,1634,28,21,2,3,2
2021,Cornwall 038A,E01019032,1424,1410,14,8,4,2,0
2021,Cornwall 039A,E01019033,1541,1475,66,27,22,14,3
2021,Cornwall 038B,E01019034,1521,1484,37,22,11,4,0
2021,Cornwall 027A,E01019035,1651,1634,17,11,6,0,0
2021,Cornwall 027B,E01019036,1784,1778,6,6,0,0,0
2021,Cornwall 027C,E01019037,1575,1566,9,6,2,1,0
2021,Cornwall 041A,E01019038,1035,1017,18,10,4,4,0
2021,Cornwall 041B,E01019039,1304,1296,8,6,2,0,0
2021,Cornwall 041C,E01019040,1283,1271,12,12,0,0,0
2021,Cornwall 039B,E01019041,1816,1767,49,17,24,8,0
2021,Cornwall 039C,E01019042,1685,1647,38,24,8,6,0
2021,Cornwall 039D,E01019043,1924,1898,26,12,10,3,1
2021,Cornwall 039E,E01019044,1462,1450,12,7,2,3,0
2021,Cornwall 038C,E01019045,2588,2547,41,23,10,7,1
2021,Cornwall 039F,E01019046,1306,1280,26,17,2,6,1
2021,Cornwall 038D,E01019047,1479,1462,17,8,6,3,0
2021,Cornwall 018A,E01019048,1876,1839,37,22,7,7,1
2021,Cornwall 018C,E01019050,1789,1769,20,17,3,0,0
2021,Cornwall 018D,E01019051,1595,1556,39,22,11,3,3
2021,Cornwall 024A,E01019052,1952,1924,28,8,12,7,1
2021,Cornwall 024B,E01019053,2213,2096,117,25,39,44,9
2021,Cornwall 024C,E01019054,1903,1887,16,11,3,2,0
2021,Cornwall 024D,E01019055,1486,1469,17,7,8,2,0
2021,Cornwall 031A,E01019056,1314,1300,14,6,7,1,0
2021,Cornwall 031B,E01019057,1813,1802,11,7,3,1,0
2021,Cornwall 031C,E01019058,2137,2109,28,22,4,1,1
2021,Cornwall 031D,E01019059,1459,1458,1,1,0,0,0
2021,Cornwall 019A,E01019060,1344,1315,29,16,7,6,0
2021,Cornwall 019B,E01019061,1802,1782,20,12,5,3,0
2021,Cornwall 019C,E01019062,1770,1738,32,17,10,5,0
2021,Cornwall 019D,E01019063,2165,2139,26,12,10,3,1
2021,Cornwall 019E,E01019064,2137,2116,21,16,5,0,0
2021,Cornwall 019F,E01019065,1288,1279,9,8,1,0,0
2021,Cornwall 041D,E01019066,1336,1329,7,2,4,1,0
2021,Cornwall 041E,E01019067,1354,1342,12,6,3,3,0
2021,Cornwall 041F,E01019068,1566,1557,9,5,1,3,0
2021,Cornwall 030A,E01019069,1200,1187,13,5,5,3,0
2021,Cornwall 030B,E01019070,2026,2009,17,14,0,0,3
2021,Cornwall 030C,E01019071,1732,1722,10,6,4,0,0
2021,Cornwall 030D,E01019072,1455,1444,11,5,5,0,1
2021,Cornwall 030E,E01019073,1560,1549,11,4,5,2,0
2021,Cornwall 027D,E01019074,1851,1808,43,20,16,6,1
2021,Cornwall 027E,E01019075,1827,1811,16,9,5,1,1
2021,Cornwall 027F,E01019076,2073,1894,179,59,69,42,9
2021,Isles of Scilly 001A,E01019077,1986,1940,46,27,14,4,1
2021,Allerdale 007A,E01019078,1421,1404,17,8,7,2,0
2021,Allerdale 007B,E01019079,1348,1336,12,6,6,0,0
2021,Allerdale 007C,E01019080,1853,1829,24,12,10,1,1
2021,Allerdale 003A,E01019081,1796,1788,8,5,3,0,0
2021,Allerdale 003B,E01019082,1443,1435,8,3,4,0,1
2021,Allerdale 002A,E01019083,1773,1745,28,21,7,0,0
2021,Allerdale 006A,E01019084,1561,1551,10,5,4,0,1
2021,Allerdale 006B,E01019085,1893,1868,25,14,7,4,0
2021,Allerdale 006C,E01019086,1042,1028,14,7,5,2,0
2021,Allerdale 007D,E01019087,1553,1532,21,15,6,0,0
2021,Allerdale 006D,E01019088,1814,1761,53,24,19,6,4
2021,Allerdale 011A,E01019089,1576,1572,4,1,3,0,0
2021,Allerdale 007E,E01019090,1386,1377,9,5,4,0,0
2021,Allerdale 006E,E01019091,1718,1698,20,13,4,1,2
2021,Allerdale 012A,E01019092,1401,1349,52,27,20,2,3
2021,Allerdale 004A,E01019093,1520,1506,14,9,1,4,0
2021,Allerdale 004B,E01019094,2071,2057,14,12,1,1,0
2021,Allerdale 005A,E01019095,1334,1298,36,9,16,10,1
2021,Allerdale 004C,E01019096,2092,2086,6,2,2,0,2
2021,Allerdale 005B,E01019097,1742,1691,51,14,30,7,0
2021,Allerdale 005C,E01019098,1580,1567,13,4,7,1,1
2021,Allerdale 005D,E01019099,1668,1661,7,5,1,1,0
2021,Allerdale 011B,E01019100,1989,1977,12,5,5,1,1
2021,Allerdale 011C,E01019101,1401,1396,5,4,1,0,0
2021,Allerdale 003C,E01019102,1569,1549,20,9,7,3,1
2021,Allerdale 012C,E01019104,1332,1290,42,26,13,3,0
2021,Allerdale 012E,E01019106,1376,1361,15,8,5,2,0
2021,Allerdale 002B,E01019107,1518,1511,7,5,0,2,0
2021,Allerdale 010A,E01019108,1455,1444,11,2,5,4,0
2021,Allerdale 010B,E01019109,1687,1675,12,7,1,4,0
2021,Allerdale 010C,E01019110,1525,1506,19,8,6,5,0
2021,Allerdale 009A,E01019111,1785,1771,14,8,3,1,2
2021,Allerdale 009B,E01019112,1625,1613,12,4,6,2,0
2021,Allerdale 009C,E01019113,1599,1567,32,18,10,3,1
2021,Allerdale 004D,E01019114,1411,1391,20,8,6,3,3
2021,Allerdale 004E,E01019115,1522,1504,18,8,1,9,0
2021,Allerdale 008A,E01019116,1118,1088,30,10,12,7,1
2021,Allerdale 010D,E01019117,1303,1296,7,4,3,0,0
2021,Allerdale 008B,E01019118,1235,1210,25,12,5,6,2
2021,Allerdale 010E,E01019119,1424,1419,5,3,2,0,0
2021,Allerdale 009D,E01019120,1508,1487,21,12,3,6,0
2021,Allerdale 009E,E01019121,1783,1739,44,18,17,9,0
2021,Allerdale 008C,E01019122,1312,1290,22,5,9,5,3
2021,Allerdale 008D,E01019123,1732,1722,10,6,1,3,0
2021,Allerdale 008E,E01019124,1909,1907,2,1,1,0,0
2021,Allerdale 008F,E01019125,1410,1405,5,3,2,0,0
2021,Allerdale 001A,E01019126,1578,1566,12,4,5,3,0
2021,Allerdale 001B,E01019127,1521,1517,4,1,1,2,0
2021,Allerdale 003D,E01019128,1600,1596,4,3,1,0,0
2021,Allerdale 011D,E01019129,2066,2060,6,4,2,0,0
2021,Allerdale 002C,E01019130,1742,1729,13,7,3,3,0
2021,Allerdale 002D,E01019131,1843,1835,8,5,1,2,0
2021,Allerdale 001C,E01019132,1758,1750,8,7,1,0,0
2021,Allerdale 003E,E01019133,1499,1492,7,5,1,0,1
2021,Allerdale 001D,E01019134,1337,1330,7,3,3,0,1
2021,Allerdale 001E,E01019135,1535,1524,11,6,5,0,0
2021,Allerdale 001F,E01019136,1969,1950,19,10,5,2,2
2021,Allerdale 001G,E01019137,1020,1014,6,3,2,0,1
2021,Barrow-in-Furness 010A,E01019138,1125,1112,13,11,0,2,0
2021,Barrow-in-Furness 010B,E01019139,1021,989,32,18,11,3,0
2021,Barrow-in-Furness 008A,E01019141,1143,1080,63,18,26,16,3
2021,Barrow-in-Furness 008B,E01019142,1279,1222,57,26,13,13,5
2021,Barrow-in-Furness 008C,E01019143,1407,1334,73,18,33,22,0
2021,Barrow-in-Furness 001A,E01019144,1359,1346,13,7,2,3,1
2021,Barrow-in-Furness 001B,E01019145,1935,1923,12,6,5,1,0
2021,Barrow-in-Furness 001C,E01019146,1276,1262,14,8,5,1,0
2021,Barrow-in-Furness 001D,E01019147,1454,1443,11,9,2,0,0
2021,Barrow-in-Furness 002A,E01019148,1293,1289,4,4,0,0,0
2021,Barrow-in-Furness 002B,E01019149,1414,1401,13,4,6,3,0
2021,Barrow-in-Furness 002C,E01019150,1448,1437,11,8,3,0,0
2021,Barrow-in-Furness 002D,E01019151,1433,1419,14,2,12,0,0
2021,Barrow-in-Furness 003A,E01019152,1293,1221,72,36,23,12,1
2021,Barrow-in-Furness 003B,E01019153,984,975,9,1,4,2,2
2021,Barrow-in-Furness 003C,E01019154,1269,1250,19,2,11,5,1
2021,Barrow-in-Furness 003D,E01019155,1318,1295,23,13,8,2,0
2021,Barrow-in-Furness 004A,E01019156,1330,1273,57,23,16,16,2
2021,Barrow-in-Furness 008D,E01019157,1270,1208,62,14,30,12,6
2021,Barrow-in-Furness 008E,E01019158,1062,1005,57,24,21,8,4
2021,Barrow-in-Furness 004B,E01019159,1130,1110,20,7,7,6,0
2021,Barrow-in-Furness 007B,E01019160,1338,1320,18,10,5,2,1
2021,Barrow-in-Furness 006A,E01019161,2076,2046,30,17,8,4,1
2021,Barrow-in-Furness 003E,E01019162,1501,1483,18,14,4,0,0
2021,Barrow-in-Furness 003F,E01019163,1216,1189,27,12,5,8,2
2021,Barrow-in-Furness 004C,E01019164,1462,1434,28,12,10,6,0
2021,Barrow-in-Furness 004D,E01019165,1368,1356,12,10,1,0,1
2021,Barrow-in-Furness 004E,E01019166,1210,1205,5,3,2,0,0
2021,Barrow-in-Furness 005A,E01019167,1317,1293,24,10,12,2,0
2021,Barrow-in-Furness 005B,E01019168,1282,1271,11,4,6,1,0
2021,Barrow-in-Furness 005C,E01019169,1343,1330,13,11,1,1,0
2021,Barrow-in-Furness 005D,E01019170,1191,1175,16,5,9,2,0
2021,Barrow-in-Furness 005E,E01019171,1124,1116,8,3,3,2,0
2021,Barrow-in-Furness 007C,E01019172,1223,1204,19,11,3,4,1
2021,Barrow-in-Furness 007D,E01019173,1101,1092,9,4,3,1,1
2021,Barrow-in-Furness 007F,E01019175,1418,1401,17,7,6,0,4
2021,Barrow-in-Furness 006B,E01019176,1766,1754,12,5,4,3,0
2021,Barrow-in-Furness 006C,E01019177,1395,1372,23,10,6,7,0
2021,Barrow-in-Furness 006D,E01019178,1472,1463,9,4,2,3,0
2021,Barrow-in-Furness 006E,E01019179,1159,1144,15,7,3,5,0
2021,Barrow-in-Furness 009A,E01019180,1655,1647,8,5,0,1,2
2021,Barrow-in-Furness 009C,E01019182,1365,1353,12,6,3,2,1
2021,Barrow-in-Furness 009E,E01019184,1287,1281,6,6,0,0,0
2021,Barrow-in-Furness 010C,E01019185,1320,1315,5,4,0,1,0
2021,Barrow-in-Furness 010D,E01019186,1172,1165,7,7,0,0,0
2021,Barrow-in-Furness 010E,E01019187,1240,1237,3,2,1,0,0
2021,Carlisle 003A,E01019188,1516,1467,49,21,18,8,2
2021,Carlisle 003B,E01019189,1338,1287,51,25,17,6,3
2021,Carlisle 003C,E01019190,1625,1588,37,15,13,9,0
2021,Carlisle 003D,E01019191,1421,1373,48,12,26,7,3
2021,Carlisle 005A,E01019192,1328,1318,10,4,2,4,0
2021,Carlisle 009A,E01019193,1915,1775,140,63,41,28,8
2021,Carlisle 009B,E01019194,2070,1986,84,38,39,7,0
2021,Carlisle 005B,E01019195,1339,1326,13,5,6,2,0
2021,Carlisle 004A,E01019196,1731,1600,131,43,51,34,3
2021,Carlisle 011A,E01019197,2019,1750,269,84,116,63,6
2021,Carlisle 011B,E01019198,1273,1199,74,30,30,13,1
2021,Carlisle 011C,E01019199,1000,963,37,17,16,4,0
2021,Carlisle 002A,E01019200,1564,1551,13,10,2,1,0
2021,Carlisle 002B,E01019201,1371,1362,9,3,2,4,0
2021,Carlisle 002C,E01019202,1500,1489,11,6,3,2,0
2021,Carlisle 005C,E01019203,2152,2143,9,7,0,2,0
2021,Carlisle 006A,E01019204,1000,909,91,35,42,14,0
2021,Carlisle 008A,E01019205,1553,1408,145,74,41,27,3
2021,Carlisle 006B,E01019206,1655,1485,170,65,66,36,3
2021,Carlisle 008B,E01019207,1261,1169,92,34,39,16,3
2021,Carlisle 012A,E01019208,1394,1340,54,20,25,9,0
2021,Carlisle 010A,E01019209,1320,1285,35,13,16,5,1
2021,Carlisle 012B,E01019210,1291,1239,52,16,18,13,5
2021,Carlisle 010B,E01019211,1474,1382,92,29,46,17,0
2021,Carlisle 013A,E01019212,1658,1643,15,4,8,3,0
2021,Carlisle 008C,E01019215,1456,1395,61,24,22,11,4
2021,Carlisle 010C,E01019216,1678,1607,71,29,27,12,3
2021,Carlisle 010D,E01019217,1529,1463,66,27,20,18,1
2021,Carlisle 008D,E01019218,1463,1408,55,26,16,11,2
2021,Carlisle 007A,E01019219,2117,2107,10,6,3,1,0
2021,Carlisle 010E,E01019220,1485,1425,60,35,13,7,5
2021,Carlisle 011D,E01019221,1714,1652,62,41,15,6,0
2021,Carlisle 011E,E01019222,1677,1575,102,50,39,12,1
2021,Carlisle 013D,E01019223,1353,1333,20,8,6,6,0
2021,Carlisle 007B,E01019224,1924,1916,8,7,1,0,0
2021,Carlisle 002D,E01019225,1909,1899,10,9,1,0,0
2021,Carlisle 001A,E01019226,1120,1113,7,2,2,2,1
2021,Carlisle 001B,E01019227,1368,1333,35,14,19,2,0
2021,Carlisle 001C,E01019228,1564,1538,26,9,10,5,2
2021,Carlisle 001D,E01019229,1808,1790,18,7,9,2,0
2021,Carlisle 009C,E01019230,1522,1496,26,7,11,7,1
2021,Carlisle 009D,E01019231,1636,1585,51,23,19,7,2
2021,Carlisle 009E,E01019232,1370,1325,45,15,23,5,2
2021,Carlisle 008E,E01019233,1262,1237,25,17,6,2,0
2021,Carlisle 006C,E01019234,1312,1112,200,58,99,34,9
2021,Carlisle 006D,E01019235,1336,1294,42,16,18,7,1
2021,Carlisle 010F,E01019236,1579,1282,297,79,129,79,10
2021,Carlisle 006E,E01019237,1335,1263,72,22,28,17,5
2021,Carlisle 004B,E01019238,1450,1410,40,22,14,2,2
2021,Carlisle 007C,E01019239,1433,1424,9,5,4,0,0
2021,Carlisle 004C,E01019240,2150,2115,35,22,8,4,1
2021,Carlisle 004D,E01019241,1843,1808,35,17,11,7,0
2021,Carlisle 006F,E01019242,1216,1191,25,15,4,6,0
2021,Carlisle 004E,E01019243,1380,1350,30,14,12,4,0
2021,Carlisle 003E,E01019244,1408,1399,9,2,7,0,0
2021,Carlisle 011F,E01019245,1479,1339,140,46,47,45,2
2021,Carlisle 012C,E01019246,1178,1160,18,11,3,1,3
2021,Carlisle 012D,E01019247,1327,1289,38,22,12,3,1
2021,Carlisle 012E,E01019248,1101,1052,49,14,23,10,2
2021,Carlisle 007D,E01019249,1539,1522,17,13,3,1,0
2021,Carlisle 007E,E01019250,1594,1583,11,8,3,0,0
2021,Carlisle 004F,E01019251,2115,2072,43,28,7,8,0
2021,Carlisle 009F,E01019252,1292,1265,27,19,6,2,0
2021,Carlisle 013E,E01019253,1650,1628,22,6,10,5,1
2021,Carlisle 005D,E01019254,1273,1265,8,1,7,0,0
2021,Carlisle 005E,E01019255,1281,1275,6,4,0,2,0
2021,Copeland 004A,E01019256,1349,1341,8,6,1,1,0
2021,Copeland 007A,E01019257,1325,1316,9,5,1,2,1
2021,Copeland 007B,E01019258,1409,1402,7,5,2,0,0
2021,Copeland 008A,E01019259,1212,1207,5,4,1,0,0
2021,Copeland 002A,E01019260,1382,1373,9,5,3,1,0
2021,Copeland 003A,E01019261,1629,1611,18,9,4,4,1
2021,Copeland 003B,E01019262,1575,1558,17,8,4,4,1
2021,Copeland 004C,E01019264,1717,1710,7,4,3,0,0
2021,Copeland 004D,E01019265,1238,1223,15,9,4,2,0
2021,Copeland 004E,E01019266,1330,1326,4,2,2,0,0
2021,Copeland 004F,E01019267,1172,1171,1,1,0,0,0
2021,Copeland 001B,E01019269,1481,1470,11,8,2,1,0
2021,Copeland 001C,E01019270,1264,1248,16,4,6,5,1
2021,Copeland 006A,E01019271,1258,1252,6,5,0,1,0
2021,Copeland 006B,E01019272,1363,1356,7,3,4,0,0
2021,Copeland 006C,E01019273,1467,1458,9,8,1,0,0
2021,Copeland 006D,E01019274,1393,1375,18,9,4,2,3
2021,Copeland 006E,E01019275,1982,1976,6,3,1,0,2
2021,Copeland 004H,E01019277,1152,1135,17,12,2,2,1
2021,Copeland 004I,E01019278,1331,1323,8,7,1,0,0
2021,Copeland 007C,E01019279,1299,1290,9,5,4,0,0
2021,Copeland 002B,E01019280,1440,1383,57,26,18,10,3
2021,Copeland 002C,E01019281,1096,1072,24,10,14,0,0
2021,Copeland 002D,E01019282,1166,1161,5,3,0,2,0
2021,Copeland 008B,E01019283,1519,1507,12,4,6,2,0
2021,Copeland 003C,E01019284,1126,1121,5,5,0,0,0
2021,Copeland 003D,E01019285,1326,1288,38,22,9,7,0
2021,Copeland 003E,E01019286,1281,1256,25,13,11,1,0
2021,Copeland 003F,E01019287,1062,1053,9,2,5,2,0
2021,Copeland 003G,E01019288,1295,1279,16,7,6,3,0
2021,Copeland 008C,E01019289,1249,1237,12,7,4,1,0
2021,Copeland 008D,E01019290,1019,1016,3,2,1,0,0
2021,Copeland 005A,E01019291,1400,1387,13,7,4,2,0
2021,Copeland 005B,E01019292,1034,1026,8,3,4,1,0
2021,Copeland 008E,E01019293,1240,1237,3,3,0,0,0
2021,Copeland 005C,E01019294,1347,1334,13,4,3,4,2
2021,Copeland 005D,E01019295,1388,1372,16,10,3,2,1
2021,Copeland 005E,E01019296,1353,1337,16,5,6,3,2
2021,Copeland 008F,E01019298,1411,1409,2,1,1,0,0
2021,Copeland 008G,E01019299,1832,1798,34,16,12,6,0
2021,Copeland 007D,E01019300,1608,1582,26,19,7,0,0
2021,Copeland 005F,E01019301,1515,1486,29,14,9,5,1
2021,Copeland 005G,E01019302,1438,1404,34,18,11,4,1
2021,Copeland 007E,E01019303,1457,1448,9,6,3,0,0
2021,Copeland 007F,E01019304,1101,1093,8,1,5,1,1
2021,Eden 001A,E01019305,1978,1966,12,11,1,0,0
2021,Eden 006A,E01019306,1212,1205,7,3,3,1,0
2021,Eden 006B,E01019307,1943,1931,12,4,4,4,0
2021,Eden 005A,E01019308,1237,1220,17,10,6,0,1
2021,Eden 007A,E01019309,2311,2301,10,3,3,3,1
2021,Eden 006C,E01019310,1433,1422,11,5,3,1,2
2021,Eden 005B,E01019311,1448,1424,24,4,12,6,2
2021,Eden 004A,E01019312,1589,1572,17,9,8,0,0
2021,Eden 005C,E01019313,1372,1370,2,2,0,0,0
2021,Eden 001B,E01019314,1326,1322,4,3,1,0,0
2021,Eden 002A,E01019315,1834,1829,5,5,0,0,0
2021,Eden 002B,E01019316,1307,1295,12,7,2,2,1
2021,Eden 007B,E01019317,1300,1296,4,2,2,0,0
2021,Eden 007C,E01019318,1241,1223,18,8,9,0,1
2021,Eden 006D,E01019319,1584,1575,9,7,1,1,0
2021,Eden 001C,E01019320,1427,1418,9,4,5,0,0
2021,Eden 001D,E01019321,1558,1555,3,3,0,0,0
2021,Eden 002C,E01019322,1565,1555,10,5,5,0,0
2021,Eden 006E,E01019323,1215,1201,14,8,4,2,0
2021,Eden 006F,E01019324,1304,1298,6,3,3,0,0
2021,Eden 007D,E01019325,1375,1369,6,5,1,0,0
2021,Eden 004B,E01019326,2081,2026,55,18,22,13,2
2021,Eden 003A,E01019327,1764,1618,146,58,58,24,6
2021,Eden 004C,E01019328,1393,1359,34,7,19,8,0
2021,Eden 004D,E01019329,1085,1062,23,12,5,4,2
2021,Eden 004E,E01019330,1453,1357,96,37,42,11,6
2021,Eden 004F,E01019331,1696,1631,65,35,19,11,0
2021,Eden 003B,E01019332,1286,1202,84,38,33,9,4
2021,Eden 003C,E01019333,1345,1194,151,44,65,29,13
2021,Eden 004G,E01019334,1305,1259,46,22,17,6,1
2021,Eden 003D,E01019335,1428,1336,92,31,57,3,1
2021,Eden 003E,E01019336,1688,1525,163,44,82,36,1
2021,Eden 006G,E01019337,1301,1291,10,7,3,0,0
2021,Eden 002D,E01019338,1387,1381,6,6,0,0,0
2021,Eden 005D,E01019339,1340,1283,57,30,22,5,0
2021,Eden 007E,E01019340,1334,1325,9,5,2,0,2
2021,South Lakeland 011C,E01019343,1480,1472,8,4,4,0,0
2021,South Lakeland 008A,E01019344,1005,993,12,9,2,0,1
2021,South Lakeland 008B,E01019345,1197,1194,3,3,0,0,0
2021,South Lakeland 003A,E01019346,1835,1822,13,8,4,1,0
2021,South Lakeland 011D,E01019347,1709,1701,8,5,2,1,0
2021,South Lakeland 010A,E01019348,1175,1163,12,7,4,1,0
2021,South Lakeland 013A,E01019349,1858,1847,11,3,5,3,0
2021,South Lakeland 008C,E01019350,1513,1499,14,9,5,0,0
2021,South Lakeland 008D,E01019351,1719,1710,9,4,3,2,0
2021,South Lakeland 010B,E01019352,2136,2128,8,7,1,0,0
2021,South Lakeland 013B,E01019353,1498,1472,26,15,8,3,0
2021,South Lakeland 013C,E01019354,1309,1246,63,26,25,12,0
2021,South Lakeland 013D,E01019355,1408,1395,13,8,2,3,0
2021,South Lakeland 007A,E01019356,1376,1359,17,8,4,5,0
2021,South Lakeland 013E,E01019357,1737,1725,12,8,4,0,0
2021,South Lakeland 005A,E01019358,1747,1715,32,18,10,4,0
2021,South Lakeland 003B,E01019359,2524,2422,102,48,43,10,1
2021,South Lakeland 004A,E01019360,2020,1899,121,50,45,24,2
2021,South Lakeland 006A,E01019361,1755,1724,31,15,11,5,0
2021,South Lakeland 005B,E01019362,1821,1796,25,18,7,0,0
2021,South Lakeland 004B,E01019363,1867,1748,119,52,41,22,4
2021,South Lakeland 004C,E01019364,1989,1897,92,43,30,15,4
2021,South Lakeland 003C,E01019365,2070,2013,57,22,26,9,0
2021,South Lakeland 005C,E01019366,1668,1646,22,12,5,5,0
2021,South Lakeland 006C,E01019368,2154,2118,36,15,17,4,0
2021,South Lakeland 006D,E01019369,1888,1849,39,12,12,15,0
2021,South Lakeland 003D,E01019370,2224,2146,78,45,21,11,1
2021,South Lakeland 004D,E01019371,2211,2135,76,38,28,9,1
2021,South Lakeland 009A,E01019372,1085,1066,19,10,7,2,0
2021,South Lakeland 009B,E01019373,1419,1399,20,12,8,0,0
2021,South Lakeland 001A,E01019374,1544,1439,105,56,40,7,2
2021,South Lakeland 001B,E01019375,1399,1312,87,48,31,8,0
2021,South Lakeland 001C,E01019376,1269,1175,94,42,44,8,0
2021,South Lakeland 010C,E01019377,1840,1821,19,18,1,0,0
2021,South Lakeland 014A,E01019378,1494,1485,9,3,6,0,0
2021,South Lakeland 014B,E01019379,1444,1436,8,4,2,2,0
2021,South Lakeland 014C,E01019380,1147,1144,3,1,2,0,0
2021,South Lakeland 007B,E01019381,2115,2097,18,7,11,0,0
2021,South Lakeland 011E,E01019382,2172,2123,49,33,12,4,0
2021,South Lakeland 010D,E01019383,2112,2096,16,13,2,1,0
2021,South Lakeland 009C,E01019384,2346,2329,17,10,5,2,0
2021,South Lakeland 009D,E01019385,1357,1322,35,19,15,1,0
2021,South Lakeland 007C,E01019386,1688,1654,34,18,13,3,0
2021,South Lakeland 002A,E01019387,2160,2103,57,32,16,9,0
2021,South Lakeland 012A,E01019388,1877,1820,57,24,20,12,1
2021,South Lakeland 012B,E01019389,2259,2218,41,22,15,3,1
2021,South Lakeland 012C,E01019390,1930,1908,22,4,7,10,1
2021,South Lakeland 014D,E01019391,1698,1691,7,6,1,0,0
2021,South Lakeland 012D,E01019392,1815,1773,42,22,14,5,1
2021,South Lakeland 014E,E01019393,1942,1934,8,3,3,2,0
2021,South Lakeland 005D,E01019394,2276,2259,17,11,4,2,0
2021,South Lakeland 001D,E01019395,1828,1711,117,48,56,10,3
2021,South Lakeland 002B,E01019396,1914,1789,125,60,56,6,3
2021,South Lakeland 002C,E01019397,1732,1496,236,96,113,26,1
2021,Amber Valley 001A,E01019400,1682,1592,90,38,34,15,3
2021,Amber Valley 001B,E01019401,1668,1569,99,28,51,18,2
2021,Amber Valley 001C,E01019402,1831,1739,92,34,43,10,5
2021,Amber Valley 003A,E01019403,1402,1355,47,10,23,11,3
2021,Amber Valley 001D,E01019404,1935,1866,69,26,21,17,5
2021,Amber Valley 007A,E01019405,1483,1469,14,4,6,4,0
2021,Amber Valley 002A,E01019406,1046,1034,12,6,4,2,0
2021,Amber Valley 010A,E01019407,1959,1921,38,23,9,6,0
2021,Amber Valley 009A,E01019408,1608,1594,14,9,5,0,0
2021,Amber Valley 009B,E01019409,1652,1647,5,3,2,0,0
2021,Amber Valley 011A,E01019410,1347,1337,10,3,6,1,0
2021,Amber Valley 011B,E01019411,1344,1325,19,9,6,4,0
2021,Amber Valley 009C,E01019412,1791,1781,10,5,3,1,1
2021,Amber Valley 009D,E01019413,1265,1248,17,7,9,1,0
2021,Amber Valley 007B,E01019414,1567,1558,9,7,1,0,1
2021,Amber Valley 010B,E01019415,1600,1583,17,13,4,0,0
2021,Amber Valley 009E,E01019416,1366,1353,13,6,4,2,1
2021,Amber Valley 010C,E01019417,1942,1916,26,20,4,1,1
2021,Amber Valley 011C,E01019418,1719,1706,13,9,3,0,1
2021,Amber Valley 010D,E01019419,1839,1818,21,12,7,2,0
2021,Amber Valley 005A,E01019420,1339,1325,14,5,5,4,0
2021,Amber Valley 008A,E01019421,2015,1996,19,14,4,1,0
2021,Amber Valley 008B,E01019422,1466,1463,3,3,0,0,0
2021,Amber Valley 002B,E01019423,1501,1489,12,7,4,1,0
2021,Amber Valley 002C,E01019424,1089,1088,1,0,1,0,0
2021,Amber Valley 016A,E01019425,1621,1589,32,15,13,2,2
2021,Amber Valley 016B,E01019426,1548,1520,28,21,6,1,0
2021,Amber Valley 016C,E01019427,1817,1788,29,17,8,1,3
2021,Amber Valley 007C,E01019428,1387,1381,6,6,0,0,0
2021,Amber Valley 006A,E01019429,1487,1474,13,7,5,1,0
2021,Amber Valley 007D,E01019430,1837,1832,5,5,0,0,0
2021,Amber Valley 012A,E01019431,1341,1324,17,13,1,1,2
2021,Amber Valley 008C,E01019432,1849,1844,5,3,1,1,0
2021,Amber Valley 012B,E01019433,1786,1754,32,15,11,5,1
2021,Amber Valley 013A,E01019434,1131,1119,12,6,2,4,0
2021,Amber Valley 013B,E01019435,1627,1589,38,14,20,2,2
2021,Amber Valley 013C,E01019436,1329,1308,21,9,9,3,0
2021,Amber Valley 017A,E01019437,1388,1372,16,8,8,0,0
2021,Amber Valley 012C,E01019438,1548,1515,33,20,8,5,0
2021,Amber Valley 013D,E01019439,1523,1501,22,10,7,3,2
2021,Amber Valley 013E,E01019440,1568,1534,34,13,16,4,1
2021,Amber Valley 017B,E01019441,1563,1505,58,18,20,18,2
2021,Amber Valley 005B,E01019442,1434,1413,21,6,12,3,0
2021,Amber Valley 004A,E01019443,1670,1636,34,16,9,8,1
2021,Amber Valley 003B,E01019444,1391,1371,20,8,10,2,0
2021,Amber Valley 005C,E01019445,1454,1424,30,16,13,1,0
2021,Amber Valley 015A,E01019446,1139,1134,5,5,0,0,0
2021,Amber Valley 011D,E01019447,1438,1435,3,1,1,1,0
2021,Amber Valley 015B,E01019448,1958,1942,16,5,8,2,1
2021,Amber Valley 011E,E01019449,1688,1685,3,2,1,0,0
2021,Amber Valley 015C,E01019450,1446,1435,11,3,6,1,1
2021,Amber Valley 012D,E01019451,2030,1995,35,14,16,4,1
2021,Amber Valley 017C,E01019452,1597,1581,16,9,4,2,1
2021,Amber Valley 017D,E01019453,1949,1897,52,17,20,13,2
2021,Amber Valley 006B,E01019454,1260,1260,0,0,0,0,0
2021,Amber Valley 005D,E01019455,1296,1290,6,4,2,0,0
2021,Amber Valley 005E,E01019456,1809,1790,19,10,8,1,0
2021,Amber Valley 005F,E01019457,1356,1348,8,8,0,0,0
2021,Amber Valley 008D,E01019458,1927,1897,30,14,9,6,1
2021,Amber Valley 008E,E01019459,1290,1275,15,4,4,5,2
2021,Amber Valley 006C,E01019460,1472,1461,11,8,3,0,0
2021,Amber Valley 006D,E01019461,1328,1314,14,5,6,3,0
2021,Amber Valley 006E,E01019462,1131,1123,8,4,1,3,0
2021,Amber Valley 008F,E01019463,1460,1441,19,9,6,3,1
2021,Amber Valley 012E,E01019464,2460,2431,29,16,7,5,1
2021,Amber Valley 015D,E01019465,1095,1083,12,3,6,3,0
2021,Amber Valley 015E,E01019467,1488,1477,11,7,4,0,0
2021,Amber Valley 003C,E01019468,1436,1406,30,12,11,7,0
2021,Amber Valley 003D,E01019469,1597,1528,69,22,36,8,3
2021,Amber Valley 004B,E01019470,1596,1578,18,4,7,5,2
2021,Amber Valley 003E,E01019471,1347,1241,106,31,43,27,5
2021,Amber Valley 004C,E01019473,1208,1204,4,4,0,0,0
2021,Amber Valley 004D,E01019474,1149,1139,10,4,4,1,1
2021,Amber Valley 004E,E01019475,1301,1296,5,1,2,2,0
2021,Amber Valley 004F,E01019476,1298,1293,5,2,2,1,0
2021,Amber Valley 002D,E01019477,2268,2261,7,2,4,1,0
2021,Bolsover 001A,E01019478,1468,1440,28,15,9,4,0
2021,Bolsover 001B,E01019479,1611,1572,39,19,13,7,0
2021,Bolsover 008A,E01019480,1495,1462,33,19,10,4,0
2021,Bolsover 009A,E01019481,1173,1162,11,6,4,1,0
2021,Bolsover 008B,E01019482,1495,1491,4,1,1,2,0
2021,Bolsover 004A,E01019483,1967,1887,80,32,27,19,2
2021,Bolsover 004B,E01019484,2172,2160,12,4,3,4,1
2021,Bolsover 004C,E01019485,1269,1253,16,6,3,5,2
2021,Bolsover 005A,E01019486,1002,988,14,7,3,4,0
2021,Bolsover 005B,E01019487,1639,1613,26,7,10,5,4
2021,Bolsover 004D,E01019488,1376,1322,54,13,24,12,5
2021,Bolsover 005C,E01019489,1194,1183,11,7,3,1,0
2021,Bolsover 005D,E01019490,1075,1070,5,3,0,2,0
2021,Bolsover 001C,E01019491,2271,2234,37,25,8,4,0
2021,Bolsover 002A,E01019492,1767,1749,18,9,7,1,1
2021,Bolsover 001D,E01019493,1463,1453,10,5,3,2,0
2021,Bolsover 002B,E01019495,1529,1490,39,13,19,6,1
2021,Bolsover 003A,E01019496,1374,1347,27,6,13,8,0
2021,Bolsover 003B,E01019497,1622,1592,30,12,8,7,3
2021,Bolsover 003C,E01019498,1828,1754,74,26,36,9,3
2021,Bolsover 010A,E01019499,1290,1256,34,16,12,5,1
2021,Bolsover 010B,E01019500,1443,1403,40,12,18,10,0
2021,Bolsover 010C,E01019501,1390,1366,24,6,11,6,1
2021,Bolsover 005E,E01019502,1524,1500,24,8,9,7,0
2021,Bolsover 007A,E01019503,2522,2411,111,37,46,25,3
2021,Bolsover 005F,E01019504,1290,1276,14,9,2,3,0
2021,Bolsover 007B,E01019505,1447,1391,56,14,29,12,1
2021,Bolsover 007C,E01019506,1449,1420,29,7,14,6,2
2021,Bolsover 007D,E01019507,1805,1404,401,74,164,142,21
2021,Bolsover 006A,E01019508,1902,1749,153,34,65,46,8
2021,Bolsover 006B,E01019509,1294,1185,109,38,39,27,5
2021,Bolsover 006C,E01019510,1312,1207,105,31,42,26,6
2021,Bolsover 007E,E01019511,2162,1697,465,84,194,165,22
2021,Bolsover 010D,E01019513,1610,1583,27,14,8,3,2
2021,Bolsover 009B,E01019514,1513,1477,36,12,12,10,2
2021,Bolsover 009C,E01019515,1591,1521,70,27,26,13,4
2021,Bolsover 009D,E01019516,1540,1478,62,18,29,14,1
2021,Bolsover 010E,E01019517,1633,1601,32,15,11,5,1
2021,Bolsover 010F,E01019518,1543,1512,31,13,12,5,1
2021,Bolsover 009E,E01019519,1773,1720,53,9,29,15,0
2021,Bolsover 008C,E01019520,2081,2035,46,24,14,8,0
2021,Bolsover 008D,E01019521,1695,1683,12,8,2,0,2
2021,Bolsover 008E,E01019522,1693,1641,52,26,13,11,2
2021,Bolsover 003D,E01019523,1076,1057,19,3,8,8,0
2021,Bolsover 002C,E01019524,1321,1309,12,4,7,1,0
2021,Bolsover 002D,E01019525,1407,1390,17,4,6,5,2
2021,Chesterfield 001A,E01019526,1233,1218,15,2,5,8,0
2021,Chesterfield 003A,E01019527,1352,1327,25,15,4,6,0
2021,Chesterfield 001B,E01019528,1427,1421,6,5,1,0,0
2021,Chesterfield 003B,E01019529,1375,1354,21,6,7,8,0
2021,Chesterfield 003C,E01019530,1381,1370,11,3,6,1,1
2021,Chesterfield 003D,E01019531,1541,1519,22,11,6,5,0
2021,Chesterfield 005A,E01019532,1165,1148,17,6,7,3,1
2021,Chesterfield 005B,E01019533,1296,1285,11,6,2,2,1
2021,Chesterfield 005C,E01019534,1361,1346,15,4,3,7,1
2021,Chesterfield 005D,E01019535,1407,1390,17,9,2,4,2
2021,Chesterfield 005E,E01019536,1808,1777,31,16,10,3,2
2021,Chesterfield 007A,E01019537,1595,1580,15,7,3,4,1
2021,Chesterfield 010A,E01019538,1933,1831,102,53,32,17,0
2021,Chesterfield 009A,E01019539,1526,1489,37,17,15,3,2
2021,Chesterfield 009B,E01019540,1374,1354,20,11,4,4,1
2021,Chesterfield 004A,E01019541,1470,1449,21,10,6,2,3
2021,Chesterfield 004B,E01019542,1536,1491,45,21,16,8,0
2021,Chesterfield 004C,E01019543,1783,1726,57,24,21,12,0
2021,Chesterfield 004D,E01019544,1497,1474,23,17,4,1,1
2021,Chesterfield 012A,E01019545,1291,1274,17,4,12,1,0
2021,Chesterfield 012B,E01019546,1351,1337,14,9,0,5,0
2021,Chesterfield 012C,E01019547,1320,1289,31,12,16,2,1
2021,Chesterfield 012D,E01019548,2161,2116,45,20,15,8,2
2021,Chesterfield 006A,E01019549,1364,1333,31,11,13,7,0
2021,Chesterfield 006B,E01019550,1579,1565,14,3,7,4,0
2021,Chesterfield 006C,E01019551,1430,1422,8,4,3,1,0
2021,Chesterfield 006D,E01019552,1267,1254,13,4,8,1,0
2021,Chesterfield 003E,E01019553,1839,1827,12,5,2,2,3
2021,Chesterfield 010B,E01019554,1280,1230,50,20,17,9,4
2021,Chesterfield 009C,E01019555,1422,1385,37,16,11,10,0
2021,Chesterfield 010C,E01019556,1456,1387,69,35,26,7,1
2021,Chesterfield 008A,E01019557,1467,1428,39,9,20,10,0
2021,Chesterfield 008B,E01019558,1252,1240,12,7,5,0,0
2021,Chesterfield 008C,E01019559,1046,1030,16,11,3,2,0
2021,Chesterfield 008D,E01019560,1308,1294,14,3,8,3,0
2021,Chesterfield 008E,E01019561,1169,1140,29,16,9,4,0
2021,Chesterfield 008F,E01019562,1167,1142,25,12,7,6,0
2021,Chesterfield 002A,E01019563,1679,1631,48,15,13,18,2
2021,Chesterfield 002B,E01019564,1622,1614,8,4,4,0,0
2021,Chesterfield 002C,E01019565,1316,1291,25,11,8,3,3
2021,Chesterfield 002D,E01019566,1702,1678,24,17,6,1,0
2021,Chesterfield 006E,E01019567,1691,1668,23,16,3,2,2
2021,Chesterfield 002E,E01019568,1434,1418,16,7,6,3,0
2021,Chesterfield 007B,E01019569,1460,1388,72,23,26,19,4
2021,Chesterfield 007C,E01019570,1260,1238,22,9,5,7,1
2021,Chesterfield 004E,E01019571,1458,1417,41,17,21,1,2
2021,Chesterfield 001C,E01019572,1284,1255,29,14,10,5,0
2021,Chesterfield 001D,E01019573,1519,1480,39,20,13,6,0
2021,Chesterfield 001E,E01019574,1253,1242,11,7,1,3,0
2021,Chesterfield 013A,E01019575,1573,1459,114,42,37,32,3
2021,Chesterfield 013B,E01019576,1570,1539,31,13,8,7,3
2021,Chesterfield 013C,E01019577,1449,1417,32,9,16,7,0
2021,Chesterfield 013D,E01019578,1485,1432,53,32,15,6,0
2021,Chesterfield 010D,E01019579,1793,1675,118,34,45,30,9
2021,Chesterfield 007D,E01019580,1569,1519,50,25,15,7,3
2021,Chesterfield 007E,E01019581,1297,1258,39,14,8,15,2
2021,Chesterfield 012E,E01019582,1436,1405,31,10,19,2,0
2021,Chesterfield 012F,E01019583,1343,1313,30,14,10,6,0
2021,Chesterfield 012G,E01019585,2193,2040,153,80,61,9,3
2021,Chesterfield 011A,E01019586,1275,1263,12,6,1,2,3
2021,Chesterfield 011B,E01019587,1358,1336,22,10,7,5,0
2021,Chesterfield 011C,E01019588,1307,1292,15,8,5,1,1
2021,Chesterfield 011D,E01019589,1271,1254,17,10,4,1,2
2021,Chesterfield 009D,E01019590,1756,1743,13,7,2,3,1
2021,Chesterfield 009E,E01019591,1473,1455,18,12,2,4,0
2021,Chesterfield 011E,E01019592,1639,1617,22,13,9,0,0
2021,Chesterfield 011F,E01019593,1088,1081,7,3,2,2,0
2021,Derbyshire Dales 009A,E01019594,1745,1704,41,17,18,5,1
2021,Derbyshire Dales 008A,E01019595,1895,1846,49,12,28,5,4
2021,Derbyshire Dales 009B,E01019596,1795,1768,27,16,7,3,1
2021,Derbyshire Dales 009C,E01019597,2045,2023,22,10,7,5,0
2021,Derbyshire Dales 009D,E01019598,1704,1647,57,15,30,9,3
2021,Derbyshire Dales 011B,E01019599,1338,1331,7,5,2,0,0
2021,Derbyshire Dales 002A,E01019600,1359,1343,16,8,8,0,0
2021,Derbyshire Dales 011A,E01019601,1490,1477,13,6,5,2,0
2021,Derbyshire Dales 001A,E01019602,1751,1742,9,2,3,3,1
2021,Derbyshire Dales 010A,E01019603,1948,1935,13,12,1,0,0
2021,Derbyshire Dales 002B,E01019604,1743,1735,8,7,0,1,0
2021,Derbyshire Dales 008B,E01019605,1743,1732,11,5,6,0,0
2021,Derbyshire Dales 002C,E01019606,1582,1576,6,2,4,0,0
2021,Derbyshire Dales 010B,E01019607,1802,1796,6,6,0,0,0
2021,Derbyshire Dales 011G,E01019608,1652,1636,16,5,6,5,0
2021,Derbyshire Dales 005A,E01019609,2553,2543,10,7,1,2,0
2021,Derbyshire Dales 011D,E01019610,1455,1434,21,11,6,4,0
2021,Derbyshire Dales 008C,E01019611,1542,1529,13,12,0,1,0
2021,Derbyshire Dales 010C,E01019612,2647,2605,42,16,21,5,0
2021,Derbyshire Dales 011C,E01019613,1620,1611,9,5,1,1,2
2021,Derbyshire Dales 001B,E01019614,1586,1568,18,17,1,0,0
2021,Derbyshire Dales 001C,E01019615,2055,2042,13,8,1,4,0
2021,Derbyshire Dales 008D,E01019616,1816,1813,3,1,0,2,0
2021,Derbyshire Dales 011F,E01019617,1488,1483,5,4,1,0,0
2021,Derbyshire Dales 002D,E01019618,1538,1531,7,4,3,0,0
2021,Derbyshire Dales 006A,E01019619,1360,1354,6,4,1,1,0
2021,Derbyshire Dales 006B,E01019620,1420,1410,10,6,2,2,0
2021,Derbyshire Dales 005B,E01019621,1360,1349,11,4,3,2,2
2021,Derbyshire Dales 005C,E01019622,1391,1387,4,3,1,0,0
2021,Derbyshire Dales 006C,E01019623,1347,1324,23,13,5,5,0
2021,Derbyshire Dales 005D,E01019624,1205,1190,15,6,4,5,0
2021,Derbyshire Dales 006D,E01019625,1558,1522,36,19,11,6,0
2021,Derbyshire Dales 006E,E01019626,1358,1351,7,6,1,0,0
2021,Derbyshire Dales 005E,E01019627,1149,1146,3,3,0,0,0
2021,Derbyshire Dales 005F,E01019628,1525,1506,19,10,7,2,0
2021,Derbyshire Dales 010D,E01019629,1702,1693,9,6,3,0,0
2021,Derbyshire Dales 011E,E01019630,1768,1758,10,6,4,0,0
2021,Derbyshire Dales 001D,E01019631,1728,1719,9,7,2,0,0
2021,Derbyshire Dales 006F,E01019632,1578,1564,14,10,2,0,2
2021,Derbyshire Dales 007A,E01019633,1510,1501,9,6,3,0,0
2021,Derbyshire Dales 007B,E01019634,1525,1515,10,6,2,2,0
2021,Derbyshire Dales 007C,E01019635,1114,1105,9,8,0,1,0
2021,Derbyshire Dales 007D,E01019636,1539,1527,12,9,3,0,0
2021,Erewash 016A,E01019638,1246,1226,20,7,7,1,5
2021,Erewash 016B,E01019639,1493,1465,28,8,13,5,2
2021,Erewash 016C,E01019640,1346,1332,14,7,5,2,0
2021,Erewash 011A,E01019641,1413,1391,22,16,5,0,1
2021,Erewash 013A,E01019642,1314,1309,5,5,0,0,0
2021,Erewash 013B,E01019643,1551,1542,9,8,1,0,0
2021,Erewash 001A,E01019644,1370,1346,24,11,10,1,2
2021,Erewash 016D,E01019645,1632,1594,38,18,14,5,1
2021,Erewash 001B,E01019646,1379,1346,33,14,11,6,2
2021,Erewash 012A,E01019647,1917,1801,116,51,48,16,1
2021,Erewash 010A,E01019648,1454,1408,46,26,12,7,1
2021,Erewash 010B,E01019649,1666,1608,58,25,24,8,1
2021,Erewash 010C,E01019650,1599,1537,62,27,28,5,2
2021,Erewash 010D,E01019651,1396,1355,41,24,14,3,0
2021,Erewash 011B,E01019652,1526,1469,57,18,26,12,1
2021,Erewash 011C,E01019653,1394,1323,71,28,35,7,1
2021,Erewash 013C,E01019654,1466,1444,22,11,9,2,0
2021,Erewash 013D,E01019655,1492,1471,21,13,5,3,0
2021,Erewash 008A,E01019656,1175,1166,9,5,2,2,0
2021,Erewash 003A,E01019657,1862,1816,46,16,21,7,2
2021,Erewash 006A,E01019658,1874,1835,39,18,16,5,0
2021,Erewash 006B,E01019659,2258,2204,54,26,21,6,1
2021,Erewash 003B,E01019660,1811,1768,43,25,11,7,0
2021,Erewash 003C,E01019661,1321,1269,52,18,21,12,1
2021,Erewash 003D,E01019662,1462,1392,70,29,22,17,2
2021,Erewash 001C,E01019663,1484,1457,27,15,10,2,0
2021,Erewash 001D,E01019664,1255,1218,37,15,16,6,0
2021,Erewash 001E,E01019665,1298,1261,37,14,13,10,0
2021,Erewash 007A,E01019666,1422,1405,17,5,9,3,0
2021,Erewash 007B,E01019667,1588,1548,40,21,16,3,0
2021,Erewash 007C,E01019668,1350,1329,21,11,9,1,0
2021,Erewash 007D,E01019669,1433,1428,5,2,2,1,0
2021,Erewash 004A,E01019670,1741,1723,18,12,4,2,0
2021,Erewash 004B,E01019671,1794,1782,12,4,4,4,0
2021,Erewash 003E,E01019672,1722,1658,64,28,27,9,0
2021,Erewash 005A,E01019673,1292,1281,11,9,2,0,0
2021,Erewash 006C,E01019674,1100,1097,3,0,0,1,2
2021,Erewash 012B,E01019675,1475,1394,81,37,33,11,0
2021,Erewash 014A,E01019676,1401,1342,59,26,23,8,2
2021,Erewash 014B,E01019677,1352,1304,48,23,23,2,0
2021,Erewash 014C,E01019678,1636,1581,55,28,22,4,1
2021,Erewash 012C,E01019679,1588,1520,68,33,25,10,0
2021,Erewash 014D,E01019680,1893,1857,36,22,12,2,0
2021,Erewash 014E,E01019681,1419,1397,22,13,8,1,0
2021,Erewash 012D,E01019682,1631,1514,117,49,46,20,2
2021,Erewash 009A,E01019683,1272,1248,24,10,10,2,2
2021,Erewash 009B,E01019684,1598,1579,19,12,6,1,0
2021,Erewash 009C,E01019685,1439,1422,17,10,4,2,1
2021,Erewash 009D,E01019686,1295,1273,22,8,7,5,2
2021,Erewash 009E,E01019687,1403,1386,17,3,9,2,3
2021,Erewash 006D,E01019688,1312,1260,52,14,19,19,0
2021,Erewash 006E,E01019689,1434,1394,40,9,20,7,4
2021,Erewash 003F,E01019690,1214,1154,60,19,29,11,1
2021,Erewash 008B,E01019691,1593,1565,28,18,7,3,0
2021,Erewash 008C,E01019692,1532,1512,20,9,9,2,0
2021,Erewash 008D,E01019693,1838,1788,50,24,17,6,3
2021,Erewash 008E,E01019694,1128,1093,35,26,9,0,0
2021,Erewash 010E,E01019695,1378,1358,20,14,6,0,0
2021,Erewash 008F,E01019696,1389,1374,15,4,8,2,1
2021,Erewash 015A,E01019697,1372,1357,15,5,8,2,0
2021,Erewash 014F,E01019698,1353,1324,29,14,10,5,0
2021,Erewash 015B,E01019699,1450,1405,45,24,13,7,1
2021,Erewash 015C,E01019700,2120,2078,42,17,17,7,1
2021,Erewash 004C,E01019701,2172,2138,34,21,9,3,1
2021,Erewash 005B,E01019702,1715,1704,11,4,5,0,2
2021,Erewash 005C,E01019703,1591,1580,11,8,2,1,0
2021,Erewash 005D,E01019704,1374,1368,6,3,3,0,0
2021,Erewash 015D,E01019705,1729,1687,42,19,18,5,0
2021,Erewash 015E,E01019706,1194,1162,32,15,13,3,1
2021,Erewash 011D,E01019707,1336,1297,39,16,19,4,0
2021,Erewash 011E,E01019708,1771,1732,39,22,15,1,1
2021,Erewash 015F,E01019709,1262,1213,49,32,14,2,1
2021,High Peak 010A,E01019710,1672,1645,27,13,8,6,0
2021,High Peak 006A,E01019711,1292,1280,12,8,3,1,0
2021,High Peak 008A,E01019712,1425,1419,6,3,3,0,0
2021,High Peak 008B,E01019713,1734,1725,9,8,1,0,0
2021,High Peak 012A,E01019714,2515,2490,25,16,6,3,0
2021,High Peak 010B,E01019715,1270,1211,59,39,8,11,1
2021,High Peak 011A,E01019716,1196,1168,28,11,8,9,0
2021,High Peak 010C,E01019717,1067,1006,61,24,24,13,0
2021,High Peak 013E,E01019718,2111,2091,20,7,5,8,0
2021,High Peak 013F,E01019719,1984,1954,30,13,7,10,0
2021,High Peak 013G,E01019720,1381,1373,8,4,4,0,0
2021,High Peak 013H,E01019721,1444,1421,23,8,10,5,0
2021,High Peak 010D,E01019722,1751,1721,30,18,8,4,0
2021,High Peak 010E,E01019723,1702,1682,20,10,7,3,0
2021,High Peak 011B,E01019724,1141,1114,27,16,8,3,0
2021,High Peak 012B,E01019725,1447,1444,3,3,0,0,0
2021,High Peak 012C,E01019726,1386,1373,13,8,4,1,0
2021,High Peak 004A,E01019727,2096,2069,27,18,5,4,0
2021,High Peak 002A,E01019728,1132,1124,8,2,3,2,1
2021,High Peak 002B,E01019729,1202,1199,3,2,0,1,0
2021,High Peak 002C,E01019730,1835,1819,16,11,2,3,0
2021,High Peak 002D,E01019731,1212,1197,15,4,10,1,0
2021,High Peak 002E,E01019732,1433,1428,5,2,2,1,0
2021,High Peak 001A,E01019733,1428,1422,6,3,3,0,0
2021,High Peak 006B,E01019734,1956,1943,13,12,1,0,0
2021,High Peak 013A,E01019735,1370,1349,21,19,2,0,0
2021,High Peak 013B,E01019736,1025,1021,4,4,0,0,0
2021,High Peak 013C,E01019737,1103,1093,10,5,3,2,0
2021,High Peak 003A,E01019738,1410,1398,12,9,2,1,0
2021,High Peak 003B,E01019739,1781,1752,29,19,8,2,0
2021,High Peak 003C,E01019740,1124,1093,31,13,12,5,1
2021,High Peak 013I,E01019741,1113,1107,6,3,2,1,0
2021,High Peak 013D,E01019742,1005,1002,3,3,0,0,0
2021,High Peak 006C,E01019743,1453,1426,27,13,11,3,0
2021,High Peak 006D,E01019744,1381,1370,11,6,3,2,0
2021,High Peak 006E,E01019745,1080,1057,23,12,4,7,0
2021,High Peak 005A,E01019746,1512,1489,23,10,6,7,0
2021,High Peak 005B,E01019747,1128,1109,19,10,4,5,0
2021,High Peak 005C,E01019748,1424,1394,30,20,7,3,0
2021,High Peak 004B,E01019749,1133,1123,10,7,1,2,0
2021,High Peak 003D,E01019750,1255,1237,18,12,6,0,0
2021,High Peak 003E,E01019751,2240,2221,19,16,2,0,1
2021,High Peak 001B,E01019752,1295,1283,12,5,3,4,0
2021,High Peak 001C,E01019753,1289,1273,16,7,7,2,0
2021,High Peak 004C,E01019754,1826,1816,10,5,2,2,1
2021,High Peak 005D,E01019755,1829,1806,23,13,5,4,1
2021,High Peak 004D,E01019756,1696,1670,26,21,2,3,0
2021,High Peak 004E,E01019757,1299,1290,9,3,3,3,0
2021,High Peak 004F,E01019758,1489,1470,19,13,6,0,0
2021,High Peak 011C,E01019759,1421,1392,29,12,15,1,1
2021,High Peak 011D,E01019760,1307,1279,28,14,12,2,0
2021,High Peak 011E,E01019761,1563,1498,65,27,22,14,2
2021,High Peak 012D,E01019762,1698,1675,23,12,10,1,0
2021,High Peak 001D,E01019763,2163,2138,25,14,5,3,3
2021,High Peak 008C,E01019764,1555,1554,1,0,1,0,0
2021,High Peak 008D,E01019765,1711,1690,21,10,7,3,1
2021,High Peak 005E,E01019766,1382,1375,7,6,1,0,0
2021,High Peak 008E,E01019767,1525,1510,15,10,4,1,0
2021,High Peak 003F,E01019768,2054,2030,24,12,8,2,2
2021,North East Derbyshire 010A,E01019769,1912,1902,10,2,8,0,0
2021,North East Derbyshire 005A,E01019770,1931,1918,13,9,3,1,0
2021,North East Derbyshire 008A,E01019771,2039,2026,13,12,1,0,0
2021,North East Derbyshire 008B,E01019772,1474,1460,14,9,5,0,0
2021,North East Derbyshire 010B,E01019774,1744,1732,12,6,5,1,0
2021,North East Derbyshire 012B,E01019775,2229,2213,16,8,6,1,1
2021,North East Derbyshire 012C,E01019776,1316,1285,31,18,7,5,1
2021,North East Derbyshire 012D,E01019777,2284,2238,46,27,14,5,0
2021,North East Derbyshire 002A,E01019778,1628,1620,8,5,3,0,0
2021,North East Derbyshire 002B,E01019779,1535,1524,11,2,3,4,2
2021,North East Derbyshire 004A,E01019780,1365,1341,24,12,10,2,0
2021,North East Derbyshire 004B,E01019781,1400,1385,15,13,2,0,0
2021,North East Derbyshire 004C,E01019782,1332,1316,16,9,4,3,0
2021,North East Derbyshire 006A,E01019783,1219,1203,16,8,6,1,1
2021,North East Derbyshire 006B,E01019784,1183,1177,6,5,1,0,0
2021,North East Derbyshire 006C,E01019785,1211,1202,9,7,2,0,0
2021,North East Derbyshire 004D,E01019786,1517,1492,25,11,11,3,0
2021,North East Derbyshire 005B,E01019787,1727,1706,21,11,6,4,0
2021,North East Derbyshire 005C,E01019788,1634,1609,25,14,4,3,4
2021,North East Derbyshire 002C,E01019790,1757,1736,21,14,4,2,1
2021,North East Derbyshire 014A,E01019791,1906,1876,30,18,7,3,2
2021,North East Derbyshire 014B,E01019792,1990,1950,40,18,16,6,0
2021,North East Derbyshire 006D,E01019793,1372,1368,4,3,1,0,0
2021,North East Derbyshire 005D,E01019794,1314,1293,21,14,7,0,0
2021,North East Derbyshire 006E,E01019795,2200,2177,23,11,9,2,1
2021,North East Derbyshire 009A,E01019796,1138,1123,15,8,4,0,3
2021,North East Derbyshire 009B,E01019797,1739,1724,15,8,5,1,1
2021,North East Derbyshire 007A,E01019798,1534,1514,20,4,6,6,4
2021,North East Derbyshire 009C,E01019799,2296,2266,30,17,10,3,0
2021,North East Derbyshire 009D,E01019800,1732,1707,25,9,9,7,0
2021,North East Derbyshire 001A,E01019801,1095,1077,18,5,13,0,0
2021,North East Derbyshire 001B,E01019802,1300,1287,13,2,5,5,1
2021,North East Derbyshire 001C,E01019803,1234,1218,16,7,6,3,0
2021,North East Derbyshire 001D,E01019804,1226,1220,6,2,1,2,1
2021,North East Derbyshire 001E,E01019805,1290,1286,4,1,2,1,0
2021,North East Derbyshire 001F,E01019806,1406,1397,9,9,0,0,0
2021,North East Derbyshire 001G,E01019807,1410,1371,39,15,17,4,3
2021,North East Derbyshire 009E,E01019808,1587,1569,18,8,10,0,0
2021,North East Derbyshire 011A,E01019809,1045,1037,8,5,2,0,1
2021,North East Derbyshire 011B,E01019810,1422,1403,19,11,4,2,2
2021,North East Derbyshire 011C,E01019811,1417,1409,8,7,1,0,0
2021,North East Derbyshire 011D,E01019812,1772,1761,11,7,1,3,0
2021,North East Derbyshire 011E,E01019813,1611,1602,9,3,6,0,0
2021,North East Derbyshire 013A,E01019814,1861,1848,13,5,7,1,0
2021,North East Derbyshire 014C,E01019815,2560,2538,22,8,13,1,0
2021,North East Derbyshire 002D,E01019816,1719,1712,7,6,0,1,0
2021,North East Derbyshire 013B,E01019817,1285,1266,19,7,8,4,0
2021,North East Derbyshire 013C,E01019818,1593,1576,17,9,5,2,1
2021,North East Derbyshire 013D,E01019819,1660,1647,13,9,2,2,0
2021,North East Derbyshire 013E,E01019820,1428,1421,7,6,1,0,0
2021,North East Derbyshire 007B,E01019821,1232,1220,12,8,2,1,1
2021,North East Derbyshire 007C,E01019822,1597,1589,8,2,2,0,4
2021,North East Derbyshire 007D,E01019823,1055,1026,29,17,8,4,0
2021,North East Derbyshire 010C,E01019824,1799,1769,30,12,12,5,1
2021,North East Derbyshire 011F,E01019825,1339,1330,9,8,1,0,0
2021,North East Derbyshire 009F,E01019826,1362,1347,15,3,10,2,0
2021,North East Derbyshire 004E,E01019827,1784,1762,22,13,5,4,0
2021,North East Derbyshire 008C,E01019828,1365,1354,11,8,0,2,1
2021,North East Derbyshire 008D,E01019829,1288,1277,11,5,4,1,1
2021,North East Derbyshire 010D,E01019830,1496,1483,13,8,3,1,1
2021,North East Derbyshire 010E,E01019831,1309,1300,9,6,2,1,0
2021,South Derbyshire 004A,E01019832,1616,1607,9,5,4,0,0
2021,South Derbyshire 004B,E01019833,2069,2056,13,8,3,1,1
2021,South Derbyshire 004C,E01019834,2390,2317,73,34,20,19,0
2021,South Derbyshire 012A,E01019837,1950,1916,34,16,16,2,0
2021,South Derbyshire 012B,E01019838,1455,1421,34,13,9,10,2
2021,South Derbyshire 001A,E01019839,2768,2651,117,79,26,10,2
2021,South Derbyshire 002A,E01019840,1719,1700,19,15,4,0,0
2021,South Derbyshire 002B,E01019841,1798,1767,31,22,7,2,0
2021,South Derbyshire 013A,E01019842,1601,1576,25,14,9,0,2
2021,South Derbyshire 006A,E01019843,1491,1475,16,9,3,1,3
2021,South Derbyshire 007A,E01019844,1480,1428,52,29,16,4,3
2021,South Derbyshire 001B,E01019845,1214,1202,12,6,4,2,0
2021,South Derbyshire 001C,E01019846,1264,1251,13,7,6,0,0
2021,South Derbyshire 002C,E01019847,1333,1317,16,8,7,1,0
2021,South Derbyshire 002D,E01019848,2614,2533,81,42,23,14,2
2021,South Derbyshire 011A,E01019850,2269,2244,25,19,3,2,1
2021,South Derbyshire 011B,E01019851,1620,1596,24,11,13,0,0
2021,South Derbyshire 011C,E01019852,1992,1947,45,16,20,7,2
2021,South Derbyshire 006B,E01019853,1678,1666,12,6,5,0,1
2021,South Derbyshire 006C,E01019854,1958,1932,26,21,5,0,0
2021,South Derbyshire 006D,E01019855,1505,1485,20,12,6,2,0
2021,South Derbyshire 007B,E01019856,1414,1358,56,21,30,5,0
2021,South Derbyshire 007C,E01019857,1363,1334,29,12,14,3,0
2021,South Derbyshire 007D,E01019858,1462,1423,39,20,15,1,3
2021,South Derbyshire 007E,E01019859,1625,1602,23,15,8,0,0
2021,South Derbyshire 008A,E01019860,1144,1129,15,6,5,1,3
2021,South Derbyshire 008B,E01019861,1687,1651,36,22,12,1,1
2021,South Derbyshire 008C,E01019862,1593,1551,42,23,11,7,1
2021,South Derbyshire 008D,E01019863,1497,1468,29,16,5,8,0
2021,South Derbyshire 008E,E01019864,1320,1269,51,18,30,2,1
2021,South Derbyshire 008F,E01019865,1227,1188,39,19,17,2,1
2021,South Derbyshire 001D,E01019866,2216,2190,26,16,6,4,0
2021,South Derbyshire 005A,E01019867,1692,1668,24,17,3,3,1
2021,South Derbyshire 005B,E01019868,1963,1939,24,20,3,1,0
2021,South Derbyshire 005C,E01019869,1496,1466,30,18,8,4,0
2021,South Derbyshire 011D,E01019870,1594,1580,14,6,6,1,1
2021,South Derbyshire 011E,E01019871,1654,1640,14,5,3,4,2
2021,South Derbyshire 011F,E01019872,2004,1975,29,12,10,6,1
2021,South Derbyshire 003A,E01019873,2453,2137,316,161,101,43,11
2021,South Derbyshire 003B,E01019874,1315,1120,195,79,70,36,10
2021,South Derbyshire 003C,E01019875,1300,1029,271,138,82,39,12
2021,South Derbyshire 009A,E01019876,1784,1738,46,25,18,3,0
2021,South Derbyshire 009B,E01019877,1999,1924,75,34,25,14,2
2021,South Derbyshire 009C,E01019878,1424,1401,23,19,3,1,0
2021,South Derbyshire 009D,E01019879,2001,1959,42,21,19,2,0
2021,South Derbyshire 005D,E01019880,1623,1609,14,6,3,5,0
2021,South Derbyshire 003E,E01019882,1860,1830,30,14,7,3,6
2021,South Derbyshire 013C,E01019885,1540,1512,28,16,11,1,0
2021,East Devon 005B,E01019887,1647,1617,30,20,7,2,1
2021,East Devon 005C,E01019888,1672,1615,57,24,27,3,3
2021,East Devon 005D,E01019889,1741,1722,19,13,4,0,2
2021,East Devon 009A,E01019890,1759,1731,28,12,14,1,1
2021,East Devon 021B,E01019891,1656,1640,16,11,5,0,0
2021,East Devon 017A,E01019894,1369,1355,14,9,5,0,0
2021,East Devon 017B,E01019895,1525,1511,14,9,2,3,0
2021,East Devon 017C,E01019896,1568,1559,9,2,3,4,0
2021,East Devon 017D,E01019897,1558,1535,23,11,5,4,3
2021,East Devon 014A,E01019898,2704,2663,41,22,10,6,3
2021,East Devon 007A,E01019899,1411,1394,17,7,4,6,0
2021,East Devon 007B,E01019900,1807,1791,16,12,3,1,0
2021,East Devon 009B,E01019901,1400,1387,13,13,0,0,0
2021,East Devon 001A,E01019902,2227,2205,22,19,2,0,1
2021,East Devon 021A,E01019903,2099,2075,24,14,7,2,1
2021,East Devon 015A,E01019904,1411,1377,34,10,13,8,3
2021,East Devon 015B,E01019905,1852,1837,15,8,4,3,0
2021,East Devon 015C,E01019906,1471,1444,27,11,10,6,0
2021,East Devon 015D,E01019907,1461,1454,7,6,1,0,0
2021,East Devon 016A,E01019908,1657,1636,21,11,9,1,0
2021,East Devon 016B,E01019909,1797,1780,17,10,4,3,0
2021,East Devon 016C,E01019910,1678,1669,9,5,3,1,0
2021,East Devon 016D,E01019911,1592,1566,26,13,11,2,0
2021,East Devon 020A,E01019912,1614,1577,37,22,10,5,0
2021,East Devon 020B,E01019913,1794,1748,46,16,9,12,9
2021,East Devon 020C,E01019914,2397,2351,46,29,14,2,1
2021,East Devon 020D,E01019915,1840,1816,24,10,9,5,0
2021,East Devon 019A,E01019916,1925,1788,137,53,66,17,1
2021,East Devon 019B,E01019917,1527,1493,34,17,14,3,0
2021,East Devon 019C,E01019918,1691,1616,75,37,25,11,2
2021,East Devon 019D,E01019919,1664,1568,96,45,41,6,4
2021,East Devon 018A,E01019920,1574,1558,16,5,10,0,1
2021,East Devon 018B,E01019921,1559,1547,12,3,5,2,2
2021,East Devon 018C,E01019922,1551,1534,17,7,9,0,1
2021,East Devon 018D,E01019923,1256,1248,8,6,2,0,0
2021,East Devon 018E,E01019924,1415,1374,41,24,10,7,0
2021,East Devon 004A,E01019925,1273,1267,6,2,1,3,0
2021,East Devon 002A,E01019927,1277,1234,43,14,12,16,1
2021,East Devon 003A,E01019928,1418,1405,13,11,2,0,0
2021,East Devon 003B,E01019929,1333,1308,25,10,12,1,2
2021,East Devon 003C,E01019930,1416,1393,23,7,15,1,0
2021,East Devon 003D,E01019931,1174,1169,5,4,0,0,1
2021,East Devon 002B,E01019932,1606,1570,36,23,6,5,2
2021,East Devon 002C,E01019933,1290,1256,34,16,16,2,0
2021,East Devon 002D,E01019934,1834,1805,29,10,9,9,1
2021,East Devon 007C,E01019935,1329,1319,10,9,1,0,0
2021,East Devon 007D,E01019936,1164,1161,3,2,1,0,0
2021,East Devon 013A,E01019937,2251,2236,15,10,3,1,1
2021,East Devon 001B,E01019938,2397,2338,59,36,10,13,0
2021,East Devon 008A,E01019939,1686,1665,21,17,4,0,0
2021,East Devon 008B,E01019940,1708,1697,11,9,1,1,0
2021,East Devon 008C,E01019942,2355,2308,47,27,14,6,0
2021,East Devon 008D,E01019943,1756,1738,18,11,4,3,0
2021,East Devon 008E,E01019944,1755,1716,39,23,13,3,0
2021,East Devon 013B,E01019945,2167,2147,20,13,4,3,0
2021,East Devon 010A,E01019946,1395,1373,22,15,7,0,0
2021,East Devon 010B,E01019947,2100,1987,113,42,49,15,7
2021,East Devon 010C,E01019948,1257,1242,15,8,6,1,0
2021,East Devon 010D,E01019949,1574,1547,27,15,7,3,2
2021,East Devon 010E,E01019950,1250,1240,10,7,1,2,0
2021,East Devon 009C,E01019951,2075,2048,27,18,6,3,0
2021,East Devon 011A,E01019952,1739,1714,25,11,9,2,3
2021,East Devon 011B,E01019953,1555,1547,8,6,2,0,0
2021,East Devon 011C,E01019954,1947,1917,30,16,14,0,0
2021,East Devon 011D,E01019955,1610,1556,54,24,22,6,2
2021,East Devon 012A,E01019956,1719,1603,116,53,41,18,4
2021,East Devon 012B,E01019957,1711,1675,36,23,11,2,0
2021,East Devon 012C,E01019958,1766,1744,22,21,0,1,0
2021,East Devon 004D,E01019959,1209,1201,8,5,1,2,0
2021,East Devon 004E,E01019960,1427,1424,3,2,0,1,0
2021,East Devon 007E,E01019961,2521,2502,19,9,6,2,2
2021,East Devon 004F,E01019962,2261,2249,12,9,2,1,0
2021,East Devon 013C,E01019963,1699,1690,9,6,2,1,0
2021,East Devon 014B,E01019964,1757,1713,44,26,14,4,0
2021,East Devon 014C,E01019965,1768,1739,29,14,11,4,0
2021,East Devon 005E,E01019966,1102,1099,3,3,0,0,0
2021,East Devon 001C,E01019967,1311,1299,12,9,2,1,0
2021,Exeter 014A,E01019968,1442,1385,57,29,21,6,1
2021,Exeter 014B,E01019969,1255,1207,48,24,19,5,0
2021,Exeter 014C,E01019970,1196,1166,30,20,5,4,1
2021,Exeter 014D,E01019971,1497,1360,137,78,42,16,1
2021,Exeter 014E,E01019972,1369,1246,123,58,50,12,3
2021,Exeter 012A,E01019973,1447,1402,45,22,18,4,1
2021,Exeter 012B,E01019974,1339,1287,52,20,22,10,0
2021,Exeter 010A,E01019975,1286,1215,71,32,25,14,0
2021,Exeter 012C,E01019976,1437,1412,25,11,9,3,2
2021,Exeter 012D,E01019977,1428,1390,38,19,15,4,0
2021,Exeter 005A,E01019980,1626,1478,148,88,45,15,0
2021,Exeter 012E,E01019981,1364,1284,80,38,26,13,3
2021,Exeter 005B,E01019982,1599,1466,133,80,37,13,3
2021,Exeter 005C,E01019983,1423,1364,59,27,22,9,1
2021,Exeter 005D,E01019984,1282,1232,50,25,19,3,3
2021,Exeter 005E,E01019985,1290,1221,69,36,25,5,3
2021,Exeter 007A,E01019986,1402,1355,47,33,10,3,1
2021,Exeter 006A,E01019987,1721,1540,181,94,63,18,6
2021,Exeter 013A,E01019988,1361,1250,111,70,29,8,4
2021,Exeter 006B,E01019989,1120,1065,55,40,13,1,1
2021,Exeter 002A,E01019990,1408,1253,155,59,63,25,8
2021,Exeter 002B,E01019991,1504,1330,174,64,65,39,6
2021,Exeter 003A,E01019992,1553,1457,96,57,27,10,2
2021,Exeter 002C,E01019993,1130,1061,69,51,14,4,0
2021,Exeter 008A,E01019994,1507,1314,193,124,56,12,1
2021,Exeter 008B,E01019995,2319,1843,476,228,206,38,4
2021,Exeter 009A,E01019996,1156,1008,148,88,43,11,6
2021,Exeter 004A,E01019997,1557,1411,146,88,28,29,1
2021,Exeter 001C,E01019998,1339,1183,156,85,58,13,0
2021,Exeter 001D,E01019999,1346,1281,65,39,20,6,0
2021,Exeter 002D,E01020000,1280,1144,136,69,38,25,4
2021,Exeter 001E,E01020001,1281,1187,94,57,24,12,1
2021,Exeter 003B,E01020002,2202,2084,118,58,38,19,3
2021,Exeter 003C,E01020003,1691,1645,46,25,15,5,1
2021,Exeter 003D,E01020004,2298,2197,101,70,27,3,1
2021,Exeter 003E,E01020005,1961,1883,78,42,28,8,0
2021,Exeter 006C,E01020006,2073,1899,174,83,69,18,4
2021,Exeter 002E,E01020007,1555,1429,126,72,37,15,2
2021,Exeter 006D,E01020008,1784,1619,165,94,55,16,0
2021,Exeter 006E,E01020009,1352,1276,76,50,13,13,0
2021,Exeter 013B,E01020010,1952,1799,153,77,58,13,5
2021,Exeter 015A,E01020011,1307,1272,35,14,14,5,2
2021,Exeter 015B,E01020012,1521,1423,98,55,30,13,0
2021,Exeter 013C,E01020013,1315,1079,236,107,99,25,5
2021,Exeter 013D,E01020014,1452,1346,106,59,34,12,1
2021,Exeter 013E,E01020015,2021,1882,139,69,51,13,6
2021,Exeter 008D,E01020017,2753,2306,447,224,170,49,4
2021,Exeter 008E,E01020018,2113,1827,286,142,90,35,19
2021,Exeter 004B,E01020019,2045,1959,86,57,17,12,0
2021,Exeter 004C,E01020020,2156,1960,196,122,56,18,0
2021,Exeter 004D,E01020021,1918,1726,192,116,67,9,0
2021,Exeter 004E,E01020022,1938,1607,331,149,129,44,9
2021,Exeter 009B,E01020023,2191,2046,145,96,37,9,3
2021,Exeter 009C,E01020024,1480,1410,70,40,23,5,2
2021,Exeter 009D,E01020025,1367,1238,129,94,28,7,0
2021,Exeter 011A,E01020026,1656,1605,51,26,20,4,1
2021,Exeter 011B,E01020027,1573,1467,106,53,36,16,1
2021,Exeter 010B,E01020029,1547,1429,118,64,39,15,0
2021,Exeter 010C,E01020030,1904,1718,186,94,73,18,1
2021,Exeter 010D,E01020031,1581,1468,113,57,32,23,1
2021,Exeter 010E,E01020032,1510,1360,150,52,67,24,7
2021,Exeter 007B,E01020036,1401,1324,77,40,25,9,3
2021,Exeter 007C,E01020037,1347,1216,131,54,65,11,1
2021,Exeter 011E,E01020038,2483,2295,188,107,63,16,2
2021,Exeter 007D,E01020039,1789,1685,104,60,32,11,1
2021,Exeter 007E,E01020040,1276,1219,57,32,23,2,0
2021,Mid Devon 011A,E01020041,2477,2353,124,56,47,19,2
2021,Mid Devon 011B,E01020042,1629,1581,48,21,8,15,4
2021,Mid Devon 008A,E01020043,1953,1931,22,13,7,1,1
2021,Mid Devon 008B,E01020044,1609,1593,16,13,3,0,0
2021,Mid Devon 006A,E01020045,1716,1710,6,3,3,0,0
2021,Mid Devon 001A,E01020046,1511,1494,17,6,7,3,1
2021,Mid Devon 002A,E01020047,2099,2056,43,13,18,12,0
2021,Mid Devon 005A,E01020048,2131,1937,194,53,94,40,7
2021,Mid Devon 001B,E01020049,1321,1319,2,2,0,0,0
2021,Mid Devon 001C,E01020050,2120,2106,14,11,3,0,0
2021,Mid Devon 002B,E01020051,1666,1649,17,8,7,2,0
2021,Mid Devon 004A,E01020052,1791,1712,79,20,35,22,2
2021,Mid Devon 004B,E01020053,1405,1361,44,11,18,13,2
2021,Mid Devon 007A,E01020054,2491,2408,83,39,27,15,2
2021,Mid Devon 007B,E01020055,1814,1684,130,36,49,39,6
2021,Mid Devon 008C,E01020056,2835,2791,44,24,12,8,0
2021,Mid Devon 007C,E01020057,2243,2085,158,54,56,43,5
2021,Mid Devon 007D,E01020058,1936,1856,80,25,25,28,2
2021,Mid Devon 006B,E01020059,2276,2252,24,10,9,5,0
2021,Mid Devon 011C,E01020060,1685,1606,79,34,31,11,3
2021,Mid Devon 011D,E01020061,2013,1974,39,23,10,5,1
2021,Mid Devon 006C,E01020062,1596,1558,38,15,17,6,0
2021,Mid Devon 003A,E01020063,2394,2341,53,24,18,9,2
2021,Mid Devon 006D,E01020064,1783,1704,79,23,31,14,11
2021,Mid Devon 004C,E01020065,1948,1818,130,57,47,24,2
2021,Mid Devon 004D,E01020067,1829,1756,73,31,35,4,3
2021,Mid Devon 010A,E01020068,1541,1518,23,15,5,3,0
2021,Mid Devon 010B,E01020069,1445,1427,18,11,5,2,0
2021,Mid Devon 010C,E01020070,1826,1815,11,4,4,3,0
2021,Mid Devon 008D,E01020071,1866,1847,19,14,4,1,0
2021,Mid Devon 009A,E01020072,1640,1628,12,5,6,1,0
2021,Mid Devon 009B,E01020073,1723,1707,16,5,8,1,2
2021,Mid Devon 003B,E01020074,2271,2261,10,5,5,0,0
2021,Mid Devon 003C,E01020075,1944,1934,10,8,1,1,0
2021,Mid Devon 009C,E01020076,1752,1744,8,4,4,0,0
2021,Mid Devon 001D,E01020077,1692,1685,7,4,2,1,0
2021,Mid Devon 005B,E01020078,1289,1223,66,32,23,10,1
2021,Mid Devon 005C,E01020079,1278,1238,40,15,15,10,0
2021,Mid Devon 002D,E01020080,1911,1862,49,24,21,3,1
2021,Mid Devon 005D,E01020081,1338,1309,29,13,10,4,2
2021,Mid Devon 009D,E01020082,1233,1223,10,7,2,1,0
2021,Mid Devon 010D,E01020083,2485,2439,46,29,13,3,1
2021,North Devon 012A,E01020084,1341,1332,9,4,4,0,1
2021,North Devon 012B,E01020085,1437,1415,22,10,10,2,0
2021,North Devon 014A,E01020087,2091,2085,6,4,0,0,2
2021,North Devon 006A,E01020088,2003,1988,15,9,2,3,1
2021,North Devon 005A,E01020089,2154,2119,35,16,10,1,8
2021,North Devon 004A,E01020090,1857,1846,11,6,1,4,0
2021,North Devon 005B,E01020091,1234,1225,9,7,2,0,0
2021,North Devon 005C,E01020092,1390,1381,9,7,2,0,0
2021,North Devon 005D,E01020093,1417,1398,19,13,3,3,0
2021,North Devon 008A,E01020094,1660,1537,123,63,38,20,2
2021,North Devon 008B,E01020095,1431,1357,74,27,32,15,0
2021,North Devon 009A,E01020096,1637,1540,97,34,42,18,3
2021,North Devon 013A,E01020097,2295,2283,12,9,2,1,0
2021,North Devon 014B,E01020098,2288,2265,23,13,8,2,0
2021,North Devon 002A,E01020099,1394,1387,7,5,2,0,0
2021,North Devon 002B,E01020100,1126,1122,4,2,1,0,1
2021,North Devon 002C,E01020101,1380,1371,9,4,4,1,0
2021,North Devon 010A,E01020102,1485,1469,16,7,8,1,0
2021,North Devon 010B,E01020103,1506,1454,52,14,20,17,1
2021,North Devon 010C,E01020104,1238,1197,41,19,13,8,1
2021,North Devon 011A,E01020105,2181,2159,22,10,8,1,3
2021,North Devon 011B,E01020106,1299,1296,3,0,1,0,2
2021,North Devon 011C,E01020107,1597,1570,27,13,13,1,0
2021,North Devon 004B,E01020108,1999,1957,42,21,17,4,0
2021,North Devon 004C,E01020109,1313,1295,18,14,4,0,0
2021,North Devon 005E,E01020110,2781,2670,111,60,46,5,0
2021,North Devon 001A,E01020111,1298,1277,21,12,7,2,0
2021,North Devon 001B,E01020112,1426,1398,28,15,10,3,0
2021,North Devon 003A,E01020113,1377,1347,30,15,6,7,2
2021,North Devon 001C,E01020114,1149,1126,23,17,1,1,4
2021,North Devon 001D,E01020115,1155,1148,7,4,2,1,0
2021,North Devon 003B,E01020116,1594,1570,24,14,4,6,0
2021,North Devon 003C,E01020117,1506,1491,15,8,7,0,0
2021,North Devon 003D,E01020118,1284,1265,19,7,10,2,0
2021,North Devon 011D,E01020119,1441,1432,9,6,2,1,0
2021,North Devon 006B,E01020120,2178,2144,34,21,8,5,0
2021,North Devon 012D,E01020121,1923,1915,8,6,0,1,1
2021,North Devon 012E,E01020122,2208,2185,23,12,8,3,0
2021,North Devon 009B,E01020123,1414,1385,29,12,10,5,2
2021,North Devon 009C,E01020124,1366,1319,47,23,18,6,0
2021,North Devon 009D,E01020125,1305,1300,5,4,1,0,0
2021,North Devon 002D,E01020126,1578,1542,36,22,12,1,1
2021,North Devon 006C,E01020127,2177,2160,17,13,2,2,0
2021,North Devon 010D,E01020128,1489,1475,14,9,3,2,0
2021,North Devon 010E,E01020129,1139,1113,26,11,8,5,2
2021,North Devon 010F,E01020130,1431,1385,46,24,13,9,0
2021,North Devon 013B,E01020131,2269,2228,41,12,23,5,1
2021,North Devon 007A,E01020132,1663,1609,54,21,24,8,1
2021,North Devon 007B,E01020133,1453,1392,61,39,16,6,0
2021,North Devon 007C,E01020134,1085,1045,40,20,15,4,1
2021,North Devon 013C,E01020135,1621,1582,39,21,14,4,0
2021,North Devon 013D,E01020136,2362,2327,35,18,14,3,0
2021,North Devon 013E,E01020137,1891,1834,57,27,24,6,0
2021,North Devon 014C,E01020138,2505,2486,19,10,9,0,0
2021,North Devon 007D,E01020139,1386,1347,39,17,13,7,2
2021,North Devon 008C,E01020140,1245,1212,33,20,10,3,0
2021,North Devon 008D,E01020141,1738,1663,75,25,34,14,2
2021,South Hams 006A,E01020142,2680,2651,29,17,9,2,1
2021,South Hams 006B,E01020143,2406,2374,32,17,11,4,0
2021,South Hams 001A,E01020144,1394,1363,31,15,14,2,0
2021,South Hams 001B,E01020145,1977,1947,30,21,5,3,1
2021,South Hams 001C,E01020146,1208,1176,32,17,10,4,1
2021,South Hams 008A,E01020147,2043,2026,17,11,5,1,0
2021,South Hams 002A,E01020148,1101,1095,6,6,0,0,0
2021,South Hams 001D,E01020149,1388,1379,9,7,1,0,1
2021,South Hams 006C,E01020150,2103,2058,45,30,10,5,0
2021,South Hams 007A,E01020151,1465,1443,22,14,6,1,1
2021,South Hams 007B,E01020152,1285,1252,33,21,10,2,0
2021,South Hams 004A,E01020153,1079,1072,7,3,0,3,1
2021,South Hams 007C,E01020154,1342,1227,115,55,59,1,0
2021,South Hams 007D,E01020155,1061,1034,27,12,10,5,0
2021,South Hams 004B,E01020156,2129,2115,14,10,2,2,0
2021,South Hams 002B,E01020157,2427,2381,46,34,9,3,0
2021,South Hams 008B,E01020158,1957,1935,22,11,5,6,0
2021,South Hams 008C,E01020159,1561,1540,21,10,9,2,0
2021,South Hams 002C,E01020160,2376,2356,20,13,2,1,4
2021,South Hams 005A,E01020161,2414,2382,32,18,3,8,3
2021,South Hams 005B,E01020162,1561,1550,11,9,2,0,0
2021,South Hams 005C,E01020163,1770,1755,15,7,5,3,0
2021,South Hams 005D,E01020164,1438,1424,14,9,3,1,1
2021,South Hams 005E,E01020165,1394,1378,16,12,1,3,0
2021,South Hams 005F,E01020166,1412,1404,8,7,1,0,0
2021,South Hams 005G,E01020167,1623,1608,15,14,0,0,1
2021,South Hams 010A,E01020168,1994,1965,29,21,6,1,1
2021,South Hams 010B,E01020169,2160,2105,55,29,19,6,1
2021,South Hams 004C,E01020170,2261,2245,16,11,5,0,0
2021,South Hams 009A,E01020171,1753,1744,9,9,0,0,0
2021,South Hams 012A,E01020172,1952,1931,21,16,5,0,0
2021,South Hams 012B,E01020173,1161,1148,13,10,2,0,1
2021,South Hams 011A,E01020174,1561,1549,12,2,10,0,0
2021,South Hams 011B,E01020175,2052,2033,19,13,5,1,0
2021,South Hams 002D,E01020176,1124,1116,8,5,3,0,0
2021,South Hams 002E,E01020177,1474,1455,19,10,4,4,1
2021,South Hams 011C,E01020178,2040,2030,10,4,4,2,0
2021,South Hams 012C,E01020179,1909,1890,19,11,6,2,0
2021,South Hams 003A,E01020180,2263,2211,52,35,12,4,1
2021,South Hams 003B,E01020181,1839,1820,19,15,2,2,0
2021,South Hams 003C,E01020182,1551,1521,30,19,10,1,0
2021,South Hams 003D,E01020183,1450,1403,47,39,8,0,0
2021,South Hams 003E,E01020184,1699,1662,37,25,10,1,1
2021,South Hams 009B,E01020185,1441,1426,15,8,5,1,1
2021,South Hams 009C,E01020186,1371,1359,12,9,2,1,0
2021,South Hams 009D,E01020187,2518,2498,20,15,5,0,0
2021,South Hams 004D,E01020188,2094,2066,28,18,8,2,0
2021,South Hams 010C,E01020189,2011,1979,32,16,10,5,1
2021,South Hams 008D,E01020190,2374,2346,28,22,4,2,0
2021,Teignbridge 013A,E01020191,1965,1933,32,14,17,1,0
2021,Teignbridge 019A,E01020192,1423,1418,5,5,0,0,0
2021,Teignbridge 019B,E01020193,1589,1582,7,7,0,0,0
2021,Teignbridge 013B,E01020194,1442,1434,8,7,1,0,0
2021,Teignbridge 017A,E01020195,1741,1722,19,11,5,3,0
2021,Teignbridge 017B,E01020196,1678,1645,33,22,9,1,1
2021,Teignbridge 017C,E01020197,1263,1258,5,3,2,0,0
2021,Teignbridge 017D,E01020198,1344,1337,7,6,1,0,0
2021,Teignbridge 017E,E01020199,1569,1547,22,10,8,4,0
2021,Teignbridge 011A,E01020200,1060,1053,7,4,3,0,0
2021,Teignbridge 011B,E01020201,1537,1531,6,5,0,0,1
2021,Teignbridge 007A,E01020202,2329,2312,17,11,6,0,0
2021,Teignbridge 004A,E01020203,1683,1676,7,5,2,0,0
2021,Teignbridge 007B,E01020204,1438,1412,26,10,12,3,1
2021,Teignbridge 003A,E01020205,1397,1385,12,4,6,2,0
2021,Teignbridge 004B,E01020206,1509,1488,21,12,6,3,0
2021,Teignbridge 012A,E01020208,1221,1201,20,9,7,3,1
2021,Teignbridge 012B,E01020209,1370,1335,35,17,15,3,0
2021,Teignbridge 012C,E01020210,1373,1358,15,7,7,1,0
2021,Teignbridge 014A,E01020211,1515,1465,50,25,16,7,2
2021,Teignbridge 016A,E01020212,1217,1200,17,9,7,0,1
2021,Teignbridge 016B,E01020213,1404,1388,16,10,6,0,0
2021,Teignbridge 016C,E01020214,1527,1507,20,10,5,4,1
2021,Teignbridge 016D,E01020215,1281,1270,11,7,3,0,1
2021,Teignbridge 015A,E01020216,1573,1533,40,20,13,6,1
2021,Teignbridge 014B,E01020217,1661,1556,105,47,41,15,2
2021,Teignbridge 014C,E01020218,1521,1455,66,20,28,16,2
2021,Teignbridge 012D,E01020219,2034,1999,35,17,14,4,0
2021,Teignbridge 004C,E01020220,1730,1719,11,7,3,1,0
2021,Teignbridge 004D,E01020221,1737,1719,18,11,2,4,1
2021,Teignbridge 004E,E01020222,1142,1132,10,6,3,1,0
2021,Teignbridge 004F,E01020223,1749,1745,4,3,0,1,0
2021,Teignbridge 014D,E01020224,1159,1135,24,14,10,0,0
2021,Teignbridge 015B,E01020225,1223,1183,40,26,7,6,1
2021,Teignbridge 015C,E01020226,1471,1449,22,13,8,1,0
2021,Teignbridge 015D,E01020227,1384,1346,38,23,7,0,8
2021,Teignbridge 006A,E01020228,1696,1651,45,24,15,5,1
2021,Teignbridge 005B,E01020230,1794,1767,27,15,8,4,0
2021,Teignbridge 005C,E01020231,1490,1484,6,1,4,1,0
2021,Teignbridge 005D,E01020232,1787,1766,21,13,6,1,1
2021,Teignbridge 006B,E01020233,1810,1793,17,9,4,4,0
2021,Teignbridge 006C,E01020234,1351,1334,17,9,2,6,0
2021,Teignbridge 006D,E01020235,1699,1656,43,22,18,2,1
2021,Teignbridge 007C,E01020236,1170,1162,8,6,1,0,1
2021,Teignbridge 007D,E01020237,1597,1588,9,9,0,0,0
2021,Teignbridge 019C,E01020238,1183,1173,10,7,1,1,1
2021,Teignbridge 019D,E01020239,1294,1287,7,7,0,0,0
2021,Teignbridge 002A,E01020240,1838,1819,19,11,6,2,0
2021,Teignbridge 002B,E01020241,1828,1801,27,19,7,1,0
2021,Teignbridge 002C,E01020242,1878,1864,14,8,4,2,0
2021,Teignbridge 001A,E01020243,1220,1207,13,10,2,1,0
2021,Teignbridge 002D,E01020244,1329,1315,14,10,3,1,0
2021,Teignbridge 002E,E01020245,1576,1567,9,8,1,0,0
2021,Teignbridge 018A,E01020246,1317,1305,12,10,1,1,0
2021,Teignbridge 018B,E01020247,1565,1544,21,14,4,3,0
2021,Teignbridge 018C,E01020248,1753,1738,15,8,5,2,0
2021,Teignbridge 018D,E01020249,1362,1355,7,4,2,0,1
2021,Teignbridge 009A,E01020250,1508,1503,5,2,3,0,0
2021,Teignbridge 011C,E01020251,1474,1467,7,5,2,0,0
2021,Teignbridge 009B,E01020252,2113,2078,35,16,12,5,2
2021,Teignbridge 009C,E01020253,1386,1375,11,5,2,3,1
2021,Teignbridge 009D,E01020254,1372,1364,8,6,2,0,0
2021,Teignbridge 009E,E01020255,1371,1363,8,6,2,0,0
2021,Teignbridge 013D,E01020256,1910,1887,23,10,8,3,2
2021,Teignbridge 009F,E01020257,1202,1195,7,1,3,3,0
2021,Teignbridge 003B,E01020258,1689,1649,40,23,11,5,1
2021,Teignbridge 003C,E01020259,1078,1061,17,8,5,4,0
2021,Teignbridge 011D,E01020260,1222,1208,14,12,1,0,1
2021,Teignbridge 011E,E01020261,1198,1177,21,11,9,1,0
2021,Teignbridge 001B,E01020262,1353,1343,10,6,4,0,0
2021,Teignbridge 001C,E01020263,1526,1513,13,7,3,2,1
2021,Teignbridge 010A,E01020264,1451,1428,23,13,7,3,0
2021,Teignbridge 008A,E01020265,1782,1771,11,6,3,0,2
2021,Teignbridge 008B,E01020266,1635,1611,24,16,5,1,2
2021,Teignbridge 008C,E01020267,1410,1394,16,9,3,1,3
2021,Teignbridge 008D,E01020268,1735,1713,22,14,8,0,0
2021,Teignbridge 010B,E01020269,1720,1669,51,22,23,5,1
2021,Teignbridge 008E,E01020270,1604,1585,19,11,7,1,0
2021,Teignbridge 010C,E01020271,1465,1447,18,10,4,4,0
2021,Teignbridge 010D,E01020272,1789,1766,23,12,6,3,2
2021,Teignbridge 003D,E01020273,1472,1465,7,6,1,0,0
2021,Teignbridge 001D,E01020274,1285,1273,12,9,0,0,3
2021,Torridge 001A,E01020275,1176,1167,9,4,2,2,1
2021,Torridge 001B,E01020276,1465,1457,8,5,1,2,0
2021,Torridge 004A,E01020277,2012,1998,14,9,1,4,0
2021,Torridge 004B,E01020278,1605,1599,6,3,1,2,0
2021,Torridge 004C,E01020279,2707,2678,29,20,8,0,1
2021,Torridge 003A,E01020280,2080,2052,28,12,9,7,0
2021,Torridge 003B,E01020281,2015,1964,51,38,9,4,0
2021,Torridge 003C,E01020282,1517,1499,18,7,6,5,0
2021,Torridge 004D,E01020283,2367,2342,25,13,8,4,0
2021,Torridge 004E,E01020284,2020,1985,35,14,16,5,0
2021,Torridge 004F,E01020285,1874,1859,15,8,3,4,0
2021,Torridge 009A,E01020286,1800,1791,9,4,4,1,0
2021,Torridge 007A,E01020287,1487,1480,7,4,1,0,2
2021,Torridge 005A,E01020288,1594,1576,18,3,9,6,0
2021,Torridge 009B,E01020289,1559,1549,10,5,2,2,1
2021,Torridge 009C,E01020290,1736,1727,9,7,2,0,0
2021,Torridge 008A,E01020291,1635,1609,26,14,6,6,0
2021,Torridge 005B,E01020292,1535,1517,18,6,8,4,0
2021,Torridge 008B,E01020293,2445,2409,36,15,9,8,4
2021,Torridge 008C,E01020294,2230,2203,27,15,10,1,1
2021,Torridge 005C,E01020295,1706,1686,20,5,5,8,2
2021,Torridge 005D,E01020296,1473,1460,13,6,1,5,1
2021,Torridge 001C,E01020297,1462,1451,11,4,3,4,0
2021,Torridge 002A,E01020298,2110,2097,13,5,7,1,0
2021,Torridge 001D,E01020299,1778,1755,23,9,13,1,0
2021,Torridge 002B,E01020300,1776,1767,9,4,4,1,0
2021,Torridge 009D,E01020301,2040,2028,12,2,6,4,0
2021,Torridge 008D,E01020302,1783,1777,6,3,2,1,0
2021,Torridge 007B,E01020303,1679,1661,18,6,6,6,0
2021,Torridge 006A,E01020304,1629,1610,19,10,7,1,1
2021,Torridge 006B,E01020305,1039,1014,25,12,10,2,1
2021,Torridge 006C,E01020306,1275,1258,17,5,9,3,0
2021,Torridge 006D,E01020307,1685,1660,25,17,8,0,0
2021,Torridge 007C,E01020308,1829,1814,15,9,6,0,0
2021,Torridge 008E,E01020309,1811,1803,8,4,3,1,0
2021,Torridge 007D,E01020311,2164,2148,16,6,8,0,2
2021,West Devon 007A,E01020312,1621,1613,8,5,2,1,0
2021,West Devon 007B,E01020313,1432,1429,3,2,1,0,0
2021,West Devon 004A,E01020314,1709,1698,11,4,3,4,0
2021,West Devon 007C,E01020315,1580,1560,20,5,9,6,0
2021,West Devon 007D,E01020316,1792,1779,13,7,3,1,2
2021,West Devon 006A,E01020317,1399,1397,2,1,1,0,0
2021,West Devon 003A,E01020318,1523,1503,20,17,2,1,0
2021,West Devon 003B,E01020319,1724,1702,22,12,7,3,0
2021,West Devon 001A,E01020320,1837,1821,16,10,4,2,0
2021,West Devon 001B,E01020321,2385,2350,35,17,8,10,0
2021,West Devon 003C,E01020323,2065,2035,30,19,9,2,0
2021,West Devon 006B,E01020324,1584,1577,7,7,0,0,0
2021,West Devon 004B,E01020325,1674,1657,17,7,8,2,0
2021,West Devon 001D,E01020326,2218,2194,24,11,8,3,2
2021,West Devon 002A,E01020327,1765,1720,45,22,17,6,0
2021,West Devon 002B,E01020328,2311,2227,84,37,31,15,1
2021,West Devon 002C,E01020329,1590,1542,48,17,19,10,2
2021,West Devon 002D,E01020330,1848,1796,52,17,28,6,1
2021,West Devon 004C,E01020331,1654,1646,8,4,2,0,2
2021,West Devon 005A,E01020332,1746,1700,46,17,24,4,1
2021,West Devon 005B,E01020333,2141,2136,5,5,0,0,0
2021,West Devon 005C,E01020334,1915,1892,23,14,3,5,1
2021,West Devon 005D,E01020335,1605,1593,12,8,2,1,1
2021,West Devon 005E,E01020336,1327,1319,8,7,1,0,0
2021,West Devon 005F,E01020337,1391,1341,50,20,21,8,1
2021,West Devon 005G,E01020338,2296,2271,25,17,6,2,0
2021,West Devon 003D,E01020339,1654,1636,18,10,3,3,2
2021,West Devon 004D,E01020340,1717,1705,12,6,6,0,0
2021,West Devon 006C,E01020341,1626,1612,14,11,3,0,0
2021,West Devon 006D,E01020342,1513,1507,6,4,1,0,1
2021,"Bournemouth, Christchurch and Poole 002A",E01020343,1496,1485,11,5,6,0,0
2021,"Bournemouth, Christchurch and Poole 002B",E01020344,1437,1407,30,23,6,1,0
2021,"Bournemouth, Christchurch and Poole 002C",E01020345,1301,1275,26,13,11,0,2
2021,"Bournemouth, Christchurch and Poole 024A",E01020346,1557,1523,34,20,9,5,0
2021,"Bournemouth, Christchurch and Poole 024B",E01020347,1646,1596,50,27,13,9,1
2021,"Bournemouth, Christchurch and Poole 024C",E01020348,1604,1552,52,25,17,10,0
2021,"Bournemouth, Christchurch and Poole 019A",E01020349,1781,1709,72,40,22,9,1
2021,"Bournemouth, Christchurch and Poole 019B",E01020350,1928,1901,27,13,5,9,0
2021,"Bournemouth, Christchurch and Poole 014A",E01020351,1253,1224,29,20,7,2,0
2021,"Bournemouth, Christchurch and Poole 014B",E01020352,1453,1439,14,4,5,4,1
2021,"Bournemouth, Christchurch and Poole 014C",E01020353,1688,1651,37,23,11,2,1
2021,"Bournemouth, Christchurch and Poole 033A",E01020354,1429,1399,30,21,6,3,0
2021,"Bournemouth, Christchurch and Poole 033B",E01020355,1896,1875,21,13,8,0,0
2021,"Bournemouth, Christchurch and Poole 033C",E01020356,1598,1574,24,14,5,5,0
2021,"Bournemouth, Christchurch and Poole 019C",E01020357,2164,2115,49,29,15,4,1
2021,"Bournemouth, Christchurch and Poole 019D",E01020358,1501,1479,22,12,9,1,0
2021,"Bournemouth, Christchurch and Poole 014D",E01020359,1333,1296,37,18,13,5,1
2021,"Bournemouth, Christchurch and Poole 031A",E01020360,1689,1640,49,20,25,4,0
2021,"Bournemouth, Christchurch and Poole 031B",E01020361,1715,1645,70,33,20,17,0
2021,"Bournemouth, Christchurch and Poole 033D",E01020362,1428,1406,22,16,3,3,0
2021,"Bournemouth, Christchurch and Poole 024D",E01020363,1112,1090,22,17,2,1,2
2021,"Bournemouth, Christchurch and Poole 031C",E01020364,1546,1517,29,14,13,2,0
2021,"Bournemouth, Christchurch and Poole 002D",E01020365,1848,1814,34,22,9,2,1
2021,"Bournemouth, Christchurch and Poole 014E",E01020366,2241,2222,19,9,6,4,0
2021,"Bournemouth, Christchurch and Poole 031D",E01020367,1761,1708,53,37,12,4,0
2021,"Bournemouth, Christchurch and Poole 018A",E01020369,1346,1301,45,23,17,5,0
2021,"Bournemouth, Christchurch and Poole 018B",E01020370,1610,1575,35,22,8,5,0
2021,"Bournemouth, Christchurch and Poole 018C",E01020371,1636,1624,12,9,2,1,0
2021,"Bournemouth, Christchurch and Poole 018D",E01020372,1525,1489,36,24,10,1,1
2021,Dorset 007A,E01020373,1282,1276,6,4,2,0,0
2021,Dorset 007B,E01020374,1515,1507,8,8,0,0,0
2021,Dorset 020A,E01020375,1306,1290,16,8,5,2,1
2021,Dorset 020B,E01020376,1059,1053,6,4,0,2,0
2021,Dorset 017A,E01020377,1535,1527,8,8,0,0,0
2021,Dorset 020C,E01020378,1517,1507,10,7,2,0,1
2021,Dorset 017B,E01020379,1477,1460,17,9,5,3,0
2021,Dorset 017C,E01020380,1611,1594,17,13,3,0,1
2021,Dorset 017D,E01020381,1223,1207,16,14,2,0,0
2021,Dorset 025A,E01020382,1484,1465,19,13,2,4,0
2021,Dorset 025B,E01020383,1961,1950,11,7,2,2,0
2021,Dorset 025C,E01020384,1600,1587,13,5,8,0,0
2021,Dorset 025D,E01020385,1239,1231,8,3,3,1,1
2021,Dorset 025E,E01020386,1294,1286,8,4,2,1,1
2021,Dorset 025F,E01020387,1092,1080,12,9,3,0,0
2021,Dorset 025G,E01020388,1432,1412,20,13,5,2,0
2021,Dorset 007C,E01020389,2116,2100,16,13,3,0,0
2021,Dorset 018A,E01020390,1317,1293,24,14,10,0,0
2021,Dorset 018B,E01020391,1449,1433,16,10,5,1,0
2021,Dorset 018C,E01020392,1718,1653,65,36,20,9,0
2021,Dorset 018D,E01020393,1459,1402,57,29,22,6,0
2021,Dorset 018E,E01020394,1692,1655,37,23,9,5,0
2021,Dorset 024A,E01020395,1893,1853,40,29,10,1,0
2021,Dorset 013A,E01020396,1098,1090,8,5,2,1,0
2021,Dorset 007D,E01020397,1391,1381,10,6,3,1,0
2021,Dorset 013B,E01020398,2368,2349,19,10,6,1,2
2021,Dorset 024B,E01020400,1611,1595,16,10,4,2,0
2021,Dorset 024C,E01020401,1618,1603,15,11,2,1,1
2021,Dorset 024D,E01020402,1526,1512,14,8,4,2,0
2021,Dorset 015A,E01020403,1618,1581,37,19,15,3,0
2021,Dorset 015B,E01020404,1657,1632,25,15,5,4,1
2021,Dorset 015C,E01020405,2002,1953,49,27,19,3,0
2021,Dorset 015D,E01020406,2465,2440,25,19,5,1,0
2021,Dorset 020D,E01020407,1173,1164,9,8,1,0,0
2021,Dorset 020E,E01020408,1104,1097,7,1,4,1,1
2021,Dorset 013C,E01020409,1281,1272,9,4,5,0,0
2021,Dorset 013D,E01020410,1236,1229,7,3,2,2,0
2021,Dorset 012A,E01020411,1093,1081,12,10,2,0,0
2021,Dorset 012B,E01020412,1364,1343,21,14,6,1,0
2021,Dorset 012C,E01020413,1445,1441,4,3,1,0,0
2021,Dorset 012D,E01020414,1928,1902,26,19,5,1,1
2021,Dorset 012E,E01020415,1465,1455,10,7,3,0,0
2021,Dorset 010A,E01020416,1464,1444,20,10,7,3,0
2021,Dorset 010B,E01020417,1109,1102,7,6,1,0,0
2021,Dorset 010C,E01020418,1516,1511,5,5,0,0,0
2021,Dorset 010D,E01020419,1982,1971,11,10,1,0,0
2021,Dorset 010E,E01020420,1413,1404,9,4,5,0,0
2021,Dorset 016A,E01020421,1274,1247,27,18,3,6,0
2021,Dorset 016B,E01020422,1588,1574,14,9,5,0,0
2021,Dorset 016C,E01020423,1433,1423,10,6,4,0,0
2021,Dorset 016D,E01020424,1356,1337,19,11,5,3,0
2021,Dorset 016E,E01020425,1604,1586,18,13,3,1,1
2021,Dorset 021A,E01020426,1775,1739,36,24,10,2,0
2021,Dorset 021B,E01020427,2087,2074,13,6,7,0,0
2021,Dorset 021C,E01020428,1896,1864,32,19,11,2,0
2021,Dorset 021D,E01020429,1955,1919,36,23,10,2,1
2021,Dorset 014A,E01020430,1409,1401,8,6,2,0,0
2021,Dorset 014B,E01020431,1193,1177,16,8,7,1,0
2021,Dorset 014C,E01020432,1269,1254,15,3,12,0,0
2021,Dorset 005A,E01020433,1732,1718,14,7,6,1,0
2021,Dorset 005B,E01020434,1753,1735,18,6,7,5,0
2021,Dorset 011A,E01020435,1671,1635,36,18,16,2,0
2021,Dorset 011B,E01020436,2155,2118,37,21,13,1,2
2021,Dorset 011C,E01020437,1936,1919,17,15,2,0,0
2021,Dorset 011D,E01020438,1992,1897,95,39,38,14,4
2021,Dorset 011E,E01020439,2311,2249,62,34,20,6,2
2021,Dorset 002A,E01020440,1961,1944,17,11,5,1,0
2021,Dorset 014D,E01020441,1936,1924,12,6,3,2,1
2021,Dorset 009A,E01020442,1932,1915,17,8,7,1,1
2021,Dorset 001A,E01020443,2342,2209,133,53,53,26,1
2021,Dorset 006A,E01020444,1769,1754,15,10,4,0,1
2021,Dorset 006B,E01020445,1433,1402,31,20,11,0,0
2021,Dorset 006C,E01020446,1525,1505,20,12,7,0,1
2021,Dorset 001B,E01020447,1709,1684,25,10,12,2,1
2021,Dorset 014E,E01020448,1938,1914,24,4,15,4,1
2021,Dorset 005C,E01020449,2012,1995,17,8,7,2,0
2021,Dorset 002B,E01020450,2207,2137,70,27,24,17,2
2021,Dorset 009B,E01020452,2530,2486,44,24,17,2,1
2021,Dorset 009C,E01020453,1789,1781,8,7,1,0,0
2021,Dorset 003A,E01020454,1974,1896,78,27,32,18,1
2021,Dorset 003B,E01020456,1741,1667,74,28,40,6,0
2021,Dorset 003C,E01020457,1587,1560,27,12,11,4,0
2021,Dorset 005D,E01020458,2143,2014,129,54,40,28,7
2021,Dorset 006D,E01020460,2321,2268,53,29,20,2,2
2021,Dorset 002C,E01020462,1820,1799,21,15,4,1,1
2021,Dorset 001C,E01020463,1606,1585,21,12,9,0,0
2021,Dorset 001D,E01020464,1507,1468,39,15,24,0,0
2021,Dorset 027A,E01020465,1888,1880,8,3,4,1,0
2021,Dorset 039A,E01020466,1672,1644,28,19,9,0,0
2021,Dorset 039B,E01020467,1797,1784,13,10,3,0,0
2021,Dorset 039C,E01020468,1515,1511,4,4,0,0,0
2021,Dorset 027B,E01020469,2020,2003,17,10,5,2,0
2021,Dorset 027C,E01020470,1781,1765,16,11,5,0,0
2021,Dorset 028A,E01020471,1274,1246,28,15,12,0,1
2021,Dorset 028B,E01020472,1442,1427,15,10,4,1,0
2021,Dorset 028C,E01020473,1555,1512,43,29,11,3,0
2021,Dorset 028D,E01020474,1904,1880,24,14,9,1,0
2021,Dorset 028E,E01020475,2251,2223,28,13,13,1,1
2021,Dorset 033A,E01020476,1170,1157,13,10,3,0,0
2021,Dorset 033B,E01020477,1381,1373,8,5,1,2,0
2021,Dorset 042A,E01020478,1094,1079,15,9,1,5,0
2021,Dorset 042B,E01020479,1108,1083,25,15,10,0,0
2021,Dorset 042C,E01020480,1667,1624,43,23,14,5,1
2021,Dorset 042D,E01020481,1294,1268,26,13,12,0,1
2021,Dorset 042E,E01020482,1522,1459,63,34,23,6,0
2021,Dorset 042F,E01020483,1157,1136,21,13,4,3,1
2021,Dorset 042G,E01020484,1402,1387,15,8,5,2,0
2021,Dorset 033C,E01020485,1424,1410,14,7,5,2,0
2021,Dorset 033D,E01020486,1665,1646,19,12,3,4,0
2021,Dorset 033E,E01020487,1203,1189,14,9,4,1,0
2021,Dorset 033F,E01020488,1457,1431,26,12,5,5,4
2021,Dorset 035A,E01020489,1284,1256,28,15,9,3,1
2021,Dorset 035B,E01020490,1607,1580,27,9,13,5,0
2021,Dorset 035C,E01020491,1619,1600,19,9,6,2,2
2021,Dorset 035D,E01020492,1132,1126,6,4,2,0,0
2021,Dorset 035E,E01020493,2456,2374,82,50,26,5,1
2021,Dorset 019A,E01020494,1237,1235,2,1,1,0,0
2021,Dorset 019B,E01020495,1364,1348,16,5,10,1,0
2021,Dorset 019C,E01020496,1562,1543,19,11,8,0,0
2021,Dorset 008A,E01020497,1847,1834,13,6,7,0,0
2021,Dorset 026A,E01020498,2017,2003,14,6,5,3,0
2021,Dorset 026B,E01020499,1303,1286,17,4,6,2,5
2021,Dorset 026C,E01020500,1618,1559,59,24,25,6,4
2021,Dorset 026D,E01020501,1350,1339,11,6,4,1,0
2021,Dorset 030A,E01020502,1667,1647,20,12,4,4,0
2021,Dorset 030B,E01020503,1627,1588,39,19,12,7,1
2021,Dorset 030C,E01020504,2140,2123,17,14,3,0,0
2021,Dorset 036A,E01020505,1908,1900,8,7,0,0,1
2021,Dorset 019D,E01020506,1746,1731,15,10,5,0,0
2021,Dorset 029A,E01020507,1818,1805,13,9,4,0,0
2021,Dorset 008B,E01020508,2072,2040,32,16,12,3,1
2021,Dorset 022A,E01020509,2789,2740,49,37,11,1,0
2021,Dorset 022B,E01020510,2345,2331,14,9,4,1,0
2021,Dorset 023A,E01020511,1672,1662,10,7,3,0,0
2021,Dorset 037A,E01020512,2059,2034,25,11,7,7,0
2021,Dorset 037B,E01020513,1648,1627,21,14,3,3,1
2021,Dorset 037C,E01020514,1873,1845,28,16,7,5,0
2021,Dorset 037D,E01020515,1131,1110,21,11,7,3,0
2021,Dorset 037E,E01020516,1482,1455,27,12,9,4,2
2021,Dorset 029B,E01020517,1755,1732,23,14,4,5,0
2021,Dorset 034A,E01020518,1570,1524,46,27,13,5,1
2021,Dorset 034B,E01020519,1691,1643,48,23,20,5,0
2021,Dorset 034C,E01020520,1424,1394,30,20,10,0,0
2021,Dorset 034D,E01020523,1218,1192,26,11,15,0,0
2021,Dorset 034E,E01020524,1420,1398,22,9,5,8,0
2021,Dorset 034F,E01020525,1289,1272,17,11,6,0,0
2021,Dorset 032A,E01020526,1307,1277,30,14,9,7,0
2021,Dorset 032B,E01020527,1425,1365,60,40,13,7,0
2021,Dorset 032C,E01020528,2382,2288,94,59,27,8,0
2021,Dorset 022C,E01020529,2223,2205,18,7,6,5,0
2021,Dorset 019E,E01020530,1843,1816,27,15,7,3,2
2021,Dorset 029C,E01020531,1719,1706,13,6,4,3,0
2021,Dorset 023B,E01020532,1577,1555,22,11,6,5,0
2021,Dorset 023C,E01020533,2113,2090,23,14,8,1,0
2021,Dorset 019F,E01020534,2102,2086,16,4,11,1,0
2021,Dorset 023D,E01020535,1718,1707,11,6,3,2,0
2021,Dorset 029D,E01020536,2231,2212,19,11,4,4,0
2021,Dorset 036B,E01020537,2067,2042,25,15,7,3,0
2021,Dorset 036C,E01020538,1817,1804,13,7,5,1,0
2021,Dorset 022D,E01020539,2041,2004,37,18,16,3,0
2021,Dorset 022E,E01020540,2525,2503,22,10,11,1,0
2021,Dorset 008C,E01020541,2069,2050,19,8,4,6,1
2021,Dorset 004A,E01020542,1315,1301,14,8,6,0,0
2021,Dorset 004B,E01020543,1402,1350,52,24,21,7,0
2021,Dorset 004C,E01020544,1589,1541,48,25,21,2,0
2021,Dorset 004D,E01020546,1460,1430,30,22,8,0,0
2021,Dorset 004E,E01020547,1112,1101,11,5,5,1,0
2021,Dorset 036D,E01020549,2067,2043,24,17,6,1,0
2021,Dorset 008D,E01020550,1656,1626,30,22,6,2,0
2021,Dorset 038A,E01020551,2122,2080,42,28,10,3,1
2021,Dorset 038B,E01020552,1699,1672,27,15,5,6,1
2021,Dorset 044A,E01020553,1432,1334,98,36,43,17,2
2021,Dorset 044B,E01020554,1698,1535,163,75,53,28,7
2021,Dorset 044C,E01020555,1398,1321,77,38,27,12,0
2021,Dorset 044D,E01020556,1548,1487,61,28,22,8,3
2021,Dorset 040A,E01020557,1518,1499,19,9,9,1,0
2021,Dorset 040B,E01020558,1757,1749,8,6,2,0,0
2021,Dorset 040C,E01020559,1724,1714,10,7,1,0,2
2021,Dorset 040D,E01020560,1803,1782,21,8,9,4,0
2021,Dorset 040E,E01020561,1902,1860,42,25,14,2,1
2021,Dorset 048A,E01020562,2127,2103,24,8,13,3,0
2021,Dorset 047A,E01020563,1613,1581,32,17,15,0,0
2021,Dorset 048B,E01020564,1548,1536,12,5,5,0,2
2021,Dorset 048C,E01020565,1476,1451,25,12,10,2,1
2021,Dorset 048D,E01020566,2011,2008,3,2,1,0,0
2021,Dorset 047B,E01020569,1710,1676,34,6,22,5,1
2021,Dorset 038C,E01020570,1526,1510,16,7,8,1,0
2021,Dorset 038D,E01020571,2078,2044,34,20,12,2,0
2021,Dorset 043A,E01020572,1896,1824,72,46,16,10,0
2021,Dorset 043B,E01020573,1770,1718,52,27,19,5,1
2021,Dorset 041A,E01020574,1866,1818,48,27,15,6,0
2021,Dorset 041B,E01020575,1734,1696,38,18,17,3,0
2021,Dorset 041C,E01020576,1663,1635,28,11,5,7,5
2021,Dorset 043C,E01020577,1817,1774,43,26,12,5,0
2021,Dorset 043D,E01020578,2042,1997,45,19,19,4,3
2021,Dorset 041D,E01020579,2108,2093,15,11,4,0,0
2021,Dorset 041E,E01020580,1476,1468,8,3,4,1,0
2021,Dorset 044E,E01020581,1766,1737,29,17,9,3,0
2021,Dorset 044F,E01020582,1479,1456,23,14,6,3,0
2021,Dorset 045A,E01020583,1836,1821,15,6,7,2,0
2021,Dorset 045B,E01020584,1630,1592,38,12,19,4,3
2021,Dorset 045C,E01020585,1478,1464,14,8,4,2,0
2021,Dorset 046A,E01020586,1232,1218,14,6,7,1,0
2021,Dorset 046B,E01020587,1430,1416,14,8,5,1,0
2021,Dorset 046C,E01020588,1436,1417,19,19,0,0,0
2021,Dorset 046D,E01020589,1371,1353,18,5,7,6,0
2021,County Durham 015A,E01020590,1219,1218,1,0,0,1,0
2021,County Durham 015B,E01020591,1395,1382,13,8,4,1,0
2021,County Durham 011A,E01020592,1438,1392,46,17,14,12,3
2021,County Durham 011B,E01020593,1172,1122,50,19,27,4,0
2021,County Durham 013A,E01020594,1479,1444,35,16,14,5,0
2021,County Durham 013B,E01020595,1630,1624,6,4,0,2,0
2021,County Durham 007A,E01020596,1546,1532,14,8,2,1,3
2021,County Durham 007B,E01020597,1363,1352,11,5,4,0,2
2021,County Durham 007C,E01020598,1642,1635,7,7,0,0,0
2021,County Durham 011C,E01020599,1665,1622,43,14,22,6,1
2021,County Durham 013C,E01020600,1413,1402,11,10,1,0,0
2021,County Durham 011D,E01020601,1353,1334,19,11,3,5,0
2021,County Durham 011E,E01020602,1829,1793,36,12,3,17,4
2021,County Durham 013D,E01020603,1613,1596,17,6,6,5,0
2021,County Durham 019A,E01020604,1360,1355,5,4,1,0,0
2021,County Durham 013E,E01020605,1622,1611,11,8,2,0,1
2021,County Durham 005A,E01020606,1311,1304,7,1,3,2,1
2021,County Durham 019B,E01020607,1788,1762,26,12,8,5,1
2021,County Durham 015C,E01020608,1852,1830,22,12,5,3,2
2021,County Durham 015D,E01020609,1279,1273,6,2,2,0,2
2021,County Durham 015E,E01020610,1353,1344,9,7,2,0,0
2021,County Durham 007D,E01020611,1756,1737,19,13,3,3,0
2021,County Durham 007E,E01020612,1469,1457,12,7,4,0,1
2021,County Durham 002A,E01020613,1303,1291,12,3,6,3,0
2021,County Durham 002B,E01020614,1364,1349,15,9,2,2,2
2021,County Durham 005B,E01020615,1622,1605,17,13,3,1,0
2021,County Durham 005C,E01020616,1575,1556,19,9,5,5,0
2021,County Durham 005D,E01020617,2370,2355,15,10,5,0,0
2021,County Durham 011F,E01020618,1867,1843,24,9,10,2,3
2021,County Durham 019C,E01020619,1530,1516,14,5,7,1,1
2021,County Durham 019D,E01020620,1517,1482,35,20,12,3,0
2021,County Durham 019E,E01020621,1962,1925,37,16,18,3,0
2021,County Durham 002C,E01020622,1499,1491,8,2,5,1,0
2021,County Durham 002D,E01020623,1424,1413,11,7,1,3,0
2021,County Durham 009A,E01020624,1634,1608,26,13,7,4,2
2021,County Durham 009B,E01020625,1605,1589,16,5,8,3,0
2021,County Durham 006A,E01020626,1426,1419,7,3,2,2,0
2021,County Durham 003A,E01020627,1450,1429,21,12,6,2,1
2021,County Durham 003B,E01020628,1765,1750,15,2,8,5,0
2021,County Durham 003C,E01020629,1758,1714,44,23,14,6,1
2021,County Durham 014A,E01020630,1310,1283,27,4,13,8,2
2021,County Durham 014B,E01020631,1551,1527,24,11,8,4,1
2021,County Durham 010A,E01020632,1654,1642,12,4,7,0,1
2021,County Durham 020A,E01020633,1577,1560,17,10,5,2,0
2021,County Durham 001A,E01020634,1556,1543,13,9,1,3,0
2021,County Durham 001B,E01020635,1261,1256,5,1,2,2,0
2021,County Durham 001C,E01020636,1668,1654,14,8,3,2,1
2021,County Durham 014C,E01020637,1616,1602,14,6,7,1,0
2021,County Durham 006B,E01020638,1536,1513,23,11,10,2,0
2021,County Durham 006C,E01020639,1608,1578,30,15,12,1,2
2021,County Durham 010B,E01020640,2161,2125,36,9,21,6,0
2021,County Durham 010C,E01020641,2128,2089,39,17,14,7,1
2021,County Durham 010D,E01020642,1330,1321,9,5,2,2,0
2021,County Durham 010E,E01020643,1974,1931,43,9,13,18,3
2021,County Durham 014E,E01020645,1483,1419,64,16,33,12,3
2021,County Durham 024A,E01020646,1577,1571,6,2,3,1,0
2021,County Durham 008A,E01020647,1987,1952,35,10,13,11,1
2021,County Durham 008B,E01020648,2570,2516,54,21,13,7,13
2021,County Durham 008C,E01020649,1589,1572,17,4,7,4,2
2021,County Durham 012A,E01020650,2322,2269,53,31,19,2,1
2021,County Durham 012B,E01020651,1661,1637,24,12,5,6,1
2021,County Durham 012C,E01020652,1975,1920,55,26,16,12,1
2021,County Durham 006D,E01020653,1432,1420,12,3,8,1,0
2021,County Durham 001D,E01020654,1797,1770,27,18,6,3,0
2021,County Durham 003D,E01020655,1914,1902,12,5,6,1,0
2021,County Durham 003E,E01020656,1394,1379,15,5,7,3,0
2021,County Durham 003F,E01020657,1425,1415,10,7,3,0,0
2021,County Durham 024B,E01020658,1802,1780,22,12,9,0,1
2021,County Durham 024C,E01020659,1343,1328,15,9,4,1,1
2021,County Durham 024D,E01020660,1538,1519,19,11,3,3,2
2021,County Durham 004A,E01020661,1775,1763,12,4,6,2,0
2021,County Durham 004B,E01020662,1689,1673,16,8,5,3,0
2021,County Durham 004C,E01020663,1762,1745,17,7,6,4,0
2021,County Durham 020B,E01020664,1557,1539,18,11,6,0,1
2021,County Durham 020C,E01020665,1355,1336,19,9,8,1,1
2021,County Durham 020D,E01020666,1346,1340,6,3,2,1,0
2021,County Durham 010F,E01020667,1501,1477,24,9,8,5,2
2021,County Durham 012D,E01020668,1386,1351,35,8,17,9,1
2021,County Durham 012E,E01020669,1396,1366,30,12,7,8,3
2021,County Durham 009C,E01020670,1507,1495,12,5,4,2,1
2021,County Durham 009D,E01020671,1210,1182,28,12,12,2,2
2021,County Durham 009E,E01020672,1629,1606,23,4,13,5,1
2021,County Durham 008D,E01020673,1492,1472,20,12,5,3,0
2021,County Durham 004D,E01020674,1519,1487,32,14,5,13,0
2021,County Durham 008E,E01020675,1662,1649,13,3,7,2,1
2021,County Durham 001E,E01020676,1443,1440,3,1,1,1,0
2021,County Durham 006E,E01020677,1462,1434,28,9,13,6,0
2021,County Durham 004E,E01020678,1252,1237,15,3,7,3,2
2021,County Durham 026A,E01020679,1493,1458,35,22,7,5,1
2021,County Durham 026B,E01020680,1612,1590,22,15,4,2,1
2021,County Durham 026C,E01020681,1444,1425,19,11,8,0,0
2021,County Durham 028A,E01020682,1775,1760,15,8,5,2,0
2021,County Durham 028B,E01020683,1555,1529,26,13,10,2,1
2021,County Durham 038A,E01020685,1582,1560,22,10,3,6,3
2021,County Durham 038B,E01020686,1396,1355,41,10,9,22,0
2021,County Durham 038C,E01020687,1253,1236,17,13,4,0,0
2021,County Durham 038D,E01020688,1386,1371,15,7,6,2,0
2021,County Durham 038E,E01020689,1527,1488,39,18,14,7,0
2021,County Durham 028C,E01020690,1237,1206,31,20,7,2,2
2021,County Durham 028D,E01020691,1283,1244,39,22,12,5,0
2021,County Durham 028E,E01020692,1417,1373,44,29,8,6,1
2021,County Durham 029A,E01020693,1323,1188,135,78,39,15,3
2021,County Durham 041A,E01020694,1416,1369,47,30,10,5,2
2021,County Durham 044A,E01020695,2033,1999,34,24,7,3,0
2021,County Durham 041B,E01020696,1201,1187,14,10,4,0,0
2021,County Durham 041C,E01020697,1497,1408,89,50,28,9,2
2021,County Durham 044B,E01020698,1521,1507,14,6,4,4,0
2021,County Durham 044C,E01020699,1380,1356,24,14,8,1,1
2021,County Durham 044D,E01020700,1491,1474,17,12,2,3,0
2021,County Durham 044E,E01020701,1298,1282,16,6,5,5,0
2021,County Durham 033B,E01020702,2689,2452,237,132,78,21,6
2021,County Durham 030A,E01020703,2552,2365,187,107,73,6,1
2021,County Durham 033C,E01020704,1833,1755,78,49,21,8,0
2021,County Durham 031A,E01020705,1611,1584,27,16,10,1,0
2021,County Durham 031B,E01020706,1782,1769,13,7,5,1,0
2021,County Durham 023A,E01020708,1192,1093,99,76,21,1,1
2021,County Durham 022A,E01020709,2587,2456,131,56,47,26,2
2021,County Durham 023B,E01020710,1642,1577,65,32,24,7,2
2021,County Durham 023C,E01020711,1826,1703,123,70,37,15,1
2021,County Durham 033D,E01020712,1750,1586,164,88,62,13,1
2021,County Durham 026D,E01020714,1428,1400,28,16,6,3,3
2021,County Durham 026E,E01020716,1587,1554,33,18,14,0,1
2021,County Durham 022B,E01020717,1505,1474,31,19,9,3,0
2021,County Durham 022C,E01020718,1291,1266,25,11,7,6,1
2021,County Durham 022D,E01020719,1164,1124,40,23,9,8,0
2021,County Durham 023D,E01020720,1373,1308,65,33,16,15,1
2021,County Durham 022E,E01020721,1067,1044,23,14,7,2,0
2021,County Durham 029B,E01020722,1931,1719,212,112,68,31,1
2021,County Durham 029C,E01020723,1684,1545,139,87,38,13,1
2021,County Durham 029D,E01020724,1629,1531,98,45,36,15,2
2021,County Durham 027A,E01020725,1479,1473,6,3,1,2,0
2021,County Durham 027B,E01020726,1104,1098,6,1,4,0,1
2021,County Durham 027C,E01020727,1163,1141,22,9,4,9,0
2021,County Durham 027D,E01020729,2141,2121,20,18,0,1,1
2021,County Durham 027E,E01020730,1583,1553,30,24,3,1,2
2021,County Durham 027F,E01020731,1416,1406,10,8,1,1,0
2021,County Durham 041D,E01020732,2290,2221,69,40,20,8,1
2021,County Durham 035A,E01020733,1099,1088,11,0,5,5,1
2021,County Durham 035B,E01020734,1147,1132,15,9,5,1,0
2021,County Durham 035C,E01020735,1422,1415,7,4,3,0,0
2021,County Durham 039B,E01020737,1403,1399,4,1,2,0,1
2021,County Durham 039D,E01020739,1123,1109,14,8,2,3,1
2021,County Durham 017A,E01020740,1353,1339,14,2,11,1,0
2021,County Durham 017B,E01020741,1069,1055,14,5,6,2,1
2021,County Durham 017C,E01020742,1643,1620,23,8,8,5,2
2021,County Durham 018A,E01020743,1675,1645,30,15,9,5,1
2021,County Durham 039E,E01020744,1132,1127,5,5,0,0,0
2021,County Durham 032A,E01020745,1252,1245,7,1,0,3,3
2021,County Durham 037A,E01020746,1062,1057,5,2,2,0,1
2021,County Durham 018B,E01020747,1171,1162,9,2,6,1,0
2021,County Durham 018C,E01020748,1177,1141,36,21,12,3,0
2021,County Durham 018D,E01020749,1298,1281,17,6,5,4,2
2021,County Durham 016A,E01020750,1056,1052,4,4,0,0,0
2021,County Durham 025A,E01020751,1605,1587,18,6,9,3,0
2021,County Durham 025B,E01020752,1073,1048,25,12,11,1,1
2021,County Durham 032B,E01020753,1834,1825,9,2,0,5,2
2021,County Durham 025C,E01020754,1317,1312,5,2,2,1,0
2021,County Durham 025D,E01020756,1586,1579,7,6,0,1,0
2021,County Durham 032C,E01020757,1194,1179,15,5,7,1,2
2021,County Durham 032D,E01020758,1341,1318,23,7,10,3,3
2021,County Durham 032E,E01020759,1487,1455,32,16,13,3,0
2021,County Durham 034A,E01020760,1918,1903,15,11,2,2,0
2021,County Durham 034B,E01020761,1506,1474,32,15,11,6,0
2021,County Durham 034C,E01020762,1330,1311,19,7,10,2,0
2021,County Durham 034D,E01020763,1776,1752,24,15,5,3,1
2021,County Durham 036A,E01020764,1083,1063,20,8,11,1,0
2021,County Durham 032F,E01020765,1598,1570,28,13,10,5,0
2021,County Durham 036B,E01020766,1325,1320,5,1,4,0,0
2021,County Durham 036C,E01020767,1580,1548,32,12,13,7,0
2021,County Durham 036D,E01020768,1420,1420,0,0,0,0,0
2021,County Durham 037B,E01020769,1135,1130,5,3,1,1,0
2021,County Durham 035D,E01020770,1086,1077,9,4,4,1,0
2021,County Durham 035E,E01020771,1009,1002,7,3,1,3,0
2021,County Durham 043A,E01020772,1979,1968,11,6,1,4,0
2021,County Durham 018E,E01020773,1451,1429,22,10,9,2,1
2021,County Durham 018F,E01020775,1571,1538,33,8,20,3,2
2021,County Durham 021C,E01020776,1687,1686,1,0,0,1,0
2021,County Durham 037C,E01020777,1447,1412,35,9,13,10,3
2021,County Durham 037D,E01020778,1161,1152,9,6,3,0,0
2021,County Durham 037E,E01020779,1504,1495,9,5,3,1,0
2021,County Durham 035F,E01020780,1217,1197,20,6,10,4,0
2021,County Durham 017D,E01020782,1223,1212,11,6,4,0,1
2021,County Durham 017E,E01020783,1184,1174,10,5,5,0,0
2021,County Durham 017F,E01020784,1444,1393,51,17,18,16,0
2021,County Durham 016D,E01020786,1495,1482,13,5,8,0,0
2021,County Durham 016E,E01020787,1747,1735,12,8,3,1,0
2021,County Durham 040A,E01020788,1331,1317,14,5,8,1,0
2021,County Durham 040B,E01020789,1650,1641,9,4,4,1,0
2021,County Durham 040C,E01020790,1316,1287,29,22,6,1,0
2021,County Durham 040D,E01020791,1212,1196,16,2,7,7,0
2021,County Durham 040E,E01020792,1432,1417,15,4,6,5,0
2021,County Durham 043B,E01020793,1578,1567,11,5,4,1,1
2021,County Durham 043C,E01020794,1864,1850,14,5,3,6,0
2021,County Durham 043D,E01020795,1727,1701,26,15,8,3,0
2021,County Durham 054A,E01020796,1241,1230,11,9,2,0,0
2021,County Durham 050A,E01020797,2363,2329,34,18,8,8,0
2021,County Durham 050B,E01020798,1457,1444,13,6,6,1,0
2021,County Durham 050C,E01020799,1412,1403,9,5,4,0,0
2021,County Durham 059A,E01020801,1416,1399,17,10,3,4,0
2021,County Durham 059B,E01020802,1773,1755,18,8,8,1,1
2021,County Durham 053D,E01020805,1853,1842,11,6,1,4,0
2021,County Durham 049A,E01020806,1379,1370,9,3,3,3,0
2021,County Durham 049B,E01020807,1145,1081,64,24,22,13,5
2021,County Durham 050D,E01020808,1282,1269,13,9,4,0,0
2021,County Durham 048A,E01020809,1336,1328,8,3,4,1,0
2021,County Durham 048B,E01020810,1154,1144,10,6,3,1,0
2021,County Durham 048C,E01020811,1169,1155,14,1,11,2,0
2021,County Durham 048D,E01020812,1415,1408,7,3,3,1,0
2021,County Durham 060A,E01020813,1173,1156,17,7,6,2,2
2021,County Durham 060B,E01020814,1281,1249,32,14,9,5,4
2021,County Durham 060C,E01020815,1231,1211,20,11,6,3,0
2021,County Durham 061A,E01020816,1274,1230,44,19,16,8,1
2021,County Durham 047A,E01020817,1176,1173,3,2,1,0,0
2021,County Durham 047B,E01020818,1380,1358,22,15,3,4,0
2021,County Durham 047C,E01020819,982,979,3,2,0,1,0
2021,County Durham 049C,E01020820,1852,1825,27,11,5,6,5
2021,County Durham 052A,E01020821,2092,2077,15,9,3,3,0
2021,County Durham 052B,E01020822,2057,2047,10,7,3,0,0
2021,County Durham 052C,E01020823,1727,1713,14,8,5,1,0
2021,County Durham 063A,E01020824,1416,1397,19,8,8,3,0
2021,County Durham 062A,E01020825,1675,1656,19,11,6,2,0
2021,County Durham 063B,E01020826,1473,1464,9,2,5,2,0
2021,County Durham 048E,E01020827,1734,1728,6,3,2,0,1
2021,County Durham 054B,E01020828,1574,1570,4,3,1,0,0
2021,County Durham 054C,E01020829,2253,2217,36,16,10,9,1
2021,County Durham 054D,E01020830,1815,1804,11,7,2,2,0
2021,County Durham 062B,E01020831,1298,1286,12,5,5,1,1
2021,County Durham 063C,E01020832,1402,1388,14,4,10,0,0
2021,County Durham 062C,E01020833,1181,1178,3,2,1,0,0
2021,County Durham 062D,E01020834,1224,1207,17,9,8,0,0
2021,County Durham 052D,E01020835,1433,1416,17,5,7,2,3
2021,County Durham 047D,E01020837,1509,1505,4,1,1,0,2
2021,County Durham 059C,E01020838,1676,1652,24,12,7,4,1
2021,County Durham 059D,E01020839,1475,1462,13,8,3,1,1
2021,County Durham 059E,E01020840,2066,2046,20,9,9,1,1
2021,County Durham 059F,E01020841,1683,1660,23,8,9,3,3
2021,County Durham 047E,E01020843,1500,1482,18,12,4,2,0
2021,County Durham 061B,E01020844,1463,1412,51,20,20,9,2
2021,County Durham 063D,E01020845,1311,1277,34,13,12,8,1
2021,County Durham 063E,E01020846,1196,1169,27,13,7,7,0
2021,County Durham 061C,E01020847,1396,1342,54,16,30,6,2
2021,County Durham 060D,E01020848,1130,1115,15,9,3,3,0
2021,County Durham 061D,E01020849,1242,1191,51,18,27,4,2
2021,County Durham 060E,E01020850,2352,2303,49,27,16,5,1
2021,County Durham 060F,E01020851,1321,1314,7,3,3,0,1
2021,County Durham 067E,E01020852,1610,1590,20,8,11,1,0
2021,County Durham 067D,E01020853,1753,1736,17,14,2,0,1
2021,County Durham 067F,E01020854,2529,2470,59,31,27,1,0
2021,County Durham 067C,E01020855,1135,1128,7,2,2,3,0
2021,County Durham 064A,E01020856,1470,1463,7,4,3,0,0
2021,County Durham 067B,E01020857,1429,1422,7,5,1,1,0
2021,County Durham 064B,E01020858,1017,1014,3,3,0,0,0
2021,County Durham 064C,E01020859,1173,1169,4,3,1,0,0
2021,County Durham 064D,E01020860,1023,1020,3,0,0,3,0
2021,County Durham 064E,E01020861,1124,1119,5,4,1,0,0
2021,County Durham 064F,E01020862,2305,2293,12,6,4,2,0
2021,County Durham 067G,E01020863,1298,1288,10,2,6,2,0
2021,County Durham 064G,E01020864,2051,2048,3,1,2,0,0
2021,County Durham 064H,E01020867,2120,2110,10,6,4,0,0
2021,County Durham 055A,E01020868,2051,2028,23,10,8,4,1
2021,County Durham 055B,E01020869,1296,1283,13,6,3,4,0
2021,County Durham 056A,E01020870,1292,1286,6,4,2,0,0
2021,County Durham 056B,E01020871,1336,1323,13,6,2,3,2
2021,County Durham 056C,E01020872,1693,1673,20,7,9,3,1
2021,County Durham 051A,E01020873,1313,1293,20,12,7,1,0
2021,County Durham 055C,E01020874,1567,1558,9,3,2,4,0
2021,County Durham 051B,E01020875,1322,1313,9,4,1,3,1
2021,County Durham 045A,E01020876,1669,1649,20,10,7,3,0
2021,County Durham 046A,E01020877,1484,1463,21,6,8,6,1
2021,County Durham 045B,E01020878,1713,1687,26,5,5,2,14
2021,County Durham 046B,E01020879,2108,2091,17,9,6,1,1
2021,County Durham 055D,E01020880,1522,1494,28,9,15,3,1
2021,County Durham 055E,E01020881,1449,1438,11,2,6,3,0
2021,County Durham 057A,E01020882,1412,1402,10,6,2,1,1
2021,County Durham 056D,E01020883,1552,1544,8,4,3,1,0
2021,County Durham 058A,E01020884,1265,1249,16,7,6,3,0
2021,County Durham 058B,E01020885,1138,1120,18,9,7,2,0
2021,County Durham 056E,E01020886,1165,1128,37,13,18,3,3
2021,County Durham 045C,E01020887,1944,1932,12,9,2,0,1
2021,County Durham 057B,E01020888,1848,1836,12,8,3,1,0
2021,County Durham 042A,E01020889,1452,1448,4,3,1,0,0
2021,County Durham 042B,E01020890,1647,1639,8,7,1,0,0
2021,County Durham 042C,E01020891,1555,1548,7,4,1,1,1
2021,County Durham 045D,E01020892,1041,1035,6,0,5,1,0
2021,County Durham 046C,E01020893,1871,1860,11,3,6,2,0
2021,County Durham 045E,E01020894,1176,1166,10,9,1,0,0
2021,County Durham 057C,E01020895,1446,1419,27,8,11,7,1
2021,County Durham 057D,E01020896,1314,1305,9,7,0,1,1
2021,County Durham 045F,E01020898,1446,1430,16,7,2,4,3
2021,County Durham 046D,E01020899,1300,1287,13,10,2,1,0
2021,County Durham 051C,E01020900,1626,1616,10,6,3,1,0
2021,County Durham 051D,E01020901,1363,1346,17,9,6,1,1
2021,County Durham 051E,E01020902,1381,1371,10,5,5,0,0
2021,County Durham 046E,E01020903,1070,1067,3,3,0,0,0
2021,County Durham 046F,E01020904,1697,1675,22,12,6,3,1
2021,County Durham 042D,E01020905,1449,1435,14,7,4,3,0
2021,County Durham 042E,E01020906,1598,1588,10,8,2,0,0
2021,County Durham 058C,E01020907,1504,1469,35,18,12,4,1
2021,County Durham 058D,E01020908,1308,1302,6,4,0,2,0
2021,County Durham 058E,E01020909,1606,1563,43,21,13,9,0
2021,Eastbourne 010A,E01020910,1968,1622,346,132,156,52,6
2021,Eastbourne 010B,E01020911,2227,1533,694,295,271,108,20
2021,Eastbourne 010C,E01020912,2136,1548,588,228,230,111,19
2021,Eastbourne 013A,E01020913,2292,2180,112,64,37,10,1
2021,Eastbourne 007A,E01020914,1883,1647,236,114,83,31,8
2021,Eastbourne 007B,E01020915,1654,1499,155,59,55,32,9
2021,Eastbourne 010D,E01020916,1774,1427,347,159,129,56,3
2021,Eastbourne 002A,E01020917,1398,1333,65,35,23,5,2
2021,Eastbourne 002B,E01020918,1599,1482,117,62,39,14,2
2021,Eastbourne 002C,E01020919,1522,1459,63,30,17,14,2
2021,Eastbourne 004A,E01020920,1460,1402,58,25,21,11,1
2021,Eastbourne 004B,E01020921,1409,1352,57,29,21,7,0
2021,Eastbourne 004C,E01020922,1387,1329,58,30,19,4,5
2021,Eastbourne 002D,E01020923,1350,1278,72,30,27,13,2
2021,Eastbourne 001A,E01020924,1343,1297,46,21,17,8,0
2021,Eastbourne 001B,E01020925,1525,1437,88,34,32,17,5
2021,Eastbourne 003A,E01020926,1441,1393,48,24,13,9,2
2021,Eastbourne 001C,E01020927,1374,1300,74,34,30,9,1
2021,Eastbourne 001D,E01020928,1581,1538,43,21,19,2,1
2021,Eastbourne 003B,E01020929,1710,1614,96,38,48,9,1
2021,Eastbourne 001E,E01020930,1351,1313,38,18,14,6,0
2021,Eastbourne 012A,E01020931,1678,1567,111,57,43,9,2
2021,Eastbourne 012B,E01020932,1292,1242,50,32,17,1,0
2021,Eastbourne 011A,E01020935,2027,1631,396,154,166,64,12
2021,Eastbourne 011B,E01020936,1595,1446,149,79,57,10,3
2021,Eastbourne 011C,E01020937,1946,1736,210,88,82,31,9
2021,Eastbourne 009A,E01020938,1568,1504,64,28,25,10,1
2021,Eastbourne 009B,E01020939,1526,1485,41,20,19,1,1
2021,Eastbourne 006A,E01020940,1575,1518,57,27,22,8,0
2021,Eastbourne 006B,E01020941,1690,1597,93,55,28,10,0
2021,Eastbourne 006C,E01020942,1511,1471,40,25,6,4,5
2021,Eastbourne 009C,E01020943,1528,1479,49,22,19,5,3
2021,Eastbourne 012E,E01020944,1476,1427,49,24,19,6,0
2021,Eastbourne 004D,E01020945,1799,1744,55,37,11,6,1
2021,Eastbourne 006D,E01020946,1669,1643,26,18,5,3,0
2021,Eastbourne 006E,E01020947,1526,1488,38,21,14,3,0
2021,Eastbourne 008A,E01020948,1400,1229,171,117,44,9,1
2021,Eastbourne 002E,E01020949,1543,1468,75,39,25,9,2
2021,Eastbourne 004E,E01020950,1514,1453,61,27,31,3,0
2021,Eastbourne 013B,E01020951,1529,1433,96,51,38,5,2
2021,Eastbourne 007C,E01020952,1831,1720,111,44,45,21,1
2021,Eastbourne 007D,E01020953,1478,1430,48,37,9,1,1
2021,Eastbourne 007E,E01020954,1707,1658,49,24,18,7,0
2021,Eastbourne 003C,E01020955,1549,1497,52,24,19,7,2
2021,Eastbourne 003D,E01020956,1573,1496,77,30,27,14,6
2021,Eastbourne 003E,E01020957,1527,1452,75,34,26,14,1
2021,Eastbourne 013C,E01020959,1465,1397,68,27,24,17,0
2021,Eastbourne 014A,E01020960,2399,2234,165,88,60,16,1
2021,Eastbourne 013D,E01020961,1441,1391,50,22,23,4,1
2021,Eastbourne 013E,E01020962,2021,1929,92,40,41,10,1
2021,Eastbourne 008B,E01020963,1928,1813,115,64,35,15,1
2021,Eastbourne 009D,E01020964,1558,1461,97,57,30,7,3
2021,Eastbourne 008C,E01020965,1756,1593,163,80,56,22,5
2021,Eastbourne 008D,E01020966,1676,1496,180,82,70,24,4
2021,Eastbourne 009E,E01020967,1836,1725,111,71,31,8,1
2021,Eastbourne 011D,E01020968,1904,1658,246,136,81,26,3
2021,Hastings 001A,E01020969,1484,1452,32,15,10,7,0
2021,Hastings 001B,E01020970,2660,2601,59,37,15,5,2
2021,Hastings 001C,E01020971,2089,2036,53,38,9,5,1
2021,Hastings 005A,E01020972,1793,1701,92,36,47,4,5
2021,Hastings 005B,E01020973,1826,1773,53,30,17,6,0
2021,Hastings 002A,E01020974,1683,1653,30,20,9,1,0
2021,Hastings 008A,E01020975,1619,1557,62,33,23,6,0
2021,Hastings 008B,E01020976,1820,1728,92,49,31,12,0
2021,Hastings 005C,E01020977,1526,1448,78,38,30,9,1
2021,Hastings 009A,E01020978,1916,1661,255,109,91,49,6
2021,Hastings 009B,E01020979,1863,1537,326,129,119,67,11
2021,Hastings 009C,E01020980,1481,1352,129,67,43,19,0
2021,Hastings 009D,E01020981,1409,1355,54,31,18,4,1
2021,Hastings 011A,E01020982,1616,1362,254,98,111,41,4
2021,Hastings 011B,E01020983,1456,1240,216,113,76,24,3
2021,Hastings 011C,E01020984,1797,1506,291,150,97,42,2
2021,Hastings 011D,E01020985,1534,1391,143,56,69,15,3
2021,Hastings 002B,E01020986,1538,1479,59,33,20,2,4
2021,Hastings 001D,E01020987,1801,1699,102,60,29,12,1
2021,Hastings 002C,E01020988,1595,1549,46,17,23,5,1
2021,Hastings 011E,E01020989,1550,1315,235,114,83,36,2
2021,Hastings 008C,E01020990,1577,1451,126,49,52,22,3
2021,Hastings 008D,E01020991,1304,1228,76,29,31,13,3
2021,Hastings 008E,E01020992,1807,1653,154,78,49,22,5
2021,Hastings 003A,E01020993,1404,1344,60,27,24,9,0
2021,Hastings 003B,E01020994,1528,1485,43,15,16,11,1
2021,Hastings 003C,E01020995,1366,1329,37,14,18,5,0
2021,Hastings 003D,E01020996,1874,1804,70,34,26,8,2
2021,Hastings 010A,E01020997,1591,1542,49,27,21,1,0
2021,Hastings 010B,E01020998,1835,1713,122,66,40,15,1
2021,Hastings 010C,E01020999,1839,1792,47,19,20,6,2
2021,Hastings 007A,E01021000,1408,1387,21,15,6,0,0
2021,Hastings 007B,E01021001,1183,1174,9,5,2,0,2
2021,Hastings 007C,E01021002,1385,1349,36,22,10,4,0
2021,Hastings 007D,E01021003,1412,1371,41,17,19,4,1
2021,Hastings 004A,E01021004,1780,1736,44,25,14,3,2
2021,Hastings 004B,E01021005,1646,1592,54,20,20,10,4
2021,Hastings 004C,E01021006,1656,1589,67,30,19,15,3
2021,Hastings 002D,E01021007,1579,1555,24,8,13,3,0
2021,Hastings 002E,E01021008,1534,1494,40,21,10,8,1
2021,Hastings 002F,E01021009,1905,1873,32,10,17,4,1
2021,Hastings 006A,E01021010,1498,1466,32,13,12,7,0
2021,Hastings 006B,E01021011,1552,1472,80,32,33,12,3
2021,Hastings 006C,E01021012,1674,1602,72,39,23,7,3
2021,Hastings 004D,E01021013,1743,1699,44,25,13,6,0
2021,Hastings 007E,E01021014,1724,1616,108,46,39,21,2
2021,Hastings 005D,E01021015,1715,1669,46,14,22,10,0
2021,Hastings 010D,E01021016,1774,1688,86,40,22,19,5
2021,Hastings 010E,E01021017,1540,1495,45,22,21,1,1
2021,Hastings 010F,E01021018,1836,1768,68,36,23,7,2
2021,Hastings 003E,E01021019,1621,1557,64,30,20,11,3
2021,Hastings 006D,E01021020,1943,1873,70,32,31,7,0
2021,Hastings 006E,E01021021,1841,1744,97,49,35,9,4
2021,Lewes 001A,E01021022,2164,2117,47,30,12,2,3
2021,Lewes 002A,E01021023,2833,2793,40,28,9,3,0
2021,Lewes 001B,E01021024,1074,1071,3,1,2,0,0
2021,Lewes 001C,E01021025,1815,1796,19,14,2,2,1
2021,Lewes 002B,E01021026,2517,2488,29,21,8,0,0
2021,Lewes 006A,E01021027,1467,1428,39,28,9,2,0
2021,Lewes 006B,E01021028,1473,1427,46,26,13,7,0
2021,Lewes 006C,E01021029,1529,1481,48,30,15,3,0
2021,Lewes 006D,E01021030,1229,1184,45,26,13,5,1
2021,Lewes 006E,E01021031,1517,1402,115,51,49,14,1
2021,Lewes 002C,E01021032,1884,1840,44,25,14,5,0
2021,Lewes 003A,E01021033,1768,1722,46,32,11,1,2
2021,Lewes 003B,E01021034,1217,1176,41,22,12,6,1
2021,Lewes 003C,E01021035,1729,1670,59,37,20,2,0
2021,Lewes 003D,E01021036,1382,1357,25,20,3,1,1
2021,Lewes 003E,E01021037,1459,1433,26,15,7,3,1
2021,Lewes 003F,E01021038,1582,1541,41,23,14,4,0
2021,Lewes 005A,E01021039,1304,1249,55,36,11,7,1
2021,Lewes 005B,E01021040,1734,1673,61,36,14,10,1
2021,Lewes 005C,E01021041,1470,1425,45,34,8,3,0
2021,Lewes 005D,E01021042,1211,1186,25,18,7,0,0
2021,Lewes 005E,E01021043,1468,1425,43,28,10,5,0
2021,Lewes 009A,E01021044,2047,1948,99,51,33,10,5
2021,Lewes 008A,E01021045,1875,1814,61,35,18,8,0
2021,Lewes 008B,E01021046,1451,1422,29,14,9,6,0
2021,Lewes 008C,E01021047,1472,1438,34,16,13,3,2
2021,Lewes 008D,E01021048,1605,1526,79,42,28,6,3
2021,Lewes 009B,E01021049,1389,1289,100,53,30,17,0
2021,Lewes 009C,E01021050,1289,1243,46,27,15,4,0
2021,Lewes 009D,E01021051,1100,1068,32,13,16,3,0
2021,Lewes 001D,E01021052,1198,1189,9,8,1,0,0
2021,Lewes 001E,E01021053,1214,1202,12,5,7,0,0
2021,Lewes 004A,E01021054,1424,1400,24,15,8,1,0
2021,Lewes 004B,E01021055,1714,1688,26,15,7,3,1
2021,Lewes 004C,E01021056,1725,1680,45,22,16,5,2
2021,Lewes 004D,E01021057,1504,1479,25,8,14,3,0
2021,Lewes 010A,E01021058,1923,1834,89,37,33,19,0
2021,Lewes 010B,E01021059,1713,1639,74,37,25,9,3
2021,Lewes 010C,E01021060,2244,2120,124,83,26,10,5
2021,Lewes 007A,E01021061,1462,1394,68,39,23,5,1
2021,Lewes 010D,E01021062,1662,1568,94,61,26,6,1
2021,Lewes 007B,E01021063,1637,1582,55,29,21,4,1
2021,Lewes 007C,E01021064,1725,1617,108,63,29,12,4
2021,Lewes 007D,E01021065,1123,1041,82,47,22,10,3
2021,Lewes 007E,E01021066,1482,1435,47,31,11,2,3
2021,Lewes 002D,E01021067,1039,1030,9,9,0,0,0
2021,Lewes 002E,E01021068,1146,1135,11,10,1,0,0
2021,Lewes 011A,E01021069,1517,1482,35,25,8,2,0
2021,Lewes 013A,E01021070,1573,1518,55,34,17,4,0
2021,Lewes 013B,E01021071,1810,1717,93,45,28,18,2
2021,Lewes 012A,E01021072,1542,1526,16,14,0,2,0
2021,Lewes 012B,E01021073,1423,1406,17,8,7,2,0
2021,Lewes 012C,E01021074,1710,1682,28,21,5,2,0
2021,Lewes 011B,E01021075,1786,1769,17,13,4,0,0
2021,Lewes 012D,E01021076,1837,1796,41,19,11,8,3
2021,Lewes 011C,E01021077,1458,1434,24,19,2,2,1
2021,Lewes 012E,E01021078,1359,1325,34,25,7,2,0
2021,Lewes 013C,E01021079,1485,1453,32,21,9,2,0
2021,Lewes 013D,E01021080,1471,1445,26,12,10,4,0
2021,Lewes 011D,E01021081,1530,1509,21,12,5,2,2
2021,Lewes 011E,E01021082,1588,1571,17,15,2,0,0
2021,Lewes 011F,E01021083,1255,1232,23,19,3,1,0
2021,Rother 006A,E01021084,1849,1803,46,25,13,8,0
2021,Rother 006B,E01021085,1657,1642,15,12,3,0,0
2021,Rother 006C,E01021086,1770,1746,24,12,7,4,1
2021,Rother 005A,E01021087,1884,1856,28,21,4,3,0
2021,Rother 005B,E01021088,1567,1555,12,10,2,0,0
2021,Rother 005C,E01021089,1536,1519,17,8,5,3,1
2021,Rother 011A,E01021090,1621,1521,100,35,44,18,3
2021,Rother 011B,E01021091,2000,1862,138,63,42,31,2
2021,Rother 011C,E01021092,2086,2013,73,33,25,11,4
2021,Rother 009A,E01021093,1420,1401,19,12,5,2,0
2021,Rother 010A,E01021094,1467,1450,17,14,1,2,0
2021,Rother 009B,E01021095,1247,1234,13,7,4,0,2
2021,Rother 006D,E01021096,1269,1249,20,11,7,0,2
2021,Rother 006E,E01021097,1395,1387,8,7,1,0,0
2021,Rother 003A,E01021098,1726,1710,16,9,5,2,0
2021,Rother 003B,E01021099,1671,1640,31,18,10,3,0
2021,Rother 003C,E01021100,1653,1640,13,5,7,1,0
2021,Rother 004A,E01021101,1630,1622,8,7,1,0,0
2021,Rother 004B,E01021102,1445,1433,12,7,5,0,0
2021,Rother 002A,E01021103,1410,1382,28,17,6,5,0
2021,Rother 003D,E01021104,1457,1442,15,10,3,0,2
2021,Rother 003E,E01021105,1224,1206,18,12,2,2,2
2021,Rother 010B,E01021106,1696,1678,18,7,8,1,2
2021,Rother 010C,E01021107,1517,1501,16,12,0,4,0
2021,Rother 010D,E01021108,1449,1428,21,14,7,0,0
2021,Rother 005D,E01021109,1791,1686,105,47,39,12,7
2021,Rother 005E,E01021110,2273,2246,27,18,8,1,0
2021,Rother 007A,E01021111,1064,1040,24,19,4,1,0
2021,Rother 008A,E01021112,1367,1338,29,18,7,2,2
2021,Rother 007B,E01021113,1644,1608,36,26,7,3,0
2021,Rother 002B,E01021114,1715,1702,13,10,3,0,0
2021,Rother 002C,E01021115,1577,1561,16,12,2,2,0
2021,Rother 002D,E01021116,1533,1513,20,15,3,2,0
2021,Rother 004C,E01021117,1522,1492,30,20,9,1,0
2021,Rother 004D,E01021118,1763,1742,21,15,6,0,0
2021,Rother 004E,E01021119,1084,1066,18,9,5,3,1
2021,Rother 008B,E01021120,1517,1472,45,29,14,1,1
2021,Rother 011D,E01021121,1548,1493,55,29,15,10,1
2021,Rother 011E,E01021122,1474,1412,62,25,33,4,0
2021,Rother 009C,E01021123,1520,1498,22,13,7,2,0
2021,Rother 009D,E01021124,2095,2069,26,13,11,1,1
2021,Rother 009E,E01021125,1263,1245,18,13,5,0,0
2021,Rother 008C,E01021126,1518,1427,91,51,34,6,0
2021,Rother 008D,E01021127,1564,1532,32,15,13,2,2
2021,Rother 008E,E01021128,1883,1842,41,17,18,5,1
2021,Rother 009F,E01021129,1703,1680,23,18,5,0,0
2021,Rother 010E,E01021130,1465,1434,31,18,8,3,2
2021,Rother 007C,E01021131,1500,1460,40,21,19,0,0
2021,Rother 001A,E01021132,1458,1434,24,16,8,0,0
2021,Rother 001B,E01021133,1563,1554,9,8,1,0,0
2021,Rother 001C,E01021134,1451,1420,31,8,13,10,0
2021,Rother 007D,E01021135,1872,1835,37,17,15,5,0
2021,Rother 007E,E01021136,1300,1264,36,19,10,3,4
2021,Rother 007F,E01021137,1607,1589,18,12,6,0,0
2021,Rother 009G,E01021138,1127,1116,11,4,3,2,2
2021,Rother 001D,E01021139,1365,1357,8,5,0,3,0
2021,Rother 001E,E01021140,1694,1666,28,18,6,4,0
2021,Rother 001F,E01021141,1466,1453,13,9,4,0,0
2021,Wealden 018A,E01021142,1117,1110,7,4,3,0,0
2021,Wealden 018B,E01021143,1152,1145,7,6,1,0,0
2021,Wealden 008A,E01021144,1686,1668,18,13,5,0,0
2021,Wealden 008B,E01021145,2179,2141,38,23,11,0,4
2021,Wealden 013A,E01021146,2201,2174,27,16,9,1,1
2021,Wealden 013B,E01021147,1634,1608,26,17,8,0,1
2021,Wealden 013C,E01021148,1473,1452,21,14,6,0,1
2021,Wealden 011A,E01021149,1379,1358,21,11,8,2,0
2021,Wealden 010A,E01021150,1401,1366,35,9,19,6,1
2021,Wealden 006A,E01021151,1822,1785,37,22,11,2,2
2021,Wealden 006B,E01021152,1778,1610,168,92,58,18,0
2021,Wealden 006C,E01021153,1926,1880,46,34,9,3,0
2021,Wealden 006D,E01021154,1400,1371,29,13,11,5,0
2021,Wealden 006E,E01021155,1183,1141,42,19,17,6,0
2021,Wealden 003A,E01021156,1873,1797,76,42,23,11,0
2021,Wealden 003B,E01021157,1755,1721,34,17,7,6,4
2021,Wealden 003C,E01021158,2247,2222,25,22,3,0,0
2021,Wealden 004A,E01021159,2307,2282,25,22,3,0,0
2021,Wealden 004B,E01021160,1661,1605,56,30,22,4,0
2021,Wealden 004C,E01021161,1583,1558,25,14,8,3,0
2021,Wealden 004D,E01021162,1584,1546,38,23,8,7,0
2021,Wealden 007A,E01021163,2072,2042,30,21,7,1,1
2021,Wealden 007B,E01021164,1788,1745,43,33,8,2,0
2021,Wealden 013D,E01021165,1266,1245,21,11,9,1,0
2021,Wealden 018C,E01021166,2193,2165,28,20,6,2,0
2021,Wealden 001A,E01021167,2239,2152,87,58,19,7,3
2021,Wealden 001B,E01021168,1617,1548,69,47,18,4,0
2021,Wealden 001C,E01021169,1215,1152,63,40,17,6,0
2021,Wealden 008C,E01021170,2724,2706,18,12,4,2,0
2021,Wealden 002A,E01021171,1972,1946,26,16,6,3,1
2021,Wealden 002B,E01021172,1693,1669,24,12,8,4,0
2021,Wealden 002C,E01021173,1444,1430,14,12,1,1,0
2021,Wealden 015A,E01021174,2026,1994,32,24,7,1,0
2021,Wealden 015B,E01021175,1399,1392,7,4,3,0,0
2021,Wealden 015C,E01021176,1483,1462,21,12,9,0,0
2021,Wealden 015D,E01021177,1419,1362,57,27,20,8,2
2021,Wealden 017A,E01021178,1558,1512,46,21,20,5,0
2021,Wealden 017B,E01021179,1615,1575,40,21,14,5,0
2021,Wealden 016A,E01021180,1416,1391,25,15,5,5,0
2021,Wealden 016B,E01021181,1415,1396,19,8,7,4,0
2021,Wealden 016C,E01021182,1541,1508,33,13,17,3,0
2021,Wealden 016D,E01021183,1246,1209,37,18,14,5,0
2021,Wealden 017C,E01021184,1514,1496,18,10,7,1,0
2021,Wealden 017D,E01021185,1415,1368,47,28,17,2,0
2021,Wealden 001D,E01021186,1215,1199,16,7,7,1,1
2021,Wealden 007C,E01021187,1377,1332,45,18,20,7,0
2021,Wealden 014A,E01021188,1108,1106,2,0,2,0,0
2021,Wealden 011B,E01021189,1313,1289,24,19,2,3,0
2021,Wealden 011C,E01021190,1424,1421,3,1,1,1,0
2021,Wealden 010B,E01021191,1586,1545,41,24,11,4,2
2021,Wealden 010C,E01021192,1480,1455,25,16,5,2,2
2021,Wealden 010D,E01021193,1732,1717,15,14,0,1,0
2021,Wealden 010E,E01021194,1662,1629,33,17,12,4,0
2021,Wealden 018E,E01021196,2011,1986,25,14,10,1,0
2021,Wealden 014B,E01021198,1551,1522,29,19,9,1,0
2021,Wealden 014C,E01021199,1291,1287,4,3,1,0,0
2021,Wealden 011D,E01021200,1378,1360,18,14,3,1,0
2021,Wealden 011E,E01021201,1661,1645,16,12,4,0,0
2021,Wealden 005A,E01021202,1203,1155,48,37,6,5,0
2021,Wealden 005B,E01021203,1546,1533,13,12,1,0,0
2021,Wealden 014D,E01021204,1173,1161,12,6,5,1,0
2021,Wealden 014E,E01021205,1205,1200,5,4,0,0,1
2021,Wealden 020A,E01021206,1500,1476,24,17,7,0,0
2021,Wealden 020B,E01021207,1360,1352,8,8,0,0,0
2021,Wealden 020C,E01021208,2540,2487,53,35,12,6,0
2021,Wealden 020D,E01021209,2302,2259,43,24,16,3,0
2021,Wealden 020E,E01021210,1594,1559,35,22,8,5,0
2021,Wealden 020F,E01021211,1485,1443,42,21,16,5,0
2021,Wealden 019B,E01021213,1776,1721,55,31,18,5,1
2021,Wealden 019C,E01021214,1728,1705,23,9,10,3,1
2021,Wealden 019D,E01021215,1310,1282,28,16,10,2,0
2021,Wealden 019E,E01021216,1100,1074,26,17,3,3,3
2021,Wealden 008D,E01021217,1250,1239,11,5,5,1,0
2021,Wealden 002D,E01021218,1151,1144,7,5,0,2,0
2021,Wealden 009A,E01021219,1286,1275,11,4,5,2,0
2021,Wealden 009B,E01021220,1580,1504,76,36,24,16,0
2021,Wealden 012A,E01021221,1267,1233,34,17,14,3,0
2021,Wealden 012B,E01021222,1447,1396,51,20,15,13,3
2021,Wealden 009C,E01021223,1069,1051,18,13,3,2,0
2021,Wealden 009D,E01021224,1488,1444,44,15,20,7,2
2021,Wealden 009E,E01021225,1570,1548,22,12,6,4,0
2021,Wealden 009F,E01021226,1276,1239,37,19,13,4,1
2021,Wealden 012C,E01021227,1974,1933,41,24,12,3,2
2021,Wealden 012D,E01021228,1651,1625,26,15,8,3,0
2021,Wealden 005C,E01021229,1795,1740,55,22,20,11,2
2021,Wealden 005D,E01021230,1699,1668,31,26,3,1,1
2021,Wealden 005E,E01021231,1695,1670,25,16,6,3,0
2021,Wealden 021A,E01021232,1652,1608,44,23,14,5,2
2021,Wealden 021B,E01021233,1478,1439,39,27,10,1,1
2021,Wealden 021C,E01021234,1415,1406,9,7,2,0,0
2021,Wealden 021D,E01021235,1312,1297,15,9,3,2,1
2021,Wealden 021E,E01021236,1540,1529,11,7,1,2,1
2021,Basildon 001A,E01021237,1342,1322,20,14,5,1,0
2021,Basildon 001B,E01021238,1327,1312,15,11,3,1,0
2021,Basildon 003A,E01021239,1414,1396,18,15,2,1,0
2021,Basildon 003B,E01021240,1704,1646,58,29,21,6,2
2021,Basildon 003C,E01021241,1646,1556,90,47,32,10,1
2021,Basildon 001C,E01021242,1210,1172,38,28,4,4,2
2021,Basildon 003D,E01021243,1618,1576,42,26,14,1,1
2021,Basildon 004A,E01021244,1513,1464,49,32,14,3,0
2021,Basildon 002A,E01021245,1397,1357,40,26,12,2,0
2021,Basildon 002B,E01021246,1395,1371,24,12,8,4,0
2021,Basildon 003E,E01021247,1463,1432,31,24,6,1,0
2021,Basildon 002C,E01021248,1462,1412,50,29,13,7,1
2021,Basildon 002D,E01021249,1495,1469,26,13,10,2,1
2021,Basildon 001D,E01021250,1499,1468,31,23,4,4,0
2021,Basildon 001E,E01021251,1538,1511,27,16,8,3,0
2021,Basildon 002E,E01021252,1329,1313,16,10,1,5,0
2021,Basildon 004B,E01021253,1718,1683,35,19,13,3,0
2021,Basildon 009A,E01021254,1464,1433,31,25,4,2,0
2021,Basildon 004C,E01021255,1490,1450,40,28,10,2,0
2021,Basildon 004D,E01021256,1451,1427,24,16,6,2,0
2021,Basildon 009B,E01021257,1514,1492,22,14,4,3,1
2021,Basildon 004E,E01021258,1650,1613,37,25,5,5,2
2021,Basildon 009C,E01021259,1498,1470,28,19,8,0,1
2021,Basildon 009D,E01021260,1787,1758,29,13,13,3,0
2021,Basildon 010A,E01021261,1654,1610,44,25,15,1,3
2021,Basildon 010B,E01021262,1511,1488,23,12,7,4,0
2021,Basildon 010C,E01021263,1806,1748,58,35,19,4,0
2021,Basildon 006A,E01021264,1438,1411,27,17,8,2,0
2021,Basildon 012A,E01021265,1721,1598,123,55,50,14,4
2021,Basildon 015A,E01021266,1710,1558,152,73,50,24,5
2021,Basildon 012B,E01021267,1904,1823,81,38,31,9,3
2021,Basildon 015B,E01021268,1621,1516,105,45,38,20,2
2021,Basildon 012C,E01021269,2036,1919,117,58,39,12,8
2021,Basildon 012D,E01021270,2105,1981,124,63,35,24,2
2021,Basildon 013A,E01021271,1772,1663,109,50,36,20,3
2021,Basildon 012E,E01021272,1573,1492,81,36,40,5,0
2021,Basildon 014A,E01021273,1832,1742,90,43,31,16,0
2021,Basildon 010D,E01021274,1855,1772,83,51,25,7,0
2021,Basildon 014B,E01021275,1608,1542,66,37,18,9,2
2021,Basildon 014C,E01021276,1466,1366,100,45,40,15,0
2021,Basildon 014D,E01021277,1372,1320,52,27,20,5,0
2021,Basildon 010E,E01021279,1585,1504,81,43,22,14,2
2021,Basildon 021A,E01021280,1429,1380,49,36,6,7,0
2021,Basildon 021B,E01021281,1426,1375,51,27,16,6,2
2021,Basildon 021C,E01021282,1510,1482,28,19,5,4,0
2021,Basildon 021D,E01021283,1525,1461,64,32,24,8,0
2021,Basildon 021E,E01021284,1477,1389,88,63,19,6,0
2021,Basildon 021F,E01021285,1361,1307,54,34,12,8,0
2021,Basildon 016A,E01021286,1914,1724,190,80,85,23,2
2021,Basildon 017A,E01021287,1530,1402,128,75,40,11,2
2021,Basildon 016B,E01021288,1687,1592,95,45,44,6,0
2021,Basildon 016C,E01021289,1860,1783,77,42,23,12,0
2021,Basildon 016D,E01021290,1805,1744,61,31,23,7,0
2021,Basildon 016E,E01021291,2061,1841,220,121,84,13,2
2021,Basildon 017B,E01021292,1651,1500,151,77,58,16,0
2021,Basildon 017C,E01021293,1770,1556,214,115,74,23,2
2021,Basildon 020A,E01021294,1697,1589,108,79,25,4,0
2021,Basildon 020B,E01021295,1600,1495,105,55,37,12,1
2021,Basildon 020D,E01021297,2114,1845,269,178,67,21,3
2021,Basildon 017D,E01021298,1528,1396,132,87,33,9,3
2021,Basildon 020E,E01021299,1505,1411,94,62,27,3,2
2021,Basildon 022A,E01021300,2035,1897,138,66,50,19,3
2021,Basildon 011A,E01021301,1477,1413,64,27,33,3,1
2021,Basildon 013B,E01021302,1609,1535,74,35,29,9,1
2021,Basildon 011B,E01021303,1345,1262,83,35,37,9,2
2021,Basildon 013C,E01021304,1395,1301,94,35,31,19,9
2021,Basildon 013D,E01021305,1390,1284,106,44,42,20,0
2021,Basildon 013E,E01021306,1423,1322,101,38,45,15,3
2021,Basildon 011C,E01021307,1335,1253,82,29,34,14,5
2021,Basildon 011D,E01021308,1183,1140,43,25,13,5,0
2021,Basildon 011E,E01021309,1307,1239,68,34,20,11,3
2021,Basildon 022B,E01021310,1276,1187,89,38,44,6,1
2021,Basildon 022C,E01021311,1364,1245,119,49,51,19,0
2021,Basildon 011F,E01021312,1593,1543,50,13,25,12,0
2021,Basildon 018A,E01021313,1425,1390,35,16,14,4,1
2021,Basildon 018B,E01021314,1381,1294,87,32,40,14,1
2021,Basildon 018C,E01021315,1491,1414,77,26,34,13,4
2021,Basildon 018D,E01021316,1665,1547,118,64,34,16,4
2021,Basildon 018E,E01021317,1592,1466,126,56,57,11,2
2021,Basildon 015C,E01021318,2482,2110,372,155,150,60,7
2021,Basildon 017E,E01021319,2299,1946,353,160,119,61,13
2021,Basildon 015D,E01021320,1658,1491,167,75,61,28,3
2021,Basildon 015E,E01021321,1630,1434,196,84,80,23,9
2021,Basildon 019A,E01021322,1569,1437,132,65,45,18,4
2021,Basildon 019B,E01021323,1736,1648,88,40,36,9,3
2021,Basildon 019C,E01021324,1723,1643,80,30,32,14,4
2021,Basildon 019D,E01021325,1566,1450,116,42,60,12,2
2021,Basildon 022D,E01021326,1802,1676,126,45,57,20,4
2021,Basildon 019E,E01021327,1671,1586,85,41,28,16,0
2021,Basildon 022E,E01021328,1509,1400,109,42,47,14,6
2021,Basildon 006B,E01021329,1461,1435,26,16,7,3,0
2021,Basildon 006C,E01021330,1572,1541,31,17,13,1,0
2021,Basildon 008A,E01021331,1800,1725,75,34,24,17,0
2021,Basildon 006D,E01021332,1391,1376,15,10,2,2,1
2021,Basildon 006E,E01021333,1518,1507,11,6,3,1,1
2021,Basildon 005A,E01021334,1671,1634,37,22,7,8,0
2021,Basildon 007A,E01021335,1349,1309,40,21,11,7,1
2021,Basildon 005B,E01021336,1654,1619,35,17,14,3,1
2021,Basildon 007B,E01021337,1459,1435,24,10,3,11,0
2021,Basildon 005C,E01021338,2053,1996,57,32,18,5,2
2021,Basildon 005D,E01021339,1393,1367,26,16,6,3,1
2021,Basildon 007C,E01021340,1741,1714,27,15,8,2,2
2021,Basildon 007D,E01021341,1630,1615,15,7,4,4,0
2021,Basildon 008B,E01021342,1607,1584,23,13,8,2,0
2021,Basildon 008C,E01021343,1683,1655,28,15,11,2,0
2021,Basildon 008D,E01021344,2161,2123,38,24,12,1,1
2021,Basildon 007E,E01021345,1992,1965,27,10,12,5,0
2021,Basildon 008E,E01021346,2049,1994,55,32,12,8,3
2021,Braintree 013A,E01021347,2617,2564,53,31,16,4,2
2021,Braintree 018A,E01021348,1554,1529,25,18,4,3,0
2021,Braintree 007A,E01021349,1356,1310,46,26,15,5,0
2021,Braintree 009A,E01021350,1775,1712,63,36,20,7,0
2021,Braintree 007B,E01021351,1562,1505,57,23,25,7,2
2021,Braintree 007C,E01021352,1511,1469,42,20,13,6,3
2021,Braintree 009B,E01021353,1695,1610,85,48,22,14,1
2021,Braintree 008A,E01021354,1202,1150,52,34,13,5,0
2021,Braintree 007D,E01021355,1986,1950,36,16,16,3,1
2021,Braintree 007E,E01021356,1469,1456,13,8,4,1,0
2021,Braintree 008B,E01021357,1493,1461,32,11,13,8,0
2021,Braintree 008C,E01021358,2434,2303,131,77,40,11,3
2021,Braintree 008D,E01021359,2028,1926,102,53,34,12,3
2021,Braintree 012A,E01021360,1807,1785,22,13,6,2,1
2021,Braintree 012B,E01021361,1702,1686,16,10,5,0,1
2021,Braintree 015A,E01021362,2210,2157,53,33,18,2,0
2021,Braintree 010A,E01021364,1629,1557,72,33,22,15,2
2021,Braintree 009D,E01021365,2374,2147,227,99,91,31,6
2021,Braintree 010B,E01021366,1596,1547,49,31,12,5,1
2021,Braintree 012C,E01021367,1435,1394,41,26,10,5,0
2021,Braintree 011A,E01021368,1504,1400,104,48,42,12,2
2021,Braintree 012D,E01021369,2714,2592,122,63,49,6,4
2021,Braintree 011B,E01021370,1670,1566,104,45,40,15,4
2021,Braintree 013B,E01021371,1640,1598,42,26,14,2,0
2021,Braintree 011C,E01021372,2037,1928,109,57,38,12,2
2021,Braintree 011E,E01021374,1474,1398,76,27,40,9,0
2021,Braintree 001A,E01021375,1060,1055,5,3,0,1,1
2021,Braintree 001B,E01021376,1391,1372,19,15,4,0,0
2021,Braintree 014A,E01021377,1752,1723,29,17,8,2,2
2021,Braintree 014B,E01021378,1536,1522,14,12,2,0,0
2021,Braintree 014C,E01021379,1762,1747,15,9,4,1,1
2021,Braintree 012E,E01021380,2564,2510,54,33,18,2,1
2021,Braintree 007F,E01021381,1202,1184,18,5,8,3,2
2021,Braintree 003A,E01021382,1866,1852,14,10,2,2,0
2021,Braintree 010C,E01021383,2195,2147,48,31,12,5,0
2021,Braintree 013C,E01021384,2224,2172,52,32,10,9,1
2021,Braintree 013D,E01021385,1238,1219,19,9,7,3,0
2021,Braintree 013E,E01021386,1560,1533,27,17,5,5,0
2021,Braintree 004A,E01021387,2049,1971,78,37,27,12,2
2021,Braintree 004B,E01021388,1708,1654,54,24,23,7,0
2021,Braintree 006A,E01021389,2096,2074,22,14,8,0,0
2021,Braintree 006B,E01021390,1799,1773,26,15,7,3,1
2021,Braintree 004C,E01021391,1614,1577,37,24,12,1,0
2021,Braintree 004D,E01021392,1682,1635,47,24,19,4,0
2021,Braintree 004E,E01021393,1530,1504,26,5,13,7,1
2021,Braintree 018B,E01021394,1405,1389,16,12,2,2,0
2021,Braintree 018C,E01021395,1452,1432,20,6,8,3,3
2021,Braintree 018D,E01021396,1347,1339,8,6,1,1,0
2021,Braintree 003B,E01021397,2354,2279,75,32,32,10,1
2021,Braintree 002A,E01021398,1432,1428,4,3,1,0,0
2021,Braintree 003C,E01021399,1647,1641,6,3,1,2,0
2021,Braintree 003D,E01021400,1691,1679,12,4,6,0,2
2021,Braintree 014D,E01021401,1584,1563,21,8,12,1,0
2021,Braintree 014E,E01021402,1985,1962,23,7,12,3,1
2021,Braintree 014F,E01021403,1555,1544,11,8,3,0,0
2021,Braintree 005A,E01021404,2133,2107,26,10,12,3,1
2021,Braintree 010D,E01021405,2282,2252,30,14,9,5,2
2021,Braintree 002B,E01021406,2240,2228,12,10,0,1,1
2021,Braintree 002C,E01021407,2173,2153,20,13,4,1,2
2021,Braintree 006C,E01021408,1757,1739,18,11,6,1,0
2021,Braintree 006D,E01021409,1777,1770,7,1,5,1,0
2021,Braintree 006E,E01021410,1807,1768,39,17,11,8,3
2021,Braintree 005B,E01021411,1332,1320,12,10,2,0,0
2021,Braintree 005C,E01021412,1406,1392,14,11,1,1,1
2021,Braintree 005D,E01021413,1258,1252,6,4,1,1,0
2021,Braintree 001C,E01021414,2179,2161,18,11,5,2,0
2021,Braintree 017A,E01021415,1536,1487,49,26,13,8,2
2021,Braintree 017B,E01021416,1884,1774,110,28,50,27,5
2021,Braintree 015B,E01021417,1485,1467,18,7,5,5,1
2021,Braintree 015C,E01021418,1470,1405,65,32,25,8,0
2021,Braintree 015D,E01021419,1671,1629,42,9,22,9,2
2021,Braintree 017C,E01021420,1666,1575,91,40,38,12,1
2021,Braintree 017E,E01021422,1689,1641,48,21,17,8,2
2021,Braintree 016A,E01021423,1532,1443,89,39,34,16,0
2021,Braintree 018E,E01021424,2171,2095,76,29,29,16,2
2021,Braintree 016B,E01021425,1424,1376,48,20,21,7,0
2021,Braintree 015E,E01021426,1207,1166,41,23,10,7,1
2021,Braintree 016C,E01021427,1298,1229,69,26,35,8,0
2021,Braintree 015F,E01021428,1372,1349,23,11,6,6,0
2021,Braintree 016D,E01021429,1280,1234,46,18,22,6,0
2021,Braintree 001D,E01021430,2245,2203,42,29,8,4,1
2021,Brentwood 004A,E01021431,1582,1501,81,44,27,10,0
2021,Brentwood 004B,E01021432,1788,1706,82,51,18,12,1
2021,Brentwood 007A,E01021433,2100,1928,172,95,54,20,3
2021,Brentwood 004C,E01021434,1587,1515,72,43,19,10,0
2021,Brentwood 008A,E01021435,1817,1710,107,73,28,5,1
2021,Brentwood 008B,E01021437,1703,1644,59,30,18,8,3
2021,Brentwood 006A,E01021438,2145,2087,58,35,14,6,3
2021,Brentwood 001A,E01021441,1433,1418,15,9,0,5,1
2021,Brentwood 001B,E01021442,1254,1248,6,5,1,0,0
2021,Brentwood 001C,E01021443,1531,1504,27,14,7,6,0
2021,Brentwood 001D,E01021444,1667,1648,19,10,8,1,0
2021,Brentwood 009A,E01021445,2103,2064,39,26,7,1,5
2021,Brentwood 009B,E01021446,1592,1562,30,18,8,3,1
2021,Brentwood 005A,E01021447,2458,2351,107,76,23,8,0
2021,Brentwood 003A,E01021448,1486,1432,54,40,8,6,0
2021,Brentwood 003B,E01021449,1620,1579,41,24,13,3,1
2021,Brentwood 003C,E01021450,1928,1859,69,41,21,5,2
2021,Brentwood 003D,E01021451,1478,1400,78,58,12,8,0
2021,Brentwood 003E,E01021452,1433,1386,47,30,13,4,0
2021,Brentwood 005B,E01021453,1212,1151,61,38,16,7,0
2021,Brentwood 009C,E01021454,1122,1085,37,26,9,2,0
2021,Brentwood 005C,E01021455,1350,1304,46,31,7,6,2
2021,Brentwood 009D,E01021456,1184,1123,61,37,19,5,0
2021,Brentwood 002A,E01021457,1466,1438,28,18,9,1,0
2021,Brentwood 002B,E01021458,1670,1638,32,25,7,0,0
2021,Brentwood 002C,E01021459,1252,1240,12,8,4,0,0
2021,Brentwood 002D,E01021460,1775,1736,39,27,10,1,1
2021,Brentwood 004D,E01021461,1419,1369,50,29,20,0,1
2021,Brentwood 006B,E01021462,1378,1321,57,37,13,6,1
2021,Brentwood 006C,E01021463,1558,1513,45,27,10,7,1
2021,Brentwood 004E,E01021464,1525,1496,29,19,8,0,2
2021,Brentwood 005D,E01021465,1869,1770,99,64,23,9,3
2021,Brentwood 005E,E01021466,1701,1659,42,32,7,2,1
2021,Brentwood 005F,E01021467,1730,1690,40,30,9,1,0
2021,Brentwood 006D,E01021468,1943,1855,88,50,27,9,2
2021,Brentwood 001E,E01021469,1146,1142,4,3,1,0,0
2021,Brentwood 001F,E01021470,1040,1032,8,5,2,1,0
2021,Brentwood 001G,E01021471,1577,1563,14,13,1,0,0
2021,Brentwood 008C,E01021472,1721,1599,122,72,42,8,0
2021,Brentwood 008D,E01021473,1483,1384,99,54,34,9,2
2021,Brentwood 008E,E01021474,1490,1451,39,18,11,10,0
2021,Brentwood 007E,E01021475,1495,1348,147,80,43,17,7
2021,Castle Point 003A,E01021476,1926,1883,43,17,14,9,3
2021,Castle Point 003B,E01021477,1493,1472,21,6,11,3,1
2021,Castle Point 003C,E01021478,1744,1725,19,8,4,5,2
2021,Castle Point 004A,E01021479,1491,1478,13,6,4,2,1
2021,Castle Point 007A,E01021480,1702,1674,28,12,13,3,0
2021,Castle Point 004B,E01021481,1588,1567,21,14,4,2,1
2021,Castle Point 006A,E01021482,1506,1489,17,11,5,0,1
2021,Castle Point 004C,E01021483,1750,1728,22,12,6,3,1
2021,Castle Point 011A,E01021484,1307,1298,9,3,4,2,0
2021,Castle Point 010A,E01021485,1198,1172,26,7,11,7,1
2021,Castle Point 010B,E01021486,1272,1255,17,10,5,1,1
2021,Castle Point 008A,E01021487,1290,1272,18,8,7,3,0
2021,Castle Point 010C,E01021488,1470,1454,16,6,7,3,0
2021,Castle Point 012A,E01021489,1357,1344,13,6,6,1,0
2021,Castle Point 012B,E01021490,1378,1359,19,6,10,3,0
2021,Castle Point 012C,E01021491,1618,1601,17,8,7,2,0
2021,Castle Point 009A,E01021492,1589,1556,33,18,13,2,0
2021,Castle Point 009B,E01021493,1481,1456,25,6,14,3,2
2021,Castle Point 008B,E01021494,1380,1349,31,15,10,5,1
2021,Castle Point 009C,E01021495,2012,2001,11,3,7,1,0
2021,Castle Point 009D,E01021496,1411,1380,31,10,9,9,3
2021,Castle Point 012D,E01021497,1482,1461,21,10,11,0,0
2021,Castle Point 011B,E01021498,1582,1542,40,4,25,10,1
2021,Castle Point 011C,E01021499,1541,1526,15,4,5,4,2
2021,Castle Point 012E,E01021500,2316,2281,35,12,17,6,0
2021,Castle Point 011D,E01021501,1356,1343,13,4,5,4,0
2021,Castle Point 011E,E01021502,1977,1947,30,14,12,4,0
2021,Castle Point 010D,E01021503,1415,1388,27,8,12,6,1
2021,Castle Point 008C,E01021504,1442,1356,86,19,41,22,4
2021,Castle Point 008D,E01021505,1395,1359,36,15,9,11,1
2021,Castle Point 008E,E01021506,1229,1188,41,11,18,8,4
2021,Castle Point 010E,E01021507,1444,1406,38,16,13,7,2
2021,Castle Point 010F,E01021508,1280,1261,19,12,6,1,0
2021,Castle Point 002A,E01021509,1385,1363,22,9,8,5,0
2021,Castle Point 002B,E01021510,1428,1413,15,8,5,2,0
2021,Castle Point 002C,E01021511,1932,1877,55,35,13,4,3
2021,Castle Point 004D,E01021512,1481,1444,37,24,8,5,0
2021,Castle Point 001A,E01021513,1573,1555,18,6,8,4,0
2021,Castle Point 001B,E01021514,1490,1477,13,9,3,1,0
2021,Castle Point 001C,E01021515,1289,1270,19,9,4,4,2
2021,Castle Point 003D,E01021516,1297,1271,26,12,10,4,0
2021,Castle Point 005A,E01021517,1619,1608,11,6,4,1,0
2021,Castle Point 006B,E01021518,2039,1980,59,31,17,9,2
2021,Castle Point 005B,E01021519,1495,1470,25,21,4,0,0
2021,Castle Point 006C,E01021520,1482,1460,22,14,8,0,0
2021,Castle Point 007B,E01021521,1359,1344,15,10,3,2,0
2021,Castle Point 007C,E01021522,1812,1765,47,18,18,9,2
2021,Castle Point 007D,E01021523,1367,1358,9,6,2,1,0
2021,Castle Point 007E,E01021524,1581,1556,25,17,5,3,0
2021,Castle Point 001D,E01021525,1595,1535,60,30,17,13,0
2021,Castle Point 004E,E01021526,1550,1537,13,5,6,2,0
2021,Castle Point 001E,E01021527,1643,1610,33,16,11,6,0
2021,Castle Point 002D,E01021528,1543,1523,20,6,8,6,0
2021,Castle Point 006D,E01021529,1461,1432,29,12,13,3,1
2021,Castle Point 005C,E01021530,1414,1394,20,5,10,5,0
2021,Castle Point 002E,E01021531,1465,1449,16,12,3,0,1
2021,Castle Point 005D,E01021532,1362,1349,13,7,3,1,2
2021,Chelmsford 016A,E01021533,2233,2200,33,21,8,4,0
2021,Chelmsford 016B,E01021535,1724,1699,25,10,12,1,2
2021,Chelmsford 005A,E01021536,1553,1525,28,14,8,6,0
2021,Chelmsford 005B,E01021537,2289,2212,77,32,38,7,0
2021,Chelmsford 001A,E01021538,2855,2812,43,25,13,5,0
2021,Chelmsford 001B,E01021539,1352,1334,18,7,7,4,0
2021,Chelmsford 001C,E01021540,2095,2042,53,27,16,10,0
2021,Chelmsford 002A,E01021542,2335,2096,239,158,66,15,0
2021,Chelmsford 002B,E01021543,1686,1643,43,33,8,1,1
2021,Chelmsford 008A,E01021544,1222,1159,63,40,20,3,0
2021,Chelmsford 008B,E01021545,1513,1438,75,47,19,9,0
2021,Chelmsford 008C,E01021546,1376,1312,64,33,18,12,1
2021,Chelmsford 008D,E01021547,1419,1331,88,39,37,12,0
2021,Chelmsford 013A,E01021548,1196,1148,48,35,9,4,0
2021,Chelmsford 003A,E01021550,1737,1689,48,34,9,3,2
2021,Chelmsford 011A,E01021551,1373,1332,41,27,8,4,2
2021,Chelmsford 017A,E01021552,1493,1454,39,26,8,4,1
2021,Chelmsford 017B,E01021553,1290,1242,48,19,17,11,1
2021,Chelmsford 017C,E01021554,1352,1315,37,15,12,10,0
2021,Chelmsford 017D,E01021555,1327,1315,12,10,1,0,1
2021,Chelmsford 012A,E01021556,2073,1948,125,84,30,9,2
2021,Chelmsford 015A,E01021557,1237,1177,60,41,12,7,0
2021,Chelmsford 015B,E01021558,1152,1118,34,22,8,4,0
2021,Chelmsford 017E,E01021559,1364,1344,20,9,7,2,2
2021,Chelmsford 013B,E01021560,1664,1612,52,33,10,8,1
2021,Chelmsford 013C,E01021561,1800,1760,40,29,7,3,1
2021,Chelmsford 014A,E01021562,1660,1635,25,12,11,2,0
2021,Chelmsford 014B,E01021563,1663,1496,167,82,58,20,7
2021,Chelmsford 013D,E01021564,1487,1425,62,35,18,8,1
2021,Chelmsford 014C,E01021565,1594,1545,49,24,13,9,3
2021,Chelmsford 014D,E01021566,1621,1576,45,29,13,1,2
2021,Chelmsford 005D,E01021568,1574,1565,9,4,1,3,1
2021,Chelmsford 016C,E01021569,1707,1691,16,13,2,1,0
2021,Chelmsford 016D,E01021570,1902,1884,18,14,1,3,0
2021,Chelmsford 013E,E01021571,1507,1493,14,13,1,0,0
2021,Chelmsford 016E,E01021572,1462,1438,24,11,11,2,0
2021,Chelmsford 009A,E01021573,1719,1598,121,72,30,18,1
2021,Chelmsford 009B,E01021575,1643,1467,176,84,67,24,1
2021,Chelmsford 006A,E01021576,1652,1542,110,70,28,12,0
2021,Chelmsford 012B,E01021577,1489,1416,73,35,29,8,1
2021,Chelmsford 023D,E01021578,1746,1507,239,112,94,29,4
2021,Chelmsford 012C,E01021579,1736,1596,140,71,47,17,5
2021,Chelmsford 012D,E01021580,1435,1399,36,15,16,5,0
2021,Chelmsford 023C,E01021582,2016,1751,265,151,81,33,0
2021,Chelmsford 015C,E01021583,1537,1449,88,46,33,8,1
2021,Chelmsford 012E,E01021584,1230,1182,48,30,14,4,0
2021,Chelmsford 015D,E01021585,1235,1206,29,20,7,1,1
2021,Chelmsford 015E,E01021586,1497,1438,59,28,21,10,0
2021,Chelmsford 002C,E01021587,1440,1370,70,53,9,3,5
2021,Chelmsford 006B,E01021588,1337,1220,117,72,35,9,1
2021,Chelmsford 006C,E01021589,1524,1395,129,90,30,7,2
2021,Chelmsford 002D,E01021590,1370,1298,72,49,17,6,0
2021,Chelmsford 002E,E01021591,1569,1445,124,82,32,10,0
2021,Chelmsford 006D,E01021592,1595,1449,146,59,61,24,2
2021,Chelmsford 021A,E01021593,1579,1565,14,8,3,2,1
2021,Chelmsford 021C,E01021595,1797,1773,24,15,8,1,0
2021,Chelmsford 006E,E01021596,1559,1396,163,76,51,29,7
2021,Chelmsford 003B,E01021597,1501,1404,97,46,33,18,0
2021,Chelmsford 003C,E01021598,1541,1442,99,39,36,24,0
2021,Chelmsford 009C,E01021599,1788,1671,117,69,26,17,5
2021,Chelmsford 003D,E01021600,1108,1051,57,32,21,4,0
2021,Chelmsford 003E,E01021601,1478,1403,75,38,22,14,1
2021,Chelmsford 018B,E01021602,1684,1662,22,16,4,2,0
2021,Chelmsford 018D,E01021604,2276,2262,14,10,3,1,0
2021,Chelmsford 020A,E01021605,1148,1136,12,10,1,1,0
2021,Chelmsford 020B,E01021606,1568,1548,20,13,4,3,0
2021,Chelmsford 020C,E01021607,1412,1379,33,21,9,3,0
2021,Chelmsford 020D,E01021608,1092,1073,19,7,8,4,0
2021,Chelmsford 020E,E01021609,1320,1309,11,8,0,1,2
2021,Chelmsford 020F,E01021610,1212,1185,27,10,7,8,2
2021,Chelmsford 019A,E01021611,1362,1358,4,1,2,1,0
2021,Chelmsford 019B,E01021612,1420,1410,10,5,5,0,0
2021,Chelmsford 019C,E01021613,1790,1743,47,24,16,7,0
2021,Chelmsford 019D,E01021614,1728,1719,9,2,3,3,1
2021,Chelmsford 019E,E01021615,1470,1456,14,9,3,1,1
2021,Chelmsford 004B,E01021617,1271,1191,80,44,27,8,1
2021,Chelmsford 007A,E01021618,1398,1334,64,39,20,4,1
2021,Chelmsford 004C,E01021619,1389,1327,62,37,19,5,1
2021,Chelmsford 004D,E01021620,1405,1299,106,56,38,12,0
2021,Chelmsford 007B,E01021621,1498,1374,124,58,48,15,3
2021,Chelmsford 007C,E01021622,1487,1424,63,32,23,8,0
2021,Chelmsford 004E,E01021623,1189,1091,98,60,32,4,2
2021,Chelmsford 004F,E01021624,1201,1141,60,39,17,3,1
2021,Chelmsford 007D,E01021625,1419,1335,84,48,25,9,2
2021,Chelmsford 007E,E01021626,1448,1371,77,48,21,6,2
2021,Chelmsford 022B,E01021627,1563,1443,120,62,42,14,2
2021,Chelmsford 008E,E01021628,1795,1675,120,71,38,10,1
2021,Chelmsford 008F,E01021629,1749,1591,158,81,56,20,1
2021,Chelmsford 009E,E01021631,1852,1662,190,71,75,40,4
2021,Chelmsford 011B,E01021632,1517,1445,72,42,21,6,3
2021,Chelmsford 011C,E01021633,1310,1269,41,27,9,5,0
2021,Chelmsford 011D,E01021634,1426,1411,15,12,0,3,0
2021,Chelmsford 011E,E01021635,1346,1317,29,19,5,4,1
2021,Chelmsford 011F,E01021636,1114,1074,40,25,9,4,2
2021,Colchester 018A,E01021637,1163,1090,73,37,31,3,2
2021,Colchester 018B,E01021638,1945,1827,118,61,45,11,1
2021,Colchester 018C,E01021639,2220,2100,120,62,47,11,0
2021,Colchester 018D,E01021640,1173,1121,52,28,14,8,2
2021,Colchester 018E,E01021641,1474,1415,59,30,16,10,3
2021,Colchester 018F,E01021642,2102,1915,187,84,68,27,8
2021,Colchester 019A,E01021643,2392,2384,8,7,1,0,0
2021,Colchester 019B,E01021644,1689,1678,11,6,5,0,0
2021,Colchester 019C,E01021645,1439,1429,10,3,7,0,0
2021,Colchester 007A,E01021646,2054,1819,235,135,77,18,5
2021,Colchester 007B,E01021647,2243,1966,277,152,90,32,3
2021,Colchester 007C,E01021648,2296,2056,240,127,78,30,5
2021,Colchester 007E,E01021650,2088,1725,363,185,131,42,5
2021,Colchester 013A,E01021651,2347,2123,224,121,77,24,2
2021,Colchester 013B,E01021652,1542,1475,67,41,14,11,1
2021,Colchester 013C,E01021653,1289,1242,47,35,10,2,0
2021,Colchester 001A,E01021655,1352,1321,31,17,7,7,0
2021,Colchester 001B,E01021656,1611,1595,16,10,4,2,0
2021,Colchester 016A,E01021657,2050,1987,63,37,21,3,2
2021,Colchester 016B,E01021658,1054,1014,40,18,14,6,2
2021,Colchester 001C,E01021659,2055,2037,18,9,4,5,0
2021,Colchester 003A,E01021660,1462,1448,14,9,2,1,2
2021,Colchester 001D,E01021661,1941,1898,43,28,14,1,0
2021,Colchester 010B,E01021662,1502,1489,13,6,5,2,0
2021,Colchester 010C,E01021663,1102,1086,16,8,8,0,0
2021,Colchester 016C,E01021664,1902,1772,130,55,49,23,3
2021,Colchester 016D,E01021665,1369,1298,71,40,22,6,3
2021,Colchester 016E,E01021666,1262,1170,92,48,31,11,2
2021,Colchester 016F,E01021667,1473,1419,54,27,18,8,1
2021,Colchester 002A,E01021668,1506,1373,133,73,38,20,2
2021,Colchester 002B,E01021669,1380,1268,112,71,31,8,2
2021,Colchester 002C,E01021670,1394,1282,112,67,30,10,5
2021,Colchester 002D,E01021671,1411,1331,80,54,22,4,0
2021,Colchester 009A,E01021673,1420,1371,49,34,8,6,1
2021,Colchester 009B,E01021674,1348,1292,56,22,26,5,3
2021,Colchester 009C,E01021675,1306,1266,40,20,17,3,0
2021,Colchester 009D,E01021676,1597,1495,102,57,32,10,3
2021,Colchester 010D,E01021677,1186,1172,14,7,5,2,0
2021,Colchester 010E,E01021678,1377,1339,38,20,14,1,3
2021,Colchester 011A,E01021683,2079,1751,328,152,98,47,31
2021,Colchester 011B,E01021684,1468,1354,114,61,42,11,0
2021,Colchester 011E,E01021687,1749,1506,243,109,102,29,3
2021,Colchester 011F,E01021688,1716,1528,188,93,70,20,5
2021,Colchester 014A,E01021689,1474,1417,57,29,27,1,0
2021,Colchester 014B,E01021690,1273,1230,43,26,15,2,0
2021,Colchester 014C,E01021691,1511,1456,55,37,15,3,0
2021,Colchester 014D,E01021692,1400,1345,55,32,18,4,1
2021,Colchester 014E,E01021693,1681,1640,41,24,10,7,0
2021,Colchester 019D,E01021694,1446,1434,12,8,3,1,0
2021,Colchester 019E,E01021695,1145,1134,11,6,4,1,0
2021,Colchester 008A,E01021696,1487,1324,163,78,61,19,5
2021,Colchester 008B,E01021697,1662,1496,166,87,57,18,4
2021,Colchester 008C,E01021698,1520,1368,152,82,55,12,3
2021,Colchester 008D,E01021699,1421,1275,146,81,49,13,3
2021,Colchester 008E,E01021700,1336,1166,170,76,70,22,2
2021,Colchester 022D,E01021702,1285,1162,123,51,49,20,3
2021,Colchester 022E,E01021703,1286,1170,116,52,40,23,1
2021,Colchester 022F,E01021704,1457,1332,125,64,46,15,0
2021,Colchester 022G,E01021705,1904,1851,53,38,6,9,0
2021,Colchester 022H,E01021706,1326,1132,194,97,67,27,3
2021,Colchester 022I,E01021707,1331,1270,61,36,17,7,1
2021,Colchester 022A,E01021708,1410,1360,50,32,10,5,3
2021,Colchester 022B,E01021709,1461,1410,51,31,11,8,1
2021,Colchester 022C,E01021710,2241,2152,89,46,28,11,4
2021,Colchester 015A,E01021711,1365,1296,69,34,23,9,3
2021,Colchester 015C,E01021713,1259,1215,44,27,10,5,2
2021,Colchester 015D,E01021714,1792,1592,200,79,73,36,12
2021,Colchester 015E,E01021715,1460,1398,62,38,16,7,1
2021,Colchester 013D,E01021717,2642,2476,166,94,56,11,5
2021,Colchester 012A,E01021718,1799,1752,47,34,11,1,1
2021,Colchester 012B,E01021719,1561,1495,66,39,15,8,4
2021,Colchester 012C,E01021720,1567,1502,65,38,22,5,0
2021,Colchester 012D,E01021721,1925,1858,67,43,14,10,0
2021,Colchester 012E,E01021722,2439,2364,75,46,20,7,2
2021,Colchester 020A,E01021723,1837,1789,48,26,15,6,1
2021,Colchester 020B,E01021724,1633,1611,22,16,5,1,0
2021,Colchester 020C,E01021725,1437,1393,44,25,19,0,0
2021,Colchester 020D,E01021726,1471,1451,20,12,8,0,0
2021,Colchester 020E,E01021727,1491,1474,17,7,7,3,0
2021,Colchester 003B,E01021728,1632,1619,13,9,2,2,0
2021,Colchester 003C,E01021729,1603,1587,16,9,5,2,0
2021,Colchester 003D,E01021730,1722,1699,23,11,8,4,0
2021,Colchester 021A,E01021731,1396,1378,18,7,5,1,5
2021,Colchester 021B,E01021732,1489,1480,9,7,1,1,0
2021,Colchester 021C,E01021733,1533,1525,8,7,1,0,0
2021,Colchester 021D,E01021734,1342,1330,12,9,3,0,0
2021,Colchester 021E,E01021735,1342,1338,4,3,1,0,0
2021,Colchester 017A,E01021736,2369,2046,323,228,86,9,0
2021,Colchester 017B,E01021737,1111,1068,43,24,18,1,0
2021,Colchester 017C,E01021738,2138,2047,91,68,17,6,0
2021,Colchester 017D,E01021739,1495,1469,26,16,7,1,2
2021,Colchester 017E,E01021740,1668,1600,68,53,14,0,1
2021,Epping Forest 002A,E01021741,2226,2120,106,36,31,25,14
2021,Epping Forest 015A,E01021742,1282,1215,67,30,30,6,1
2021,Epping Forest 015B,E01021743,1634,1526,108,69,35,4,0
2021,Epping Forest 015C,E01021744,1606,1475,131,66,39,23,3
2021,Epping Forest 015D,E01021745,1601,1510,91,56,21,14,0
2021,Epping Forest 015E,E01021746,1857,1730,127,73,44,9,1
2021,Epping Forest 015F,E01021747,1620,1543,77,51,15,11,0
2021,Epping Forest 015G,E01021748,1699,1566,133,75,40,16,2
2021,Epping Forest 016A,E01021749,2284,2109,175,97,45,25,8
2021,Epping Forest 016B,E01021750,1651,1480,171,103,47,18,3
2021,Epping Forest 016C,E01021751,1377,1236,141,83,40,15,3
2021,Epping Forest 016D,E01021752,1471,1336,135,66,52,15,2
2021,Epping Forest 004A,E01021753,1566,1530,36,26,9,1,0
2021,Epping Forest 004B,E01021754,1505,1487,18,10,4,3,1
2021,Epping Forest 004C,E01021755,1173,1163,10,7,2,1,0
2021,Epping Forest 006A,E01021756,1520,1496,24,12,7,4,1
2021,Epping Forest 006B,E01021757,1669,1573,96,58,27,8,3
2021,Epping Forest 006C,E01021758,1474,1399,75,44,23,6,2
2021,Epping Forest 006D,E01021759,1523,1466,57,36,11,7,3
2021,Epping Forest 005A,E01021760,1474,1440,34,22,11,1,0
2021,Epping Forest 005B,E01021761,2025,1937,88,47,25,13,3
2021,Epping Forest 005C,E01021762,1450,1349,101,64,28,6,3
2021,Epping Forest 005D,E01021763,1939,1891,48,28,15,5,0
2021,Epping Forest 017A,E01021764,1777,1412,365,146,152,62,5
2021,Epping Forest 017B,E01021765,1955,1618,337,152,133,41,11
2021,Epping Forest 017C,E01021766,1634,1281,353,190,110,45,8
2021,Epping Forest 017D,E01021767,1899,1653,246,95,97,45,9
2021,Epping Forest 001A,E01021768,2278,2252,26,12,12,1,1
2021,Epping Forest 003A,E01021769,2389,2352,37,21,9,7,0
2021,Epping Forest 010A,E01021770,1980,1923,57,24,22,7,4
2021,Epping Forest 013A,E01021771,1649,1472,177,76,75,24,2
2021,Epping Forest 013B,E01021772,1465,1361,104,47,39,16,2
2021,Epping Forest 013C,E01021773,1498,1325,173,75,68,25,5
2021,Epping Forest 011A,E01021774,1463,1349,114,58,42,14,0
2021,Epping Forest 011B,E01021775,1574,1439,135,76,38,16,5
2021,Epping Forest 011C,E01021776,1672,1518,154,67,65,18,4
2021,Epping Forest 011D,E01021777,1403,1299,104,53,41,10,0
2021,Epping Forest 011E,E01021778,1485,1345,140,85,38,14,3
2021,Epping Forest 011F,E01021779,1529,1350,179,81,69,28,1
2021,Epping Forest 014A,E01021780,1346,1293,53,30,16,6,1
2021,Epping Forest 014B,E01021781,1479,1423,56,41,14,1,0
2021,Epping Forest 014C,E01021782,1369,1270,99,54,25,15,5
2021,Epping Forest 013D,E01021783,1519,1417,102,55,29,13,5
2021,Epping Forest 013E,E01021784,1467,1377,90,50,29,11,0
2021,Epping Forest 014D,E01021785,1629,1504,125,65,40,18,2
2021,Epping Forest 012A,E01021786,1245,1173,72,42,23,6,1
2021,Epping Forest 012B,E01021787,1553,1497,56,33,15,6,2
2021,Epping Forest 012C,E01021788,1579,1483,96,55,32,7,2
2021,Epping Forest 012D,E01021789,1569,1504,65,44,15,5,1
2021,Epping Forest 012E,E01021790,1998,1824,174,111,46,13,4
2021,Epping Forest 012F,E01021791,1624,1482,142,59,56,25,2
2021,Epping Forest 002B,E01021792,1342,1276,66,22,27,17,0
2021,Epping Forest 002C,E01021793,1628,1566,62,26,13,20,3
2021,Epping Forest 002D,E01021794,1193,1133,60,13,23,21,3
2021,Epping Forest 001B,E01021795,2115,2027,88,63,25,0,0
2021,Epping Forest 003B,E01021796,2338,2305,33,14,12,7,0
2021,Epping Forest 001C,E01021797,1311,1276,35,24,10,1,0
2021,Epping Forest 001D,E01021798,1492,1473,19,13,5,1,0
2021,Epping Forest 001E,E01021799,1793,1752,41,27,7,6,1
2021,Epping Forest 003C,E01021800,2446,2380,66,29,25,12,0
2021,Epping Forest 002E,E01021801,2186,2095,91,34,37,19,1
2021,Epping Forest 004D,E01021802,2633,2596,37,17,15,5,0
2021,Epping Forest 010B,E01021803,1291,1259,32,26,2,4,0
2021,Epping Forest 010C,E01021804,1446,1407,39,22,14,3,0
2021,Epping Forest 010D,E01021805,1334,1301,33,23,8,2,0
2021,Epping Forest 009A,E01021806,2681,2586,95,39,40,15,1
2021,Epping Forest 008A,E01021807,1490,1409,81,39,26,15,1
2021,Epping Forest 008B,E01021808,1521,1401,120,53,40,24,3
2021,Epping Forest 008C,E01021809,1363,1270,93,48,31,11,3
2021,Epping Forest 008D,E01021810,1740,1623,117,55,42,17,3
2021,Epping Forest 007A,E01021811,1348,1259,89,35,37,13,4
2021,Epping Forest 009B,E01021812,1225,1182,43,18,20,2,3
2021,Epping Forest 007B,E01021813,1361,1309,52,17,26,9,0
2021,Epping Forest 007C,E01021814,1772,1689,83,40,29,12,2
2021,Epping Forest 007D,E01021815,1560,1473,87,32,35,20,0
2021,Epping Forest 007E,E01021816,1401,1327,74,38,28,6,2
2021,Epping Forest 008E,E01021817,2573,2434,139,61,52,23,3
2021,Epping Forest 009C,E01021818,1949,1733,216,76,91,43,6
2021,Harlow 006A,E01021819,1625,1464,161,62,71,25,3
2021,Harlow 006B,E01021820,1502,1389,113,48,46,16,3
2021,Harlow 008A,E01021821,1385,1263,122,39,53,25,5
2021,Harlow 006C,E01021822,1606,1455,151,68,58,22,3
2021,Harlow 006D,E01021823,1787,1594,193,67,89,32,5
2021,Harlow 005A,E01021824,1702,1598,104,62,26,12,4
2021,Harlow 005B,E01021825,1567,1464,103,46,37,16,4
2021,Harlow 005C,E01021826,1484,1401,83,36,36,8,3
2021,Harlow 005D,E01021827,1604,1469,135,63,57,15,0
2021,Harlow 005E,E01021828,2256,2145,111,54,49,7,1
2021,Harlow 009A,E01021829,1440,1311,129,49,66,11,3
2021,Harlow 009B,E01021830,1227,1146,81,31,27,22,1
2021,Harlow 007A,E01021831,1355,1206,149,64,59,22,4
2021,Harlow 009C,E01021832,1187,1116,71,34,27,10,0
2021,Harlow 009D,E01021833,1166,1083,83,27,38,18,0
2021,Harlow 008B,E01021834,1526,1396,130,62,50,17,1
2021,Harlow 008C,E01021835,1469,1390,79,35,31,10,3
2021,Harlow 008D,E01021836,1492,1358,134,55,57,16,6
2021,Harlow 008E,E01021837,1477,1346,131,57,59,14,1
2021,Harlow 010A,E01021838,1462,1366,96,42,39,12,3
2021,Harlow 004A,E01021839,1947,1655,292,158,85,40,9
2021,Harlow 004B,E01021840,1763,1493,270,121,101,44,4
2021,Harlow 004C,E01021841,1515,1355,160,72,72,15,1
2021,Harlow 004D,E01021842,1634,1368,266,113,110,38,5
2021,Harlow 004E,E01021843,2788,2308,480,254,176,45,5
2021,Harlow 002A,E01021844,1377,1232,145,52,59,28,6
2021,Harlow 002B,E01021845,1573,1394,179,61,80,33,5
2021,Harlow 002C,E01021846,1418,1235,183,61,81,41,0
2021,Harlow 002D,E01021847,1432,1316,116,45,45,24,2
2021,Harlow 002E,E01021848,1878,1709,169,58,81,29,1
2021,Harlow 003A,E01021849,1629,1395,234,95,98,34,7
2021,Harlow 003B,E01021850,1442,1266,176,71,73,28,4
2021,Harlow 003C,E01021851,1721,1412,309,128,119,47,15
2021,Harlow 003D,E01021852,1595,1401,194,96,57,37,4
2021,Harlow 003E,E01021853,1741,1562,179,83,74,21,1
2021,Harlow 001A,E01021854,2119,2017,102,43,45,8,6
2021,Harlow 001B,E01021855,1502,1440,62,29,19,12,2
2021,Harlow 001C,E01021856,1461,1368,93,42,38,12,1
2021,Harlow 010B,E01021858,1562,1380,182,75,79,26,2
2021,Harlow 010C,E01021859,1561,1312,249,96,115,30,8
2021,Harlow 010D,E01021860,1538,1362,176,69,76,26,5
2021,Harlow 010E,E01021861,1378,1238,140,72,52,16,0
2021,Harlow 011A,E01021862,1517,1327,190,75,90,22,3
2021,Harlow 011B,E01021863,1700,1483,217,91,90,29,7
2021,Harlow 011C,E01021864,1490,1282,208,69,106,30,3
2021,Harlow 009E,E01021865,1335,1176,159,60,65,25,9
2021,Harlow 011D,E01021866,1297,1187,110,39,42,27,2
2021,Harlow 011E,E01021867,1452,1376,76,39,21,13,3
2021,Harlow 007B,E01021868,1594,1456,138,61,56,20,1
2021,Harlow 007C,E01021869,1369,1244,125,47,52,25,1
2021,Harlow 006E,E01021870,1324,1187,137,57,60,20,0
2021,Harlow 007D,E01021871,1457,1302,155,62,59,32,2
2021,Maldon 007A,E01021873,1317,1301,16,10,6,0,0
2021,Maldon 007B,E01021874,1460,1441,19,13,6,0,0
2021,Maldon 007C,E01021875,1456,1454,2,1,1,0,0
2021,Maldon 008C,E01021878,1331,1323,8,7,0,1,0
2021,Maldon 008D,E01021879,1396,1386,10,3,4,3,0
2021,Maldon 008E,E01021880,1557,1530,27,13,7,3,4
2021,Maldon 008F,E01021881,1116,1109,7,4,1,2,0
2021,Maldon 002A,E01021882,2120,2100,20,10,5,4,1
2021,Maldon 002B,E01021883,1646,1635,11,6,4,1,0
2021,Maldon 003A,E01021884,1342,1325,17,2,11,4,0
2021,Maldon 003B,E01021885,1090,1084,6,5,1,0,0
2021,Maldon 003C,E01021886,1554,1540,14,7,6,1,0
2021,Maldon 003D,E01021887,2276,2257,19,10,7,1,1
2021,Maldon 003E,E01021888,2351,2296,55,26,22,5,2
2021,Maldon 004A,E01021889,2430,2361,69,29,26,12,2
2021,Maldon 004B,E01021890,1753,1671,82,23,33,23,3
2021,Maldon 004C,E01021891,1494,1485,9,6,0,3,0
2021,Maldon 004D,E01021892,1043,1002,41,19,15,7,0
2021,Maldon 005A,E01021893,1432,1420,12,5,4,3,0
2021,Maldon 005B,E01021894,1198,1166,32,14,10,8,0
2021,Maldon 005C,E01021895,1123,1097,26,10,10,6,0
2021,Maldon 005D,E01021896,1752,1743,9,8,1,0,0
2021,Maldon 005E,E01021897,1059,1049,10,8,1,1,0
2021,Maldon 005F,E01021898,1244,1223,21,5,8,7,1
2021,Maldon 007D,E01021899,1374,1363,11,5,6,0,0
2021,Maldon 007E,E01021900,1098,1089,9,8,1,0,0
2021,Maldon 006A,E01021901,1883,1877,6,5,1,0,0
2021,Maldon 007F,E01021902,1834,1820,14,6,2,3,3
2021,Maldon 007G,E01021903,1627,1615,12,4,6,1,1
2021,Maldon 006B,E01021904,1945,1937,8,4,4,0,0
2021,Maldon 006C,E01021905,1215,1208,7,5,2,0,0
2021,Maldon 006D,E01021906,1496,1479,17,11,1,5,0
2021,Maldon 006E,E01021907,2274,2266,8,4,2,1,1
2021,Maldon 001A,E01021908,2043,2021,22,15,5,2,0
2021,Maldon 001B,E01021909,1453,1440,13,8,4,1,0
2021,Maldon 001C,E01021910,1592,1586,6,2,3,1,0
2021,Maldon 001D,E01021911,1270,1247,23,8,11,2,2
2021,Maldon 002C,E01021912,2047,2029,18,9,6,3,0
2021,Maldon 002D,E01021913,1576,1562,14,10,3,1,0
2021,Rochford 002A,E01021914,1953,1935,18,15,0,2,1
2021,Rochford 004A,E01021915,1331,1322,9,1,3,4,1
2021,Rochford 004B,E01021916,1163,1158,5,4,1,0,0
2021,Rochford 010A,E01021917,1687,1679,8,4,2,1,1
2021,Rochford 005A,E01021918,1435,1430,5,3,2,0,0
2021,Rochford 005B,E01021919,1309,1300,9,4,4,1,0
2021,Rochford 006A,E01021920,2118,2099,19,12,6,1,0
2021,Rochford 010B,E01021921,1429,1420,9,5,4,0,0
2021,Rochford 010C,E01021922,1536,1527,9,3,4,2,0
2021,Rochford 010D,E01021923,1289,1277,12,6,6,0,0
2021,Rochford 010E,E01021924,1770,1757,13,6,4,3,0
2021,Rochford 005C,E01021925,1624,1584,40,27,5,8,0
2021,Rochford 006B,E01021926,2019,2001,18,9,6,3,0
2021,Rochford 002B,E01021927,1201,1190,11,3,8,0,0
2021,Rochford 002C,E01021928,1448,1438,10,5,3,2,0
2021,Rochford 002D,E01021929,1557,1542,15,9,6,0,0
2021,Rochford 007A,E01021930,1285,1267,18,10,4,2,2
2021,Rochford 002E,E01021931,1541,1528,13,8,2,2,1
2021,Rochford 007B,E01021932,1486,1469,17,9,3,5,0
2021,Rochford 012E,E01021933,1940,1921,19,11,3,5,0
2021,Rochford 012D,E01021934,1334,1329,5,2,2,1,0
2021,Rochford 012C,E01021935,1276,1266,10,4,4,2,0
2021,Rochford 012B,E01021936,1621,1604,17,7,7,3,0
2021,Rochford 012A,E01021937,1527,1508,19,6,10,2,1
2021,Rochford 011B,E01021938,1482,1466,16,9,4,1,2
2021,Rochford 011D,E01021939,1638,1618,20,9,7,4,0
2021,Rochford 011A,E01021940,1952,1928,24,18,6,0,0
2021,Rochford 011C,E01021941,2249,2225,24,15,7,1,1
2021,Rochford 001A,E01021942,1630,1615,15,3,10,1,1
2021,Rochford 001B,E01021943,1626,1623,3,3,0,0,0
2021,Rochford 001C,E01021944,1644,1635,9,9,0,0,0
2021,Rochford 001D,E01021945,1560,1547,13,10,2,1,0
2021,Rochford 009A,E01021946,1444,1423,21,17,2,1,1
2021,Rochford 009B,E01021947,1200,1196,4,4,0,0,0
2021,Rochford 009C,E01021948,1246,1225,21,9,8,4,0
2021,Rochford 009D,E01021949,1431,1406,25,9,13,2,1
2021,Rochford 008A,E01021950,1406,1394,12,6,4,2,0
2021,Rochford 008B,E01021951,1243,1225,18,8,7,3,0
2021,Rochford 007C,E01021952,1436,1422,14,8,3,2,1
2021,Rochford 004C,E01021953,1273,1269,4,4,0,0,0
2021,Rochford 007D,E01021954,2694,2630,64,38,21,3,2
2021,Rochford 004D,E01021955,1673,1637,36,21,11,4,0
2021,Rochford 007E,E01021956,1429,1399,30,18,4,7,1
2021,Rochford 006C,E01021957,1645,1616,29,22,4,3,0
2021,Rochford 006D,E01021958,1177,1166,11,8,3,0,0
2021,Rochford 006E,E01021959,1592,1568,24,18,5,0,1
2021,Rochford 005D,E01021960,2001,1980,21,11,8,2,0
2021,Rochford 005E,E01021961,1557,1541,16,9,3,4,0
2021,Rochford 008C,E01021962,1196,1159,37,18,11,8,0
2021,Rochford 008D,E01021963,1339,1325,14,12,0,2,0
2021,Rochford 008E,E01021964,1570,1552,18,12,3,1,2
2021,Rochford 009E,E01021965,2290,2268,22,12,10,0,0
2021,Rochford 008F,E01021966,1694,1671,23,12,6,5,0
2021,Tendring 009A,E01021967,2377,2344,33,17,12,3,1
2021,Tendring 017A,E01021968,1859,1827,32,4,15,12,1
2021,Tendring 017B,E01021969,1436,1404,32,13,10,7,2
2021,Tendring 016A,E01021970,1767,1712,55,20,25,9,1
2021,Tendring 005A,E01021971,1587,1505,82,36,32,13,1
2021,Tendring 005B,E01021972,1341,1319,22,13,7,1,1
2021,Tendring 007A,E01021973,1244,1242,2,1,1,0,0
2021,Tendring 007B,E01021974,1306,1296,10,6,4,0,0
2021,Tendring 013A,E01021975,1500,1475,25,8,12,5,0
2021,Tendring 013B,E01021976,1492,1481,11,8,3,0,0
2021,Tendring 013C,E01021977,2698,2657,41,18,14,8,1
2021,Tendring 003A,E01021978,2371,2361,10,8,2,0,0
2021,Tendring 011A,E01021979,1469,1456,13,5,4,4,0
2021,Tendring 011B,E01021980,1652,1627,25,8,12,4,1
2021,Tendring 011C,E01021981,1906,1879,27,14,11,2,0
2021,Tendring 011D,E01021982,2000,1966,34,15,14,4,1
2021,Tendring 009B,E01021983,1456,1442,14,9,3,2,0
2021,Tendring 010A,E01021984,2143,2120,23,11,10,2,0
2021,Tendring 006A,E01021985,1290,1273,17,9,3,4,1
2021,Tendring 006B,E01021986,1441,1414,27,19,6,1,1
2021,Tendring 008A,E01021987,1287,1275,12,4,6,2,0
2021,Tendring 018A,E01021988,1941,1908,33,18,8,4,3
2021,Tendring 018B,E01021989,1444,1434,10,8,0,1,1
2021,Tendring 018C,E01021990,1610,1590,20,11,5,4,0
2021,Tendring 004A,E01021991,1026,1014,12,6,5,1,0
2021,Tendring 004B,E01021992,1157,1143,14,9,2,3,0
2021,Tendring 009C,E01021993,2447,2416,31,17,9,5,0
2021,Tendring 008B,E01021994,1149,1138,11,7,2,2,0
2021,Tendring 008C,E01021995,1320,1307,13,5,6,2,0
2021,Tendring 008D,E01021996,1284,1270,14,10,2,1,1
2021,Tendring 001A,E01021997,1284,1241,43,12,18,13,0
2021,Tendring 001B,E01021998,1408,1374,34,9,19,6,0
2021,Tendring 001C,E01021999,1654,1616,38,13,16,8,1
2021,Tendring 002A,E01022000,1600,1572,28,9,14,5,0
2021,Tendring 001D,E01022001,1871,1755,116,24,60,30,2
2021,Tendring 004C,E01022002,1896,1877,19,9,7,3,0
2021,Tendring 004D,E01022004,1702,1691,11,8,2,1,0
2021,Tendring 004E,E01022005,1754,1736,18,11,6,1,0
2021,Tendring 002C,E01022006,1735,1704,31,13,8,8,2
2021,Tendring 002D,E01022007,1808,1773,35,8,19,8,0
2021,Tendring 012A,E01022008,2086,2064,22,14,3,5,0
2021,Tendring 008E,E01022009,1495,1482,13,5,4,4,0
2021,Tendring 008F,E01022010,1699,1685,14,8,4,2,0
2021,Tendring 008G,E01022011,1885,1865,20,8,9,3,0
2021,Tendring 008H,E01022012,1948,1931,17,10,3,4,0
2021,Tendring 003B,E01022013,1847,1821,26,20,4,1,1
2021,Tendring 003C,E01022014,1459,1446,13,10,1,2,0
2021,Tendring 003D,E01022015,1331,1314,17,12,2,3,0
2021,Tendring 007C,E01022016,1787,1780,7,3,3,1,0
2021,Tendring 007D,E01022017,1669,1655,14,11,3,0,0
2021,Tendring 007E,E01022018,1740,1711,29,13,11,4,1
2021,Tendring 003E,E01022019,1664,1651,13,8,3,1,1
2021,Tendring 003F,E01022020,1641,1623,18,11,7,0,0
2021,Tendring 003G,E01022021,1433,1422,11,9,2,0,0
2021,Tendring 013D,E01022022,1475,1451,24,12,8,2,2
2021,Tendring 015A,E01022023,1420,1397,23,9,8,3,3
2021,Tendring 015B,E01022024,1465,1445,20,7,8,2,3
2021,Tendring 016B,E01022025,1870,1771,99,31,41,23,4
2021,Tendring 016C,E01022026,1651,1583,68,21,24,19,4
2021,Tendring 016D,E01022027,1629,1552,77,26,37,13,1
2021,Tendring 004F,E01022028,1372,1354,18,6,10,1,1
2021,Tendring 015C,E01022030,1528,1508,20,6,11,3,0
2021,Tendring 015D,E01022031,1283,1246,37,13,14,9,1
2021,Tendring 015E,E01022032,1780,1735,45,22,13,10,0
2021,Tendring 012B,E01022033,1464,1461,3,3,0,0,0
2021,Tendring 012C,E01022034,1514,1491,23,10,8,5,0
2021,Tendring 012D,E01022035,1435,1421,14,4,10,0,0
2021,Tendring 017C,E01022036,1183,1169,14,9,4,1,0
2021,Tendring 017D,E01022037,1354,1322,32,15,12,5,0
2021,Tendring 017E,E01022038,1390,1357,33,14,14,3,2
2021,Tendring 010B,E01022039,1469,1449,20,12,5,3,0
2021,Tendring 010C,E01022040,1745,1726,19,10,5,2,2
2021,Tendring 010D,E01022041,1481,1463,18,8,7,3,0
2021,Tendring 014A,E01022042,1498,1467,31,13,14,4,0
2021,Tendring 014B,E01022043,1828,1768,60,26,20,14,0
2021,Tendring 013E,E01022044,1608,1584,24,11,6,4,3
2021,Tendring 018D,E01022045,1659,1650,9,2,5,2,0
2021,Tendring 011E,E01022046,1675,1659,16,11,4,1,0
2021,Tendring 018E,E01022047,1424,1395,29,19,8,0,2
2021,Tendring 014C,E01022048,1468,1452,16,9,5,1,1
2021,Tendring 014D,E01022049,1459,1432,27,12,8,6,1
2021,Tendring 014E,E01022050,1768,1751,17,5,7,5,0
2021,Tendring 005C,E01022051,1509,1497,12,11,1,0,0
2021,Tendring 005D,E01022052,1516,1484,32,23,6,3,0
2021,Tendring 009D,E01022053,1999,1977,22,13,5,0,4
2021,Tendring 006C,E01022054,1529,1509,20,13,3,2,2
2021,Tendring 006D,E01022055,1482,1450,32,15,12,4,1
2021,Tendring 006E,E01022056,1668,1618,50,22,15,11,2
2021,Uttlesford 001A,E01022057,1714,1691,23,18,5,0,0
2021,Uttlesford 008A,E01022058,1610,1589,21,13,5,3,0
2021,Uttlesford 009A,E01022059,1591,1572,19,15,4,0,0
2021,Uttlesford 009B,E01022060,2014,1990,24,16,6,2,0
2021,Uttlesford 003A,E01022061,1547,1526,21,12,5,3,1
2021,Uttlesford 005A,E01022062,2404,2351,53,35,14,3,1
2021,Uttlesford 005B,E01022063,2344,2269,75,52,19,4,0
2021,Uttlesford 008B,E01022064,1884,1857,27,21,3,2,1
2021,Uttlesford 007B,E01022067,1863,1750,113,53,49,10,1
2021,Uttlesford 007C,E01022068,1911,1861,50,27,13,6,4
2021,Uttlesford 008D,E01022069,1563,1507,56,28,20,7,1
2021,Uttlesford 009C,E01022070,1953,1920,33,20,8,5,0
2021,Uttlesford 003B,E01022071,1664,1637,27,14,7,5,1
2021,Uttlesford 003C,E01022072,2020,1981,39,23,10,6,0
2021,Uttlesford 003D,E01022073,1981,1932,49,27,11,9,2
2021,Uttlesford 002A,E01022074,1443,1369,74,41,24,7,2
2021,Uttlesford 001B,E01022075,1791,1734,57,34,13,9,1
2021,Uttlesford 002B,E01022076,1613,1525,88,53,29,6,0
2021,Uttlesford 001C,E01022077,1969,1878,91,52,28,10,1
2021,Uttlesford 002C,E01022078,1468,1399,69,36,24,7,2
2021,Uttlesford 002D,E01022079,2089,1986,103,60,29,11,3
2021,Uttlesford 002E,E01022080,1403,1292,111,57,44,9,1
2021,Uttlesford 002F,E01022081,2521,2391,130,68,38,21,3
2021,Uttlesford 002G,E01022082,2184,2072,112,73,25,13,1
2021,Uttlesford 005C,E01022083,1754,1696,58,30,22,6,0
2021,Uttlesford 005D,E01022084,1932,1890,42,27,8,5,2
2021,Uttlesford 005E,E01022085,1652,1558,94,50,27,14,3
2021,Uttlesford 006A,E01022086,1690,1565,125,58,41,22,4
2021,Uttlesford 005F,E01022087,2669,2541,128,78,38,9,3
2021,Uttlesford 008E,E01022088,1686,1665,21,16,4,0,1
2021,Uttlesford 005G,E01022089,1569,1557,12,9,3,0,0
2021,Uttlesford 004A,E01022092,1807,1787,20,11,8,0,1
2021,Uttlesford 004B,E01022093,2183,2145,38,24,9,5,0
2021,Uttlesford 001D,E01022094,1923,1869,54,29,13,6,6
2021,Uttlesford 006D,E01022095,1703,1691,12,8,4,0,0
2021,Uttlesford 009D,E01022096,2031,2009,22,15,2,5,0
2021,Uttlesford 004C,E01022097,1896,1881,15,11,3,1,0
2021,Uttlesford 003E,E01022098,1533,1515,18,14,3,1,0
2021,Uttlesford 004D,E01022099,2182,2110,72,50,22,0,0
2021,Cheltenham 008A,E01022100,1613,1543,70,47,17,5,1
2021,Cheltenham 008B,E01022101,1688,1601,87,50,27,10,0
2021,Cheltenham 008C,E01022102,1921,1591,330,157,135,34,4
2021,Cheltenham 012B,E01022104,1650,1588,62,36,16,10,0
2021,Cheltenham 012C,E01022105,1448,1424,24,16,7,1,0
2021,Cheltenham 010A,E01022106,1657,1615,42,23,13,5,1
2021,Cheltenham 010B,E01022107,1528,1473,55,37,16,1,1
2021,Cheltenham 010C,E01022108,1641,1600,41,16,23,2,0
2021,Cheltenham 012D,E01022109,1556,1540,16,9,6,1,0
2021,Cheltenham 012E,E01022110,1374,1338,36,28,5,3,0
2021,Cheltenham 012F,E01022111,1497,1464,33,12,15,5,1
2021,Cheltenham 012G,E01022112,1332,1292,40,29,11,0,0
2021,Cheltenham 014A,E01022113,1722,1663,59,28,23,6,2
2021,Cheltenham 014B,E01022114,1567,1542,25,17,6,1,1
2021,Cheltenham 014C,E01022115,1525,1451,74,46,20,7,1
2021,Cheltenham 009A,E01022116,1482,1348,134,81,42,9,2
2021,Cheltenham 009B,E01022117,1610,1503,107,64,35,8,0
2021,Cheltenham 014D,E01022118,1434,1380,54,34,16,4,0
2021,Cheltenham 009C,E01022119,1176,1137,39,27,11,1,0
2021,Cheltenham 005A,E01022120,1564,1378,186,85,70,28,3
2021,Cheltenham 005B,E01022121,1717,1456,261,98,119,38,6
2021,Cheltenham 003A,E01022122,1400,1183,217,93,79,34,11
2021,Cheltenham 010D,E01022123,2117,1933,184,92,65,24,3
2021,Cheltenham 009D,E01022124,1188,1126,62,34,21,6,1
2021,Cheltenham 009E,E01022125,1147,1089,58,33,22,3,0
2021,Cheltenham 009F,E01022126,1343,1248,95,56,30,9,0
2021,Cheltenham 009G,E01022127,1788,1560,228,152,59,14,3
2021,Cheltenham 015A,E01022128,1516,1485,31,27,4,0,0
2021,Cheltenham 015B,E01022129,2331,2285,46,32,10,4,0
2021,Cheltenham 015C,E01022130,1564,1525,39,23,14,2,0
2021,Cheltenham 006A,E01022131,1298,1184,114,49,40,23,2
2021,Cheltenham 006B,E01022132,1440,1353,87,36,35,14,2
2021,Cheltenham 006C,E01022133,1391,1317,74,39,20,12,3
2021,Cheltenham 006D,E01022134,1527,1441,86,40,31,15,0
2021,Cheltenham 011A,E01022135,1652,1582,70,40,26,4,0
2021,Cheltenham 011B,E01022136,1318,1260,58,29,27,1,1
2021,Cheltenham 011C,E01022137,1489,1437,52,25,21,5,1
2021,Cheltenham 011D,E01022138,1655,1592,63,37,20,6,0
2021,Cheltenham 004A,E01022139,1835,1767,68,38,22,6,2
2021,Cheltenham 008D,E01022140,1372,1339,33,19,11,3,0
2021,Cheltenham 008E,E01022141,1360,1286,74,36,28,9,1
2021,Cheltenham 008F,E01022142,1340,1225,115,64,39,11,1
2021,Cheltenham 002A,E01022143,2077,1983,94,65,22,7,0
2021,Cheltenham 002B,E01022144,1380,1337,43,14,23,4,2
2021,Cheltenham 002C,E01022145,1205,1179,26,18,4,2,2
2021,Cheltenham 002D,E01022146,1323,1301,22,13,8,1,0
2021,Cheltenham 005C,E01022147,1619,1467,152,61,66,18,7
2021,Cheltenham 007A,E01022148,1552,1472,80,41,26,11,2
2021,Cheltenham 007B,E01022149,1439,1345,94,52,30,12,0
2021,Cheltenham 007C,E01022150,1474,1345,129,62,56,11,0
2021,Cheltenham 004B,E01022151,1627,1381,246,93,109,39,5
2021,Cheltenham 004C,E01022152,1217,1056,161,65,62,30,4
2021,Cheltenham 004D,E01022153,1439,1229,210,96,86,26,2
2021,Cheltenham 004E,E01022154,1797,1536,261,112,117,31,1
2021,Cheltenham 007D,E01022155,1521,1350,171,72,76,22,1
2021,Cheltenham 007E,E01022156,1831,1630,201,92,78,28,3
2021,Cheltenham 005D,E01022157,1412,1230,182,61,85,34,2
2021,Cheltenham 005E,E01022159,1585,1388,197,90,63,36,8
2021,Cheltenham 003B,E01022160,2146,1880,266,119,107,34,6
2021,Cheltenham 003C,E01022161,1410,1223,187,92,74,20,1
2021,Cheltenham 003D,E01022162,1532,1420,112,61,34,12,5
2021,Cheltenham 001A,E01022163,1403,1268,135,59,53,20,3
2021,Cheltenham 001B,E01022164,1350,1149,201,64,89,38,10
2021,Cheltenham 001C,E01022165,1427,1305,122,67,42,11,2
2021,Cheltenham 001D,E01022166,1188,1113,75,43,24,5,3
2021,Cheltenham 013A,E01022167,1234,1204,30,19,8,3,0
2021,Cheltenham 013B,E01022168,1103,1067,36,19,10,6,1
2021,Cheltenham 013C,E01022169,1453,1392,61,35,19,7,0
2021,Cheltenham 013D,E01022170,1336,1282,54,32,16,6,0
2021,Cheltenham 013E,E01022171,1264,1221,43,28,11,3,1
2021,Cheltenham 013F,E01022172,1427,1391,36,13,18,5,0
2021,Cheltenham 013G,E01022173,1285,1220,65,40,16,9,0
2021,Cheltenham 011E,E01022174,1324,1267,57,33,20,4,0
2021,Cotswold 005A,E01022175,1758,1711,47,27,12,8,0
2021,Cotswold 011A,E01022176,1807,1791,16,11,3,1,1
2021,Cotswold 002A,E01022177,1876,1852,24,14,9,1,0
2021,Cotswold 002B,E01022178,1268,1240,28,16,10,2,0
2021,Cotswold 001A,E01022179,1919,1899,20,13,6,1,0
2021,Cotswold 003B,E01022181,1755,1707,48,29,15,4,0
2021,Cotswold 001B,E01022182,1663,1649,14,13,1,0,0
2021,Cotswold 001C,E01022183,1514,1471,43,21,17,5,0
2021,Cotswold 001D,E01022184,1513,1496,17,12,4,1,0
2021,Cotswold 001E,E01022185,1919,1901,18,15,2,1,0
2021,Cotswold 004A,E01022186,1601,1581,20,14,6,0,0
2021,Cotswold 004B,E01022187,1893,1828,65,41,15,8,1
2021,Cotswold 006A,E01022188,2009,1968,41,20,19,1,1
2021,Cotswold 006B,E01022189,1210,1198,12,5,5,1,1
2021,Cotswold 006C,E01022190,1432,1406,26,16,8,2,0
2021,Cotswold 008A,E01022191,1286,1231,55,28,20,7,0
2021,Cotswold 008B,E01022192,1252,1228,24,15,5,4,0
2021,Cotswold 008C,E01022193,1027,1021,6,6,0,0,0
2021,Cotswold 007A,E01022194,1707,1619,88,55,29,4,0
2021,Cotswold 007B,E01022195,1566,1538,28,16,8,3,1
2021,Cotswold 006D,E01022196,1722,1701,21,18,2,1,0
2021,Cotswold 006E,E01022197,1797,1777,20,13,7,0,0
2021,Cotswold 008D,E01022198,1215,1162,53,24,24,5,0
2021,Cotswold 007C,E01022199,1578,1525,53,28,19,6,0
2021,Cotswold 007D,E01022200,1135,1085,50,27,17,4,2
2021,Cotswold 004C,E01022201,1758,1722,36,21,11,2,2
2021,Cotswold 009A,E01022202,1340,1331,9,6,2,1,0
2021,Cotswold 009B,E01022203,2111,2048,63,31,18,13,1
2021,Cotswold 009C,E01022204,1363,1330,33,16,14,3,0
2021,Cotswold 002C,E01022205,1751,1738,13,10,2,1,0
2021,Cotswold 005B,E01022207,1654,1639,15,11,3,1,0
2021,Cotswold 009D,E01022208,1625,1609,16,12,4,0,0
2021,Cotswold 009E,E01022209,1157,1149,8,6,2,0,0
2021,Cotswold 009F,E01022210,1428,1405,23,11,11,1,0
2021,Cotswold 002D,E01022211,1905,1842,63,28,29,6,0
2021,Cotswold 005C,E01022213,1944,1929,15,13,2,0,0
2021,Cotswold 005D,E01022215,1696,1678,18,16,2,0,0
2021,Cotswold 004D,E01022216,1868,1843,25,19,6,0,0
2021,Cotswold 011C,E01022217,1224,1204,20,12,8,0,0
2021,Cotswold 011D,E01022218,1174,1151,23,14,7,2,0
2021,Cotswold 011E,E01022219,1450,1427,23,12,9,2,0
2021,Cotswold 011F,E01022220,1558,1504,54,25,26,3,0
2021,Cotswold 010A,E01022221,2032,1991,41,21,15,4,1
2021,Cotswold 003D,E01022222,1867,1828,39,28,8,3,0
2021,Cotswold 010C,E01022224,1503,1489,14,3,7,4,0
2021,Cotswold 008E,E01022225,2489,2365,124,69,51,3,1
2021,Forest of Dean 009A,E01022226,1386,1354,32,14,11,7,0
2021,Forest of Dean 009B,E01022227,1542,1532,10,6,2,2,0
2021,Forest of Dean 005A,E01022228,1638,1630,8,6,1,1,0
2021,Forest of Dean 007A,E01022229,1540,1531,9,7,2,0,0
2021,Forest of Dean 005B,E01022230,1776,1750,26,10,10,3,3
2021,Forest of Dean 008A,E01022231,1628,1620,8,5,3,0,0
2021,Forest of Dean 008B,E01022232,1536,1520,16,8,6,2,0
2021,Forest of Dean 001A,E01022233,1838,1795,43,19,14,6,4
2021,Forest of Dean 006A,E01022234,1503,1501,2,1,1,0,0
2021,Forest of Dean 001B,E01022235,1759,1739,20,15,1,1,3
2021,Forest of Dean 004A,E01022236,1992,1900,92,22,28,35,7
2021,Forest of Dean 004B,E01022237,1437,1418,19,9,6,2,2
2021,Forest of Dean 004C,E01022238,1495,1456,39,9,20,10,0
2021,Forest of Dean 004D,E01022239,1545,1515,30,13,13,4,0
2021,Forest of Dean 004E,E01022240,2026,1860,166,32,72,52,10
2021,Forest of Dean 007B,E01022241,1797,1776,21,9,8,3,1
2021,Forest of Dean 007C,E01022242,1766,1741,25,9,9,5,2
2021,Forest of Dean 007D,E01022243,1373,1371,2,1,1,0,0
2021,Forest of Dean 007E,E01022244,1502,1492,10,8,2,0,0
2021,Forest of Dean 007F,E01022245,1311,1293,18,10,4,4,0
2021,Forest of Dean 007G,E01022246,1276,1275,1,1,0,0,0
2021,Forest of Dean 001C,E01022247,2582,2547,35,30,4,1,0
2021,Forest of Dean 010A,E01022248,1634,1619,15,10,2,1,2
2021,Forest of Dean 004F,E01022249,1997,1976,21,14,3,4,0
2021,Forest of Dean 004G,E01022250,2081,2064,17,13,3,1,0
2021,Forest of Dean 003A,E01022251,1402,1386,16,7,3,5,1
2021,Forest of Dean 003B,E01022252,1755,1739,16,6,6,4,0
2021,Forest of Dean 006B,E01022253,1636,1631,5,4,1,0,0
2021,Forest of Dean 009C,E01022254,2426,2371,55,27,22,5,1
2021,Forest of Dean 009D,E01022255,2161,2111,50,25,18,7,0
2021,Forest of Dean 009E,E01022256,1706,1671,35,10,19,6,0
2021,Forest of Dean 009F,E01022257,1730,1712,18,9,6,2,1
2021,Forest of Dean 003C,E01022258,1204,1183,21,13,5,3,0
2021,Forest of Dean 003D,E01022259,1489,1469,20,14,4,1,1
2021,Forest of Dean 003E,E01022260,1824,1817,7,1,5,1,0
2021,Forest of Dean 002A,E01022261,2301,2156,145,61,57,23,4
2021,Forest of Dean 002B,E01022262,2124,1906,218,47,95,62,14
2021,Forest of Dean 006C,E01022263,1858,1846,12,5,6,1,0
2021,Forest of Dean 008C,E01022264,1503,1490,13,7,4,1,1
2021,Forest of Dean 005C,E01022265,1658,1642,16,4,1,2,9
2021,Forest of Dean 005D,E01022266,1370,1342,28,11,3,11,3
2021,Forest of Dean 002C,E01022267,1752,1681,71,17,35,14,5
2021,Forest of Dean 008D,E01022268,1630,1621,9,6,3,0,0
2021,Forest of Dean 008E,E01022269,1833,1824,9,8,1,0,0
2021,Forest of Dean 001D,E01022270,1926,1916,10,10,0,0,0
2021,Forest of Dean 001E,E01022271,1668,1657,11,10,1,0,0
2021,Forest of Dean 010B,E01022272,1307,1283,24,14,7,3,0
2021,Forest of Dean 010C,E01022273,1354,1325,29,19,8,2,0
2021,Forest of Dean 010D,E01022274,1173,1167,6,4,0,2,0
2021,Forest of Dean 010E,E01022275,1923,1886,37,27,8,2,0
2021,Gloucester 010A,E01022276,1521,1494,27,11,14,1,1
2021,Gloucester 010B,E01022277,1410,1375,35,20,10,5,0
2021,Gloucester 007A,E01022278,1567,1515,52,30,16,4,2
2021,Gloucester 007B,E01022279,1434,1381,53,23,20,9,1
2021,Gloucester 010C,E01022280,1430,1379,51,26,20,5,0
2021,Gloucester 010D,E01022281,1649,1630,19,11,5,3,0
2021,Gloucester 007C,E01022282,2589,2468,121,77,30,14,0
2021,Gloucester 006A,E01022283,1432,1391,41,23,12,5,1
2021,Gloucester 007D,E01022284,1229,1120,109,62,32,13,2
2021,Gloucester 007E,E01022285,1364,1302,62,21,24,13,4
2021,Gloucester 007F,E01022286,1666,1532,134,49,62,20,3
2021,Gloucester 007G,E01022287,1897,1782,115,58,38,15,4
2021,Gloucester 005A,E01022288,1931,1444,487,172,195,105,15
2021,Gloucester 005B,E01022289,1701,1164,537,132,246,140,19
2021,Gloucester 005C,E01022290,1362,1086,276,100,111,56,9
2021,Gloucester 005D,E01022291,1761,1189,572,183,227,137,25
2021,Gloucester 005E,E01022292,1489,1046,443,177,143,103,20
2021,Gloucester 008A,E01022293,1561,1203,358,114,165,64,15
2021,Gloucester 008B,E01022294,1705,1374,331,146,122,50,13
2021,Gloucester 003A,E01022295,1334,1292,42,18,18,5,1
2021,Gloucester 003B,E01022296,1488,1404,84,33,34,15,2
2021,Gloucester 003C,E01022297,1320,1286,34,17,12,5,0
2021,Gloucester 003D,E01022298,1587,1527,60,32,17,8,3
2021,Gloucester 013A,E01022299,1278,1243,35,21,8,6,0
2021,Gloucester 013B,E01022300,1259,1216,43,16,16,11,0
2021,Gloucester 013C,E01022301,1510,1466,44,28,10,3,3
2021,Gloucester 013D,E01022302,1485,1452,33,14,15,2,2
2021,Gloucester 006B,E01022303,1371,1336,35,14,13,8,0
2021,Gloucester 006C,E01022304,1716,1681,35,22,9,4,0
2021,Gloucester 006D,E01022305,1325,1302,23,12,5,3,3
2021,Gloucester 010E,E01022306,1297,1256,41,18,16,7,0
2021,Gloucester 010F,E01022307,1500,1463,37,23,10,1,3
2021,Gloucester 006E,E01022308,1383,1346,37,26,9,1,1
2021,Gloucester 002A,E01022309,1502,1423,79,34,38,7,0
2021,Gloucester 002B,E01022310,1781,1679,102,40,51,11,0
2021,Gloucester 002C,E01022311,1934,1644,290,137,103,42,8
2021,Gloucester 002D,E01022312,2247,1843,404,205,143,45,11
2021,Gloucester 001A,E01022313,1582,1549,33,18,12,3,0
2021,Gloucester 002E,E01022314,1629,1559,70,52,14,3,1
2021,Gloucester 001B,E01022315,1440,1414,26,17,6,2,1
2021,Gloucester 001C,E01022316,1491,1445,46,33,10,3,0
2021,Gloucester 001D,E01022317,1477,1439,38,24,10,4,0
2021,Gloucester 001E,E01022318,1669,1635,34,23,6,5,0
2021,Gloucester 011A,E01022319,1512,1402,110,51,43,16,0
2021,Gloucester 011B,E01022320,1624,1556,68,25,27,13,3
2021,Gloucester 011C,E01022321,1597,1479,118,57,46,11,4
2021,Gloucester 011D,E01022322,1321,1245,76,33,29,14,0
2021,Gloucester 008C,E01022323,1730,1601,129,69,35,24,1
2021,Gloucester 011E,E01022324,1573,1471,102,52,35,13,2
2021,Gloucester 011F,E01022325,1241,1173,68,35,29,4,0
2021,Gloucester 009A,E01022326,1298,1155,143,57,55,28,3
2021,Gloucester 009B,E01022327,1454,1366,88,34,38,16,0
2021,Gloucester 008D,E01022328,1355,1266,89,34,32,22,1
2021,Gloucester 008E,E01022329,1613,1422,191,86,70,30,5
2021,Gloucester 009C,E01022330,1444,1319,125,43,54,27,1
2021,Gloucester 009D,E01022331,1297,1219,78,38,27,10,3
2021,Gloucester 004A,E01022332,1781,1406,375,126,165,78,6
2021,Gloucester 009E,E01022333,1472,1394,78,32,33,11,2
2021,Gloucester 009F,E01022334,1854,1739,115,67,40,5,3
2021,Gloucester 015A,E01022335,1417,1361,56,27,20,8,1
2021,Gloucester 015B,E01022336,1117,1055,62,26,23,12,1
2021,Gloucester 015D,E01022338,1260,1150,110,41,52,16,1
2021,Gloucester 014A,E01022339,1708,1669,39,14,20,5,0
2021,Gloucester 014B,E01022340,1313,1243,70,34,24,8,4
2021,Gloucester 014C,E01022341,2394,2264,130,69,39,20,2
2021,Gloucester 014D,E01022342,1632,1562,70,40,24,6,0
2021,Gloucester 012A,E01022343,1378,1319,59,29,20,10,0
2021,Gloucester 012B,E01022344,1513,1460,53,27,17,7,2
2021,Gloucester 012C,E01022345,1638,1611,27,14,11,2,0
2021,Gloucester 012D,E01022346,1471,1436,35,17,9,7,2
2021,Stroud 010A,E01022350,2116,2106,10,8,2,0,0
2021,Stroud 012A,E01022351,1567,1555,12,6,4,1,1
2021,Stroud 012B,E01022352,1274,1260,14,9,5,0,0
2021,Stroud 012C,E01022353,1567,1534,33,17,14,2,0
2021,Stroud 002A,E01022354,2182,2165,17,9,4,3,1
2021,Stroud 004A,E01022355,1635,1608,27,13,10,4,0
2021,Stroud 004B,E01022356,2435,2373,62,37,18,7,0
2021,Stroud 004C,E01022357,1849,1826,23,15,6,2,0
2021,Stroud 004D,E01022358,1532,1510,22,12,8,0,2
2021,Stroud 011A,E01022359,1492,1475,17,11,4,2,0
2021,Stroud 011B,E01022360,1448,1441,7,5,2,0,0
2021,Stroud 011C,E01022361,1169,1149,20,9,4,7,0
2021,Stroud 011D,E01022362,1114,1106,8,4,3,1,0
2021,Stroud 011E,E01022363,1973,1948,25,16,6,1,2
2021,Stroud 011F,E01022364,1097,1077,20,7,9,1,3
2021,Stroud 008A,E01022366,1652,1642,10,6,3,1,0
2021,Stroud 008B,E01022367,1582,1576,6,5,0,0,1
2021,Stroud 008C,E01022368,1324,1312,12,5,6,1,0
2021,Stroud 008D,E01022369,1577,1560,17,11,5,1,0
2021,Stroud 009A,E01022370,1305,1277,28,11,16,1,0
2021,Stroud 009B,E01022371,1081,1076,5,3,1,1,0
2021,Stroud 014A,E01022372,2357,2305,52,36,10,5,1
2021,Stroud 014B,E01022373,1647,1609,38,18,14,6,0
2021,Stroud 014C,E01022374,1996,1943,53,27,15,8,3
2021,Stroud 014D,E01022375,1211,1162,49,23,14,10,2
2021,Stroud 003A,E01022376,2665,2617,48,30,15,3,0
2021,Stroud 004E,E01022377,2081,2026,55,23,22,6,4
2021,Stroud 001A,E01022378,2119,2086,33,14,15,4,0
2021,Stroud 001B,E01022379,1376,1286,90,28,42,16,4
2021,Stroud 015A,E01022381,2161,2140,21,12,9,0,0
2021,Stroud 010B,E01022382,1592,1578,14,9,4,1,0
2021,Stroud 010C,E01022383,1460,1441,19,11,3,5,0
2021,Stroud 010D,E01022384,1381,1364,17,9,5,0,3
2021,Stroud 013A,E01022385,1597,1583,14,7,7,0,0
2021,Stroud 013B,E01022386,1508,1489,19,12,7,0,0
2021,Stroud 013C,E01022387,1491,1441,50,22,17,10,1
2021,Stroud 013D,E01022388,1758,1712,46,28,14,4,0
2021,Stroud 004F,E01022389,1679,1666,13,7,3,2,1
2021,Stroud 002B,E01022390,1179,1158,21,16,4,0,1
2021,Stroud 002C,E01022391,1605,1588,17,12,4,1,0
2021,Stroud 002D,E01022392,1595,1571,24,18,4,2,0
2021,Stroud 007A,E01022393,1381,1367,14,12,2,0,0
2021,Stroud 007B,E01022394,1478,1456,22,18,4,0,0
2021,Stroud 007C,E01022395,1455,1438,17,12,4,1,0
2021,Stroud 003B,E01022396,1765,1755,10,4,4,2,0
2021,Stroud 003C,E01022397,1983,1968,15,9,5,0,1
2021,Stroud 003D,E01022398,1148,1143,5,5,0,0,0
2021,Stroud 006B,E01022399,2090,2048,42,31,6,5,0
2021,Stroud 005A,E01022400,1894,1845,49,18,22,8,1
2021,Stroud 005B,E01022401,1316,1297,19,11,5,3,0
2021,Stroud 005C,E01022402,1451,1419,32,21,8,2,1
2021,Stroud 005D,E01022403,1497,1467,30,8,13,9,0
2021,Stroud 005E,E01022404,1685,1636,49,24,19,3,3
2021,Stroud 009C,E01022405,2025,1997,28,17,10,0,1
2021,Stroud 009D,E01022406,1235,1229,6,6,0,0,0
2021,Stroud 009E,E01022407,1305,1294,11,8,2,1,0
2021,Stroud 007D,E01022408,1001,989,12,9,3,0,0
2021,Stroud 007E,E01022409,1262,1239,23,16,6,1,0
2021,Stroud 006C,E01022410,2135,2095,40,24,15,1,0
2021,Stroud 006D,E01022411,2023,1977,46,19,22,5,0
2021,Stroud 012D,E01022413,1975,1959,16,9,6,1,0
2021,Stroud 006E,E01022414,2391,2323,68,32,22,12,2
2021,Stroud 015B,E01022415,1520,1503,17,9,8,0,0
2021,Stroud 015C,E01022416,1474,1457,17,11,5,1,0
2021,Stroud 015D,E01022417,1743,1719,24,18,5,1,0
2021,Stroud 015E,E01022418,1580,1552,28,20,3,3,2
2021,Tewkesbury 009A,E01022421,1654,1589,65,29,23,11,2
2021,Tewkesbury 009C,E01022423,2148,2097,51,32,16,2,1
2021,Tewkesbury 009D,E01022424,1585,1518,67,38,19,8,2
2021,Tewkesbury 007A,E01022425,1176,1159,17,8,5,4,0
2021,Tewkesbury 007B,E01022426,1390,1380,10,7,1,2,0
2021,Tewkesbury 007C,E01022427,1364,1319,45,14,23,7,1
2021,Tewkesbury 007D,E01022428,1848,1733,115,52,44,18,1
2021,Tewkesbury 007E,E01022429,1512,1481,31,21,9,1,0
2021,Tewkesbury 007F,E01022430,1428,1407,21,13,6,2,0
2021,Tewkesbury 007G,E01022431,1837,1783,54,33,14,7,0
2021,Tewkesbury 011E,E01022432,1926,1869,57,31,19,6,1
2021,Tewkesbury 011C,E01022433,1917,1888,29,17,7,5,0
2021,Tewkesbury 004A,E01022434,2058,2020,38,26,7,5,0
2021,Tewkesbury 010D,E01022437,1421,1381,40,29,7,4,0
2021,Tewkesbury 010E,E01022438,1251,1210,41,23,13,4,1
2021,Tewkesbury 010C,E01022439,2517,2404,113,73,30,10,0
2021,Tewkesbury 006A,E01022440,2254,2193,61,45,13,3,0
2021,Tewkesbury 004B,E01022441,1514,1475,39,19,15,5,0
2021,Tewkesbury 006B,E01022442,1618,1611,7,3,2,2,0
2021,Tewkesbury 006C,E01022443,1443,1424,19,10,8,1,0
2021,Tewkesbury 006D,E01022444,1598,1582,16,8,6,2,0
2021,Tewkesbury 004C,E01022445,1395,1376,19,11,5,3,0
2021,Tewkesbury 007H,E01022447,1410,989,421,196,180,36,9
2021,Tewkesbury 008B,E01022448,2110,1989,121,71,39,8,3
2021,Tewkesbury 003A,E01022449,2000,1981,19,11,8,0,0
2021,Tewkesbury 001B,E01022450,2012,1861,151,70,58,19,4
2021,Tewkesbury 001C,E01022451,1419,1389,30,7,13,10,0
2021,Tewkesbury 001D,E01022452,1289,1245,44,28,11,3,2
2021,Tewkesbury 004D,E01022453,2320,2295,25,11,9,5,0
2021,Tewkesbury 008C,E01022454,2475,2396,79,45,24,10,0
2021,Tewkesbury 001E,E01022455,1805,1777,28,14,10,4,0
2021,Tewkesbury 002A,E01022456,1243,1203,40,18,15,7,0
2021,Tewkesbury 002B,E01022457,1307,1255,52,18,21,12,1
2021,Tewkesbury 002C,E01022458,1341,1226,115,48,48,18,1
2021,Tewkesbury 002D,E01022459,1434,1327,107,46,48,12,1
2021,Tewkesbury 002E,E01022460,1842,1776,66,26,29,9,2
2021,Tewkesbury 002F,E01022461,1309,1287,22,12,6,4,0
2021,Tewkesbury 002G,E01022462,1892,1870,22,5,11,3,3
2021,Tewkesbury 003B,E01022463,1404,1385,19,11,5,3,0
2021,Tewkesbury 003C,E01022464,1525,1498,27,14,11,2,0
2021,Tewkesbury 003D,E01022465,1734,1717,17,12,5,0,0
2021,Tewkesbury 003E,E01022466,2219,2192,27,17,6,2,2
2021,Basingstoke and Deane 017A,E01022467,1559,1529,30,20,9,0,1
2021,Basingstoke and Deane 017B,E01022468,1833,1802,31,17,8,4,2
2021,Basingstoke and Deane 017C,E01022469,1519,1486,33,19,8,4,2
2021,Basingstoke and Deane 008A,E01022470,1795,1747,48,31,14,3,0
2021,Basingstoke and Deane 008B,E01022471,1443,1387,56,39,15,2,0
2021,Basingstoke and Deane 004A,E01022472,1230,1200,30,14,9,5,2
2021,Basingstoke and Deane 004B,E01022473,1183,1170,13,8,5,0,0
2021,Basingstoke and Deane 019A,E01022474,1692,1516,176,69,83,17,7
2021,Basingstoke and Deane 016A,E01022475,1579,1439,140,58,61,19,2
2021,Basingstoke and Deane 016B,E01022476,1675,1552,123,56,49,15,3
2021,Basingstoke and Deane 019B,E01022477,1325,1237,88,48,27,13,0
2021,Basingstoke and Deane 019C,E01022478,1397,1314,83,44,26,11,2
2021,Basingstoke and Deane 019D,E01022479,1414,1270,144,65,61,17,1
2021,Basingstoke and Deane 016C,E01022480,1288,1169,119,50,52,15,2
2021,Basingstoke and Deane 012A,E01022481,1921,1517,404,144,181,53,26
2021,Basingstoke and Deane 012B,E01022482,1590,1260,330,123,146,47,14
2021,Basingstoke and Deane 013A,E01022484,1357,1226,131,53,65,12,1
2021,Basingstoke and Deane 013B,E01022485,1162,1055,107,46,43,10,8
2021,Basingstoke and Deane 013C,E01022486,2139,1987,152,68,59,17,8
2021,Basingstoke and Deane 013D,E01022487,1284,1203,81,24,39,12,6
2021,Basingstoke and Deane 003A,E01022488,1364,1331,33,23,8,2,0
2021,Basingstoke and Deane 003B,E01022489,1509,1454,55,24,27,4,0
2021,Basingstoke and Deane 005A,E01022490,1772,1728,44,29,10,3,2
2021,Basingstoke and Deane 005B,E01022491,1957,1913,44,35,8,0,1
2021,Basingstoke and Deane 005C,E01022492,1466,1405,61,28,22,11,0
2021,Basingstoke and Deane 002A,E01022493,1338,1312,26,11,10,4,1
2021,Basingstoke and Deane 008C,E01022494,2372,2278,94,56,27,7,4
2021,Basingstoke and Deane 006A,E01022495,1391,1308,83,51,26,6,0
2021,Basingstoke and Deane 006C,E01022497,1284,1211,73,50,16,7,0
2021,Basingstoke and Deane 006D,E01022498,1460,1370,90,56,26,7,1
2021,Basingstoke and Deane 003C,E01022499,1592,1561,31,28,3,0,0
2021,Basingstoke and Deane 003D,E01022500,1343,1279,64,30,20,13,1
2021,Basingstoke and Deane 011B,E01022502,1538,1289,249,102,112,31,4
2021,Basingstoke and Deane 012D,E01022503,1689,1507,182,97,54,25,6
2021,Basingstoke and Deane 016D,E01022504,1627,1553,74,36,27,7,4
2021,Basingstoke and Deane 016E,E01022505,1709,1589,120,56,46,14,4
2021,Basingstoke and Deane 011C,E01022506,1290,1213,77,37,25,14,1
2021,Basingstoke and Deane 011D,E01022507,1505,1374,131,75,43,13,0
2021,Basingstoke and Deane 019E,E01022509,1348,1286,62,42,17,3,0
2021,Basingstoke and Deane 021B,E01022510,1554,1509,45,24,11,9,1
2021,Basingstoke and Deane 021C,E01022511,1185,1137,48,35,10,3,0
2021,Basingstoke and Deane 021D,E01022512,1287,1249,38,23,8,7,0
2021,Basingstoke and Deane 003E,E01022513,1586,1561,25,15,8,1,1
2021,Basingstoke and Deane 020A,E01022514,1583,1559,24,12,10,1,1
2021,Basingstoke and Deane 018A,E01022515,1291,1265,26,18,6,2,0
2021,Basingstoke and Deane 018B,E01022516,1466,1428,38,24,10,4,0
2021,Basingstoke and Deane 018C,E01022517,1199,1171,28,21,5,2,0
2021,Basingstoke and Deane 018D,E01022518,1888,1868,20,16,1,3,0
2021,Basingstoke and Deane 018E,E01022519,1240,1203,37,22,10,3,2
2021,Basingstoke and Deane 004C,E01022520,1711,1654,57,33,21,3,0
2021,Basingstoke and Deane 004D,E01022521,1538,1513,25,12,5,6,2
2021,Basingstoke and Deane 004E,E01022522,1725,1702,23,12,8,2,1
2021,Basingstoke and Deane 008D,E01022523,2460,2064,396,150,142,81,23
2021,Basingstoke and Deane 009A,E01022524,1852,1556,296,132,118,39,7
2021,Basingstoke and Deane 009B,E01022525,1603,1435,168,83,64,15,6
2021,Basingstoke and Deane 009D,E01022527,1559,1408,151,79,45,24,3
2021,Basingstoke and Deane 015A,E01022528,1235,1229,6,5,1,0,0
2021,Basingstoke and Deane 015B,E01022529,1542,1517,25,18,3,3,1
2021,Basingstoke and Deane 015C,E01022530,1402,1370,32,22,7,2,1
2021,Basingstoke and Deane 015D,E01022531,1381,1361,20,11,8,1,0
2021,Basingstoke and Deane 022A,E01022532,2183,2114,69,42,18,7,2
2021,Basingstoke and Deane 022B,E01022533,1664,1631,33,21,6,6,0
2021,Basingstoke and Deane 022C,E01022534,1858,1829,29,21,7,1,0
2021,Basingstoke and Deane 022D,E01022535,1561,1530,31,22,8,0,1
2021,Basingstoke and Deane 002B,E01022536,1337,1321,16,12,3,1,0
2021,Basingstoke and Deane 002C,E01022537,1245,1235,10,6,4,0,0
2021,Basingstoke and Deane 007B,E01022539,1216,1034,182,75,81,19,7
2021,Basingstoke and Deane 007C,E01022540,2443,2101,342,188,105,42,7
2021,Basingstoke and Deane 007E,E01022542,1189,1027,162,84,40,34,4
2021,Basingstoke and Deane 007F,E01022543,1582,1326,256,110,113,27,6
2021,Basingstoke and Deane 005E,E01022547,1740,1712,28,21,4,3,0
2021,Basingstoke and Deane 014A,E01022548,1349,1230,119,51,50,16,2
2021,Basingstoke and Deane 014B,E01022549,1570,1421,149,72,49,22,6
2021,Basingstoke and Deane 014C,E01022550,1665,1510,155,75,48,28,4
2021,Basingstoke and Deane 014D,E01022551,1457,1249,208,107,63,25,13
2021,Basingstoke and Deane 014E,E01022552,1533,1343,190,78,78,30,4
2021,Basingstoke and Deane 001A,E01022553,1381,1354,27,16,5,5,1
2021,Basingstoke and Deane 001B,E01022554,1740,1724,16,11,3,2,0
2021,Basingstoke and Deane 001C,E01022555,1395,1354,41,22,18,1,0
2021,Basingstoke and Deane 001D,E01022556,1820,1764,56,26,23,7,0
2021,Basingstoke and Deane 002D,E01022557,1455,1417,38,17,16,5,0
2021,Basingstoke and Deane 002E,E01022558,1192,1145,47,29,16,2,0
2021,Basingstoke and Deane 002F,E01022559,1223,1205,18,9,5,4,0
2021,Basingstoke and Deane 001E,E01022560,1145,1102,43,29,10,2,2
2021,Basingstoke and Deane 017D,E01022561,1446,1422,24,16,7,0,1
2021,Basingstoke and Deane 017E,E01022562,1400,1383,17,8,5,3,1
2021,Basingstoke and Deane 020B,E01022563,1802,1781,21,13,8,0,0
2021,Basingstoke and Deane 020C,E01022564,2075,2031,44,24,16,4,0
2021,Basingstoke and Deane 020D,E01022565,1829,1787,42,27,8,7,0
2021,Basingstoke and Deane 010B,E01022566,1219,1154,65,33,23,5,4
2021,Basingstoke and Deane 010C,E01022567,1283,1158,125,53,54,17,1
2021,Basingstoke and Deane 010D,E01022568,1318,1247,71,29,30,9,3
2021,Basingstoke and Deane 013E,E01022569,1435,1346,89,52,26,9,2
2021,Basingstoke and Deane 010E,E01022570,1481,1407,74,50,17,6,1
2021,East Hampshire 003A,E01022571,1074,1057,17,10,7,0,0
2021,East Hampshire 003B,E01022572,1136,1122,14,12,1,1,0
2021,East Hampshire 003C,E01022573,2325,2242,83,46,30,6,1
2021,East Hampshire 002A,E01022574,1518,1453,65,32,25,8,0
2021,East Hampshire 002B,E01022575,1501,1447,54,22,29,3,0
2021,East Hampshire 002C,E01022576,1501,1436,65,29,26,9,1
2021,East Hampshire 003D,E01022577,1411,1384,27,17,6,4,0
2021,East Hampshire 002D,E01022579,1824,1719,105,48,39,14,4
2021,East Hampshire 003F,E01022580,1168,1114,54,28,18,6,2
2021,East Hampshire 001A,E01022581,1790,1736,54,33,15,5,1
2021,East Hampshire 001B,E01022582,1459,1446,13,10,3,0,0
2021,East Hampshire 009A,E01022583,1800,1728,72,37,30,5,0
2021,East Hampshire 009B,E01022584,1791,1724,67,41,16,6,4
2021,East Hampshire 009C,E01022585,1865,1821,44,24,15,4,1
2021,East Hampshire 009D,E01022586,2034,1993,41,21,14,3,3
2021,East Hampshire 009E,E01022587,2036,1971,65,28,24,12,1
2021,East Hampshire 013A,E01022588,2561,2504,57,38,13,6,0
2021,East Hampshire 013B,E01022589,1982,1936,46,28,9,9,0
2021,East Hampshire 013C,E01022590,1485,1466,19,11,5,3,0
2021,East Hampshire 007A,E01022591,2525,2477,48,28,17,1,2
2021,East Hampshire 011A,E01022592,2229,2198,31,16,11,2,2
2021,East Hampshire 007B,E01022593,1413,1393,20,14,6,0,0
2021,East Hampshire 007C,E01022594,1877,1834,43,25,14,3,1
2021,East Hampshire 007D,E01022595,2407,2374,33,22,6,5,0
2021,East Hampshire 007E,E01022596,1851,1813,38,22,9,6,1
2021,East Hampshire 011B,E01022597,2837,2757,80,38,30,12,0
2021,East Hampshire 017A,E01022599,1318,1259,59,30,25,3,1
2021,East Hampshire 017B,E01022600,1454,1437,17,15,1,1,0
2021,East Hampshire 017C,E01022601,1333,1311,22,18,0,4,0
2021,East Hampshire 017D,E01022602,1312,1297,15,12,2,1,0
2021,East Hampshire 004A,E01022603,1368,1304,64,34,26,4,0
2021,East Hampshire 001C,E01022604,1367,1350,17,15,1,1,0
2021,East Hampshire 001D,E01022605,2069,2011,58,36,17,2,3
2021,East Hampshire 014A,E01022606,2408,2382,26,17,6,2,1
2021,East Hampshire 013D,E01022607,1156,1143,13,4,2,5,2
2021,East Hampshire 013E,E01022608,1298,1292,6,5,0,1,0
2021,East Hampshire 016A,E01022610,1803,1761,42,25,8,8,1
2021,East Hampshire 014B,E01022611,1493,1467,26,15,6,1,4
2021,East Hampshire 014C,E01022613,1394,1368,26,10,8,6,2
2021,East Hampshire 014D,E01022614,1086,1076,10,3,4,3,0
2021,East Hampshire 006A,E01022615,2646,2553,93,40,39,12,2
2021,East Hampshire 010A,E01022616,1642,1576,66,33,22,9,2
2021,East Hampshire 010B,E01022617,1685,1640,45,17,16,11,1
2021,East Hampshire 010C,E01022618,1777,1756,21,15,4,1,1
2021,East Hampshire 011C,E01022619,1175,1130,45,20,22,2,1
2021,East Hampshire 012A,E01022620,1151,1114,37,21,8,6,2
2021,East Hampshire 012B,E01022621,1401,1363,38,23,11,2,2
2021,East Hampshire 012C,E01022622,2208,2168,40,27,9,1,3
2021,East Hampshire 012D,E01022623,2195,2122,73,46,23,3,1
2021,East Hampshire 011D,E01022624,2192,2158,34,20,11,3,0
2021,East Hampshire 011E,E01022625,2556,2510,46,29,12,5,0
2021,East Hampshire 007F,E01022627,2264,2224,40,25,13,1,1
2021,East Hampshire 016B,E01022628,1399,1338,61,30,19,10,2
2021,East Hampshire 016C,E01022629,1509,1502,7,7,0,0,0
2021,East Hampshire 008A,E01022630,2199,2161,38,22,9,7,0
2021,East Hampshire 010D,E01022631,1235,1213,22,12,9,1,0
2021,East Hampshire 010E,E01022632,1109,1093,16,11,3,2,0
2021,East Hampshire 006B,E01022633,1232,1174,58,37,16,3,2
2021,East Hampshire 004B,E01022634,1085,1018,67,27,26,13,1
2021,East Hampshire 006C,E01022635,1404,1337,67,43,18,3,3
2021,East Hampshire 006D,E01022636,1277,1203,74,48,23,3,0
2021,East Hampshire 004C,E01022639,1544,1386,158,69,66,20,3
2021,East Hampshire 004D,E01022640,2521,2344,177,96,60,13,8
2021,East Hampshire 006E,E01022641,1218,1114,104,44,30,27,3
2021,East Hampshire 008D,E01022642,1008,960,48,24,17,7,0
2021,Eastleigh 005A,E01022643,1480,1449,31,22,6,3,0
2021,Eastleigh 005B,E01022644,1179,1153,26,15,6,3,2
2021,Eastleigh 008A,E01022645,1090,1079,11,9,2,0,0
2021,Eastleigh 005C,E01022646,1434,1411,23,14,7,2,0
2021,Eastleigh 005D,E01022647,1713,1671,42,31,7,4,0
2021,Eastleigh 004A,E01022648,1612,1574,38,25,9,3,1
2021,Eastleigh 005E,E01022649,1479,1458,21,15,6,0,0
2021,Eastleigh 005F,E01022650,1167,1122,45,26,12,7,0
2021,Eastleigh 012A,E01022651,1699,1664,35,20,10,3,2
2021,Eastleigh 011A,E01022652,1714,1703,11,7,4,0,0
2021,Eastleigh 013A,E01022654,1263,1213,50,26,21,3,0
2021,Eastleigh 013B,E01022655,1417,1379,38,21,13,4,0
2021,Eastleigh 013C,E01022656,2312,2200,112,70,36,3,3
2021,Eastleigh 013D,E01022657,2627,2537,90,38,40,11,1
2021,Eastleigh 013E,E01022658,1656,1626,30,18,8,4,0
2021,Eastleigh 002A,E01022659,1466,1412,54,35,15,4,0
2021,Eastleigh 002B,E01022660,1428,1365,63,28,19,12,4
2021,Eastleigh 003A,E01022661,1638,1582,56,32,16,4,4
2021,Eastleigh 003B,E01022662,1327,1267,60,29,23,8,0
2021,Eastleigh 003C,E01022663,1559,1487,72,43,24,5,0
2021,Eastleigh 003D,E01022664,1485,1439,46,29,14,2,1
2021,Eastleigh 003E,E01022665,1325,1282,43,26,13,4,0
2021,Eastleigh 007A,E01022666,1992,1808,184,71,71,35,7
2021,Eastleigh 004B,E01022667,2021,1892,129,57,53,13,6
2021,Eastleigh 007B,E01022669,1689,1520,169,93,51,19,6
2021,Eastleigh 007C,E01022670,1420,1326,94,49,26,18,1
2021,Eastleigh 007D,E01022671,1416,1315,101,48,41,11,1
2021,Eastleigh 004C,E01022672,1441,1366,75,38,25,11,1
2021,Eastleigh 004D,E01022673,2184,2069,115,55,37,19,4
2021,Eastleigh 004E,E01022674,1452,1373,79,47,24,8,0
2021,Eastleigh 002C,E01022675,1296,1253,43,26,13,3,1
2021,Eastleigh 002D,E01022676,1787,1749,38,25,10,2,1
2021,Eastleigh 006C,E01022678,1935,1850,85,41,31,12,1
2021,Eastleigh 007E,E01022679,1871,1714,157,83,57,10,7
2021,Eastleigh 006D,E01022680,1666,1577,89,49,34,5,1
2021,Eastleigh 006E,E01022681,1729,1619,110,49,45,13,3
2021,Eastleigh 008B,E01022682,1814,1799,15,11,3,1,0
2021,Eastleigh 008C,E01022683,2195,2160,35,14,10,6,5
2021,Eastleigh 008D,E01022684,1374,1362,12,9,1,2,0
2021,Eastleigh 008E,E01022685,1088,1071,17,8,3,5,1
2021,Eastleigh 008F,E01022686,1951,1917,34,12,17,4,1
2021,Eastleigh 008G,E01022687,1622,1591,31,14,15,1,1
2021,Eastleigh 015A,E01022688,2153,2108,45,36,8,1,0
2021,Eastleigh 015B,E01022689,1872,1818,54,31,18,5,0
2021,Eastleigh 015C,E01022690,1839,1790,49,30,15,3,1
2021,Eastleigh 010B,E01022691,1460,1425,35,23,7,5,0
2021,Eastleigh 010D,E01022693,1410,1374,36,18,13,3,2
2021,Eastleigh 010E,E01022694,1696,1631,65,46,14,5,0
2021,Eastleigh 011B,E01022695,1204,1182,22,15,5,1,1
2021,Eastleigh 012B,E01022696,1460,1435,25,16,9,0,0
2021,Eastleigh 012C,E01022697,1553,1534,19,9,6,2,2
2021,Eastleigh 012D,E01022698,1928,1895,33,19,7,2,5
2021,Eastleigh 012E,E01022699,1684,1638,46,19,19,5,3
2021,Eastleigh 011C,E01022700,1498,1445,53,30,17,5,1
2021,Eastleigh 011D,E01022701,1031,1017,14,8,3,3,0
2021,Eastleigh 012F,E01022702,1250,1217,33,19,9,5,0
2021,Eastleigh 011E,E01022703,1375,1328,47,32,7,7,1
2021,Eastleigh 002E,E01022704,1807,1725,82,59,18,5,0
2021,Eastleigh 001A,E01022705,1606,1541,65,53,8,4,0
2021,Eastleigh 001B,E01022706,1664,1625,39,22,8,8,1
2021,Eastleigh 001C,E01022707,1896,1843,53,38,10,4,1
2021,Eastleigh 001D,E01022708,1729,1603,126,75,38,13,0
2021,Eastleigh 001E,E01022709,1702,1642,60,43,14,3,0
2021,Eastleigh 014A,E01022710,2030,1991,39,22,11,4,2
2021,Eastleigh 014B,E01022711,1725,1707,18,11,7,0,0
2021,Eastleigh 014C,E01022712,1561,1518,43,25,16,2,0
2021,Eastleigh 009A,E01022713,1988,1948,40,18,14,8,0
2021,Eastleigh 009B,E01022714,1577,1557,20,17,2,1,0
2021,Eastleigh 009C,E01022715,1867,1790,77,43,21,12,1
2021,Eastleigh 009D,E01022716,1407,1327,80,46,29,3,2
2021,Eastleigh 009E,E01022717,1141,1080,61,28,22,9,2
2021,Eastleigh 009F,E01022718,1499,1429,70,34,21,12,3
2021,Eastleigh 009G,E01022719,1544,1523,21,10,9,2,0
2021,Fareham 004A,E01022720,1455,1404,51,32,13,6,0
2021,Fareham 008A,E01022721,1502,1473,29,23,6,0,0
2021,Fareham 008B,E01022722,1584,1546,38,20,15,1,2
2021,Fareham 008C,E01022723,1466,1372,94,44,35,10,5
2021,Fareham 008D,E01022724,1339,1301,38,23,9,5,1
2021,Fareham 004B,E01022725,1258,1238,20,14,3,2,1
2021,Fareham 004C,E01022726,1405,1383,22,11,9,2,0
2021,Fareham 004D,E01022727,1478,1458,20,10,8,2,0
2021,Fareham 011A,E01022728,1598,1527,71,30,26,13,2
2021,Fareham 004E,E01022729,1117,1099,18,17,0,0,1
2021,Fareham 003A,E01022730,1454,1425,29,17,11,1,0
2021,Fareham 003B,E01022731,1211,1194,17,7,4,5,1
2021,Fareham 003C,E01022732,1414,1388,26,16,8,2,0
2021,Fareham 003D,E01022733,1602,1577,25,17,7,1,0
2021,Fareham 003E,E01022734,1355,1311,44,24,13,7,0
2021,Fareham 011B,E01022735,1702,1649,53,30,17,6,0
2021,Fareham 011C,E01022736,1521,1486,35,16,18,1,0
2021,Fareham 008E,E01022737,1505,1449,56,21,21,12,2
2021,Fareham 011D,E01022738,985,954,31,16,7,7,1
2021,Fareham 011E,E01022739,1512,1453,59,28,24,6,1
2021,Fareham 009A,E01022740,1532,1521,11,8,3,0,0
2021,Fareham 009B,E01022741,1406,1376,30,20,6,4,0
2021,Fareham 009C,E01022742,1636,1596,40,14,15,9,2
2021,Fareham 004F,E01022743,1762,1722,40,25,9,6,0
2021,Fareham 014A,E01022744,1272,1263,9,4,3,2,0
2021,Fareham 014B,E01022745,1518,1506,12,6,6,0,0
2021,Fareham 014C,E01022746,1652,1636,16,10,5,1,0
2021,Fareham 014D,E01022747,1172,1157,15,13,1,1,0
2021,Fareham 014E,E01022748,1346,1332,14,10,3,1,0
2021,Fareham 002A,E01022749,1291,1280,11,8,2,1,0
2021,Fareham 005A,E01022750,1386,1367,19,14,3,2,0
2021,Fareham 005B,E01022751,1508,1477,31,13,15,3,0
2021,Fareham 005C,E01022752,1332,1325,7,6,1,0,0
2021,Fareham 002B,E01022753,1117,1092,25,16,5,2,2
2021,Fareham 002C,E01022754,2220,2129,91,48,24,11,8
2021,Fareham 006A,E01022755,1618,1588,30,19,9,1,1
2021,Fareham 006B,E01022756,1716,1671,45,19,14,8,4
2021,Fareham 005D,E01022757,1535,1494,41,22,12,6,1
2021,Fareham 001A,E01022758,2125,2088,37,22,11,3,1
2021,Fareham 010A,E01022759,1530,1512,18,13,2,2,1
2021,Fareham 012A,E01022760,1491,1476,15,10,5,0,0
2021,Fareham 012B,E01022761,1391,1369,22,18,3,1,0
2021,Fareham 012C,E01022762,1418,1388,30,19,9,2,0
2021,Fareham 010B,E01022763,1484,1451,33,19,8,4,2
2021,Fareham 012D,E01022764,1493,1477,16,6,5,3,2
2021,Fareham 010C,E01022765,1716,1688,28,17,8,3,0
2021,Fareham 008F,E01022766,1227,1212,15,8,7,0,0
2021,Fareham 012E,E01022767,1262,1242,20,12,7,1,0
2021,Fareham 010D,E01022768,1315,1307,8,3,1,2,2
2021,Fareham 008G,E01022769,1250,1230,20,11,8,1,0
2021,Fareham 010E,E01022770,1886,1858,28,19,9,0,0
2021,Fareham 001B,E01022771,1643,1602,41,28,9,3,1
2021,Fareham 001C,E01022772,2455,2393,62,46,12,1,3
2021,Fareham 001D,E01022773,1669,1656,13,11,2,0,0
2021,Fareham 001E,E01022774,2051,2012,39,25,11,3,0
2021,Fareham 013B,E01022776,1469,1447,22,17,4,1,0
2021,Fareham 013C,E01022777,1540,1526,14,9,4,1,0
2021,Fareham 013D,E01022778,1368,1360,8,2,4,2,0
2021,Fareham 002D,E01022780,1666,1628,38,23,9,3,3
2021,Fareham 007A,E01022781,1322,1307,15,9,4,2,0
2021,Fareham 007B,E01022782,1545,1521,24,15,3,4,2
2021,Fareham 009D,E01022783,1394,1359,35,20,13,2,0
2021,Fareham 009E,E01022784,1320,1308,12,9,3,0,0
2021,Fareham 007C,E01022785,1392,1382,10,6,3,1,0
2021,Fareham 007D,E01022786,2081,2049,32,19,9,2,2
2021,Fareham 002E,E01022787,1327,1295,32,20,8,4,0
2021,Fareham 002F,E01022788,1215,1178,37,15,14,8,0
2021,Fareham 007E,E01022789,1452,1419,33,26,7,0,0
2021,Fareham 005E,E01022790,1651,1604,47,19,17,11,0
2021,Fareham 006C,E01022791,1821,1785,36,21,11,4,0
2021,Fareham 006D,E01022792,1565,1551,14,5,7,2,0
2021,Fareham 006E,E01022793,1886,1866,20,12,4,4,0
2021,Gosport 009A,E01022794,1459,1449,10,8,1,0,1
2021,Gosport 009B,E01022795,1522,1488,34,21,11,2,0
2021,Gosport 009C,E01022796,1310,1299,11,8,3,0,0
2021,Gosport 010A,E01022797,1093,1075,18,5,7,3,3
2021,Gosport 010B,E01022798,1440,1425,15,10,4,0,1
2021,Gosport 010C,E01022799,1374,1360,14,9,1,4,0
2021,Gosport 001A,E01022800,1506,1476,30,9,19,2,0
2021,Gosport 001B,E01022801,1417,1379,38,24,11,3,0
2021,Gosport 001C,E01022802,1468,1438,30,5,15,7,3
2021,Gosport 001D,E01022803,1544,1495,49,20,21,7,1
2021,Gosport 002A,E01022804,1533,1500,33,16,14,2,1
2021,Gosport 002B,E01022805,1341,1329,12,7,4,1,0
2021,Gosport 007A,E01022806,1305,1281,24,17,6,1,0
2021,Gosport 005A,E01022807,1330,1283,47,18,14,15,0
2021,Gosport 008A,E01022810,1433,1387,46,20,16,10,0
2021,Gosport 010D,E01022812,1158,1137,21,7,7,7,0
2021,Gosport 003A,E01022813,1301,1290,11,6,4,1,0
2021,Gosport 003B,E01022814,1590,1563,27,11,13,3,0
2021,Gosport 003C,E01022815,1466,1439,27,14,8,5,0
2021,Gosport 005B,E01022816,1317,1293,24,10,6,7,1
2021,Gosport 005C,E01022817,1685,1634,51,19,18,12,2
2021,Gosport 005D,E01022818,1406,1377,29,12,10,6,1
2021,Gosport 004A,E01022819,1545,1492,53,29,22,1,1
2021,Gosport 004B,E01022820,1614,1552,62,22,33,5,2
2021,Gosport 003D,E01022823,1449,1427,22,8,10,4,0
2021,Gosport 003E,E01022825,1289,1267,22,10,6,5,1
2021,Gosport 006A,E01022826,1448,1427,21,10,5,6,0
2021,Gosport 006C,E01022828,1246,1226,20,9,6,5,0
2021,Gosport 006D,E01022829,2515,2481,34,21,12,1,0
2021,Gosport 006E,E01022830,1324,1310,14,10,4,0,0
2021,Gosport 010E,E01022831,1280,1256,24,5,15,4,0
2021,Gosport 007D,E01022832,1570,1527,43,26,15,2,0
2021,Gosport 008C,E01022833,1652,1596,56,28,21,5,2
2021,Gosport 002C,E01022834,1215,1189,26,14,11,1,0
2021,Gosport 002D,E01022835,1305,1262,43,14,25,3,1
2021,Gosport 001E,E01022836,1379,1360,19,10,7,1,1
2021,Gosport 009D,E01022837,1493,1472,21,13,5,3,0
2021,Gosport 009E,E01022838,1247,1239,8,3,4,1,0
2021,Gosport 007E,E01022839,1243,1226,17,7,4,6,0
2021,Gosport 002E,E01022840,1454,1414,40,17,19,3,1
2021,Gosport 004E,E01022841,1462,1435,27,13,11,2,1
2021,Gosport 004F,E01022842,1547,1465,82,43,20,13,6
2021,Gosport 008D,E01022843,1457,1428,29,19,7,2,1
2021,Gosport 010F,E01022845,1320,1288,32,11,13,7,1
2021,Hart 003A,E01022846,2477,2208,269,107,153,9,0
2021,Hart 003B,E01022847,1737,1618,119,50,39,24,6
2021,Hart 003C,E01022848,1484,1381,103,60,30,12,1
2021,Hart 009A,E01022849,1650,1602,48,28,11,9,0
2021,Hart 009B,E01022850,1440,1399,41,26,14,0,1
2021,Hart 009C,E01022851,1602,1569,33,21,8,4,0
2021,Hart 010A,E01022852,1730,1676,54,23,22,8,1
2021,Hart 009D,E01022853,1823,1777,46,30,8,7,1
2021,Hart 010B,E01022854,1560,1530,30,20,9,1,0
2021,Hart 010C,E01022855,1182,1167,15,9,3,3,0
2021,Hart 010D,E01022856,1632,1602,30,15,11,4,0
2021,Hart 004A,E01022858,1212,1174,38,28,7,2,1
2021,Hart 002A,E01022859,1658,1637,21,13,6,2,0
2021,Hart 005A,E01022860,1966,1880,86,53,28,3,2
2021,Hart 007A,E01022861,1592,1563,29,19,6,2,2
2021,Hart 005B,E01022862,2168,1936,232,101,100,30,1
2021,Hart 007B,E01022863,1536,1515,21,17,4,0,0
2021,Hart 008A,E01022864,1421,1370,51,19,23,8,1
2021,Hart 007C,E01022865,1599,1573,26,20,5,0,1
2021,Hart 005D,E01022867,1548,1467,81,49,23,7,2
2021,Hart 007D,E01022868,1650,1623,27,17,8,1,1
2021,Hart 009E,E01022869,1488,1441,47,25,14,7,1
2021,Hart 007E,E01022870,1352,1320,32,26,3,1,2
2021,Hart 008B,E01022871,1297,1251,46,22,18,6,0
2021,Hart 008C,E01022872,1746,1645,101,47,41,12,1
2021,Hart 003D,E01022874,1257,1172,85,42,28,12,3
2021,Hart 003E,E01022875,1375,1236,139,63,49,24,3
2021,Hart 003F,E01022876,1480,1421,59,36,17,4,2
2021,Hart 003G,E01022877,1383,1355,28,18,9,1,0
2021,Hart 004B,E01022878,1640,1628,12,10,2,0,0
2021,Hart 004C,E01022879,2080,2038,42,35,5,2,0
2021,Hart 004D,E01022880,2047,2007,40,23,13,4,0
2021,Hart 006A,E01022881,2666,2561,105,69,24,10,2
2021,Hart 006B,E01022882,2405,2312,93,43,41,8,1
2021,Hart 006C,E01022883,1348,1319,29,21,6,1,1
2021,Hart 006D,E01022884,1527,1471,56,24,22,7,3
2021,Hart 006E,E01022885,1375,1329,46,30,14,2,0
2021,Hart 008E,E01022887,1506,1480,26,14,7,5,0
2021,Hart 011B,E01022888,2093,2057,36,21,11,2,2
2021,Hart 011C,E01022889,1479,1441,38,25,10,3,0
2021,Hart 001A,E01022890,1424,1367,57,36,17,3,1
2021,Hart 001B,E01022891,1778,1718,60,25,30,2,3
2021,Hart 001C,E01022892,1851,1823,28,16,10,1,1
2021,Hart 001D,E01022893,1761,1734,27,18,7,2,0
2021,Hart 001E,E01022894,1364,1336,28,18,6,4,0
2021,Hart 002B,E01022895,1621,1576,45,26,12,7,0
2021,Hart 002C,E01022896,1464,1448,16,9,5,1,1
2021,Hart 002D,E01022897,1553,1530,23,18,4,1,0
2021,Hart 002E,E01022898,1434,1416,18,10,4,3,1
2021,Havant 018A,E01022899,1322,1290,32,20,12,0,0
2021,Havant 010A,E01022900,1706,1660,46,15,15,15,1
2021,Havant 006A,E01022901,1756,1717,39,19,15,4,1
2021,Havant 006B,E01022902,1448,1422,26,17,3,5,1
2021,Havant 008A,E01022903,1637,1602,35,18,12,5,0
2021,Havant 010B,E01022904,2023,1948,75,36,33,4,2
2021,Havant 010C,E01022905,1650,1601,49,10,28,10,1
2021,Havant 008B,E01022906,1378,1358,20,13,6,1,0
2021,Havant 018B,E01022907,1502,1484,18,10,6,1,1
2021,Havant 010D,E01022908,1421,1398,23,13,8,2,0
2021,Havant 018C,E01022909,1720,1687,33,14,9,7,3
2021,Havant 018D,E01022910,1420,1372,48,24,12,10,2
2021,Havant 018E,E01022911,1487,1451,36,18,10,8,0
2021,Havant 009A,E01022913,1239,1230,9,8,1,0,0
2021,Havant 009B,E01022914,1243,1218,25,10,10,4,1
2021,Havant 009C,E01022915,1455,1423,32,13,13,6,0
2021,Havant 009D,E01022916,1537,1513,24,13,8,2,1
2021,Havant 009E,E01022917,1133,1115,18,8,6,3,1
2021,Havant 020A,E01022918,1467,1446,21,11,7,3,0
2021,Havant 019A,E01022919,1517,1496,21,11,8,1,1
2021,Havant 020B,E01022920,1550,1528,22,12,10,0,0
2021,Havant 020C,E01022921,1463,1453,10,8,1,0,1
2021,Havant 004A,E01022922,1411,1388,23,13,5,5,0
2021,Havant 013A,E01022924,1487,1475,12,8,2,2,0
2021,Havant 013B,E01022925,2124,2097,27,19,6,2,0
2021,Havant 013C,E01022926,1718,1695,23,12,9,2,0
2021,Havant 013D,E01022927,1598,1580,18,11,2,5,0
2021,Havant 013E,E01022928,1679,1645,34,12,11,7,4
2021,Havant 013F,E01022929,1438,1385,53,30,13,8,2
2021,Havant 003A,E01022930,1679,1658,21,10,7,4,0
2021,Havant 003B,E01022931,1561,1528,33,20,9,4,0
2021,Havant 019B,E01022933,1486,1460,26,16,6,4,0
2021,Havant 019C,E01022934,1742,1697,45,21,16,6,2
2021,Havant 003C,E01022935,1437,1408,29,17,7,2,3
2021,Havant 017A,E01022936,1441,1401,40,18,18,4,0
2021,Havant 015A,E01022937,1277,1266,11,4,6,1,0
2021,Havant 017B,E01022938,1691,1659,32,16,11,5,0
2021,Havant 017C,E01022939,1509,1493,16,6,6,2,2
2021,Havant 016A,E01022940,1529,1500,29,11,11,7,0
2021,Havant 017D,E01022941,1429,1417,12,8,3,0,1
2021,Havant 016B,E01022942,1429,1377,52,22,23,7,0
2021,Havant 015B,E01022943,1361,1335,26,16,8,2,0
2021,Havant 015C,E01022944,1251,1236,15,9,6,0,0
2021,Havant 016C,E01022945,2194,2143,51,29,13,9,0
2021,Havant 015D,E01022946,1972,1935,37,22,12,2,1
2021,Havant 011A,E01022947,1600,1575,25,10,9,4,2
2021,Havant 011B,E01022948,1597,1575,22,19,2,1,0
2021,Havant 011C,E01022949,1436,1382,54,30,19,5,0
2021,Havant 011D,E01022950,1735,1695,40,22,16,2,0
2021,Havant 011E,E01022951,1341,1323,18,12,6,0,0
2021,Havant 011F,E01022952,1392,1357,35,26,8,1,0
2021,Havant 014B,E01022954,1527,1503,24,14,6,4,0
2021,Havant 014C,E01022955,1548,1514,34,19,8,7,0
2021,Havant 014D,E01022956,1116,1098,18,14,1,3,0
2021,Havant 014E,E01022957,1279,1237,42,20,16,6,0
2021,Havant 014F,E01022958,2226,2193,33,18,14,1,0
2021,Havant 005A,E01022959,1408,1359,49,28,14,5,2
2021,Havant 007A,E01022960,1252,1181,71,38,32,1,0
2021,Havant 007B,E01022961,1241,1173,68,48,17,3,0
2021,Havant 005B,E01022962,2055,2016,39,26,8,5,0
2021,Havant 007C,E01022963,1397,1354,43,26,14,1,2
2021,Havant 007D,E01022964,1312,1266,46,21,24,1,0
2021,Havant 005C,E01022965,1356,1332,24,16,8,0,0
2021,Havant 006C,E01022966,1294,1270,24,8,10,4,2
2021,Havant 006D,E01022967,1088,1074,14,8,6,0,0
2021,Havant 008C,E01022968,1334,1315,19,10,5,3,1
2021,Havant 008D,E01022969,1746,1696,50,30,15,5,0
2021,Havant 010E,E01022970,1809,1759,50,25,19,5,1
2021,Havant 004B,E01022971,1405,1383,22,14,8,0,0
2021,Havant 004C,E01022972,1771,1745,26,7,8,9,2
2021,Havant 005D,E01022973,2084,2000,84,38,29,15,2
2021,Havant 004D,E01022974,1308,1286,22,9,10,3,0
2021,Havant 003D,E01022975,1930,1889,41,21,13,5,2
2021,Havant 003E,E01022976,1390,1376,14,9,3,2,0
2021,New Forest 006A,E01022977,1427,1416,11,9,0,2,0
2021,New Forest 006B,E01022978,1563,1550,13,4,5,3,1
2021,New Forest 006C,E01022979,1106,1090,16,14,2,0,0
2021,New Forest 006D,E01022980,1452,1432,20,15,3,1,1
2021,New Forest 022A,E01022981,1873,1843,30,22,6,2,0
2021,New Forest 022B,E01022982,1866,1784,82,36,36,8,2
2021,New Forest 022C,E01022983,1590,1573,17,10,4,3,0
2021,New Forest 018A,E01022984,1434,1426,8,5,3,0,0
2021,New Forest 018B,E01022985,1150,1118,32,20,8,4,0
2021,New Forest 021A,E01022986,1408,1383,25,9,13,3,0
2021,New Forest 022D,E01022987,1993,1954,39,20,12,7,0
2021,New Forest 021B,E01022988,1419,1370,49,26,20,3,0
2021,New Forest 015A,E01022989,1757,1740,17,11,5,1,0
2021,New Forest 017A,E01022990,1525,1512,13,6,7,0,0
2021,New Forest 015B,E01022991,2090,2056,34,19,13,2,0
2021,New Forest 007A,E01022992,1137,1132,5,3,2,0,0
2021,New Forest 007B,E01022993,1301,1288,13,12,0,1,0
2021,New Forest 016A,E01022994,1478,1475,3,3,0,0,0
2021,New Forest 016B,E01022995,1379,1359,20,10,9,1,0
2021,New Forest 016C,E01022996,1168,1148,20,13,3,3,1
2021,New Forest 016D,E01022997,1278,1261,17,10,5,2,0
2021,New Forest 015C,E01022998,1713,1656,57,37,17,3,0
2021,New Forest 017B,E01022999,2036,1996,40,30,10,0,0
2021,New Forest 015D,E01023000,1711,1661,50,17,24,9,0
2021,New Forest 019A,E01023001,1964,1869,95,48,37,7,3
2021,New Forest 019B,E01023002,1631,1551,80,50,25,5,0
2021,New Forest 011A,E01023003,1684,1667,17,14,0,2,1
2021,New Forest 011B,E01023004,1764,1746,18,9,8,1,0
2021,New Forest 011C,E01023005,1424,1410,14,7,7,0,0
2021,New Forest 011D,E01023006,1345,1317,28,17,7,3,1
2021,New Forest 008A,E01023007,1065,1061,4,4,0,0,0
2021,New Forest 009A,E01023008,1553,1528,25,15,6,3,1
2021,New Forest 009B,E01023009,1407,1379,28,16,10,2,0
2021,New Forest 008B,E01023010,1345,1333,12,6,5,1,0
2021,New Forest 001A,E01023011,1468,1455,13,10,3,0,0
2021,New Forest 001B,E01023012,1321,1303,18,13,5,0,0
2021,New Forest 014A,E01023013,1361,1350,11,4,7,0,0
2021,New Forest 014B,E01023014,1612,1588,24,9,6,5,4
2021,New Forest 014C,E01023015,1384,1352,32,16,9,6,1
2021,New Forest 014D,E01023016,1330,1323,7,5,2,0,0
2021,New Forest 020A,E01023017,1908,1888,20,13,5,0,2
2021,New Forest 020B,E01023018,1439,1396,43,20,21,0,2
2021,New Forest 020C,E01023019,1348,1280,68,35,29,3,1
2021,New Forest 018C,E01023020,1389,1370,19,11,5,3,0
2021,New Forest 001C,E01023021,1515,1490,25,16,6,3,0
2021,New Forest 001D,E01023022,1769,1716,53,31,18,4,0
2021,New Forest 001E,E01023023,1626,1618,8,2,6,0,0
2021,New Forest 001F,E01023024,1673,1656,17,10,5,1,1
2021,New Forest 001G,E01023025,1288,1278,10,8,2,0,0
2021,New Forest 010A,E01023026,1152,1125,27,14,11,2,0
2021,New Forest 014E,E01023027,1385,1370,15,11,3,1,0
2021,New Forest 011E,E01023028,1984,1933,51,35,12,2,2
2021,New Forest 013A,E01023029,1621,1604,17,12,4,1,0
2021,New Forest 013B,E01023030,1228,1215,13,10,0,3,0
2021,New Forest 014F,E01023031,1157,1141,16,4,6,6,0
2021,New Forest 013C,E01023032,1294,1291,3,0,1,2,0
2021,New Forest 013D,E01023033,1256,1246,10,6,1,3,0
2021,New Forest 018D,E01023034,1765,1746,19,6,5,4,4
2021,New Forest 018E,E01023035,1738,1717,21,15,5,1,0
2021,New Forest 018F,E01023036,1974,1958,16,10,1,5,0
2021,New Forest 011F,E01023037,1933,1904,29,16,7,4,2
2021,New Forest 009C,E01023038,1370,1354,16,11,4,1,0
2021,New Forest 009D,E01023039,1377,1361,16,11,4,1,0
2021,New Forest 009E,E01023040,1417,1406,11,8,1,2,0
2021,New Forest 017C,E01023041,1580,1540,40,14,26,0,0
2021,New Forest 017D,E01023042,1600,1543,57,29,24,4,0
2021,New Forest 017E,E01023043,1616,1554,62,42,14,4,2
2021,New Forest 023A,E01023044,1085,1064,21,10,10,1,0
2021,New Forest 007C,E01023045,1533,1499,34,14,12,7,1
2021,New Forest 007D,E01023046,1431,1370,61,22,20,14,5
2021,New Forest 008C,E01023047,1199,1170,29,21,6,2,0
2021,New Forest 008D,E01023048,1283,1268,15,6,8,1,0
2021,New Forest 008E,E01023049,1425,1390,35,28,6,1,0
2021,New Forest 008F,E01023050,1677,1635,42,30,12,0,0
2021,New Forest 023B,E01023051,1468,1448,20,10,10,0,0
2021,New Forest 023C,E01023052,1699,1674,25,19,5,1,0
2021,New Forest 023D,E01023053,1672,1649,23,13,10,0,0
2021,New Forest 021C,E01023054,1763,1668,95,38,38,17,2
2021,New Forest 020D,E01023055,1290,1229,61,25,30,5,1
2021,New Forest 021D,E01023056,1461,1407,54,30,16,6,2
2021,New Forest 021E,E01023057,1705,1582,123,63,49,9,2
2021,New Forest 019C,E01023058,1394,1333,61,30,25,5,1
2021,New Forest 023E,E01023059,1695,1652,43,24,14,3,2
2021,New Forest 019D,E01023060,1514,1486,28,18,6,3,1
2021,New Forest 019E,E01023061,1397,1332,65,32,28,5,0
2021,New Forest 010B,E01023062,1461,1447,14,10,4,0,0
2021,New Forest 016E,E01023063,1442,1428,14,10,3,0,1
2021,New Forest 010C,E01023064,1322,1306,16,12,1,3,0
2021,New Forest 012A,E01023065,1578,1567,11,7,0,4,0
2021,New Forest 010D,E01023066,1675,1661,14,12,2,0,0
2021,New Forest 010E,E01023067,1475,1451,24,16,8,0,0
2021,New Forest 012B,E01023068,1243,1230,13,5,8,0,0
2021,New Forest 012C,E01023069,1840,1813,27,19,5,3,0
2021,New Forest 012D,E01023070,1764,1709,55,23,21,10,1
2021,New Forest 012E,E01023071,1420,1395,25,14,10,1,0
2021,New Forest 005A,E01023072,1215,1183,32,19,12,1,0
2021,New Forest 003A,E01023073,1221,1198,23,15,8,0,0
2021,New Forest 004A,E01023074,1319,1300,19,9,10,0,0
2021,New Forest 005B,E01023075,1315,1267,48,24,17,5,2
2021,New Forest 002A,E01023076,1387,1369,18,8,9,0,1
2021,New Forest 004B,E01023077,1663,1577,86,28,35,22,1
2021,New Forest 004C,E01023078,1409,1385,24,12,7,5,0
2021,New Forest 004D,E01023079,1691,1662,29,18,7,4,0
2021,New Forest 003B,E01023080,1401,1371,30,19,6,5,0
2021,New Forest 003C,E01023081,1965,1928,37,25,6,4,2
2021,New Forest 002B,E01023082,1334,1316,18,12,4,1,1
2021,New Forest 002C,E01023083,1419,1402,17,9,8,0,0
2021,New Forest 005C,E01023084,1437,1424,13,7,6,0,0
2021,New Forest 004E,E01023085,1425,1402,23,16,6,0,1
2021,New Forest 005D,E01023086,1507,1490,17,5,9,1,2
2021,New Forest 005E,E01023087,1354,1328,26,20,5,1,0
2021,New Forest 002D,E01023088,1545,1505,40,22,18,0,0
2021,New Forest 003D,E01023089,1434,1411,23,12,9,2,0
2021,New Forest 003E,E01023090,1758,1714,44,23,14,6,1
2021,Rushmoor 006A,E01023091,1752,1527,225,69,89,50,17
2021,Rushmoor 005A,E01023092,1358,1312,46,26,16,2,2
2021,Rushmoor 005B,E01023093,1255,1200,55,32,18,2,3
2021,Rushmoor 006B,E01023094,1276,1193,83,34,27,16,6
2021,Rushmoor 006C,E01023095,1840,1611,229,121,76,20,12
2021,Rushmoor 004A,E01023096,2269,1977,292,197,71,23,1
2021,Rushmoor 004B,E01023097,1481,1370,111,69,21,14,7
2021,Rushmoor 006D,E01023098,1638,1428,210,103,68,30,9
2021,Rushmoor 001A,E01023099,1587,1449,138,72,30,20,16
2021,Rushmoor 003A,E01023100,1167,1067,100,37,38,16,9
2021,Rushmoor 003B,E01023101,1213,1145,68,35,27,6,0
2021,Rushmoor 003C,E01023102,1390,1328,62,35,17,7,3
2021,Rushmoor 004C,E01023103,1522,1350,172,79,45,31,17
2021,Rushmoor 001B,E01023104,1586,1161,425,156,151,88,30
2021,Rushmoor 002A,E01023105,1562,1159,403,154,148,57,44
2021,Rushmoor 001C,E01023106,1437,1118,319,117,123,52,27
2021,Rushmoor 012A,E01023107,1445,1308,137,49,58,22,8
2021,Rushmoor 012B,E01023108,1494,1394,100,41,40,18,1
2021,Rushmoor 011A,E01023109,1519,1288,231,80,98,36,17
2021,Rushmoor 012C,E01023110,1780,1562,218,91,93,30,4
2021,Rushmoor 004D,E01023111,1787,1667,120,76,27,12,5
2021,Rushmoor 004E,E01023112,1246,1167,79,43,28,7,1
2021,Rushmoor 007A,E01023113,1826,1644,182,94,60,23,5
2021,Rushmoor 007B,E01023114,1410,1366,44,26,11,7,0
2021,Rushmoor 011B,E01023115,1401,1271,130,52,41,26,11
2021,Rushmoor 011C,E01023116,1886,1446,440,174,148,69,49
2021,Rushmoor 011D,E01023117,1728,1634,94,58,26,9,1
2021,Rushmoor 009A,E01023118,1816,1256,560,152,247,116,45
2021,Rushmoor 002B,E01023119,1205,959,246,66,103,47,30
2021,Rushmoor 002C,E01023120,1694,1243,451,164,160,86,41
2021,Rushmoor 001D,E01023121,1922,1705,217,94,66,44,13
2021,Rushmoor 002D,E01023122,1439,1060,379,148,125,70,36
2021,Rushmoor 012D,E01023123,1523,1270,253,91,98,43,21
2021,Rushmoor 009B,E01023124,1258,1061,197,76,77,35,9
2021,Rushmoor 009C,E01023125,2282,2056,226,107,77,30,12
2021,Rushmoor 010A,E01023128,1340,1073,267,119,100,37,11
2021,Rushmoor 010B,E01023129,1381,1047,334,99,124,78,33
2021,Rushmoor 010C,E01023130,1365,1297,68,39,16,9,4
2021,Rushmoor 010D,E01023131,1449,1323,126,41,46,33,6
2021,Rushmoor 005C,E01023132,1503,1364,139,68,51,19,1
2021,Rushmoor 005D,E01023133,1253,1200,53,31,17,3,2
2021,Rushmoor 003D,E01023134,1669,1552,117,59,35,17,6
2021,Rushmoor 005E,E01023135,2370,2204,166,88,53,22,3
2021,Rushmoor 007C,E01023136,2657,2318,339,166,129,33,11
2021,Rushmoor 007D,E01023137,1322,1195,127,62,40,22,3
2021,Rushmoor 007E,E01023138,1402,1258,144,65,41,30,8
2021,Rushmoor 007F,E01023139,1205,1119,86,40,26,15,5
2021,Rushmoor 007G,E01023140,1830,1502,328,152,134,33,9
2021,Rushmoor 008A,E01023141,2001,1504,497,216,239,29,13
2021,Rushmoor 008D,E01023144,1849,1046,803,226,267,181,129
2021,Rushmoor 010E,E01023145,2180,1461,719,185,262,170,102
2021,Rushmoor 002E,E01023146,1333,1084,249,79,103,47,20
2021,Rushmoor 003E,E01023147,1496,1288,208,99,64,31,14
2021,Rushmoor 006E,E01023148,1280,1104,176,74,69,26,7
2021,Rushmoor 006F,E01023149,1311,1126,185,73,60,37,15
2021,Test Valley 011A,E01023150,1649,1612,37,22,12,3,0
2021,Test Valley 011B,E01023151,1343,1282,61,23,27,9,2
2021,Test Valley 011C,E01023152,1629,1609,20,14,2,3,1
2021,Test Valley 002A,E01023153,1663,1452,211,90,90,31,0
2021,Test Valley 002B,E01023154,1560,1440,120,54,37,24,5
2021,Test Valley 002C,E01023156,1345,1198,147,62,59,23,3
2021,Test Valley 002D,E01023157,1287,1144,143,57,66,18,2
2021,Test Valley 012A,E01023158,2359,2303,56,36,15,5,0
2021,Test Valley 007A,E01023159,2276,2244,32,20,7,4,1
2021,Test Valley 008A,E01023160,1479,1466,13,10,3,0,0
2021,Test Valley 013A,E01023162,1819,1793,26,13,11,2,0
2021,Test Valley 013B,E01023163,1590,1567,23,14,6,2,1
2021,Test Valley 013C,E01023164,1509,1491,18,5,9,4,0
2021,Test Valley 001A,E01023165,2066,2023,43,32,11,0,0
2021,Test Valley 009A,E01023166,1542,1521,21,15,6,0,0
2021,Test Valley 009B,E01023167,1517,1500,17,12,0,5,0
2021,Test Valley 008B,E01023168,1397,1374,23,9,10,4,0
2021,Test Valley 001B,E01023169,2055,1992,63,40,17,6,0
2021,Test Valley 015A,E01023170,2437,2335,102,75,17,7,3
2021,Test Valley 015B,E01023171,1770,1615,155,80,54,19,2
2021,Test Valley 015C,E01023172,1449,1414,35,15,15,5,0
2021,Test Valley 015D,E01023173,1385,1345,40,20,15,4,1
2021,Test Valley 010A,E01023174,1603,1570,33,19,10,2,2
2021,Test Valley 010B,E01023175,1499,1485,14,12,2,0,0
2021,Test Valley 010C,E01023176,1505,1476,29,10,16,2,1
2021,Test Valley 009C,E01023177,2211,2193,18,10,6,2,0
2021,Test Valley 008C,E01023178,2242,2197,45,29,12,4,0
2021,Test Valley 004A,E01023179,1801,1719,82,34,32,13,3
2021,Test Valley 005B,E01023180,1612,1495,117,64,36,13,4
2021,Test Valley 001C,E01023181,1284,1230,54,23,21,9,1
2021,Test Valley 001D,E01023182,1455,1392,63,34,19,5,5
2021,Test Valley 004B,E01023183,1367,1293,74,26,34,13,1
2021,Test Valley 009D,E01023184,1371,1358,13,6,4,2,1
2021,Test Valley 009E,E01023185,1178,1166,12,7,2,0,3
2021,Test Valley 005C,E01023186,1614,1525,89,52,25,9,3
2021,Test Valley 006A,E01023187,1510,1426,84,47,28,8,1
2021,Test Valley 006B,E01023188,1231,1183,48,24,16,5,3
2021,Test Valley 005D,E01023189,1866,1769,97,41,38,12,6
2021,Test Valley 004C,E01023190,1189,1128,61,32,22,7,0
2021,Test Valley 012B,E01023191,1775,1734,41,24,11,6,0
2021,Test Valley 012C,E01023192,1831,1765,66,27,27,10,2
2021,Test Valley 012D,E01023193,1801,1759,42,30,10,2,0
2021,Test Valley 012E,E01023194,1397,1378,19,15,4,0,0
2021,Test Valley 007B,E01023195,1987,1952,35,24,10,0,1
2021,Test Valley 005E,E01023196,1642,1620,22,13,6,3,0
2021,Test Valley 007C,E01023197,1401,1345,56,41,12,2,1
2021,Test Valley 007D,E01023198,1416,1403,13,7,4,2,0
2021,Test Valley 012F,E01023200,1467,1433,34,21,7,5,1
2021,Test Valley 018A,E01023202,1902,1664,238,88,100,44,6
2021,Test Valley 004D,E01023203,1394,1308,86,33,32,21,0
2021,Test Valley 004E,E01023204,1547,1403,144,49,70,23,2
2021,Test Valley 002E,E01023205,1259,1108,151,62,53,28,8
2021,Test Valley 011D,E01023206,1126,1108,18,7,9,2,0
2021,Test Valley 010D,E01023207,1517,1495,22,14,6,1,1
2021,Test Valley 010E,E01023208,1062,1038,24,18,5,1,0
2021,Test Valley 010F,E01023209,1233,1198,35,17,16,2,0
2021,Test Valley 014A,E01023210,1455,1370,85,56,16,10,3
2021,Test Valley 014B,E01023211,1854,1726,128,95,24,7,2
2021,Test Valley 014C,E01023212,1371,1343,28,16,6,4,2
2021,Test Valley 014D,E01023213,1246,1182,64,39,21,4,0
2021,Test Valley 014E,E01023214,1242,1195,47,30,14,3,0
2021,Test Valley 018C,E01023215,1653,1569,84,35,25,17,7
2021,Test Valley 006C,E01023216,1850,1680,170,73,73,22,2
2021,Test Valley 006D,E01023217,1543,1481,62,28,31,2,1
2021,Test Valley 006E,E01023218,1472,1443,29,18,11,0,0
2021,Test Valley 018B,E01023219,1365,1273,92,37,32,20,3
2021,Winchester 012A,E01023220,1914,1884,30,24,5,1,0
2021,Winchester 012B,E01023221,1797,1780,17,13,4,0,0
2021,Winchester 012C,E01023222,1533,1515,18,9,8,1,0
2021,Winchester 012D,E01023223,1496,1489,7,4,2,1,0
2021,Winchester 004A,E01023225,2182,2109,73,44,26,3,0
2021,Winchester 010A,E01023226,1635,1606,29,19,8,2,0
2021,Winchester 010B,E01023227,1971,1930,41,28,9,4,0
2021,Winchester 010C,E01023228,2216,2182,34,23,10,1,0
2021,Winchester 009A,E01023229,2051,2010,41,26,12,3,0
2021,Winchester 010D,E01023230,2075,2033,42,32,7,1,2
2021,Winchester 014B,E01023231,1809,1793,16,8,6,1,1
2021,Winchester 014C,E01023232,2766,2720,46,32,12,2,0
2021,Winchester 014D,E01023233,1783,1766,17,11,4,2,0
2021,Winchester 014E,E01023234,1511,1494,17,10,5,1,1
2021,Winchester 011A,E01023235,2071,2054,17,12,4,1,0
2021,Winchester 002A,E01023236,1982,1926,56,26,27,3,0
2021,Winchester 002B,E01023237,1413,1363,50,27,16,7,0
2021,Winchester 002C,E01023238,1747,1694,53,27,24,1,1
2021,Winchester 002D,E01023239,1634,1584,50,34,10,5,1
2021,Winchester 003A,E01023240,2116,1954,162,95,44,18,5
2021,Winchester 003B,E01023241,1825,1766,59,27,32,0,0
2021,Winchester 009B,E01023242,1183,1126,57,36,17,3,1
2021,Winchester 009C,E01023243,1210,1115,95,52,29,14,0
2021,Winchester 009D,E01023244,1555,1498,57,43,12,2,0
2021,Winchester 013A,E01023245,2654,2625,29,16,11,2,0
2021,Winchester 010E,E01023246,1589,1571,18,16,0,2,0
2021,Winchester 005A,E01023247,1552,1486,66,27,15,17,7
2021,Winchester 003C,E01023248,1697,1670,27,14,3,9,1
2021,Winchester 005B,E01023249,1308,1243,65,37,20,8,0
2021,Winchester 005C,E01023250,1831,1662,169,72,70,20,7
2021,Winchester 006A,E01023251,1178,1070,108,45,39,13,11
2021,Winchester 007A,E01023252,1776,1577,199,113,54,25,7
2021,Winchester 003D,E01023253,1982,1915,67,48,18,1,0
2021,Winchester 007B,E01023254,1759,1654,105,64,31,10,0
2021,Winchester 006B,E01023255,1647,1507,140,60,58,21,1
2021,Winchester 006C,E01023256,1502,1346,156,58,70,22,6
2021,Winchester 006D,E01023257,1554,1447,107,55,35,14,3
2021,Winchester 006E,E01023258,1535,1436,99,46,34,12,7
2021,Winchester 009E,E01023259,2040,1951,89,61,19,8,1
2021,Winchester 008A,E01023260,1268,1206,62,32,20,9,1
2021,Winchester 008B,E01023261,1595,1523,72,33,27,10,2
2021,Winchester 008C,E01023262,1533,1466,67,45,16,5,1
2021,Winchester 007C,E01023263,2032,1922,110,78,28,4,0
2021,Winchester 007D,E01023264,1744,1647,97,68,23,6,0
2021,Winchester 007E,E01023265,1801,1746,55,34,11,9,1
2021,Winchester 008D,E01023266,2227,2136,91,48,33,9,1
2021,Winchester 007F,E01023267,1354,1289,65,42,16,6,1
2021,Winchester 005D,E01023268,1189,1141,48,30,16,2,0
2021,Winchester 005E,E01023269,2465,2314,151,91,53,5,2
2021,Winchester 005F,E01023270,1484,1410,74,36,25,12,1
2021,Winchester 013B,E01023271,1238,1209,29,11,12,3,3
2021,Winchester 012E,E01023272,1527,1515,12,9,2,0,1
2021,Winchester 012F,E01023273,1608,1595,13,8,3,2,0
2021,Winchester 003E,E01023274,2579,2479,100,63,24,8,5
2021,Winchester 011B,E01023275,1662,1651,11,10,1,0,0
2021,Winchester 011C,E01023276,1702,1687,15,11,1,1,2
2021,Winchester 011D,E01023277,1228,1222,6,3,2,1,0
2021,Winchester 004B,E01023278,1495,1478,17,7,9,1,0
2021,Winchester 004C,E01023279,1409,1402,7,4,2,1,0
2021,Winchester 004D,E01023280,1529,1506,23,13,9,0,1
2021,Winchester 004E,E01023281,1712,1665,47,29,14,4,0
2021,Winchester 011E,E01023282,2093,2063,30,17,10,3,0
2021,Winchester 013E,E01023285,1555,1528,27,16,6,5,0
2021,Winchester 001A,E01023286,1458,1425,33,22,8,3,0
2021,Winchester 001B,E01023287,2853,2769,84,60,17,4,3
2021,Winchester 001C,E01023288,1393,1357,36,27,7,1,1
2021,Broxbourne 004A,E01023289,1524,1475,49,21,21,7,0
2021,Broxbourne 004B,E01023290,1610,1562,48,24,16,6,2
2021,Broxbourne 004C,E01023291,1571,1523,48,29,12,5,2
2021,Broxbourne 004D,E01023292,1523,1475,48,31,12,5,0
2021,Broxbourne 011A,E01023293,1694,1631,63,21,30,11,1
2021,Broxbourne 011B,E01023294,1814,1651,163,73,56,27,7
2021,Broxbourne 011C,E01023295,1352,1242,110,54,38,18,0
2021,Broxbourne 011D,E01023296,1882,1770,112,69,32,7,4
2021,Broxbourne 010A,E01023297,1319,1196,123,50,51,19,3
2021,Broxbourne 010B,E01023298,1508,1399,109,46,38,22,3
2021,Broxbourne 010C,E01023299,1664,1438,226,104,83,35,4
2021,Broxbourne 010D,E01023300,1519,1270,249,104,97,41,7
2021,Broxbourne 010E,E01023301,1741,1484,257,99,108,45,5
2021,Broxbourne 008A,E01023302,1419,1274,145,53,57,32,3
2021,Broxbourne 008B,E01023303,1500,1311,189,81,73,30,5
2021,Broxbourne 008C,E01023304,1491,1336,155,68,55,24,8
2021,Broxbourne 008D,E01023305,1356,1253,103,39,39,24,1
2021,Broxbourne 008E,E01023306,1429,1338,91,33,40,17,1
2021,Broxbourne 006A,E01023307,1481,1434,47,22,19,4,2
2021,Broxbourne 006B,E01023308,1631,1581,50,25,19,5,1
2021,Broxbourne 006C,E01023309,1604,1564,40,22,15,3,0
2021,Broxbourne 006D,E01023310,2751,2467,284,111,110,56,7
2021,Broxbourne 007A,E01023311,1782,1693,89,36,33,17,3
2021,Broxbourne 007B,E01023312,1532,1478,54,20,24,10,0
2021,Broxbourne 007C,E01023313,1589,1536,53,22,23,8,0
2021,Broxbourne 009A,E01023314,1545,1466,79,40,20,16,3
2021,Broxbourne 007D,E01023315,1718,1665,53,25,15,12,1
2021,Broxbourne 001A,E01023316,1338,1310,28,13,12,3,0
2021,Broxbourne 001B,E01023317,2612,2473,139,56,64,17,2
2021,Broxbourne 001C,E01023318,1586,1498,88,37,27,21,3
2021,Broxbourne 001D,E01023319,1523,1456,67,25,31,10,1
2021,Broxbourne 003A,E01023320,2141,1788,353,114,159,73,7
2021,Broxbourne 003B,E01023321,1942,1850,92,41,38,11,2
2021,Broxbourne 003C,E01023322,1868,1740,128,46,54,25,3
2021,Broxbourne 003D,E01023323,1659,1526,133,54,58,17,4
2021,Broxbourne 009B,E01023324,1291,1220,71,37,20,12,2
2021,Broxbourne 009C,E01023325,1348,1243,105,46,45,10,4
2021,Broxbourne 009D,E01023326,1548,1444,104,44,39,21,0
2021,Broxbourne 002A,E01023327,1312,1133,179,48,85,37,9
2021,Broxbourne 002B,E01023328,1328,1273,55,19,25,10,1
2021,Broxbourne 002C,E01023329,1292,1213,79,30,25,23,1
2021,Broxbourne 002D,E01023330,1641,1509,132,55,42,23,12
2021,Broxbourne 002E,E01023331,1645,1497,148,55,57,33,3
2021,Broxbourne 012A,E01023332,2291,1844,447,163,185,87,12
2021,Broxbourne 012B,E01023333,2038,1718,320,133,127,57,3
2021,Broxbourne 012C,E01023334,1706,1510,196,80,85,29,2
2021,Broxbourne 012D,E01023335,1748,1479,269,98,109,52,10
2021,Broxbourne 013A,E01023336,2052,1587,465,158,189,108,10
2021,Broxbourne 013B,E01023337,1920,1359,561,183,244,117,17
2021,Broxbourne 013D,E01023339,1539,1245,294,87,123,76,8
2021,Broxbourne 005A,E01023340,1750,1666,84,37,32,12,3
2021,Broxbourne 005B,E01023341,1753,1690,63,21,24,17,1
2021,Broxbourne 005D,E01023343,2058,1854,204,79,93,29,3
2021,Broxbourne 005E,E01023344,1598,1520,78,36,31,9,2
2021,Dacorum 013A,E01023345,1886,1695,191,89,78,19,5
2021,Dacorum 013B,E01023346,2620,2344,276,162,79,30,5
2021,Dacorum 013C,E01023347,1393,1273,120,44,62,13,1
2021,Dacorum 013D,E01023348,1489,1321,168,65,75,25,3
2021,Dacorum 015A,E01023349,1836,1679,157,67,67,19,4
2021,Dacorum 015B,E01023350,1747,1638,109,57,38,12,2
2021,Dacorum 015C,E01023351,1650,1515,135,70,49,14,2
2021,Dacorum 004A,E01023352,2350,2277,73,32,26,13,2
2021,Dacorum 018B,E01023354,2332,2244,88,58,22,6,2
2021,Dacorum 006A,E01023355,1522,1507,15,9,6,0,0
2021,Dacorum 006B,E01023356,1106,1083,23,16,5,2,0
2021,Dacorum 020A,E01023357,1632,1452,180,71,80,26,3
2021,Dacorum 020B,E01023358,1485,1294,191,62,89,34,6
2021,Dacorum 020C,E01023359,1780,1648,132,54,52,24,2
2021,Dacorum 020D,E01023360,1498,1403,95,44,39,12,0
2021,Dacorum 009A,E01023361,1607,1541,66,39,22,5,0
2021,Dacorum 009B,E01023362,1793,1762,31,21,6,4,0
2021,Dacorum 009C,E01023363,1490,1442,48,37,9,1,1
2021,Dacorum 009D,E01023364,1294,1284,10,8,2,0,0
2021,Dacorum 014A,E01023365,1286,1187,99,42,46,11,0
2021,Dacorum 014B,E01023366,1481,1443,38,25,11,2,0
2021,Dacorum 014C,E01023367,1202,1183,19,15,2,2,0
2021,Dacorum 014D,E01023368,1707,1658,49,33,12,4,0
2021,Dacorum 012A,E01023369,1477,1427,50,29,17,3,1
2021,Dacorum 012B,E01023370,1629,1593,36,22,8,4,2
2021,Dacorum 012C,E01023371,1709,1671,38,24,10,4,0
2021,Dacorum 012D,E01023372,1493,1477,16,15,1,0,0
2021,Dacorum 021A,E01023373,2117,1976,141,60,63,17,1
2021,Dacorum 021B,E01023374,1352,1297,55,35,16,4,0
2021,Dacorum 021C,E01023375,1533,1506,27,16,10,1,0
2021,Dacorum 021D,E01023376,1203,1169,34,13,18,3,0
2021,Dacorum 021E,E01023377,1347,1322,25,10,10,4,1
2021,Dacorum 021F,E01023378,1735,1676,59,34,16,7,2
2021,Dacorum 018C,E01023379,1564,1514,50,27,14,9,0
2021,Dacorum 018D,E01023380,1143,1080,63,40,17,4,2
2021,Dacorum 018E,E01023381,1340,1319,21,14,6,1,0
2021,Dacorum 018F,E01023382,1482,1418,64,42,16,6,0
2021,Dacorum 016A,E01023383,1428,1383,45,29,12,3,1
2021,Dacorum 016B,E01023384,1895,1783,112,71,25,13,3
2021,Dacorum 016C,E01023385,1536,1467,69,32,26,9,2
2021,Dacorum 019A,E01023386,1403,1279,124,71,33,15,5
2021,Dacorum 019B,E01023387,1318,1204,114,57,36,16,5
2021,Dacorum 019C,E01023388,1458,1306,152,60,76,14,2
2021,Dacorum 019D,E01023389,1610,1494,116,64,37,13,2
2021,Dacorum 010A,E01023390,2050,1942,108,51,40,14,3
2021,Dacorum 010B,E01023391,1664,1556,108,46,40,19,3
2021,Dacorum 011A,E01023392,1582,1520,62,30,20,11,1
2021,Dacorum 007A,E01023393,1607,1404,203,94,86,20,3
2021,Dacorum 007B,E01023394,1385,1217,168,84,63,19,2
2021,Dacorum 007C,E01023395,1626,1416,210,85,93,30,2
2021,Dacorum 007D,E01023396,1539,1398,141,63,51,22,5
2021,Dacorum 007E,E01023397,1354,1276,78,44,27,7,0
2021,Dacorum 010C,E01023399,1621,1513,108,47,47,11,3
2021,Dacorum 015E,E01023400,2001,1794,207,104,71,29,3
2021,Dacorum 008A,E01023401,1701,1556,145,74,46,21,4
2021,Dacorum 008B,E01023402,1647,1452,195,105,74,12,4
2021,Dacorum 008C,E01023403,1448,1281,167,80,60,25,2
2021,Dacorum 008D,E01023404,1285,1165,120,51,48,19,2
2021,Dacorum 008E,E01023405,1511,1347,164,73,69,15,7
2021,Dacorum 022A,E01023406,1885,1842,43,24,13,4,2
2021,Dacorum 022B,E01023407,1661,1603,58,35,17,6,0
2021,Dacorum 022C,E01023408,1557,1515,42,31,10,0,1
2021,Dacorum 017A,E01023409,1853,1696,157,85,44,22,6
2021,Dacorum 017B,E01023410,1290,1263,27,18,7,0,2
2021,Dacorum 017C,E01023411,1533,1418,115,55,49,8,3
2021,Dacorum 017D,E01023412,1234,1209,25,18,5,2,0
2021,Dacorum 017E,E01023413,1273,1166,107,49,41,14,3
2021,Dacorum 020E,E01023414,2251,2044,207,131,53,18,5
2021,Dacorum 020F,E01023415,1367,1324,43,25,13,4,1
2021,Dacorum 006C,E01023416,1451,1434,17,11,5,1,0
2021,Dacorum 006D,E01023417,1315,1277,38,22,13,2,1
2021,Dacorum 003A,E01023418,1406,1361,45,23,18,3,1
2021,Dacorum 003B,E01023419,1977,1934,43,27,12,1,3
2021,Dacorum 003C,E01023420,1475,1441,34,24,9,1,0
2021,Dacorum 004B,E01023421,1527,1503,24,13,11,0,0
2021,Dacorum 004C,E01023422,1297,1273,24,11,12,1,0
2021,Dacorum 002A,E01023423,1428,1403,25,19,4,2,0
2021,Dacorum 002B,E01023424,1510,1497,13,9,1,3,0
2021,Dacorum 002C,E01023425,1341,1323,18,13,4,1,0
2021,Dacorum 002D,E01023426,1590,1531,59,41,16,2,0
2021,Dacorum 011B,E01023427,1727,1616,111,64,39,6,2
2021,Dacorum 011C,E01023428,1412,1300,112,65,39,8,0
2021,Dacorum 011D,E01023429,1794,1670,124,73,38,11,2
2021,Dacorum 001A,E01023430,1227,1207,20,19,0,1,0
2021,Dacorum 001B,E01023431,1321,1267,54,30,24,0,0
2021,Dacorum 001C,E01023432,1608,1577,31,24,5,2,0
2021,Dacorum 001D,E01023433,1446,1425,21,11,9,1,0
2021,Dacorum 005A,E01023434,1586,1359,227,99,88,30,10
2021,Dacorum 005B,E01023435,1406,1172,234,101,89,39,5
2021,Dacorum 005C,E01023436,1185,1049,136,55,53,23,5
2021,Dacorum 005D,E01023437,1353,1223,130,68,47,15,0
2021,East Hertfordshire 005A,E01023438,1489,1352,137,79,43,15,0
2021,East Hertfordshire 005B,E01023439,1384,1229,155,76,66,13,0
2021,East Hertfordshire 005C,E01023440,1688,1605,83,38,35,8,2
2021,East Hertfordshire 005D,E01023441,1486,1215,271,164,78,25,4
2021,East Hertfordshire 005E,E01023442,2183,1942,241,153,70,13,5
2021,East Hertfordshire 007A,E01023443,1367,1243,124,76,39,7,2
2021,East Hertfordshire 007B,E01023444,1820,1564,256,150,85,18,3
2021,East Hertfordshire 007C,E01023445,1682,1529,153,81,53,17,2
2021,East Hertfordshire 007E,E01023447,1266,1183,83,38,29,11,5
2021,East Hertfordshire 007F,E01023448,1437,1376,61,38,17,5,1
2021,East Hertfordshire 004A,E01023449,1768,1617,151,95,49,6,1
2021,East Hertfordshire 004C,E01023451,2247,2047,200,116,56,23,5
2021,East Hertfordshire 003A,E01023452,1276,1225,51,35,11,5,0
2021,East Hertfordshire 003B,E01023453,1992,1900,92,55,27,8,2
2021,East Hertfordshire 003C,E01023454,2115,2001,114,76,31,5,2
2021,East Hertfordshire 003D,E01023455,1323,1217,106,55,38,9,4
2021,East Hertfordshire 008A,E01023456,1299,1233,66,35,21,10,0
2021,East Hertfordshire 008B,E01023457,1422,1308,114,63,36,13,2
2021,East Hertfordshire 008C,E01023458,1351,1242,109,62,37,10,0
2021,East Hertfordshire 008D,E01023459,1257,1208,49,27,15,7,0
2021,East Hertfordshire 008E,E01023460,1503,1451,52,25,20,7,0
2021,East Hertfordshire 008F,E01023461,1519,1477,42,31,6,4,1
2021,East Hertfordshire 001A,E01023462,1364,1356,8,6,1,0,1
2021,East Hertfordshire 003E,E01023463,1321,1311,10,8,1,1,0
2021,East Hertfordshire 001C,E01023465,1585,1554,31,21,5,5,0
2021,East Hertfordshire 001D,E01023466,2065,2019,46,24,16,6,0
2021,East Hertfordshire 019E,E01023467,2308,2276,32,26,3,3,0
2021,East Hertfordshire 018A,E01023468,1259,1236,23,15,4,2,2
2021,East Hertfordshire 018B,E01023469,1423,1399,24,11,6,7,0
2021,East Hertfordshire 014A,E01023470,1717,1656,61,30,27,4,0
2021,East Hertfordshire 014B,E01023471,1376,1352,24,16,3,4,1
2021,East Hertfordshire 014C,E01023472,1322,1300,22,15,7,0,0
2021,East Hertfordshire 014D,E01023473,1708,1664,44,32,9,2,1
2021,East Hertfordshire 014E,E01023474,1506,1477,29,24,4,1,0
2021,East Hertfordshire 017A,E01023475,1396,1352,44,28,12,4,0
2021,East Hertfordshire 017B,E01023476,1681,1654,27,19,6,2,0
2021,East Hertfordshire 017C,E01023477,2099,1988,111,77,30,4,0
2021,East Hertfordshire 017E,E01023479,1536,1459,77,42,29,5,1
2021,East Hertfordshire 018C,E01023480,1610,1592,18,10,5,2,1
2021,East Hertfordshire 018D,E01023481,1818,1726,92,60,29,1,2
2021,East Hertfordshire 016A,E01023482,1866,1819,47,28,15,4,0
2021,East Hertfordshire 016B,E01023483,2318,2241,77,42,21,13,1
2021,East Hertfordshire 016C,E01023484,1555,1488,67,35,14,17,1
2021,East Hertfordshire 010A,E01023485,2220,2187,33,22,7,4,0
2021,East Hertfordshire 010B,E01023486,2579,2535,44,34,8,1,1
2021,East Hertfordshire 015A,E01023487,1486,1440,46,19,20,5,2
2021,East Hertfordshire 015B,E01023488,1581,1494,87,49,28,9,1
2021,East Hertfordshire 015C,E01023489,1321,1266,55,32,16,7,0
2021,East Hertfordshire 015D,E01023490,1247,1217,30,16,9,4,1
2021,East Hertfordshire 009A,E01023491,1324,1287,37,18,16,3,0
2021,East Hertfordshire 009B,E01023492,2102,2050,52,28,17,6,1
2021,East Hertfordshire 003F,E01023493,2456,2418,38,27,9,2,0
2021,East Hertfordshire 019A,E01023494,1571,1552,19,16,2,1,0
2021,East Hertfordshire 019D,E01023495,1304,1291,13,9,4,0,0
2021,East Hertfordshire 009C,E01023496,1375,1339,36,19,11,4,2
2021,East Hertfordshire 009D,E01023497,1639,1612,27,20,6,1,0
2021,East Hertfordshire 011A,E01023499,2110,2014,96,41,31,17,7
2021,East Hertfordshire 011B,E01023500,1636,1609,27,20,3,4,0
2021,East Hertfordshire 011C,E01023501,1513,1468,45,22,19,4,0
2021,East Hertfordshire 011D,E01023502,1693,1647,46,34,10,2,0
2021,East Hertfordshire 011E,E01023503,1559,1534,25,14,8,3,0
2021,East Hertfordshire 018E,E01023504,1390,1337,53,27,16,9,1
2021,East Hertfordshire 018F,E01023505,1612,1570,42,26,10,6,0
2021,East Hertfordshire 006B,E01023506,1528,1514,14,8,3,2,1
2021,East Hertfordshire 006C,E01023507,1662,1613,49,24,18,7,0
2021,East Hertfordshire 019B,E01023509,1313,1302,11,5,5,1,0
2021,East Hertfordshire 013A,E01023510,1570,1508,62,39,14,9,0
2021,East Hertfordshire 013B,E01023511,1578,1504,74,49,19,3,3
2021,East Hertfordshire 012A,E01023512,1987,1942,45,31,11,3,0
2021,East Hertfordshire 012B,E01023513,1455,1399,56,31,19,6,0
2021,East Hertfordshire 012C,E01023514,2068,1949,119,56,49,13,1
2021,East Hertfordshire 013C,E01023515,1610,1559,51,31,17,2,1
2021,East Hertfordshire 013D,E01023516,1868,1817,51,35,12,3,1
2021,East Hertfordshire 013E,E01023517,1481,1427,54,21,22,10,1
2021,East Hertfordshire 012D,E01023518,2074,2018,56,20,24,12,0
2021,East Hertfordshire 012E,E01023519,1686,1604,82,45,24,10,3
2021,East Hertfordshire 012F,E01023520,1574,1537,37,22,12,3,0
2021,Hertsmere 005A,E01023523,1716,1646,70,42,20,7,1
2021,Hertsmere 005B,E01023524,1415,1383,32,26,5,1,0
2021,Hertsmere 005C,E01023525,1704,1503,201,99,83,19,0
2021,Hertsmere 005D,E01023526,1711,1649,62,38,22,2,0
2021,Hertsmere 005E,E01023527,1431,1309,122,78,29,12,3
2021,Hertsmere 010A,E01023528,1404,1299,105,49,35,21,0
2021,Hertsmere 007A,E01023529,1476,1256,220,101,86,26,7
2021,Hertsmere 007B,E01023530,1235,964,271,98,122,49,2
2021,Hertsmere 007C,E01023531,1918,1664,254,106,107,36,5
2021,Hertsmere 007D,E01023532,1581,1422,159,79,59,19,2
2021,Hertsmere 007E,E01023533,1596,1383,213,118,72,17,6
2021,Hertsmere 006A,E01023534,1788,1547,241,116,90,30,5
2021,Hertsmere 006B,E01023535,1734,1517,217,98,87,29,3
2021,Hertsmere 006C,E01023536,1575,1349,226,106,75,37,8
2021,Hertsmere 006D,E01023537,2638,2277,361,188,136,35,2
2021,Hertsmere 006E,E01023538,2034,1696,338,153,134,44,7
2021,Hertsmere 011B,E01023540,1784,1659,125,74,32,15,4
2021,Hertsmere 011C,E01023541,2376,2087,289,169,99,18,3
2021,Hertsmere 011D,E01023542,1882,1636,246,121,85,31,9
2021,Hertsmere 011E,E01023543,1371,1156,215,108,81,24,2
2021,Hertsmere 009A,E01023544,1135,1039,96,54,34,8,0
2021,Hertsmere 009B,E01023545,1727,1474,253,132,96,23,2
2021,Hertsmere 009C,E01023546,1918,1654,264,125,106,32,1
2021,Hertsmere 009D,E01023547,1797,1542,255,118,93,38,6
2021,Hertsmere 013A,E01023548,1995,1849,146,79,49,16,2
2021,Hertsmere 013B,E01023549,1696,1533,163,100,48,12,3
2021,Hertsmere 013C,E01023550,1716,1448,268,152,90,25,1
2021,Hertsmere 013D,E01023551,1518,1441,77,39,28,9,1
2021,Hertsmere 008A,E01023552,1663,1549,114,66,30,15,3
2021,Hertsmere 008B,E01023553,2011,1740,271,153,88,23,7
2021,Hertsmere 008C,E01023554,1679,1446,233,120,88,19,6
2021,Hertsmere 008D,E01023555,1881,1699,182,103,52,25,2
2021,Hertsmere 013E,E01023556,1830,1698,132,73,40,16,3
2021,Hertsmere 013F,E01023557,1486,1397,89,51,29,8,1
2021,Hertsmere 012A,E01023558,1762,1581,181,86,74,18,3
2021,Hertsmere 012B,E01023559,1599,1487,112,64,33,11,4
2021,Hertsmere 012C,E01023560,1854,1608,246,129,89,24,4
2021,Hertsmere 012D,E01023561,1638,1509,129,68,42,19,0
2021,Hertsmere 012E,E01023562,1761,1639,122,69,43,10,0
2021,Hertsmere 012F,E01023563,1768,1631,137,70,51,16,0
2021,Hertsmere 010B,E01023564,1674,1392,282,135,119,23,5
2021,Hertsmere 010C,E01023565,1772,1599,173,93,63,17,0
2021,Hertsmere 010D,E01023566,1498,1427,71,51,11,8,1
2021,Hertsmere 002A,E01023567,2020,1936,84,49,24,7,4
2021,Hertsmere 002B,E01023568,1521,1411,110,67,34,9,0
2021,Hertsmere 002C,E01023569,1681,1520,161,100,38,18,5
2021,Hertsmere 002D,E01023570,1434,1314,120,58,37,22,3
2021,Hertsmere 003A,E01023571,1547,1445,102,53,35,11,3
2021,Hertsmere 003B,E01023572,1548,1428,120,56,46,16,2
2021,Hertsmere 003C,E01023573,1273,1112,161,66,62,28,5
2021,Hertsmere 003D,E01023574,1592,1435,157,69,60,20,8
2021,Hertsmere 003E,E01023575,1533,1389,144,81,37,23,3
2021,Hertsmere 001A,E01023576,1437,1357,80,45,22,12,1
2021,Hertsmere 001B,E01023577,1647,1531,116,67,37,9,3
2021,Hertsmere 001C,E01023578,1663,1576,87,52,29,5,1
2021,Hertsmere 001D,E01023579,1398,1157,241,130,86,21,4
2021,Hertsmere 001E,E01023580,1632,1482,150,69,57,23,1
2021,Hertsmere 004A,E01023581,1260,1211,49,34,12,2,1
2021,Hertsmere 004B,E01023582,1590,1497,93,44,40,8,1
2021,Hertsmere 004C,E01023583,1347,1286,61,17,30,11,3
2021,Hertsmere 004D,E01023584,1033,994,39,20,10,8,1
2021,North Hertfordshire 016A,E01023585,1132,1122,10,5,3,2,0
2021,North Hertfordshire 016B,E01023586,1613,1580,33,28,3,1,1
2021,North Hertfordshire 004A,E01023587,1009,977,32,23,5,4,0
2021,North Hertfordshire 004B,E01023588,1366,1310,56,37,16,1,2
2021,North Hertfordshire 004C,E01023589,1657,1604,53,20,21,10,2
2021,North Hertfordshire 004D,E01023590,1750,1704,46,30,8,6,2
2021,North Hertfordshire 004E,E01023591,1516,1485,31,9,13,9,0
2021,North Hertfordshire 004F,E01023592,1591,1536,55,32,18,2,3
2021,North Hertfordshire 004G,E01023593,1444,1409,35,14,15,4,2
2021,North Hertfordshire 014A,E01023594,2297,2241,56,35,15,6,0
2021,North Hertfordshire 015A,E01023595,1492,1460,32,16,10,6,0
2021,North Hertfordshire 015B,E01023596,1107,1092,15,9,5,0,1
2021,North Hertfordshire 016C,E01023597,1220,1196,24,19,4,1,0
2021,North Hertfordshire 016D,E01023598,1484,1461,23,16,5,1,1
2021,North Hertfordshire 017B,E01023600,1347,1330,17,16,1,0,0
2021,North Hertfordshire 010A,E01023601,2129,1872,257,146,77,27,7
2021,North Hertfordshire 010B,E01023602,1472,1377,95,40,25,28,2
2021,North Hertfordshire 010C,E01023603,1508,1427,81,42,24,12,3
2021,North Hertfordshire 010D,E01023604,1345,1221,124,66,38,16,4
2021,North Hertfordshire 010E,E01023605,1373,1259,114,45,44,19,6
2021,North Hertfordshire 013A,E01023606,1671,1596,75,44,23,8,0
2021,North Hertfordshire 013B,E01023607,1433,1346,87,57,24,6,0
2021,North Hertfordshire 013C,E01023608,1564,1509,55,36,11,7,1
2021,North Hertfordshire 013D,E01023609,1608,1527,81,54,20,7,0
2021,North Hertfordshire 013E,E01023610,1320,1269,51,40,10,1,0
2021,North Hertfordshire 012A,E01023611,1597,1520,77,46,19,9,3
2021,North Hertfordshire 012B,E01023612,1765,1657,108,64,25,15,4
2021,North Hertfordshire 012C,E01023613,1560,1501,59,27,15,17,0
2021,North Hertfordshire 012D,E01023614,2006,1937,69,40,18,10,1
2021,North Hertfordshire 012E,E01023615,1806,1766,40,23,9,4,4
2021,North Hertfordshire 012F,E01023616,2406,2276,130,87,31,12,0
2021,North Hertfordshire 011A,E01023617,1506,1422,84,47,23,9,5
2021,North Hertfordshire 011B,E01023618,1668,1584,84,39,26,15,4
2021,North Hertfordshire 011C,E01023619,1640,1498,142,78,42,20,2
2021,North Hertfordshire 011D,E01023620,1311,1232,79,40,25,14,0
2021,North Hertfordshire 011E,E01023621,1306,1219,87,55,22,10,0
2021,North Hertfordshire 014B,E01023622,1125,1102,23,5,14,4,0
2021,North Hertfordshire 014C,E01023623,1537,1526,11,8,0,3,0
2021,North Hertfordshire 014D,E01023624,1361,1354,7,6,1,0,0
2021,North Hertfordshire 014E,E01023625,1057,1034,23,9,13,1,0
2021,North Hertfordshire 015C,E01023626,2226,2197,29,20,4,4,1
2021,North Hertfordshire 015D,E01023627,1830,1782,48,32,10,4,2
2021,North Hertfordshire 015E,E01023628,1789,1731,58,34,21,2,1
2021,North Hertfordshire 015F,E01023629,1638,1585,53,35,16,2,0
2021,North Hertfordshire 006A,E01023630,1796,1694,102,51,28,22,1
2021,North Hertfordshire 006B,E01023631,1608,1519,89,45,25,16,3
2021,North Hertfordshire 006C,E01023632,1826,1692,134,66,39,26,3
2021,North Hertfordshire 006D,E01023633,1279,1203,76,42,27,7,0
2021,North Hertfordshire 006E,E01023634,1250,1204,46,20,20,6,0
2021,North Hertfordshire 003A,E01023635,1444,1365,79,34,26,15,4
2021,North Hertfordshire 003B,E01023636,1805,1750,55,36,15,2,2
2021,North Hertfordshire 003C,E01023637,1753,1693,60,26,22,10,2
2021,North Hertfordshire 003D,E01023638,1583,1493,90,48,32,8,2
2021,North Hertfordshire 009A,E01023639,1232,1168,64,39,16,9,0
2021,North Hertfordshire 009B,E01023640,1212,1125,87,44,23,20,0
2021,North Hertfordshire 009C,E01023641,1305,1234,71,36,23,10,2
2021,North Hertfordshire 009D,E01023642,1232,1174,58,32,16,8,2
2021,North Hertfordshire 009E,E01023643,1227,1139,88,43,31,12,2
2021,North Hertfordshire 008A,E01023644,1679,1562,117,59,42,13,3
2021,North Hertfordshire 008B,E01023645,1530,1454,76,46,19,11,0
2021,North Hertfordshire 008C,E01023646,1425,1363,62,29,20,12,1
2021,North Hertfordshire 008D,E01023647,1434,1347,87,48,28,8,3
2021,North Hertfordshire 008E,E01023648,1173,1114,59,45,12,2,0
2021,North Hertfordshire 007A,E01023649,1233,1156,77,38,19,14,6
2021,North Hertfordshire 007B,E01023650,1569,1471,98,44,38,12,4
2021,North Hertfordshire 007C,E01023651,1201,1096,105,53,37,12,3
2021,North Hertfordshire 007D,E01023652,1441,1363,78,33,32,11,2
2021,North Hertfordshire 014F,E01023653,2456,2420,36,27,4,5,0
2021,North Hertfordshire 002A,E01023654,1511,1479,32,23,6,3,0
2021,North Hertfordshire 002B,E01023655,1967,1901,66,41,18,5,2
2021,North Hertfordshire 002C,E01023656,2175,2040,135,90,32,11,2
2021,North Hertfordshire 002D,E01023657,2475,2403,72,48,21,1,2
2021,North Hertfordshire 002E,E01023658,1700,1648,52,25,18,5,4
2021,North Hertfordshire 002F,E01023659,1299,1276,23,16,5,2,0
2021,North Hertfordshire 001A,E01023660,2292,2187,105,62,35,7,1
2021,North Hertfordshire 001B,E01023661,1323,1286,37,25,11,1,0
2021,North Hertfordshire 001C,E01023662,1971,1859,112,86,21,5,0
2021,North Hertfordshire 016E,E01023663,2024,1987,37,24,9,4,0
2021,St Albans 013A,E01023664,1862,1708,154,83,53,16,2
2021,St Albans 013B,E01023665,1690,1511,179,120,43,10,6
2021,St Albans 011A,E01023666,1892,1555,337,173,96,57,11
2021,St Albans 013C,E01023667,1392,1272,120,77,31,11,1
2021,St Albans 013D,E01023668,1373,1323,50,30,14,6,0
2021,St Albans 009A,E01023669,1694,1559,135,80,39,12,4
2021,St Albans 009B,E01023670,2013,1901,112,62,35,13,2
2021,St Albans 009C,E01023671,1891,1726,165,88,40,30,7
2021,St Albans 009D,E01023672,1859,1740,119,66,35,14,4
2021,St Albans 010A,E01023673,1411,1363,48,33,12,0,3
2021,St Albans 011B,E01023674,1783,1601,182,93,54,30,5
2021,St Albans 011C,E01023675,1349,1302,47,28,13,4,2
2021,St Albans 011D,E01023676,2446,2097,349,226,93,23,7
2021,St Albans 021B,E01023677,1219,1149,70,42,16,10,2
2021,St Albans 021D,E01023678,1878,1761,117,70,29,16,2
2021,St Albans 021A,E01023680,1435,1311,124,63,34,27,0
2021,St Albans 016A,E01023681,1513,1310,203,84,67,46,6
2021,St Albans 016B,E01023682,1765,1596,169,89,47,31,2
2021,St Albans 016C,E01023683,1645,1481,164,89,56,17,2
2021,St Albans 016D,E01023684,1531,1424,107,66,38,3,0
2021,St Albans 002A,E01023685,1669,1586,83,55,22,6,0
2021,St Albans 002B,E01023686,1550,1519,31,26,4,1,0
2021,St Albans 002C,E01023687,1470,1411,59,32,16,7,4
2021,St Albans 002D,E01023688,1487,1425,62,40,11,11,0
2021,St Albans 002E,E01023689,1462,1413,49,28,13,6,2
2021,St Albans 001A,E01023690,1689,1610,79,59,17,3,0
2021,St Albans 001B,E01023691,1449,1427,22,17,5,0,0
2021,St Albans 001C,E01023692,1223,1180,43,30,12,1,0
2021,St Albans 001D,E01023693,1473,1416,57,33,17,7,0
2021,St Albans 001E,E01023694,1689,1647,42,35,4,0,3
2021,St Albans 005A,E01023695,1599,1567,32,18,8,5,1
2021,St Albans 005B,E01023696,1778,1732,46,40,3,0,3
2021,St Albans 005C,E01023697,1806,1723,83,47,26,9,1
2021,St Albans 005D,E01023698,1470,1406,64,50,9,5,0
2021,St Albans 003A,E01023699,1583,1533,50,34,13,1,2
2021,St Albans 003B,E01023700,1352,1319,33,24,5,4,0
2021,St Albans 003C,E01023701,1885,1733,152,95,46,10,1
2021,St Albans 003D,E01023702,1598,1527,71,47,14,9,1
2021,St Albans 003E,E01023703,1461,1426,35,23,11,1,0
2021,St Albans 018A,E01023704,1478,1345,133,68,48,15,2
2021,St Albans 018B,E01023705,1730,1520,210,64,83,51,12
2021,St Albans 018C,E01023706,1613,1486,127,57,54,15,1
2021,St Albans 018E,E01023708,1532,1444,88,42,37,8,1
2021,St Albans 008A,E01023709,1686,1542,144,90,34,20,0
2021,St Albans 008B,E01023710,1569,1516,53,35,11,7,0
2021,St Albans 008C,E01023711,1593,1493,100,56,23,19,2
2021,St Albans 008D,E01023712,1943,1699,244,153,71,19,1
2021,St Albans 007A,E01023713,1981,1811,170,98,50,20,2
2021,St Albans 010B,E01023714,1758,1708,50,43,5,2,0
2021,St Albans 010C,E01023715,1555,1504,51,31,10,9,1
2021,St Albans 010D,E01023716,1993,1875,118,81,28,6,3
2021,St Albans 020A,E01023717,1313,1234,79,55,16,4,4
2021,St Albans 019A,E01023718,1729,1681,48,32,14,2,0
2021,St Albans 019B,E01023719,1177,1113,64,31,22,9,2
2021,St Albans 019C,E01023720,1960,1852,108,61,32,14,1
2021,St Albans 019D,E01023721,1367,1330,37,26,7,4,0
2021,St Albans 006A,E01023722,1422,1400,22,14,8,0,0
2021,St Albans 006B,E01023723,1656,1613,43,20,15,8,0
2021,St Albans 006C,E01023724,1621,1592,29,19,7,3,0
2021,St Albans 006D,E01023725,1506,1486,20,15,4,0,1
2021,St Albans 012A,E01023726,1939,1731,208,129,52,22,5
2021,St Albans 012B,E01023727,2128,1825,303,182,91,28,2
2021,St Albans 012C,E01023728,2116,1967,149,107,30,12,0
2021,St Albans 020B,E01023730,1728,1680,48,38,7,3,0
2021,St Albans 020C,E01023731,1513,1425,88,56,23,9,0
2021,St Albans 020D,E01023732,1585,1513,72,41,19,9,3
2021,St Albans 020E,E01023733,1850,1749,101,57,30,11,3
2021,St Albans 007B,E01023734,1593,1508,85,59,23,3,0
2021,St Albans 007C,E01023735,1632,1526,106,54,44,7,1
2021,St Albans 007D,E01023736,1583,1540,43,26,13,4,0
2021,St Albans 017A,E01023737,1325,1152,173,54,71,41,7
2021,St Albans 017B,E01023738,1592,1412,180,87,66,26,1
2021,St Albans 017C,E01023739,1518,1355,163,72,56,33,2
2021,St Albans 017D,E01023740,1398,1227,171,101,47,20,3
2021,St Albans 017E,E01023741,1530,1439,91,65,14,9,3
2021,St Albans 014A,E01023742,1834,1762,72,47,17,7,1
2021,St Albans 014B,E01023743,1958,1840,118,76,33,7,2
2021,St Albans 014C,E01023744,1523,1487,36,31,4,0,1
2021,St Albans 014D,E01023745,1738,1663,75,54,18,2,1
2021,St Albans 004A,E01023746,1544,1467,77,42,28,7,0
2021,St Albans 004B,E01023747,1763,1733,30,19,7,3,1
2021,St Albans 004C,E01023748,1375,1354,21,9,8,0,4
2021,St Albans 004D,E01023749,1832,1786,46,41,3,2,0
2021,Stevenage 009A,E01023750,1178,1121,57,31,23,3,0
2021,Stevenage 009B,E01023751,1157,1094,63,32,23,7,1
2021,Stevenage 009C,E01023752,1405,1285,120,59,43,14,4
2021,Stevenage 009D,E01023753,1621,1534,87,43,31,10,3
2021,Stevenage 009E,E01023754,1289,1212,77,39,21,17,0
2021,Stevenage 008A,E01023755,1641,1448,193,88,79,22,4
2021,Stevenage 008B,E01023756,1643,1449,194,87,80,27,0
2021,Stevenage 008C,E01023757,1918,1649,269,115,107,43,4
2021,Stevenage 007A,E01023759,1446,1331,115,55,39,18,3
2021,Stevenage 007B,E01023760,1497,1405,92,45,40,6,1
2021,Stevenage 007C,E01023761,2090,1895,195,109,57,28,1
2021,Stevenage 007D,E01023762,1542,1424,118,68,33,14,3
2021,Stevenage 012A,E01023763,1490,1430,60,32,24,3,1
2021,Stevenage 012B,E01023764,1235,1171,64,32,27,5,0
2021,Stevenage 012C,E01023765,1534,1462,72,37,20,13,2
2021,Stevenage 012D,E01023766,1535,1440,95,53,34,7,1
2021,Stevenage 013D,E01023767,1459,1352,107,61,35,8,3
2021,Stevenage 013B,E01023769,1691,1600,91,54,30,6,1
2021,Stevenage 013C,E01023770,1453,1392,61,37,13,9,2
2021,Stevenage 003A,E01023771,1553,1477,76,48,21,6,1
2021,Stevenage 003B,E01023772,1727,1581,146,73,54,15,4
2021,Stevenage 003C,E01023773,1298,1252,46,22,18,6,0
2021,Stevenage 003D,E01023774,1617,1436,181,73,70,34,4
2021,Stevenage 006A,E01023775,2229,2034,195,115,58,18,4
2021,Stevenage 002A,E01023776,2569,2342,227,146,62,17,2
2021,Stevenage 002B,E01023777,1772,1669,103,68,29,6,0
2021,Stevenage 002C,E01023778,1697,1592,105,47,42,15,1
2021,Stevenage 006B,E01023779,1693,1467,226,105,92,25,4
2021,Stevenage 006C,E01023780,1392,1262,130,55,46,26,3
2021,Stevenage 006D,E01023781,1834,1755,79,38,30,10,1
2021,Stevenage 006E,E01023782,1340,1248,92,49,34,9,0
2021,Stevenage 011A,E01023783,1646,1544,102,61,29,9,3
2021,Stevenage 011B,E01023784,1547,1447,100,45,39,13,3
2021,Stevenage 011C,E01023785,1856,1748,108,53,39,15,1
2021,Stevenage 011D,E01023786,1801,1621,180,92,63,23,2
2021,Stevenage 001A,E01023787,1423,1283,140,78,44,16,2
2021,Stevenage 001B,E01023788,1539,1358,181,96,57,25,3
2021,Stevenage 001D,E01023790,1665,1469,196,109,59,27,1
2021,Stevenage 010A,E01023791,1625,1518,107,59,34,8,6
2021,Stevenage 010B,E01023792,1593,1457,136,62,53,17,4
2021,Stevenage 010C,E01023793,1468,1366,102,60,38,4,0
2021,Stevenage 010D,E01023794,1561,1413,148,71,52,19,6
2021,Stevenage 005A,E01023795,1602,1480,122,60,49,9,4
2021,Stevenage 005B,E01023796,1474,1339,135,68,47,17,3
2021,Stevenage 005C,E01023797,1311,1267,44,28,12,4,0
2021,Stevenage 005D,E01023798,1471,1345,126,75,36,13,2
2021,Stevenage 002D,E01023799,1317,1225,92,62,14,13,3
2021,Stevenage 002E,E01023800,2118,1792,326,217,84,21,4
2021,Stevenage 002F,E01023801,2335,2184,151,79,57,10,5
2021,Three Rivers 001A,E01023802,1629,1564,65,38,24,3,0
2021,Three Rivers 001B,E01023803,1518,1484,34,21,13,0,0
2021,Three Rivers 001C,E01023804,1448,1396,52,25,19,8,0
2021,Three Rivers 010A,E01023805,1711,1436,275,136,101,32,6
2021,Three Rivers 012A,E01023806,2206,1863,343,188,127,25,3
2021,Three Rivers 001D,E01023807,1542,1505,37,26,8,3,0
2021,Three Rivers 010B,E01023809,1779,1500,279,183,65,28,3
2021,Three Rivers 010C,E01023810,1778,1571,207,118,62,24,3
2021,Three Rivers 010D,E01023811,1453,1293,160,83,58,16,3
2021,Three Rivers 004A,E01023812,1519,1400,119,80,23,15,1
2021,Three Rivers 004B,E01023813,1601,1513,88,61,18,7,2
2021,Three Rivers 004C,E01023814,1066,1027,39,24,9,5,1
2021,Three Rivers 005A,E01023815,1544,1484,60,44,12,4,0
2021,Three Rivers 005B,E01023816,1259,1221,38,26,5,3,4
2021,Three Rivers 005C,E01023817,1345,1278,67,45,14,7,1
2021,Three Rivers 005D,E01023818,1434,1416,18,17,1,0,0
2021,Three Rivers 006A,E01023819,1604,1536,68,54,8,5,1
2021,Three Rivers 006B,E01023820,1322,1267,55,35,12,6,2
2021,Three Rivers 006C,E01023821,1255,1201,54,39,13,2,0
2021,Three Rivers 006D,E01023822,1351,1303,48,31,16,0,1
2021,Three Rivers 003A,E01023823,1602,1534,68,46,14,7,1
2021,Three Rivers 003B,E01023824,2138,2064,74,47,21,6,0
2021,Three Rivers 006E,E01023825,2266,2041,225,139,59,25,2
2021,Three Rivers 006F,E01023826,1601,1529,72,39,27,5,1
2021,Three Rivers 008A,E01023827,2332,1970,362,161,146,50,5
2021,Three Rivers 008B,E01023828,1596,1314,282,121,118,38,5
2021,Three Rivers 002A,E01023829,1727,1655,72,28,26,14,4
2021,Three Rivers 002B,E01023830,1399,1338,61,33,23,4,1
2021,Three Rivers 003C,E01023831,2023,1948,75,49,24,2,0
2021,Three Rivers 002C,E01023832,2029,1842,187,107,61,19,0
2021,Three Rivers 002E,E01023834,1707,1583,124,70,43,8,3
2021,Three Rivers 009A,E01023835,1370,1320,50,27,21,2,0
2021,Three Rivers 009B,E01023836,1320,1227,93,55,27,11,0
2021,Three Rivers 009C,E01023837,1568,1488,80,40,30,8,2
2021,Three Rivers 009D,E01023838,1255,1181,74,35,29,8,2
2021,Three Rivers 011A,E01023839,2223,1972,251,173,55,19,4
2021,Three Rivers 011B,E01023840,1737,1526,211,140,53,18,0
2021,Three Rivers 011C,E01023841,1711,1502,209,135,58,12,4
2021,Three Rivers 012B,E01023842,1658,1452,206,105,73,25,3
2021,Three Rivers 012C,E01023843,2040,1654,386,213,130,36,7
2021,Three Rivers 012D,E01023844,1640,1334,306,164,105,31,6
2021,Three Rivers 008C,E01023845,1793,1634,159,99,44,15,1
2021,Three Rivers 008D,E01023846,1579,1492,87,58,21,7,1
2021,Three Rivers 007A,E01023847,1805,1690,115,65,39,11,0
2021,Three Rivers 007B,E01023848,1786,1695,91,55,28,7,1
2021,Three Rivers 011D,E01023849,1427,1353,74,54,11,7,2
2021,Three Rivers 007C,E01023850,1532,1369,163,107,41,13,2
2021,Three Rivers 004D,E01023851,1874,1684,190,122,50,17,1
2021,Three Rivers 007D,E01023852,1464,1355,109,54,39,16,0
2021,Three Rivers 007E,E01023853,2132,2068,64,45,14,4,1
2021,Three Rivers 003D,E01023854,1896,1878,18,9,7,2,0
2021,Watford 006A,E01023855,2140,1518,622,282,232,88,20
2021,Watford 006B,E01023856,2472,1843,629,269,277,73,10
2021,Watford 006C,E01023857,1765,1405,360,155,128,67,10
2021,Watford 006D,E01023858,1889,1460,429,210,151,66,2
2021,Watford 009B,E01023860,1996,1552,444,201,171,65,7
2021,Watford 009D,E01023862,2550,1860,690,357,236,80,17
2021,Watford 011A,E01023863,1770,1233,537,265,194,69,9
2021,Watford 011B,E01023864,1650,1201,449,242,155,46,6
2021,Watford 011C,E01023865,1911,1540,371,158,139,62,12
2021,Watford 011D,E01023866,1599,1350,249,106,102,36,5
2021,Watford 004A,E01023868,1838,1590,248,140,83,21,4
2021,Watford 004B,E01023869,1431,1223,208,68,101,35,4
2021,Watford 004C,E01023870,1677,1356,321,126,130,55,10
2021,Watford 004D,E01023871,1755,1459,296,156,103,30,7
2021,Watford 004E,E01023872,1656,1327,329,178,111,38,2
2021,Watford 003A,E01023873,1302,1152,150,67,66,16,1
2021,Watford 003B,E01023874,1283,1123,160,93,46,20,1
2021,Watford 003C,E01023875,2116,1803,313,161,111,29,12
2021,Watford 003D,E01023876,1722,1473,249,125,86,32,6
2021,Watford 003E,E01023877,1687,1476,211,122,70,17,2
2021,Watford 007A,E01023878,2073,1843,230,165,50,13,2
2021,Watford 007C,E01023880,2151,1735,416,222,149,43,2
2021,Watford 007D,E01023881,1633,1452,181,112,59,9,1
2021,Watford 012A,E01023882,1588,1508,80,47,24,9,0
2021,Watford 012B,E01023883,1730,1462,268,108,100,51,9
2021,Watford 012C,E01023884,1884,1653,231,133,78,16,4
2021,Watford 012D,E01023885,1717,1547,170,97,61,10,2
2021,Watford 008A,E01023886,2795,2302,493,286,142,65,0
2021,Watford 008B,E01023887,1751,1617,134,84,39,10,1
2021,Watford 008C,E01023888,1641,1336,305,133,121,44,7
2021,Watford 008D,E01023889,1799,1661,138,82,42,10,4
2021,Watford 002A,E01023890,1292,1111,181,92,58,26,5
2021,Watford 002B,E01023891,1453,1241,212,117,71,21,3
2021,Watford 002C,E01023892,1285,1178,107,66,31,9,1
2021,Watford 002D,E01023893,1637,1488,149,81,50,15,3
2021,Watford 002E,E01023894,1362,1211,151,75,60,15,1
2021,Watford 005A,E01023895,1602,1321,281,171,82,25,3
2021,Watford 005B,E01023896,1266,1084,182,95,65,18,4
2021,Watford 005C,E01023897,1547,1372,175,108,45,19,3
2021,Watford 005D,E01023898,1551,1366,185,95,56,29,5
2021,Watford 010A,E01023899,1668,1060,608,276,225,90,17
2021,Watford 010B,E01023900,1813,1272,541,239,197,90,15
2021,Watford 010C,E01023901,2005,1335,670,280,275,103,12
2021,Watford 010D,E01023902,1672,1194,478,220,191,64,3
2021,Watford 010E,E01023903,1614,1065,549,239,224,80,6
2021,Watford 001A,E01023904,2087,1871,216,119,67,26,4
2021,Watford 001B,E01023905,1966,1705,261,143,91,24,3
2021,Watford 001C,E01023906,1507,1359,148,67,55,22,4
2021,Watford 001D,E01023907,1866,1621,245,134,79,29,3
2021,Welwyn Hatfield 015A,E01023908,1673,1605,68,43,16,9,0
2021,Welwyn Hatfield 015B,E01023909,1308,1236,72,32,35,4,1
2021,Welwyn Hatfield 015C,E01023910,1389,1357,32,16,10,6,0
2021,Welwyn Hatfield 015D,E01023911,1643,1565,78,49,25,3,1
2021,Welwyn Hatfield 004A,E01023912,1490,1398,92,46,38,6,2
2021,Welwyn Hatfield 004B,E01023913,1266,1192,74,38,28,7,1
2021,Welwyn Hatfield 004C,E01023914,1615,1517,98,52,39,5,2
2021,Welwyn Hatfield 004D,E01023915,1521,1417,104,64,30,8,2
2021,Welwyn Hatfield 006A,E01023916,1632,1548,84,58,20,4,2
2021,Welwyn Hatfield 006B,E01023917,1715,1627,88,60,22,5,1
2021,Welwyn Hatfield 006C,E01023918,1818,1671,147,79,42,23,3
2021,Welwyn Hatfield 006D,E01023919,1583,1546,37,26,10,0,1
2021,Welwyn Hatfield 012A,E01023920,1574,1219,355,140,151,57,7
2021,Welwyn Hatfield 012B,E01023921,2266,1630,636,323,241,65,7
2021,Welwyn Hatfield 012C,E01023922,1810,1389,421,211,138,68,4
2021,Welwyn Hatfield 012D,E01023923,2252,1724,528,273,194,52,9
2021,Welwyn Hatfield 011A,E01023924,1728,1272,456,160,190,101,5
2021,Welwyn Hatfield 011B,E01023925,1685,1614,71,42,23,5,1
2021,Welwyn Hatfield 011C,E01023926,1814,1593,221,113,77,30,1
2021,Welwyn Hatfield 011D,E01023927,1790,1452,338,150,152,34,2
2021,Welwyn Hatfield 010A,E01023929,1710,1482,228,96,96,33,3
2021,Welwyn Hatfield 010B,E01023930,1617,1368,249,92,108,45,4
2021,Welwyn Hatfield 013A,E01023932,1805,1335,470,220,196,46,8
2021,Welwyn Hatfield 017A,E01023933,1462,1169,293,134,112,42,5
2021,Welwyn Hatfield 013B,E01023934,1334,945,389,175,157,54,3
2021,Welwyn Hatfield 013C,E01023935,2604,2047,557,324,197,35,1
2021,Welwyn Hatfield 013D,E01023936,2115,1716,399,161,179,54,5
2021,Welwyn Hatfield 013E,E01023937,2282,1768,514,285,184,44,1
2021,Welwyn Hatfield 010D,E01023938,2356,2012,344,198,109,37,0
2021,Welwyn Hatfield 009A,E01023939,1144,1072,72,37,27,7,1
2021,Welwyn Hatfield 009B,E01023940,1757,1679,78,50,18,9,1
2021,Welwyn Hatfield 009D,E01023942,1711,1607,104,54,32,14,4
2021,Welwyn Hatfield 008A,E01023943,1535,1436,99,57,31,7,4
2021,Welwyn Hatfield 008B,E01023944,2117,1970,147,72,44,27,4
2021,Welwyn Hatfield 008C,E01023945,1636,1517,119,69,34,15,1
2021,Welwyn Hatfield 008D,E01023946,2166,1991,175,96,67,11,1
2021,Welwyn Hatfield 016A,E01023947,1701,1605,96,48,32,13,3
2021,Welwyn Hatfield 016B,E01023948,1731,1683,48,22,21,4,1
2021,Welwyn Hatfield 016C,E01023949,2057,1982,75,57,12,6,0
2021,Welwyn Hatfield 005A,E01023950,1547,1460,87,64,17,3,3
2021,Welwyn Hatfield 005B,E01023951,1635,1547,88,53,29,6,0
2021,Welwyn Hatfield 005C,E01023952,1558,1449,109,56,40,12,1
2021,Welwyn Hatfield 005D,E01023953,1344,1285,59,37,19,3,0
2021,Welwyn Hatfield 007B,E01023955,1434,1354,80,56,20,4,0
2021,Welwyn Hatfield 007C,E01023956,1304,1208,96,54,33,6,3
2021,Welwyn Hatfield 007D,E01023957,1395,1291,104,51,43,10,0
2021,Welwyn Hatfield 007E,E01023958,1442,1342,100,50,40,9,1
2021,Welwyn Hatfield 003A,E01023959,1314,1260,54,33,18,2,1
2021,Welwyn Hatfield 003B,E01023960,1598,1522,76,49,19,8,0
2021,Welwyn Hatfield 003C,E01023961,1398,1327,71,49,16,6,0
2021,Welwyn Hatfield 003D,E01023962,1456,1419,37,29,6,2,0
2021,Welwyn Hatfield 017B,E01023963,2304,2164,140,67,46,22,5
2021,Welwyn Hatfield 001A,E01023965,1420,1391,29,14,9,5,1
2021,Welwyn Hatfield 001B,E01023966,1674,1632,42,25,11,4,2
2021,Welwyn Hatfield 001C,E01023967,1367,1332,35,13,15,7,0
2021,Welwyn Hatfield 002B,E01023968,1331,1297,34,26,5,3,0
2021,Welwyn Hatfield 002C,E01023969,1415,1393,22,18,3,1,0
2021,Welwyn Hatfield 002D,E01023970,1901,1835,66,41,19,6,0
2021,Welwyn Hatfield 001D,E01023971,1619,1558,61,34,24,3,0
2021,Ashford 006A,E01023972,1376,1263,113,43,46,20,4
2021,Ashford 005A,E01023973,2645,2258,387,186,132,47,22
2021,Ashford 007A,E01023974,1419,1143,276,116,106,41,13
2021,Ashford 007B,E01023975,2086,1721,365,137,154,50,24
2021,Ashford 008A,E01023976,1768,1408,360,109,147,74,30
2021,Ashford 007C,E01023977,1380,1273,107,46,39,15,7
2021,Ashford 011A,E01023978,1292,1278,14,10,2,2,0
2021,Ashford 011B,E01023979,1298,1279,19,14,3,1,1
2021,Ashford 015A,E01023980,1090,1045,45,24,13,6,2
2021,Ashford 015B,E01023981,1534,1444,90,35,29,16,10
2021,Ashford 003A,E01023983,1446,1370,76,34,32,7,3
2021,Ashford 015C,E01023984,1220,1066,154,60,58,25,11
2021,Ashford 002A,E01023985,1148,1140,8,7,1,0,0
2021,Ashford 002B,E01023986,1507,1490,17,9,7,0,1
2021,Ashford 001B,E01023987,983,964,19,10,7,2,0
2021,Ashford 001C,E01023988,1543,1513,30,17,10,2,1
2021,Ashford 002C,E01023989,1299,1283,16,12,2,1,1
2021,Ashford 002D,E01023990,1257,1238,19,9,9,1,0
2021,Ashford 016C,E01023992,1772,1420,352,144,129,66,13
2021,Ashford 016D,E01023993,1421,1228,193,78,72,24,19
2021,Ashford 006B,E01023995,1134,1013,121,79,29,9,4
2021,Ashford 006C,E01023996,1235,1144,91,63,23,5,0
2021,Ashford 014A,E01023997,1528,1511,17,7,6,3,1
2021,Ashford 014B,E01023998,1154,1142,12,7,4,1,0
2021,Ashford 003B,E01023999,2235,2168,67,44,15,5,3
2021,Ashford 009A,E01024001,1536,1354,182,54,75,42,11
2021,Ashford 005B,E01024002,1400,1217,183,63,73,40,7
2021,Ashford 006D,E01024003,1794,1689,105,68,31,4,2
2021,Ashford 006E,E01024004,2165,2001,164,114,36,12,2
2021,Ashford 006F,E01024005,1532,1456,76,46,25,3,2
2021,Ashford 009B,E01024006,1225,1154,71,49,15,5,2
2021,Ashford 009D,E01024008,1948,1839,109,58,38,9,4
2021,Ashford 013A,E01024009,1364,1340,24,15,7,2,0
2021,Ashford 013B,E01024010,1361,1344,17,13,2,2,0
2021,Ashford 013C,E01024011,1258,1240,18,12,4,2,0
2021,Ashford 013D,E01024012,1069,1060,9,8,1,0,0
2021,Ashford 010A,E01024013,1854,1831,23,17,5,1,0
2021,Ashford 010B,E01024014,1867,1851,16,14,2,0,0
2021,Ashford 010C,E01024015,1581,1559,22,12,6,3,1
2021,Ashford 007D,E01024016,1296,1203,93,38,40,12,3
2021,Ashford 007E,E01024017,1833,1734,99,51,35,13,0
2021,Ashford 008B,E01024019,1655,1385,270,69,97,76,28
2021,Ashford 008C,E01024020,1962,1634,328,89,148,70,21
2021,Ashford 015E,E01024021,1415,1235,180,73,89,16,2
2021,Ashford 015D,E01024022,1522,1285,237,80,81,56,20
2021,Ashford 005C,E01024023,2537,2221,316,159,119,28,10
2021,Ashford 013E,E01024024,2171,2135,36,21,12,3,0
2021,Ashford 013F,E01024025,1324,1293,31,16,9,5,1
2021,Ashford 014C,E01024026,1218,1205,13,9,4,0,0
2021,Ashford 007F,E01024028,1615,1356,259,78,109,52,20
2021,Ashford 005E,E01024029,2443,2105,338,124,134,56,24
2021,Ashford 012B,E01024031,1626,1614,12,10,2,0,0
2021,Ashford 011C,E01024032,2036,2013,23,9,11,3,0
2021,Ashford 002E,E01024033,1787,1771,16,11,5,0,0
2021,Ashford 002F,E01024035,1033,1020,13,8,2,3,0
2021,Ashford 011D,E01024036,1424,1402,22,16,4,1,1
2021,Ashford 014D,E01024037,1933,1905,28,15,10,3,0
2021,Ashford 012C,E01024038,2027,2010,17,9,7,1,0
2021,Ashford 012D,E01024039,1588,1566,22,13,4,2,3
2021,Ashford 001D,E01024040,1275,1254,21,16,2,3,0
2021,Ashford 001E,E01024041,1142,1125,17,10,3,3,1
2021,Canterbury 018A,E01024042,1423,1391,32,19,10,3,0
2021,Canterbury 018B,E01024043,1320,1295,25,24,1,0,0
2021,Canterbury 016A,E01024044,2447,2208,239,150,76,12,1
2021,Canterbury 016B,E01024045,1595,1432,163,84,61,13,5
2021,Canterbury 016C,E01024046,1858,1657,201,129,53,16,3
2021,Canterbury 014A,E01024047,1974,1628,346,156,130,53,7
2021,Canterbury 016D,E01024048,1443,1309,134,92,31,11,0
2021,Canterbury 014B,E01024049,1337,1197,140,50,72,18,0
2021,Canterbury 017A,E01024052,2337,2248,89,44,33,11,1
2021,Canterbury 017B,E01024053,2055,1981,74,32,25,15,2
2021,Canterbury 017C,E01024054,1762,1735,27,18,4,5,0
2021,Canterbury 007A,E01024055,1556,1544,12,9,0,3,0
2021,Canterbury 005A,E01024056,1885,1860,25,16,7,2,0
2021,Canterbury 005B,E01024057,1746,1735,11,8,2,1,0
2021,Canterbury 005C,E01024058,1561,1533,28,24,2,2,0
2021,Canterbury 004A,E01024059,1430,1401,29,18,5,5,1
2021,Canterbury 008A,E01024060,1453,1416,37,23,11,3,0
2021,Canterbury 007B,E01024061,1433,1409,24,14,6,3,1
2021,Canterbury 009A,E01024062,2122,2092,30,13,13,4,0
2021,Canterbury 007C,E01024063,1558,1537,21,12,9,0,0
2021,Canterbury 003A,E01024064,2545,2502,43,18,17,8,0
2021,Canterbury 004B,E01024065,1973,1947,26,17,3,4,2
2021,Canterbury 003B,E01024066,1530,1513,17,7,8,1,1
2021,Canterbury 012C,E01024067,1189,1132,57,36,12,9,0
2021,Canterbury 012D,E01024068,1570,1479,91,73,15,3,0
2021,Canterbury 008B,E01024069,1193,1159,34,20,12,2,0
2021,Canterbury 008C,E01024070,1226,1182,44,28,9,7,0
2021,Canterbury 007D,E01024071,1626,1597,29,17,6,4,2
2021,Canterbury 008D,E01024072,1062,1034,28,16,7,4,1
2021,Canterbury 006A,E01024073,2455,2423,32,18,11,2,1
2021,Canterbury 006B,E01024074,1416,1403,13,7,4,1,1
2021,Canterbury 006C,E01024075,1548,1527,21,11,5,4,1
2021,Canterbury 006D,E01024076,1768,1739,29,18,8,3,0
2021,Canterbury 006E,E01024077,2105,2059,46,29,9,5,3
2021,Canterbury 001A,E01024078,1715,1589,126,52,53,20,1
2021,Canterbury 003C,E01024079,1541,1520,21,10,8,0,3
2021,Canterbury 001B,E01024080,1301,1254,47,21,18,3,5
2021,Canterbury 001C,E01024081,1494,1425,69,28,28,12,1
2021,Canterbury 001D,E01024082,1376,1348,28,13,12,3,0
2021,Canterbury 003D,E01024083,1353,1335,18,7,7,4,0
2021,Canterbury 010A,E01024084,1250,1202,48,31,12,4,1
2021,Canterbury 010B,E01024085,1601,1529,72,30,12,5,25
2021,Canterbury 010C,E01024086,2167,2065,102,44,36,18,4
2021,Canterbury 010D,E01024087,1326,1282,44,28,15,1,0
2021,Canterbury 018C,E01024088,1537,1514,23,17,3,2,1
2021,Canterbury 018D,E01024089,1122,1100,22,15,6,1,0
2021,Canterbury 014C,E01024090,2793,2404,389,196,134,54,5
2021,Canterbury 011A,E01024091,1358,1134,224,73,102,35,14
2021,Canterbury 014D,E01024092,1511,1246,265,133,97,34,1
2021,Canterbury 014E,E01024093,1799,1605,194,112,60,18,4
2021,Canterbury 002A,E01024094,2608,2582,26,19,4,3,0
2021,Canterbury 001E,E01024095,1437,1419,18,8,4,6,0
2021,Canterbury 002B,E01024096,1679,1665,14,7,6,1,0
2021,Canterbury 002C,E01024097,1554,1541,13,9,4,0,0
2021,Canterbury 002D,E01024098,1512,1501,11,9,2,0,0
2021,Canterbury 013A,E01024099,1393,1273,120,62,34,21,3
2021,Canterbury 013B,E01024100,1482,1360,122,85,26,11,0
2021,Canterbury 013C,E01024101,1713,1517,196,106,56,25,9
2021,Canterbury 013D,E01024102,1739,1596,143,79,46,17,1
2021,Canterbury 013E,E01024103,1559,1441,118,66,37,13,2
2021,Canterbury 020A,E01024104,2048,1778,270,186,59,21,4
2021,Canterbury 009B,E01024105,1502,1486,16,9,4,3,0
2021,Canterbury 008E,E01024106,1537,1510,27,16,9,0,2
2021,Canterbury 009C,E01024107,1428,1406,22,15,4,2,1
2021,Canterbury 009D,E01024108,1168,1157,11,7,2,2,0
2021,Canterbury 009E,E01024109,2306,2286,20,9,8,3,0
2021,Canterbury 011B,E01024110,1474,1421,53,29,20,2,2
2021,Canterbury 011C,E01024111,1510,1460,50,18,19,9,4
2021,Canterbury 011D,E01024112,1543,1499,44,17,23,2,2
2021,Canterbury 011E,E01024113,1404,1334,70,39,18,12,1
2021,Canterbury 005D,E01024114,1705,1683,22,14,2,6,0
2021,Canterbury 005E,E01024115,1395,1379,16,14,1,1,0
2021,Canterbury 007E,E01024116,1452,1432,20,8,11,0,1
2021,Canterbury 004C,E01024117,1487,1474,13,7,5,1,0
2021,Canterbury 003E,E01024118,1748,1711,37,19,10,7,1
2021,Canterbury 004D,E01024119,1536,1517,19,10,6,2,1
2021,Canterbury 004E,E01024120,1622,1608,14,12,2,0,0
2021,Canterbury 020B,E01024121,1657,1449,208,125,53,23,7
2021,Canterbury 020C,E01024122,1432,1294,138,80,46,10,2
2021,Canterbury 012E,E01024123,1570,1477,93,59,26,7,1
2021,Canterbury 020D,E01024124,1275,1129,146,94,42,10,0
2021,Canterbury 020E,E01024126,1422,1160,262,112,96,53,1
2021,Canterbury 017D,E01024127,1673,1559,114,64,30,19,1
2021,Canterbury 019A,E01024128,1655,1498,157,71,59,24,3
2021,Canterbury 019B,E01024129,1699,1448,251,124,89,36,2
2021,Canterbury 016E,E01024131,2360,2032,328,187,116,23,2
2021,Dartford 012A,E01024132,1275,1234,41,15,18,8,0
2021,Dartford 008A,E01024133,1322,1215,107,71,25,10,1
2021,Dartford 012B,E01024134,1580,1542,38,19,14,5,0
2021,Dartford 012C,E01024135,1419,1385,34,18,14,2,0
2021,Dartford 008B,E01024136,1460,1298,162,83,54,19,6
2021,Dartford 008C,E01024137,1848,1697,151,82,51,15,3
2021,Dartford 008D,E01024138,1839,1701,138,67,60,11,0
2021,Dartford 008E,E01024139,1764,1634,130,69,44,14,3
2021,Dartford 002C,E01024143,2515,2300,215,121,76,14,4
2021,Dartford 007A,E01024144,1457,1394,63,38,16,8,1
2021,Dartford 007B,E01024145,1621,1466,155,92,42,21,0
2021,Dartford 007C,E01024146,1396,1341,55,26,20,7,2
2021,Dartford 007D,E01024147,1718,1616,102,53,34,13,2
2021,Dartford 010A,E01024150,1472,1424,48,33,12,2,1
2021,Dartford 010B,E01024151,1432,1382,50,28,13,6,3
2021,Dartford 010C,E01024152,2638,2509,129,78,37,13,1
2021,Dartford 010D,E01024153,1368,1320,48,26,16,5,1
2021,Dartford 001C,E01024154,1303,1172,131,48,58,19,6
2021,Dartford 001D,E01024155,2375,2083,292,172,80,35,5
2021,Dartford 005A,E01024156,1602,1328,274,135,109,27,3
2021,Dartford 013A,E01024157,1768,1741,27,22,2,2,1
2021,Dartford 013B,E01024158,1980,1901,79,50,17,8,4
2021,Dartford 013C,E01024159,1539,1520,19,15,4,0,0
2021,Dartford 013D,E01024160,1390,1358,32,19,9,4,0
2021,Dartford 005B,E01024161,1972,1661,311,137,118,51,5
2021,Dartford 005C,E01024162,1991,1765,226,110,85,28,3
2021,Dartford 005D,E01024163,1828,1659,169,66,71,27,5
2021,Dartford 005E,E01024164,1892,1566,326,120,135,62,9
2021,Dartford 009A,E01024165,1618,1430,188,86,69,28,5
2021,Dartford 009B,E01024166,1654,1506,148,70,55,19,4
2021,Dartford 009C,E01024167,1985,1767,218,101,82,29,6
2021,Dartford 009D,E01024168,1219,1134,85,42,32,9,2
2021,Dartford 006A,E01024169,2201,2026,175,106,47,16,6
2021,Dartford 006B,E01024170,1512,1371,141,67,51,19,4
2021,Dartford 006C,E01024171,1494,1411,83,43,32,7,1
2021,Dartford 006D,E01024172,2085,1866,219,121,77,20,1
2021,Dartford 011A,E01024173,1764,1726,38,21,9,8,0
2021,Dartford 012D,E01024174,1110,1074,36,19,11,6,0
2021,Dartford 012E,E01024175,1258,1237,21,12,4,4,1
2021,Dartford 004B,E01024176,1754,1612,142,61,64,14,3
2021,Dartford 004C,E01024177,1437,1345,92,40,40,8,4
2021,Dartford 004D,E01024178,1623,1532,91,41,34,16,0
2021,Dartford 002D,E01024179,2697,2355,342,144,153,40,5
2021,Dartford 003A,E01024180,2270,1864,406,192,151,54,9
2021,Dartford 003B,E01024181,1991,1620,371,152,148,59,12
2021,Dartford 003C,E01024182,1735,1323,412,144,176,74,18
2021,Dartford 003D,E01024183,1406,1250,156,65,52,29,10
2021,Dartford 003E,E01024184,2071,1800,271,150,89,26,6
2021,Dartford 003F,E01024185,2239,1952,287,155,98,32,2
2021,Dartford 007E,E01024186,1312,1208,104,50,38,10,6
2021,Dartford 011B,E01024187,1147,1124,23,16,1,6,0
2021,Dartford 011C,E01024188,1427,1388,39,22,13,3,1
2021,Dartford 011D,E01024189,1494,1466,28,14,9,5,0
2021,Dover 006A,E01024190,1479,1452,27,16,9,1,1
2021,Dover 006C,E01024192,1859,1795,64,26,24,10,4
2021,Dover 011A,E01024193,1482,1398,84,33,35,14,2
2021,Dover 011B,E01024194,1427,1379,48,27,17,3,1
2021,Dover 011C,E01024195,1394,1339,55,38,14,1,2
2021,Dover 011D,E01024196,1445,1365,80,27,28,19,6
2021,Dover 011E,E01024197,1514,1440,74,40,23,11,0
2021,Dover 014A,E01024198,2419,2397,22,14,5,3,0
2021,Dover 008A,E01024200,1638,1629,9,4,3,0,2
2021,Dover 005A,E01024201,1431,1411,20,14,4,2,0
2021,Dover 002A,E01024202,1787,1763,24,14,3,6,1
2021,Dover 008B,E01024203,1575,1561,14,11,2,0,1
2021,Dover 006D,E01024204,1592,1550,42,20,10,10,2
2021,Dover 008C,E01024205,1521,1487,34,18,10,6,0
2021,Dover 001A,E01024206,1946,1909,37,15,15,4,3
2021,Dover 001B,E01024207,1814,1778,36,24,11,1,0
2021,Dover 001C,E01024208,1607,1587,20,13,3,1,3
2021,Dover 001D,E01024209,1719,1694,25,15,10,0,0
2021,Dover 014B,E01024212,1404,1360,44,18,21,4,1
2021,Dover 014C,E01024213,1349,1328,21,8,9,3,1
2021,Dover 013A,E01024214,1660,1475,185,66,77,29,13
2021,Dover 013B,E01024215,1557,1292,265,116,93,54,2
2021,Dover 013C,E01024216,1483,1443,40,22,14,3,1
2021,Dover 007A,E01024218,1322,1299,23,9,8,5,1
2021,Dover 003A,E01024219,1282,1259,23,10,4,2,7
2021,Dover 003B,E01024220,1529,1512,17,14,1,1,1
2021,Dover 003C,E01024221,1459,1445,14,11,2,1,0
2021,Dover 007B,E01024222,1562,1535,27,13,9,3,2
2021,Dover 005C,E01024223,1496,1466,30,12,15,2,1
2021,Dover 007C,E01024224,1492,1478,14,10,4,0,0
2021,Dover 005D,E01024225,1592,1577,15,7,4,4,0
2021,Dover 005E,E01024226,1488,1474,14,6,8,0,0
2021,Dover 003D,E01024227,1358,1340,18,9,7,1,1
2021,Dover 004A,E01024228,1198,1153,45,18,21,6,0
2021,Dover 003E,E01024229,1354,1341,13,6,5,2,0
2021,Dover 004B,E01024230,1238,1208,30,19,7,3,1
2021,Dover 004C,E01024231,1270,1249,21,12,4,4,1
2021,Dover 009A,E01024232,1939,1919,20,9,8,1,2
2021,Dover 010C,E01024233,1528,1515,13,11,0,2,0
2021,Dover 014D,E01024234,1373,1369,4,4,0,0,0
2021,Dover 010D,E01024235,1527,1498,29,20,5,2,2
2021,Dover 009B,E01024236,1714,1693,21,13,4,4,0
2021,Dover 009C,E01024237,1548,1523,25,21,3,0,1
2021,Dover 012B,E01024238,1907,1558,349,165,160,21,3
2021,Dover 012C,E01024239,1719,1593,126,46,55,18,7
2021,Dover 011F,E01024240,1754,1617,137,51,50,31,5
2021,Dover 011G,E01024241,2090,1997,93,33,38,17,5
2021,Dover 002B,E01024242,1708,1683,25,18,5,2,0
2021,Dover 002C,E01024243,1686,1662,24,14,5,3,2
2021,Dover 002D,E01024244,1663,1612,51,26,12,8,5
2021,Dover 002E,E01024245,1918,1909,9,5,1,3,0
2021,Dover 013D,E01024246,2091,1823,268,117,95,43,13
2021,Dover 012D,E01024247,2002,1787,215,77,90,40,8
2021,Dover 011H,E01024248,1975,1868,107,34,52,20,1
2021,Dover 013E,E01024249,1981,1864,117,47,44,24,2
2021,Dover 007D,E01024250,1608,1591,17,12,3,1,1
2021,Dover 007E,E01024251,1549,1518,31,21,6,3,1
2021,Dover 004D,E01024252,2238,2184,54,30,15,7,2
2021,Dover 009D,E01024253,1641,1614,27,18,8,1,0
2021,Dover 010E,E01024254,2279,2198,81,38,31,8,4
2021,Dover 008D,E01024255,1732,1713,19,13,5,1,0
2021,Dover 010F,E01024256,1713,1693,20,14,5,0,1
2021,Gravesham 002A,E01024257,1821,1196,625,184,248,153,40
2021,Gravesham 003A,E01024258,1581,1150,431,163,159,93,16
2021,Gravesham 005A,E01024259,1491,1402,89,36,38,12,3
2021,Gravesham 005B,E01024260,1676,1509,167,84,51,26,6
2021,Gravesham 003B,E01024261,2148,2073,75,28,33,14,0
2021,Gravesham 004A,E01024262,1702,1471,231,104,83,36,8
2021,Gravesham 004B,E01024263,1543,1425,118,39,53,23,3
2021,Gravesham 009A,E01024264,1624,1530,94,32,47,12,3
2021,Gravesham 010A,E01024265,1270,1224,46,26,15,4,1
2021,Gravesham 010B,E01024266,1115,1081,34,17,11,6,0
2021,Gravesham 010C,E01024267,1455,1414,41,22,13,6,0
2021,Gravesham 012A,E01024268,1513,1478,35,13,12,10,0
2021,Gravesham 012B,E01024269,1812,1782,30,13,9,6,2
2021,Gravesham 012C,E01024270,1424,1396,28,18,7,3,0
2021,Gravesham 012D,E01024271,1380,1359,21,11,8,2,0
2021,Gravesham 012E,E01024272,1440,1417,23,13,7,2,1
2021,Gravesham 013A,E01024273,1582,1556,26,11,8,5,2
2021,Gravesham 013B,E01024274,1398,1371,27,12,12,3,0
2021,Gravesham 013C,E01024275,1356,1329,27,20,6,1,0
2021,Gravesham 001A,E01024276,2548,1941,607,245,219,128,15
2021,Gravesham 001B,E01024277,1927,1654,273,95,121,49,8
2021,Gravesham 001C,E01024278,1936,1667,269,90,115,59,5
2021,Gravesham 001D,E01024279,1560,1196,364,138,144,71,11
2021,Gravesham 006B,E01024281,1403,1240,163,78,53,27,5
2021,Gravesham 004C,E01024282,1586,1188,398,139,158,88,13
2021,Gravesham 004D,E01024283,1251,1083,168,64,61,35,8
2021,Gravesham 004E,E01024284,1580,1211,369,134,147,74,14
2021,Gravesham 006C,E01024285,1326,1198,128,52,46,24,6
2021,Gravesham 009B,E01024286,1477,1361,116,59,35,18,4
2021,Gravesham 006D,E01024287,1435,1351,84,39,30,14,1
2021,Gravesham 006E,E01024288,1306,1167,139,63,36,35,5
2021,Gravesham 002C,E01024290,1666,1294,372,174,125,58,15
2021,Gravesham 002D,E01024291,1732,1276,456,155,195,89,17
2021,Gravesham 005C,E01024292,1549,1252,297,109,111,65,12
2021,Gravesham 003C,E01024293,1748,1324,424,148,192,70,14
2021,Gravesham 003D,E01024294,2811,2418,393,174,141,65,13
2021,Gravesham 002E,E01024295,1944,1489,455,125,194,124,12
2021,Gravesham 003E,E01024296,2814,2049,765,275,326,141,23
2021,Gravesham 008A,E01024297,1485,1394,91,41,35,11,4
2021,Gravesham 008B,E01024298,1355,1273,82,34,31,10,7
2021,Gravesham 008C,E01024299,1369,1267,102,41,42,17,2
2021,Gravesham 010D,E01024300,1364,1300,64,35,19,9,1
2021,Gravesham 010E,E01024301,1204,1171,33,21,9,2,1
2021,Gravesham 013D,E01024302,1458,1419,39,26,8,4,1
2021,Gravesham 011A,E01024303,1474,1383,91,46,38,3,4
2021,Gravesham 011B,E01024304,1625,1503,122,66,40,13,3
2021,Gravesham 011C,E01024305,1658,1488,170,74,75,19,2
2021,Gravesham 011D,E01024306,1753,1559,194,85,73,34,2
2021,Gravesham 011E,E01024307,1506,1420,86,47,25,10,4
2021,Gravesham 007A,E01024308,1474,1351,123,63,36,22,2
2021,Gravesham 008D,E01024309,1334,1220,114,48,44,18,4
2021,Gravesham 007B,E01024310,1526,1435,91,50,32,8,1
2021,Gravesham 007C,E01024311,1362,1184,178,71,64,37,6
2021,Gravesham 008E,E01024312,1327,1203,124,58,46,17,3
2021,Gravesham 005D,E01024313,1526,1395,131,46,53,28,4
2021,Gravesham 007D,E01024314,1252,1144,108,60,32,12,4
2021,Gravesham 007E,E01024315,1649,1512,137,62,50,22,3
2021,Gravesham 009C,E01024316,2401,2148,253,140,68,33,12
2021,Gravesham 005E,E01024317,1585,1409,176,71,59,35,11
2021,Gravesham 005F,E01024318,1511,1338,173,78,76,16,3
2021,Gravesham 009D,E01024319,1548,1421,127,70,34,20,3
2021,Maidstone 003A,E01024320,1678,1584,94,58,24,7,5
2021,Maidstone 003B,E01024321,1664,1626,38,20,13,4,1
2021,Maidstone 003C,E01024322,1178,1145,33,20,11,1,1
2021,Maidstone 003D,E01024323,1759,1635,124,60,42,21,1
2021,Maidstone 003E,E01024324,1390,1363,27,15,9,3,0
2021,Maidstone 014A,E01024325,2335,2268,67,54,10,2,1
2021,Maidstone 007A,E01024326,1813,1791,22,13,5,4,0
2021,Maidstone 007B,E01024327,1575,1530,45,24,19,2,0
2021,Maidstone 007C,E01024328,1654,1628,26,10,11,2,3
2021,Maidstone 007D,E01024329,1521,1486,35,25,3,6,1
2021,Maidstone 005A,E01024330,1594,1568,26,13,10,2,1
2021,Maidstone 012A,E01024331,1594,1553,41,28,8,5,0
2021,Maidstone 015A,E01024332,1227,1139,88,36,24,11,17
2021,Maidstone 001A,E01024333,1264,1256,8,5,2,1,0
2021,Maidstone 001C,E01024335,1645,1605,40,18,14,7,1
2021,Maidstone 005B,E01024336,1895,1808,87,48,25,12,2
2021,Maidstone 005C,E01024337,1423,1363,60,31,19,9,1
2021,Maidstone 006A,E01024339,2197,1812,385,168,162,50,5
2021,Maidstone 006B,E01024340,2514,2171,343,138,144,53,8
2021,Maidstone 003F,E01024341,1813,1677,136,68,53,11,4
2021,Maidstone 016A,E01024342,2142,2021,121,56,46,15,4
2021,Maidstone 016B,E01024343,1329,1322,7,4,2,0,1
2021,Maidstone 016C,E01024344,1618,1580,38,17,15,5,1
2021,Maidstone 018A,E01024345,1587,1541,46,22,16,6,2
2021,Maidstone 014B,E01024346,1292,1281,11,5,1,4,1
2021,Maidstone 001E,E01024347,1807,1771,36,22,9,5,0
2021,Maidstone 005D,E01024348,1356,1314,42,19,15,7,1
2021,Maidstone 007E,E01024349,1269,1210,59,27,26,6,0
2021,Maidstone 015B,E01024350,1966,1858,108,61,32,12,3
2021,Maidstone 005E,E01024351,1563,1346,217,82,88,41,6
2021,Maidstone 004A,E01024352,1782,1473,309,89,147,66,7
2021,Maidstone 002A,E01024353,1992,1815,177,84,57,19,17
2021,Maidstone 002B,E01024354,1378,1183,195,73,80,32,10
2021,Maidstone 002C,E01024355,1930,1709,221,98,80,32,11
2021,Maidstone 006C,E01024356,1718,1499,219,90,95,30,4
2021,Maidstone 008A,E01024357,1639,1350,289,120,124,38,7
2021,Maidstone 008B,E01024358,1841,1672,169,81,60,24,4
2021,Maidstone 009A,E01024360,1512,1328,184,89,68,23,4
2021,Maidstone 011A,E01024361,1693,1666,27,11,12,4,0
2021,Maidstone 011B,E01024362,1847,1823,24,16,7,1,0
2021,Maidstone 017A,E01024364,1669,1646,23,13,9,1,0
2021,Maidstone 017B,E01024365,2449,2405,44,26,11,6,1
2021,Maidstone 017C,E01024366,1751,1713,38,16,16,6,0
2021,Maidstone 008C,E01024367,1686,1444,242,118,94,24,6
2021,Maidstone 008E,E01024369,1501,1414,87,49,27,10,1
2021,Maidstone 010A,E01024371,1746,1588,158,75,59,20,4
2021,Maidstone 009B,E01024372,2116,1593,523,199,244,69,11
2021,Maidstone 006E,E01024373,2160,1730,430,160,199,58,13
2021,Maidstone 009C,E01024374,1839,1549,290,122,121,35,12
2021,Maidstone 015C,E01024375,2343,2283,60,16,29,14,1
2021,Maidstone 016D,E01024376,2507,2436,71,37,17,13,4
2021,Maidstone 014C,E01024377,1664,1637,27,14,11,1,1
2021,Maidstone 014D,E01024378,1498,1474,24,16,6,1,1
2021,Maidstone 018B,E01024379,1776,1754,22,11,6,4,1
2021,Maidstone 018C,E01024380,2235,2141,94,55,28,9,2
2021,Maidstone 018D,E01024381,1953,1890,63,31,24,5,3
2021,Maidstone 004C,E01024382,1932,1280,652,199,319,98,36
2021,Maidstone 004D,E01024383,2665,1887,778,359,353,58,8
2021,Maidstone 004E,E01024384,1878,1732,146,67,56,20,3
2021,Maidstone 002D,E01024385,1629,1581,48,25,18,3,2
2021,Maidstone 002E,E01024386,1854,1743,111,45,45,16,5
2021,Maidstone 011D,E01024387,2616,2561,55,25,19,9,2
2021,Maidstone 013B,E01024390,1734,1551,183,79,75,21,8
2021,Maidstone 013C,E01024391,1380,1270,110,45,40,16,9
2021,Maidstone 010B,E01024392,1634,1426,208,74,80,38,16
2021,Maidstone 010C,E01024393,1602,1488,114,45,41,23,5
2021,Maidstone 012B,E01024394,1428,1365,63,38,19,3,3
2021,Maidstone 010D,E01024395,1376,1250,126,52,54,14,6
2021,Maidstone 010E,E01024396,1525,1410,115,53,44,12,6
2021,Maidstone 013D,E01024397,1374,1308,66,32,23,6,5
2021,Maidstone 013E,E01024398,1636,1524,112,44,39,23,6
2021,Maidstone 013F,E01024399,1283,1192,91,36,35,17,3
2021,Maidstone 013G,E01024400,1378,1288,90,29,38,20,3
2021,Maidstone 009D,E01024401,1880,1683,197,84,80,29,4
2021,Maidstone 012C,E01024402,1497,1466,31,16,9,6,0
2021,Maidstone 009E,E01024403,2254,1983,271,128,96,40,7
2021,Maidstone 012D,E01024404,1618,1558,60,24,27,8,1
2021,Maidstone 012E,E01024405,2648,2379,269,133,89,36,11
2021,Maidstone 019A,E01024406,1762,1701,61,40,15,5,1
2021,Maidstone 019B,E01024407,1772,1730,42,19,19,4,0
2021,Maidstone 019C,E01024408,1513,1474,39,25,12,2,0
2021,Maidstone 019D,E01024409,1429,1386,43,19,19,4,1
2021,Maidstone 015E,E01024410,1634,1565,69,26,24,14,5
2021,Maidstone 017D,E01024411,1401,1379,22,10,9,3,0
2021,Sevenoaks 016A,E01024413,1554,1519,35,17,10,6,2
2021,Sevenoaks 016B,E01024414,1535,1512,23,14,4,4,1
2021,Sevenoaks 016C,E01024415,1270,1256,14,8,4,1,1
2021,Sevenoaks 011A,E01024416,1651,1577,74,63,9,2,0
2021,Sevenoaks 013A,E01024417,1574,1531,43,26,14,2,1
2021,Sevenoaks 011B,E01024418,1402,1325,77,55,16,6,0
2021,Sevenoaks 013B,E01024419,1769,1742,27,21,5,1,0
2021,Sevenoaks 015A,E01024420,2050,2030,20,17,1,2,0
2021,Sevenoaks 003A,E01024421,1930,1889,41,22,14,5,0
2021,Sevenoaks 008B,E01024423,1641,1533,108,55,36,16,1
2021,Sevenoaks 011C,E01024424,1360,1307,53,45,6,1,1
2021,Sevenoaks 014A,E01024425,2059,1994,65,38,14,9,4
2021,Sevenoaks 014B,E01024426,1947,1903,44,28,11,3,2
2021,Sevenoaks 014C,E01024427,1327,1285,42,26,14,1,1
2021,Sevenoaks 014D,E01024428,1279,1252,27,15,9,2,1
2021,Sevenoaks 014E,E01024429,1591,1536,55,26,21,7,1
2021,Sevenoaks 014F,E01024430,1312,1269,43,25,15,3,0
2021,Sevenoaks 005A,E01024431,1822,1800,22,16,5,1,0
2021,Sevenoaks 005B,E01024432,1468,1455,13,8,3,2,0
2021,Sevenoaks 005C,E01024433,1408,1383,25,15,8,1,1
2021,Sevenoaks 005D,E01024434,1873,1822,51,33,14,2,2
2021,Sevenoaks 007A,E01024435,1590,1562,28,18,7,3,0
2021,Sevenoaks 007B,E01024436,1454,1437,17,12,2,2,1
2021,Sevenoaks 007C,E01024437,1444,1429,15,11,3,1,0
2021,Sevenoaks 007D,E01024438,1405,1381,24,15,6,3,0
2021,Sevenoaks 008C,E01024439,1616,1584,32,21,11,0,0
2021,Sevenoaks 008D,E01024440,1881,1844,37,28,6,3,0
2021,Sevenoaks 004A,E01024441,1529,1511,18,14,2,2,0
2021,Sevenoaks 004B,E01024442,1519,1503,16,11,5,0,0
2021,Sevenoaks 004C,E01024443,1494,1476,18,13,5,0,0
2021,Sevenoaks 004D,E01024444,1244,1202,42,25,13,3,1
2021,Sevenoaks 001A,E01024445,1316,1307,9,4,3,2,0
2021,Sevenoaks 001B,E01024446,1375,1354,21,13,5,3,0
2021,Sevenoaks 001C,E01024447,1288,1253,35,19,10,5,1
2021,Sevenoaks 009A,E01024448,1258,1227,31,21,8,2,0
2021,Sevenoaks 009B,E01024449,1419,1406,13,12,1,0,0
2021,Sevenoaks 009C,E01024450,1511,1485,26,17,8,1,0
2021,Sevenoaks 015B,E01024451,2414,2391,23,11,7,4,1
2021,Sevenoaks 008E,E01024452,1448,1430,18,15,2,1,0
2021,Sevenoaks 009D,E01024453,1651,1626,25,17,7,1,0
2021,Sevenoaks 009E,E01024454,1519,1495,24,18,5,1,0
2021,Sevenoaks 015C,E01024455,1173,1149,24,13,7,4,0
2021,Sevenoaks 015D,E01024456,1248,1243,5,4,1,0,0
2021,Sevenoaks 010A,E01024457,1256,1221,35,21,9,4,1
2021,Sevenoaks 012A,E01024458,1393,1358,35,28,6,1,0
2021,Sevenoaks 012B,E01024459,1527,1495,32,28,2,2,0
2021,Sevenoaks 010B,E01024460,1661,1575,86,48,20,15,3
2021,Sevenoaks 010C,E01024461,2368,2202,166,106,44,16,0
2021,Sevenoaks 012C,E01024462,1621,1563,58,44,9,4,1
2021,Sevenoaks 011D,E01024463,1557,1467,90,67,10,10,3
2021,Sevenoaks 011E,E01024464,1650,1593,57,39,13,5,0
2021,Sevenoaks 010D,E01024465,1372,1272,100,55,27,16,2
2021,Sevenoaks 010E,E01024466,1328,1270,58,32,19,7,0
2021,Sevenoaks 011F,E01024467,1716,1610,106,82,19,5,0
2021,Sevenoaks 010F,E01024468,1518,1436,82,47,20,12,3
2021,Sevenoaks 012D,E01024469,1726,1543,183,111,46,24,2
2021,Sevenoaks 012E,E01024470,1604,1517,87,63,19,4,1
2021,Sevenoaks 012F,E01024471,1966,1784,182,128,37,14,3
2021,Sevenoaks 001D,E01024472,1441,1375,66,36,28,2,0
2021,Sevenoaks 003B,E01024473,1536,1466,70,37,25,7,1
2021,Sevenoaks 003C,E01024474,1582,1491,91,60,22,8,1
2021,Sevenoaks 003D,E01024475,1536,1438,98,53,36,9,0
2021,Sevenoaks 002A,E01024476,1681,1588,93,48,35,10,0
2021,Sevenoaks 002B,E01024477,1496,1392,104,59,37,6,2
2021,Sevenoaks 002C,E01024478,1497,1400,97,62,28,6,1
2021,Sevenoaks 001E,E01024479,1495,1453,42,25,10,7,0
2021,Sevenoaks 002D,E01024480,1757,1672,85,43,30,10,2
2021,Sevenoaks 002E,E01024481,1577,1480,97,55,34,8,0
2021,Sevenoaks 002F,E01024482,1525,1457,68,36,18,11,3
2021,Sevenoaks 013C,E01024483,1490,1451,39,17,13,8,1
2021,Sevenoaks 013D,E01024484,1194,1181,13,13,0,0,0
2021,Sevenoaks 013E,E01024485,1673,1637,36,24,11,1,0
2021,Folkestone and Hythe 011A,E01024486,1930,1913,17,7,6,1,3
2021,Folkestone and Hythe 011B,E01024487,1256,1243,13,6,3,4,0
2021,Folkestone and Hythe 011C,E01024488,1225,1224,1,1,0,0,0
2021,Folkestone and Hythe 009A,E01024489,1555,1535,20,8,5,7,0
2021,Folkestone and Hythe 001A,E01024490,1946,1915,31,18,7,6,0
2021,Folkestone and Hythe 005A,E01024491,1435,1272,163,61,48,36,18
2021,Folkestone and Hythe 002A,E01024492,1542,1280,262,95,104,52,11
2021,Folkestone and Hythe 005B,E01024493,1476,1345,131,60,39,23,9
2021,Folkestone and Hythe 005C,E01024494,1887,1607,280,113,105,41,21
2021,Folkestone and Hythe 005D,E01024495,2182,1731,451,234,171,33,13
2021,Folkestone and Hythe 003A,E01024496,1438,1378,60,24,26,6,4
2021,Folkestone and Hythe 003B,E01024497,1537,1506,31,16,11,4,0
2021,Folkestone and Hythe 003C,E01024498,1564,1495,69,34,29,5,1
2021,Folkestone and Hythe 004A,E01024499,1584,1505,79,30,37,11,1
2021,Folkestone and Hythe 004B,E01024500,1200,1137,63,28,18,15,2
2021,Folkestone and Hythe 004C,E01024501,1415,1344,71,26,29,16,0
2021,Folkestone and Hythe 004D,E01024502,1371,1282,89,37,31,21,0
2021,Folkestone and Hythe 003D,E01024503,1629,1577,52,29,17,6,0
2021,Folkestone and Hythe 014A,E01024504,1784,1555,229,91,92,39,7
2021,Folkestone and Hythe 004E,E01024505,1769,1665,104,35,34,28,7
2021,Folkestone and Hythe 014B,E01024507,1844,1664,180,80,73,24,3
2021,Folkestone and Hythe 015A,E01024508,1921,1727,194,95,79,16,4
2021,Folkestone and Hythe 015B,E01024509,1423,1285,138,91,29,15,3
2021,Folkestone and Hythe 015C,E01024510,1502,1397,105,59,31,13,2
2021,Folkestone and Hythe 006A,E01024511,1759,1691,68,39,20,4,5
2021,Folkestone and Hythe 006B,E01024512,1661,1553,108,37,30,31,10
2021,Folkestone and Hythe 006C,E01024513,1583,1480,103,45,39,15,4
2021,Folkestone and Hythe 006D,E01024514,1269,1196,73,34,36,2,1
2021,Folkestone and Hythe 006E,E01024515,1754,1677,77,44,19,12,2
2021,Folkestone and Hythe 006F,E01024516,1340,1296,44,20,14,8,2
2021,Folkestone and Hythe 015D,E01024517,1635,1521,114,53,46,7,8
2021,Folkestone and Hythe 003E,E01024518,1598,1571,27,19,6,2,0
2021,Folkestone and Hythe 006G,E01024519,1762,1328,434,185,236,13,0
2021,Folkestone and Hythe 005E,E01024520,1470,1375,95,39,30,16,10
2021,Folkestone and Hythe 006H,E01024521,1577,1548,29,17,6,5,1
2021,Folkestone and Hythe 010A,E01024522,1351,1334,17,11,5,1,0
2021,Folkestone and Hythe 008A,E01024523,1543,1522,21,19,2,0,0
2021,Folkestone and Hythe 010B,E01024524,1403,1370,33,20,8,2,3
2021,Folkestone and Hythe 010C,E01024525,1500,1446,54,25,19,8,2
2021,Folkestone and Hythe 008B,E01024526,1441,1419,22,19,2,1,0
2021,Folkestone and Hythe 008C,E01024527,1613,1591,22,13,4,5,0
2021,Folkestone and Hythe 005F,E01024528,1215,1172,43,32,9,2,0
2021,Folkestone and Hythe 010D,E01024529,1415,1402,13,3,6,3,1
2021,Folkestone and Hythe 009B,E01024530,1815,1782,33,18,13,0,2
2021,Folkestone and Hythe 010E,E01024531,1383,1353,30,12,14,4,0
2021,Folkestone and Hythe 013A,E01024532,1273,1264,9,6,3,0,0
2021,Folkestone and Hythe 013B,E01024533,1116,1113,3,1,2,0,0
2021,Folkestone and Hythe 013C,E01024534,1439,1430,9,6,1,2,0
2021,Folkestone and Hythe 013D,E01024535,2352,2336,16,6,5,3,2
2021,Folkestone and Hythe 009C,E01024536,1855,1836,19,13,5,0,1
2021,Folkestone and Hythe 012A,E01024537,1604,1577,27,9,9,6,3
2021,Folkestone and Hythe 012B,E01024538,1725,1707,18,14,4,0,0
2021,Folkestone and Hythe 012C,E01024539,2019,1975,44,22,15,5,2
2021,Folkestone and Hythe 012D,E01024540,1754,1748,6,2,3,0,1
2021,Folkestone and Hythe 002B,E01024541,2458,2374,84,39,19,21,5
2021,Folkestone and Hythe 002C,E01024542,1869,1831,38,24,11,3,0
2021,Folkestone and Hythe 001B,E01024544,1336,1318,18,12,5,1,0
2021,Folkestone and Hythe 001C,E01024545,1406,1388,18,12,5,1,0
2021,Folkestone and Hythe 009D,E01024546,1698,1677,21,14,2,0,5
2021,Folkestone and Hythe 001D,E01024547,1300,1282,18,12,5,1,0
2021,Folkestone and Hythe 011D,E01024548,1266,1263,3,2,1,0,0
2021,Folkestone and Hythe 011E,E01024549,1239,1229,10,8,2,0,0
2021,Folkestone and Hythe 008D,E01024550,1996,1972,24,17,6,1,0
2021,Swale 015A,E01024551,2113,2033,80,34,36,9,1
2021,Swale 015B,E01024552,2205,2145,60,31,22,7,0
2021,Swale 015C,E01024553,1931,1873,58,31,17,9,1
2021,Swale 009A,E01024554,2537,2496,41,20,16,3,2
2021,Swale 017A,E01024555,1306,1275,31,7,19,5,0
2021,Swale 017B,E01024556,1201,1160,41,12,22,7,0
2021,Swale 017C,E01024557,1455,1420,35,19,10,6,0
2021,Swale 017D,E01024558,1696,1670,26,5,11,10,0
2021,Swale 010A,E01024559,1356,1246,110,32,53,17,8
2021,Swale 012A,E01024560,1359,1315,44,11,29,1,3
2021,Swale 009B,E01024561,1743,1597,146,61,63,18,4
2021,Swale 012B,E01024562,1646,1523,123,44,59,15,5
2021,Swale 015D,E01024563,1626,1587,39,19,14,6,0
2021,Swale 014A,E01024564,1200,1189,11,8,1,1,1
2021,Swale 016A,E01024565,1230,1207,23,9,10,3,1
2021,Swale 016B,E01024566,1479,1461,18,8,10,0,0
2021,Swale 012C,E01024569,1809,1750,59,29,17,13,0
2021,Swale 008A,E01024570,1818,1795,23,10,8,3,2
2021,Swale 008B,E01024571,1954,1921,33,21,11,1,0
2021,Swale 008C,E01024572,1309,1280,29,15,8,4,2
2021,Swale 008D,E01024573,1276,1264,12,9,2,1,0
2021,Swale 008E,E01024575,1167,1154,13,6,5,2,0
2021,Swale 007B,E01024576,1599,1500,99,48,42,9,0
2021,Swale 007C,E01024577,1309,1262,47,26,15,4,2
2021,Swale 007D,E01024578,1595,1537,58,26,25,5,2
2021,Swale 006A,E01024580,1974,1940,34,14,14,5,1
2021,Swale 006B,E01024581,1365,1338,27,12,9,6,0
2021,Swale 009E,E01024582,1489,1393,96,48,36,12,0
2021,Swale 007F,E01024583,1701,1614,87,37,38,11,1
2021,Swale 010B,E01024584,1681,1619,62,24,29,4,5
2021,Swale 003A,E01024585,1361,1344,17,11,4,0,2
2021,Swale 006C,E01024586,1605,1591,14,6,6,2,0
2021,Swale 003B,E01024587,1836,1792,44,16,19,7,2
2021,Swale 003C,E01024588,1623,1605,18,7,9,2,0
2021,Swale 003D,E01024589,1598,1586,12,4,5,3,0
2021,Swale 010C,E01024590,1486,1271,215,52,104,55,4
2021,Swale 011A,E01024591,2572,2309,263,105,111,44,3
2021,Swale 011B,E01024592,1218,1145,73,29,37,5,2
2021,Swale 011C,E01024593,1344,1223,121,44,49,24,4
2021,Swale 005A,E01024594,1406,1403,3,1,1,1,0
2021,Swale 004A,E01024595,1541,1472,69,21,25,20,3
2021,Swale 005B,E01024596,1628,1569,59,28,20,11,0
2021,Swale 005C,E01024597,1753,1714,39,8,23,5,3
2021,Swale 004B,E01024598,1638,1602,36,16,14,4,2
2021,Swale 010D,E01024599,1956,1754,202,62,105,32,3
2021,Swale 011D,E01024600,1416,1345,71,33,27,11,0
2021,Swale 011E,E01024601,1643,1554,89,34,44,8,3
2021,Swale 015E,E01024602,1377,1343,34,13,8,8,5
2021,Swale 014B,E01024603,1208,1170,38,14,16,8,0
2021,Swale 014C,E01024604,1162,1121,41,21,17,2,1
2021,Swale 014D,E01024605,1257,1236,21,13,8,0,0
2021,Swale 013A,E01024606,1325,1310,15,7,6,2,0
2021,Swale 010E,E01024608,1994,1714,280,101,122,54,3
2021,Swale 001A,E01024609,1359,1253,106,39,46,18,3
2021,Swale 001B,E01024610,1716,1626,90,33,31,23,3
2021,Swale 001C,E01024611,1648,1525,123,39,53,25,6
2021,Swale 001D,E01024612,1605,1502,103,46,34,23,0
2021,Swale 002A,E01024613,1583,1455,128,46,51,27,4
2021,Swale 002B,E01024614,1536,1482,54,11,27,16,0
2021,Swale 002C,E01024615,1431,1396,35,12,11,9,3
2021,Swale 002D,E01024616,1723,1676,47,15,22,8,2
2021,Swale 004D,E01024619,1392,1359,33,8,12,10,3
2021,Swale 005D,E01024620,1557,1541,16,9,3,4,0
2021,Swale 004E,E01024621,1352,1321,31,3,15,10,3
2021,Swale 016C,E01024622,1703,1664,39,21,15,3,0
2021,Swale 016D,E01024623,2039,1968,71,26,34,10,1
2021,Swale 016E,E01024624,2769,2613,156,63,70,20,3
2021,Swale 015F,E01024625,1844,1800,44,26,13,5,0
2021,Swale 014E,E01024626,1969,1942,27,18,8,1,0
2021,Swale 014F,E01024627,1882,1830,52,27,21,4,0
2021,Swale 013C,E01024628,1504,1487,17,10,6,1,0
2021,Swale 013D,E01024629,1124,1110,14,9,3,2,0
2021,Swale 012D,E01024630,1636,1610,26,7,14,5,0
2021,Swale 013E,E01024631,1643,1635,8,6,2,0,0
2021,Swale 012E,E01024632,1469,1455,14,6,7,1,0
2021,Thanet 006A,E01024633,1577,1534,43,15,25,3,0
2021,Thanet 006B,E01024634,1337,1292,45,25,14,6,0
2021,Thanet 009A,E01024635,1630,1596,34,21,10,2,1
2021,Thanet 008A,E01024636,2083,2050,33,15,12,3,3
2021,Thanet 008B,E01024637,1743,1720,23,10,9,2,2
2021,Thanet 008C,E01024638,1650,1616,34,17,7,10,0
2021,Thanet 008D,E01024639,1613,1577,36,18,7,7,4
2021,Thanet 008E,E01024640,1629,1610,19,8,6,2,3
2021,Thanet 007A,E01024641,1488,1471,17,3,10,3,1
2021,Thanet 009B,E01024642,1394,1364,30,16,8,5,1
2021,Thanet 010A,E01024643,1151,1086,65,29,20,15,1
2021,Thanet 009C,E01024644,1342,1339,3,2,0,1,0
2021,Thanet 015A,E01024645,1524,1464,60,23,21,12,4
2021,Thanet 016A,E01024646,1880,1750,130,48,46,30,6
2021,Thanet 015B,E01024647,1515,1476,39,20,13,1,5
2021,Thanet 016B,E01024648,1472,1403,69,31,23,14,1
2021,Thanet 016C,E01024649,1749,1674,75,34,30,10,1
2021,Thanet 017A,E01024650,1458,1440,18,11,3,4,0
2021,Thanet 017B,E01024651,1465,1407,58,30,20,5,3
2021,Thanet 017C,E01024652,1853,1827,26,10,10,4,2
2021,Thanet 002A,E01024653,1633,1598,35,15,12,6,2
2021,Thanet 002B,E01024654,1548,1497,51,14,27,8,2
2021,Thanet 002C,E01024655,1493,1468,25,15,3,5,2
2021,Thanet 002D,E01024656,1640,1595,45,21,14,10,0
2021,Thanet 001A,E01024657,2333,1836,497,131,200,142,24
2021,Thanet 001B,E01024658,2166,1783,383,146,133,90,14
2021,Thanet 001C,E01024659,1624,1448,176,72,63,37,4
2021,Thanet 001D,E01024660,1759,1422,337,103,126,99,9
2021,Thanet 004A,E01024661,1489,1306,183,77,64,28,14
2021,Thanet 006C,E01024662,1489,1438,51,22,20,9,0
2021,Thanet 006D,E01024663,1508,1417,91,44,35,11,1
2021,Thanet 004B,E01024664,1514,1438,76,27,28,12,9
2021,Thanet 004C,E01024665,1493,1455,38,16,15,6,1
2021,Thanet 006E,E01024666,1555,1448,107,37,36,33,1
2021,Thanet 016D,E01024667,1700,1525,175,51,67,45,12
2021,Thanet 015C,E01024668,1319,1212,107,59,38,8,2
2021,Thanet 012A,E01024669,1673,1577,96,42,35,18,1
2021,Thanet 015D,E01024670,1659,1587,72,29,31,10,2
2021,Thanet 016E,E01024671,1574,1485,89,31,37,17,4
2021,Thanet 005A,E01024672,1446,1406,40,12,17,8,3
2021,Thanet 005B,E01024673,1816,1772,44,24,14,3,3
2021,Thanet 005C,E01024674,1585,1568,17,9,6,1,1
2021,Thanet 002E,E01024675,2144,2080,64,35,21,4,4
2021,Thanet 003A,E01024676,2034,1733,301,75,133,85,8
2021,Thanet 003B,E01024677,1744,1641,103,45,37,16,5
2021,Thanet 017D,E01024679,1237,1217,20,11,6,2,1
2021,Thanet 017E,E01024680,1630,1596,34,20,11,3,0
2021,Thanet 015E,E01024681,1825,1770,55,31,17,5,2
2021,Thanet 013A,E01024682,2161,2017,144,82,44,18,0
2021,Thanet 013B,E01024683,1635,1577,58,21,23,12,2
2021,Thanet 013C,E01024684,1672,1620,52,25,21,6,0
2021,Thanet 013D,E01024685,1734,1675,59,30,18,5,6
2021,Thanet 011A,E01024686,1622,1577,45,25,12,6,2
2021,Thanet 013E,E01024687,1395,1349,46,22,16,6,2
2021,Thanet 011B,E01024688,1676,1626,50,21,17,8,4
2021,Thanet 011C,E01024689,1204,1160,44,17,14,10,3
2021,Thanet 011D,E01024690,1420,1382,38,19,13,4,2
2021,Thanet 011E,E01024691,1214,1169,45,25,14,4,2
2021,Thanet 009D,E01024692,1668,1635,33,16,10,5,2
2021,Thanet 009E,E01024693,1358,1330,28,16,9,2,1
2021,Thanet 004D,E01024694,1595,1474,121,56,46,17,2
2021,Thanet 003C,E01024695,1273,1213,60,38,16,2,4
2021,Thanet 004E,E01024696,1494,1439,55,20,24,7,4
2021,Thanet 003D,E01024697,1163,1101,62,32,22,7,1
2021,Thanet 012B,E01024698,1394,1336,58,29,19,10,0
2021,Thanet 012C,E01024699,1805,1748,57,23,22,11,1
2021,Thanet 012D,E01024700,1724,1692,32,18,8,5,1
2021,Thanet 014B,E01024702,1332,1311,21,7,9,2,3
2021,Thanet 014C,E01024703,1821,1807,14,9,2,3,0
2021,Thanet 014D,E01024704,1748,1725,23,10,10,3,0
2021,Thanet 010B,E01024705,1062,989,73,26,33,11,3
2021,Thanet 010C,E01024706,1394,1327,67,28,32,6,1
2021,Thanet 010D,E01024707,1359,1325,34,17,13,4,0
2021,Thanet 010E,E01024708,1952,1906,46,23,10,8,5
2021,Thanet 012E,E01024709,1356,1327,29,17,8,3,1
2021,Thanet 003E,E01024710,1430,1252,178,63,51,61,3
2021,Thanet 005D,E01024711,1405,1374,31,13,12,5,1
2021,Thanet 005E,E01024712,1581,1547,34,13,12,4,5
2021,Thanet 007B,E01024713,1778,1739,39,19,11,7,2
2021,Thanet 007C,E01024714,1656,1589,67,19,9,6,33
2021,Thanet 007D,E01024715,1863,1773,90,39,27,22,2
2021,Thanet 007E,E01024716,2044,2003,41,20,15,6,0
2021,Tonbridge and Malling 005A,E01024717,2185,2125,60,35,17,8,0
2021,Tonbridge and Malling 005B,E01024718,1309,1284,25,6,2,5,12
2021,Tonbridge and Malling 001A,E01024719,2210,2177,33,24,4,4,1
2021,Tonbridge and Malling 001B,E01024720,1312,1290,22,14,8,0,0
2021,Tonbridge and Malling 001C,E01024721,1305,1276,29,17,7,5,0
2021,Tonbridge and Malling 001D,E01024722,1330,1308,22,12,8,2,0
2021,Tonbridge and Malling 006A,E01024723,1579,1557,22,15,2,5,0
2021,Tonbridge and Malling 006B,E01024724,2029,1985,44,31,8,5,0
2021,Tonbridge and Malling 006C,E01024725,2063,2009,54,30,14,10,0
2021,Tonbridge and Malling 006D,E01024726,1818,1758,60,29,18,10,3
2021,Tonbridge and Malling 001F,E01024728,1709,1695,14,8,6,0,0
2021,Tonbridge and Malling 011A,E01024729,1664,1621,43,19,16,8,0
2021,Tonbridge and Malling 009A,E01024730,1326,1289,37,17,16,1,3
2021,Tonbridge and Malling 009B,E01024731,1114,1089,25,18,5,1,1
2021,Tonbridge and Malling 012A,E01024732,2012,1806,206,118,70,17,1
2021,Tonbridge and Malling 012B,E01024733,1741,1652,89,55,22,12,0
2021,Tonbridge and Malling 010A,E01024734,1593,1539,54,30,10,13,1
2021,Tonbridge and Malling 005C,E01024735,1465,1430,35,18,13,4,0
2021,Tonbridge and Malling 005D,E01024736,1736,1683,53,36,9,5,3
2021,Tonbridge and Malling 005E,E01024737,2350,2280,70,36,29,5,0
2021,Tonbridge and Malling 014A,E01024740,1933,1904,29,20,7,2,0
2021,Tonbridge and Malling 003A,E01024741,1545,1530,15,10,3,2,0
2021,Tonbridge and Malling 014B,E01024742,1763,1719,44,20,15,8,1
2021,Tonbridge and Malling 008A,E01024743,1812,1794,18,6,9,2,1
2021,Tonbridge and Malling 008B,E01024744,1909,1890,19,10,3,6,0
2021,Tonbridge and Malling 008C,E01024745,1815,1766,49,18,22,7,2
2021,Tonbridge and Malling 007A,E01024746,1049,1025,24,17,6,1,0
2021,Tonbridge and Malling 008D,E01024747,1482,1462,20,12,7,1,0
2021,Tonbridge and Malling 011B,E01024748,1342,1313,29,20,6,3,0
2021,Tonbridge and Malling 011C,E01024749,1562,1531,31,13,10,8,0
2021,Tonbridge and Malling 011D,E01024750,1494,1447,47,23,11,8,5
2021,Tonbridge and Malling 011E,E01024751,1484,1456,28,21,5,2,0
2021,Tonbridge and Malling 010B,E01024752,1623,1595,28,18,9,1,0
2021,Tonbridge and Malling 010C,E01024753,1543,1495,48,31,11,5,1
2021,Tonbridge and Malling 010D,E01024754,1698,1651,47,26,16,4,1
2021,Tonbridge and Malling 006E,E01024755,1983,1942,41,32,7,2,0
2021,Tonbridge and Malling 012C,E01024756,1489,1427,62,37,18,7,0
2021,Tonbridge and Malling 013A,E01024757,1579,1464,115,74,25,14,2
2021,Tonbridge and Malling 013B,E01024758,1633,1530,103,60,32,9,2
2021,Tonbridge and Malling 007C,E01024760,1460,1430,30,19,8,3,0
2021,Tonbridge and Malling 003B,E01024761,2069,2037,32,16,12,4,0
2021,Tonbridge and Malling 003C,E01024762,2133,2079,54,22,21,11,0
2021,Tonbridge and Malling 003D,E01024763,1317,1304,13,7,6,0,0
2021,Tonbridge and Malling 003E,E01024764,1291,1241,50,17,15,14,4
2021,Tonbridge and Malling 003F,E01024765,1270,1247,23,14,7,1,1
2021,Tonbridge and Malling 012E,E01024767,2009,1875,134,90,28,13,3
2021,Tonbridge and Malling 012F,E01024768,1761,1637,124,60,52,12,0
2021,Tonbridge and Malling 002C,E01024771,1861,1823,38,22,9,6,1
2021,Tonbridge and Malling 002D,E01024772,1614,1581,33,12,13,7,1
2021,Tonbridge and Malling 002E,E01024773,1676,1655,21,17,3,1,0
2021,Tonbridge and Malling 009C,E01024775,1603,1519,84,40,29,13,2
2021,Tonbridge and Malling 009D,E01024776,1342,1308,34,20,7,7,0
2021,Tonbridge and Malling 009E,E01024777,1138,1081,57,29,14,13,1
2021,Tonbridge and Malling 013C,E01024778,1773,1657,116,73,28,13,2
2021,Tonbridge and Malling 013D,E01024779,1767,1635,132,51,53,20,8
2021,Tonbridge and Malling 013E,E01024780,1519,1452,67,36,22,8,1
2021,Tonbridge and Malling 007D,E01024781,1937,1903,34,16,10,6,2
2021,Tonbridge and Malling 003G,E01024782,1185,1175,10,9,1,0,0
2021,Tonbridge and Malling 014C,E01024783,1551,1513,38,17,17,3,1
2021,Tonbridge and Malling 003H,E01024785,1473,1467,6,6,0,0,0
2021,Tonbridge and Malling 006F,E01024786,1917,1863,54,29,17,6,2
2021,Tunbridge Wells 013A,E01024787,1208,1178,30,13,10,6,1
2021,Tunbridge Wells 013B,E01024788,1391,1348,43,25,9,6,3
2021,Tunbridge Wells 014A,E01024789,2267,2222,45,34,10,1,0
2021,Tunbridge Wells 013C,E01024790,1160,1113,47,34,12,1,0
2021,Tunbridge Wells 013D,E01024791,1351,1331,20,13,5,2,0
2021,Tunbridge Wells 011A,E01024792,1818,1786,32,23,8,1,0
2021,Tunbridge Wells 004A,E01024793,1682,1657,25,16,4,2,3
2021,Tunbridge Wells 011B,E01024794,1644,1614,30,24,4,2,0
2021,Tunbridge Wells 010A,E01024795,1506,1274,232,109,87,33,3
2021,Tunbridge Wells 010B,E01024796,1338,1244,94,30,39,23,2
2021,Tunbridge Wells 012A,E01024797,1604,1495,109,53,41,13,2
2021,Tunbridge Wells 001A,E01024798,2291,2252,39,26,10,3,0
2021,Tunbridge Wells 007A,E01024799,2081,1971,110,67,30,11,2
2021,Tunbridge Wells 007B,E01024800,1585,1538,47,27,12,8,0
2021,Tunbridge Wells 008B,E01024802,1767,1510,257,139,99,14,5
2021,Tunbridge Wells 013E,E01024803,2260,2237,23,13,6,4,0
2021,Tunbridge Wells 011C,E01024804,1379,1357,22,12,3,7,0
2021,Tunbridge Wells 011D,E01024805,1601,1572,29,21,7,1,0
2021,Tunbridge Wells 011E,E01024806,1613,1567,46,24,17,5,0
2021,Tunbridge Wells 014B,E01024807,1556,1519,37,21,11,3,2
2021,Tunbridge Wells 014C,E01024808,1686,1655,31,19,6,6,0
2021,Tunbridge Wells 014D,E01024809,1370,1340,30,16,9,5,0
2021,Tunbridge Wells 014E,E01024810,1609,1584,25,10,11,3,1
2021,Tunbridge Wells 001B,E01024811,1160,1146,14,9,3,1,1
2021,Tunbridge Wells 001C,E01024812,1355,1334,21,15,3,3,0
2021,Tunbridge Wells 001D,E01024813,1546,1499,47,23,17,5,2
2021,Tunbridge Wells 001E,E01024814,1235,1221,14,8,5,1,0
2021,Tunbridge Wells 001F,E01024815,1165,1141,24,13,9,2,0
2021,Tunbridge Wells 001G,E01024816,1460,1418,42,24,13,5,0
2021,Tunbridge Wells 012B,E01024817,1671,1616,55,42,11,1,1
2021,Tunbridge Wells 012C,E01024818,1753,1686,67,37,20,7,3
2021,Tunbridge Wells 012D,E01024819,1478,1373,105,64,31,10,0
2021,Tunbridge Wells 012E,E01024820,1677,1623,54,44,8,2,0
2021,Tunbridge Wells 009A,E01024821,2005,1883,122,70,34,17,1
2021,Tunbridge Wells 009B,E01024822,2166,2032,134,87,37,8,2
2021,Tunbridge Wells 008C,E01024823,1798,1575,223,110,73,33,7
2021,Tunbridge Wells 009C,E01024824,1633,1578,55,35,10,8,2
2021,Tunbridge Wells 004B,E01024825,1317,1284,33,24,8,1,0
2021,Tunbridge Wells 004C,E01024826,1355,1318,37,18,12,7,0
2021,Tunbridge Wells 004D,E01024827,1466,1420,46,31,11,2,2
2021,Tunbridge Wells 004E,E01024828,1531,1437,94,45,34,14,1
2021,Tunbridge Wells 006A,E01024829,1575,1534,41,23,12,5,1
2021,Tunbridge Wells 010C,E01024830,1831,1758,73,44,26,3,0
2021,Tunbridge Wells 010D,E01024831,1306,1266,40,31,7,2,0
2021,Tunbridge Wells 009D,E01024832,1584,1445,139,66,41,28,4
2021,Tunbridge Wells 008D,E01024833,2434,1978,456,225,164,57,10
2021,Tunbridge Wells 009E,E01024834,2123,1940,183,94,69,19,1
2021,Tunbridge Wells 007C,E01024835,1979,1847,132,75,43,14,0
2021,Tunbridge Wells 003A,E01024836,1662,1521,141,60,55,21,5
2021,Tunbridge Wells 002A,E01024837,1807,1719,88,57,23,6,2
2021,Tunbridge Wells 007D,E01024838,1690,1600,90,48,32,10,0
2021,Tunbridge Wells 003B,E01024839,2732,2440,292,197,75,18,2
2021,Tunbridge Wells 005A,E01024840,1789,1594,195,83,80,28,4
2021,Tunbridge Wells 005B,E01024841,1899,1678,221,121,80,19,1
2021,Tunbridge Wells 005C,E01024842,1585,1466,119,68,40,7,4
2021,Tunbridge Wells 005D,E01024843,1385,1262,123,67,42,13,1
2021,Tunbridge Wells 002B,E01024844,1513,1426,87,33,36,16,2
2021,Tunbridge Wells 003C,E01024845,1325,1275,50,34,12,2,2
2021,Tunbridge Wells 002C,E01024846,1600,1546,54,29,17,6,2
2021,Tunbridge Wells 003D,E01024847,1527,1409,118,81,34,3,0
2021,Tunbridge Wells 003E,E01024848,1316,1248,68,40,19,6,3
2021,Tunbridge Wells 002D,E01024849,1572,1522,50,32,15,3,0
2021,Tunbridge Wells 002E,E01024850,1332,1308,24,19,3,2,0
2021,Tunbridge Wells 006B,E01024851,1627,1595,32,18,5,8,1
2021,Tunbridge Wells 006C,E01024852,1354,1322,32,23,9,0,0
2021,Tunbridge Wells 006D,E01024853,1334,1309,25,21,3,1,0
2021,Tunbridge Wells 006E,E01024854,1589,1564,25,19,4,2,0
2021,Burnley 007A,E01024855,1396,1306,90,26,44,20,0
2021,Burnley 003A,E01024856,1960,1261,699,158,270,225,46
2021,Burnley 007B,E01024857,1504,1313,191,51,81,53,6
2021,Burnley 007C,E01024858,1622,1195,427,87,183,129,28
2021,Burnley 001A,E01024859,1408,1403,5,1,2,2,0
2021,Burnley 009A,E01024860,1342,1334,8,3,4,1,0
2021,Burnley 001B,E01024861,1209,1189,20,12,8,0,0
2021,Burnley 001C,E01024862,1432,1413,19,7,3,7,2
2021,Burnley 008A,E01024863,1522,1486,36,8,22,4,2
2021,Burnley 007D,E01024864,1531,1491,40,15,18,7,0
2021,Burnley 008B,E01024865,1377,1337,40,10,18,12,0
2021,Burnley 008C,E01024866,1673,1651,22,3,15,3,1
2021,Burnley 008D,E01024867,1330,1327,3,1,2,0,0
2021,Burnley 009B,E01024868,1138,1130,8,3,1,2,2
2021,Burnley 009C,E01024869,1379,1376,3,2,1,0,0
2021,Burnley 009D,E01024870,1132,1130,2,1,0,1,0
2021,Burnley 014D,E01024871,1255,1238,17,13,3,1,0
2021,Burnley 010A,E01024872,1515,1336,179,55,80,33,11
2021,Burnley 014E,E01024873,1314,1272,42,13,22,4,3
2021,Burnley 011A,E01024874,1010,1004,6,6,0,0,0
2021,Burnley 003B,E01024875,1838,1175,663,121,257,233,52
2021,Burnley 003C,E01024876,1820,1213,607,157,234,174,42
2021,Burnley 003D,E01024877,1970,1352,618,154,188,223,53
2021,Burnley 003E,E01024878,1901,1250,651,186,206,208,51
2021,Burnley 005A,E01024879,1559,1537,22,12,9,0,1
2021,Burnley 005B,E01024880,1418,1395,23,12,8,3,0
2021,Burnley 006A,E01024881,1365,1348,17,8,5,2,2
2021,Burnley 006B,E01024882,1365,1312,53,19,25,6,3
2021,Burnley 004A,E01024883,1495,1467,28,14,8,6,0
2021,Burnley 004B,E01024884,1604,1590,14,4,3,5,2
2021,Burnley 004C,E01024885,1576,1548,28,8,15,5,0
2021,Burnley 004D,E01024886,1465,1419,46,22,20,4,0
2021,Burnley 011B,E01024887,1504,1490,14,3,4,6,1
2021,Burnley 011C,E01024888,1826,1799,27,14,8,3,2
2021,Burnley 004E,E01024889,1240,1229,11,2,4,5,0
2021,Burnley 004F,E01024890,1612,1598,14,3,8,3,0
2021,Burnley 001D,E01024891,1909,1705,204,86,64,46,8
2021,Burnley 001E,E01024892,1531,1435,96,34,33,16,13
2021,Burnley 002A,E01024893,1763,1387,376,90,166,105,15
2021,Burnley 001F,E01024894,1310,1289,21,11,10,0,0
2021,Burnley 003F,E01024895,1750,1182,568,124,240,153,51
2021,Burnley 002B,E01024896,1370,1258,112,37,47,23,5
2021,Burnley 002C,E01024897,1504,1304,200,40,89,56,15
2021,Burnley 002D,E01024898,1788,1228,560,119,240,176,25
2021,Burnley 010B,E01024899,1611,1509,102,36,37,25,4
2021,Burnley 010C,E01024900,1641,1362,279,90,118,61,10
2021,Burnley 011D,E01024901,1683,1673,10,2,5,3,0
2021,Burnley 006C,E01024902,1880,1850,30,10,7,11,2
2021,Burnley 014F,E01024903,1230,1198,32,14,11,7,0
2021,Burnley 014A,E01024904,1785,1723,62,24,28,9,1
2021,Burnley 014G,E01024905,1229,1220,9,5,2,1,1
2021,Burnley 014B,E01024906,2151,1919,232,78,103,40,11
2021,Burnley 010D,E01024907,1325,1215,110,33,53,23,1
2021,Burnley 010E,E01024908,1451,1289,162,54,62,44,2
2021,Burnley 010F,E01024909,1625,1492,133,44,60,26,3
2021,Burnley 014C,E01024910,1382,1315,67,18,37,10,2
2021,Burnley 006D,E01024911,1783,1729,54,19,17,13,5
2021,Burnley 005C,E01024912,1325,1316,9,2,3,4,0
2021,Burnley 005D,E01024913,1234,1217,17,9,6,2,0
2021,Burnley 005E,E01024914,1368,1339,29,8,16,5,0
2021,Chorley 014A,E01024915,2608,2562,46,21,13,11,1
2021,Chorley 014B,E01024916,1672,1662,10,4,6,0,0
2021,Chorley 014C,E01024917,1683,1668,15,5,6,4,0
2021,Chorley 014D,E01024918,1708,1692,16,10,3,3,0
2021,Chorley 008B,E01024920,1867,1843,24,13,2,9,0
2021,Chorley 002A,E01024921,1958,1948,10,6,4,0,0
2021,Chorley 013A,E01024922,1380,1367,13,4,5,3,1
2021,Chorley 011A,E01024923,1267,1255,12,5,2,4,1
2021,Chorley 011B,E01024924,1412,1403,9,7,2,0,0
2021,Chorley 009A,E01024925,1678,1539,139,46,58,30,5
2021,Chorley 009B,E01024926,2356,2230,126,41,58,23,4
2021,Chorley 009C,E01024927,1565,1523,42,12,21,9,0
2021,Chorley 009D,E01024928,1398,1338,60,23,20,14,3
2021,Chorley 006B,E01024930,1403,1370,33,10,14,8,1
2021,Chorley 006C,E01024931,1357,1297,60,21,22,12,5
2021,Chorley 006E,E01024933,1280,1236,44,17,17,10,0
2021,Chorley 008C,E01024934,1639,1612,27,10,15,2,0
2021,Chorley 008D,E01024935,1321,1312,9,4,4,1,0
2021,Chorley 010A,E01024936,1594,1521,73,29,27,15,2
2021,Chorley 006F,E01024937,1478,1452,26,17,7,2,0
2021,Chorley 010B,E01024938,2048,2029,19,10,4,4,1
2021,Chorley 010C,E01024939,2265,2236,29,11,8,8,2
2021,Chorley 010D,E01024940,1642,1527,115,37,40,32,6
2021,Chorley 010E,E01024941,1819,1761,58,24,20,12,2
2021,Chorley 012A,E01024942,1532,1470,62,17,27,16,2
2021,Chorley 012B,E01024943,2280,2173,107,34,48,22,3
2021,Chorley 012C,E01024944,2130,2112,18,10,8,0,0
2021,Chorley 003A,E01024946,1200,1176,24,6,10,6,2
2021,Chorley 003B,E01024947,1268,1253,15,8,7,0,0
2021,Chorley 004A,E01024948,1624,1610,14,10,3,1,0
2021,Chorley 004C,E01024950,1318,1309,9,6,1,2,0
2021,Chorley 001A,E01024951,1131,1047,84,20,42,19,3
2021,Chorley 001B,E01024952,1180,1117,63,32,20,10,1
2021,Chorley 001C,E01024953,1336,1197,139,36,66,24,13
2021,Chorley 001D,E01024954,1510,1456,54,21,21,10,2
2021,Chorley 003C,E01024955,1348,1327,21,13,7,0,1
2021,Chorley 003D,E01024956,1848,1820,28,14,8,3,3
2021,Chorley 003E,E01024957,2495,2472,23,13,4,4,2
2021,Chorley 003F,E01024958,1260,1231,29,12,8,7,2
2021,Chorley 013B,E01024959,1937,1904,33,12,19,2,0
2021,Chorley 013C,E01024960,1727,1707,20,5,6,6,3
2021,Chorley 013D,E01024961,1535,1529,6,4,1,0,1
2021,Chorley 013E,E01024962,1487,1471,16,5,4,6,1
2021,Chorley 011C,E01024963,1468,1458,10,5,5,0,0
2021,Chorley 007A,E01024964,1536,1534,2,2,0,0,0
2021,Chorley 011D,E01024965,1402,1392,10,5,2,2,1
2021,Chorley 011E,E01024966,1855,1847,8,5,0,3,0
2021,Chorley 005A,E01024967,1189,1182,7,4,1,1,1
2021,Chorley 005B,E01024968,2119,2087,32,17,9,5,1
2021,Chorley 005C,E01024969,1355,1333,22,12,7,2,1
2021,Chorley 005D,E01024970,1321,1305,16,4,11,1,0
2021,Chorley 005E,E01024971,1340,1323,17,12,0,5,0
2021,Chorley 005F,E01024972,1168,1154,14,8,4,2,0
2021,Chorley 014E,E01024973,2065,2056,9,2,6,1,0
2021,Chorley 007B,E01024974,1570,1561,9,5,4,0,0
2021,Chorley 007C,E01024975,3055,2964,91,29,37,20,5
2021,Chorley 007D,E01024976,1596,1584,12,3,4,5,0
2021,Chorley 004D,E01024977,2605,2577,28,15,9,3,1
2021,Chorley 002B,E01024978,1260,1251,9,6,2,0,1
2021,Chorley 002C,E01024979,1330,1321,9,5,2,1,1
2021,Chorley 002D,E01024980,1310,1307,3,2,0,1,0
2021,Fylde 008A,E01024981,1317,1293,24,16,6,1,1
2021,Fylde 008B,E01024982,1336,1305,31,15,14,2,0
2021,Fylde 008C,E01024983,1415,1399,16,9,7,0,0
2021,Fylde 006A,E01024984,1405,1374,31,13,13,4,1
2021,Fylde 006B,E01024985,1375,1362,13,11,0,2,0
2021,Fylde 006C,E01024986,1590,1510,80,30,26,20,4
2021,Fylde 006D,E01024987,1297,1183,114,44,37,30,3
2021,Fylde 006E,E01024988,1559,1520,39,22,12,5,0
2021,Fylde 006F,E01024989,1465,1449,16,9,6,1,0
2021,Fylde 009A,E01024990,1402,1371,31,20,9,2,0
2021,Fylde 009B,E01024991,1045,1022,23,15,5,3,0
2021,Fylde 009C,E01024992,1385,1371,14,7,4,3,0
2021,Fylde 001A,E01024993,1584,1576,8,3,5,0,0
2021,Fylde 008D,E01024994,1542,1513,29,18,9,2,0
2021,Fylde 008E,E01024995,1356,1348,8,6,2,0,0
2021,Fylde 006G,E01024996,1171,1129,42,16,21,4,1
2021,Fylde 007A,E01024997,1401,1391,10,6,4,0,0
2021,Fylde 003A,E01024998,1698,1642,56,26,16,14,0
2021,Fylde 007B,E01024999,1416,1409,7,5,1,1,0
2021,Fylde 007C,E01025000,1205,1199,6,5,0,1,0
2021,Fylde 005A,E01025001,2089,2037,52,30,15,5,2
2021,Fylde 005B,E01025002,1364,1350,14,6,7,1,0
2021,Fylde 008F,E01025003,1669,1651,18,11,3,3,1
2021,Fylde 004A,E01025004,1295,1266,29,12,11,4,2
2021,Fylde 005C,E01025005,1408,1380,28,13,8,5,2
2021,Fylde 004B,E01025006,1191,1148,43,13,24,6,0
2021,Fylde 002A,E01025007,1920,1854,66,26,22,15,3
2021,Fylde 002B,E01025008,1089,1082,7,4,2,0,1
2021,Fylde 002C,E01025009,1503,1445,58,12,20,22,4
2021,Fylde 003B,E01025010,1661,1607,54,25,12,15,2
2021,Fylde 002D,E01025011,1492,1369,123,23,48,45,7
2021,Fylde 002E,E01025012,2677,2590,87,33,31,19,4
2021,Fylde 002F,E01025013,1658,1534,124,33,55,31,5
2021,Fylde 003C,E01025014,1702,1695,7,2,5,0,0
2021,Fylde 003D,E01025015,1467,1449,18,8,7,3,0
2021,Fylde 005D,E01025016,2303,2259,44,26,11,7,0
2021,Fylde 008G,E01025017,1423,1403,20,15,3,0,2
2021,Fylde 005E,E01025018,1203,1185,18,11,5,2,0
2021,Fylde 002G,E01025019,1846,1829,17,12,5,0,0
2021,Fylde 009D,E01025020,1363,1336,27,10,15,2,0
2021,Fylde 009E,E01025021,1314,1296,18,10,5,3,0
2021,Fylde 009F,E01025022,1823,1785,38,31,6,0,1
2021,Fylde 004C,E01025023,1236,1230,6,3,2,1,0
2021,Fylde 004D,E01025024,2130,2083,47,28,12,5,2
2021,Fylde 004E,E01025025,1516,1486,30,14,11,4,1
2021,Fylde 001B,E01025026,1383,1374,9,5,1,3,0
2021,Fylde 001C,E01025027,1769,1726,43,25,15,3,0
2021,Fylde 001D,E01025028,1558,1535,23,15,7,0,1
2021,Fylde 007D,E01025029,2523,2509,14,10,3,1,0
2021,Fylde 007E,E01025030,1994,1942,52,27,18,7,0
2021,Fylde 001E,E01025031,1930,1908,22,13,3,6,0
2021,Hyndburn 002A,E01025032,1387,1341,46,22,16,8,0
2021,Hyndburn 002B,E01025033,2167,2116,51,21,21,7,2
2021,Hyndburn 002C,E01025034,1695,1629,66,26,26,12,2
2021,Hyndburn 008A,E01025035,1377,1330,47,13,19,12,3
2021,Hyndburn 008B,E01025036,1639,1473,166,45,71,47,3
2021,Hyndburn 008C,E01025037,1522,1409,113,42,39,27,5
2021,Hyndburn 008D,E01025038,1279,1262,17,3,3,8,3
2021,Hyndburn 008E,E01025039,1164,1161,3,1,1,1,0
2021,Hyndburn 008F,E01025040,1375,1357,18,10,5,3,0
2021,Hyndburn 006A,E01025041,1631,1316,315,71,129,97,18
2021,Hyndburn 006B,E01025042,2266,1663,603,151,206,201,45
2021,Hyndburn 005A,E01025044,1162,1034,128,23,63,36,6
2021,Hyndburn 005B,E01025045,1180,1070,110,36,53,18,3
2021,Hyndburn 005C,E01025046,1240,1182,58,19,22,12,5
2021,Hyndburn 002D,E01025048,1434,1414,20,7,9,1,3
2021,Hyndburn 002E,E01025049,1434,1396,38,11,15,11,1
2021,Hyndburn 002F,E01025050,1492,1476,16,8,7,1,0
2021,Hyndburn 004A,E01025051,1597,1474,123,40,58,22,3
2021,Hyndburn 004B,E01025052,1488,1462,26,8,13,4,1
2021,Hyndburn 002G,E01025053,1495,1481,14,4,6,3,1
2021,Hyndburn 009A,E01025054,1530,1525,5,4,1,0,0
2021,Hyndburn 007A,E01025055,1395,1364,31,12,11,8,0
2021,Hyndburn 009B,E01025056,1256,1249,7,3,1,3,0
2021,Hyndburn 004C,E01025057,1591,1522,69,13,26,27,3
2021,Hyndburn 004D,E01025058,1397,1314,83,22,30,27,4
2021,Hyndburn 004E,E01025059,1756,1679,77,27,25,21,4
2021,Hyndburn 001A,E01025060,1401,1286,115,25,46,36,8
2021,Hyndburn 001B,E01025061,1556,1497,59,11,29,17,2
2021,Hyndburn 001C,E01025062,1608,1472,136,22,52,57,5
2021,Hyndburn 001D,E01025063,1471,1437,34,19,9,5,1
2021,Hyndburn 001E,E01025064,1538,1517,21,7,6,7,1
2021,Hyndburn 001F,E01025065,1569,1543,26,13,7,5,1
2021,Hyndburn 001G,E01025066,1526,1511,15,6,3,5,1
2021,Hyndburn 004F,E01025067,1418,1353,65,21,28,14,2
2021,Hyndburn 004G,E01025068,1507,1382,125,35,53,28,9
2021,Hyndburn 004H,E01025069,1346,1298,48,13,21,12,2
2021,Hyndburn 003A,E01025070,1158,1110,48,14,23,11,0
2021,Hyndburn 003B,E01025071,1277,1267,10,5,5,0,0
2021,Hyndburn 003C,E01025072,1453,1426,27,2,18,6,1
2021,Hyndburn 003D,E01025073,1258,1245,13,7,3,1,2
2021,Hyndburn 003E,E01025074,1302,1292,10,4,4,2,0
2021,Hyndburn 007B,E01025075,1663,1609,54,17,22,14,1
2021,Hyndburn 007C,E01025076,1225,1198,27,10,10,6,1
2021,Hyndburn 007D,E01025077,1378,1358,20,5,11,1,3
2021,Hyndburn 007E,E01025078,1376,1359,17,8,8,1,0
2021,Hyndburn 009C,E01025079,1536,1490,46,15,22,9,0
2021,Hyndburn 009D,E01025080,1420,1404,16,7,5,4,0
2021,Hyndburn 005D,E01025081,1558,1544,14,4,4,6,0
2021,Hyndburn 006E,E01025082,1633,1452,181,46,84,45,6
2021,Hyndburn 006F,E01025083,2022,1768,254,63,116,63,12
2021,Hyndburn 006G,E01025084,1658,1340,318,65,128,99,26
2021,Lancaster 004A,E01025085,1408,1391,17,6,8,3,0
2021,Lancaster 004B,E01025086,1333,1324,9,4,2,2,1
2021,Lancaster 004C,E01025087,1279,1242,37,10,17,10,0
2021,Lancaster 001A,E01025088,1013,1006,7,3,3,1,0
2021,Lancaster 003A,E01025089,1401,1393,8,4,3,1,0
2021,Lancaster 003B,E01025090,1568,1558,10,5,3,1,1
2021,Lancaster 013A,E01025091,1616,1514,102,34,46,21,1
2021,Lancaster 013B,E01025092,1235,1159,76,24,36,12,4
2021,Lancaster 014A,E01025093,2174,1705,469,231,186,51,1
2021,Lancaster 014B,E01025094,1335,1218,117,63,31,20,3
2021,Lancaster 013C,E01025095,2868,2680,188,142,37,8,1
2021,Lancaster 001B,E01025096,1581,1551,30,12,6,12,0
2021,Lancaster 001C,E01025097,1444,1407,37,20,11,5,1
2021,Lancaster 001D,E01025098,1313,1294,19,6,6,4,3
2021,Lancaster 014C,E01025099,1923,1739,184,113,53,17,1
2021,Lancaster 017A,E01025100,2327,2176,151,77,53,19,2
2021,Lancaster 017B,E01025101,1329,1242,87,36,39,9,3
2021,Lancaster 017C,E01025102,1516,1385,131,64,35,29,3
2021,Lancaster 017D,E01025103,1216,1175,41,21,8,10,2
2021,Lancaster 019A,E01025105,5714,4752,962,560,337,62,3
2021,Lancaster 019B,E01025106,2012,1932,80,39,31,9,1
2021,Lancaster 019C,E01025107,1554,1530,24,11,7,5,1
2021,Lancaster 005A,E01025108,1444,1421,23,15,4,4,0
2021,Lancaster 005B,E01025109,1354,1331,23,14,7,2,0
2021,Lancaster 009A,E01025110,1477,1333,144,35,70,34,5
2021,Lancaster 008A,E01025111,1754,1668,86,28,39,18,1
2021,Lancaster 006A,E01025112,1508,1408,100,32,48,18,2
2021,Lancaster 008B,E01025113,1466,1402,64,26,25,10,3
2021,Lancaster 016A,E01025114,1479,1444,35,12,7,15,1
2021,Lancaster 016B,E01025115,1453,1379,74,26,29,12,7
2021,Lancaster 009B,E01025116,1320,1281,39,21,14,4,0
2021,Lancaster 009C,E01025117,1391,1239,152,30,62,56,4
2021,Lancaster 008C,E01025118,1042,999,43,16,12,14,1
2021,Lancaster 008D,E01025119,1314,1270,44,20,22,1,1
2021,Lancaster 009D,E01025120,1360,1269,91,42,30,17,2
2021,Lancaster 016C,E01025121,1975,1915,60,29,20,10,1
2021,Lancaster 016D,E01025122,1624,1603,21,3,9,7,2
2021,Lancaster 016E,E01025123,2537,2459,78,22,31,21,4
2021,Lancaster 016F,E01025124,1501,1444,57,21,26,9,1
2021,Lancaster 013D,E01025126,2052,1941,111,81,21,9,0
2021,Lancaster 018A,E01025127,1329,1259,70,40,19,8,3
2021,Lancaster 015B,E01025128,1287,1184,103,60,29,14,0
2021,Lancaster 002A,E01025130,2223,2203,20,14,4,1,1
2021,Lancaster 005C,E01025131,1507,1494,13,12,1,0,0
2021,Lancaster 002B,E01025132,1364,1356,8,7,0,0,1
2021,Lancaster 005D,E01025133,1553,1534,19,14,5,0,0
2021,Lancaster 006B,E01025136,1492,1418,74,25,33,14,2
2021,Lancaster 020A,E01025137,1377,1365,12,4,5,3,0
2021,Lancaster 006C,E01025138,1315,1270,45,15,21,9,0
2021,Lancaster 006D,E01025139,1500,1357,143,47,56,36,4
2021,Lancaster 006E,E01025140,1382,1347,35,20,10,5,0
2021,Lancaster 018B,E01025141,1324,1265,59,24,23,11,1
2021,Lancaster 019D,E01025142,1442,1383,59,47,11,1,0
2021,Lancaster 018C,E01025143,1376,1261,115,46,32,27,10
2021,Lancaster 017E,E01025144,1722,1569,153,83,41,28,1
2021,Lancaster 018D,E01025145,1408,1271,137,54,59,14,10
2021,Lancaster 017F,E01025146,1913,1841,72,56,14,1,1
2021,Lancaster 015D,E01025147,1442,1280,162,98,41,23,0
2021,Lancaster 001E,E01025148,2070,2061,9,7,2,0,0
2021,Lancaster 011A,E01025149,2105,2040,65,29,24,6,6
2021,Lancaster 011B,E01025150,1498,1422,76,27,19,20,10
2021,Lancaster 011C,E01025151,1559,1389,170,68,62,38,2
2021,Lancaster 011D,E01025152,1497,1477,20,7,11,2,0
2021,Lancaster 020F,E01025153,1228,1198,30,12,12,6,0
2021,Lancaster 011E,E01025154,1290,1213,77,22,26,22,7
2021,Lancaster 020G,E01025155,1240,1216,24,17,6,1,0
2021,Lancaster 020H,E01025156,1345,1158,187,63,71,47,6
2021,Lancaster 020I,E01025157,1169,1113,56,23,17,15,1
2021,Lancaster 003C,E01025158,1394,1389,5,2,2,1,0
2021,Lancaster 003D,E01025159,1329,1314,15,7,8,0,0
2021,Lancaster 003E,E01025160,1409,1399,10,6,4,0,0
2021,Lancaster 004D,E01025161,1066,1058,8,1,4,3,0
2021,Lancaster 020B,E01025162,1377,1367,10,4,6,0,0
2021,Lancaster 020C,E01025163,1290,1286,4,2,2,0,0
2021,Lancaster 020D,E01025164,1368,1354,14,4,6,4,0
2021,Lancaster 020E,E01025165,1407,1371,36,15,17,4,0
2021,Lancaster 002C,E01025166,1157,1135,22,7,9,6,0
2021,Lancaster 002D,E01025167,1121,1113,8,3,5,0,0
2021,Lancaster 001F,E01025168,1033,1021,12,6,4,1,1
2021,Lancaster 001G,E01025169,1249,1241,8,1,3,4,0
2021,Lancaster 010A,E01025170,1562,1501,61,20,21,18,2
2021,Lancaster 010B,E01025171,1872,1749,123,34,57,26,6
2021,Lancaster 010C,E01025172,1350,1282,68,29,23,15,1
2021,Lancaster 010D,E01025173,1573,1500,73,27,36,8,2
2021,Pendle 008A,E01025174,1394,1336,58,7,27,14,10
2021,Pendle 008B,E01025175,1456,1433,23,10,7,5,1
2021,Pendle 008C,E01025176,1923,1907,16,8,7,1,0
2021,Pendle 008D,E01025177,1600,1585,15,6,4,5,0
2021,Pendle 006A,E01025178,1799,1785,14,5,5,3,1
2021,Pendle 006B,E01025179,1450,1447,3,2,0,1,0
2021,Pendle 006C,E01025180,1802,1794,8,5,1,2,0
2021,Pendle 009A,E01025181,1734,1427,307,75,129,91,12
2021,Pendle 009B,E01025182,1811,1222,589,89,248,190,62
2021,Pendle 009C,E01025183,1866,1372,494,79,207,173,35
2021,Pendle 009D,E01025184,1943,1323,620,101,259,202,58
2021,Pendle 013A,E01025185,2084,1540,544,115,215,172,42
2021,Pendle 013B,E01025186,1909,1510,399,70,188,120,21
2021,Pendle 012A,E01025187,1463,1284,179,41,67,61,10
2021,Pendle 010A,E01025188,2192,1410,782,158,318,229,77
2021,Pendle 010B,E01025189,1715,1345,370,68,182,100,20
2021,Pendle 012B,E01025190,1654,1498,156,38,75,35,8
2021,Pendle 001A,E01025191,1243,1218,25,11,8,5,1
2021,Pendle 001B,E01025192,1502,1430,72,27,23,21,1
2021,Pendle 001C,E01025193,1316,1281,35,16,12,4,3
2021,Pendle 001D,E01025194,1308,1240,68,14,34,17,3
2021,Pendle 002A,E01025195,1211,1199,12,5,6,1,0
2021,Pendle 002B,E01025196,1525,1431,94,20,45,26,3
2021,Pendle 002C,E01025197,1252,1242,10,3,5,2,0
2021,Pendle 002D,E01025198,1464,1345,119,28,60,28,3
2021,Pendle 003A,E01025199,1759,1733,26,16,6,4,0
2021,Pendle 003B,E01025200,1475,1451,24,13,5,4,2
2021,Pendle 003C,E01025201,1415,1410,5,1,3,0,1
2021,Pendle 003D,E01025202,1377,1353,24,9,11,2,2
2021,Pendle 006D,E01025203,1696,1679,17,8,6,3,0
2021,Pendle 008E,E01025204,1673,1663,10,3,3,3,1
2021,Pendle 014E,E01025205,1190,1165,25,10,10,5,0
2021,Pendle 014A,E01025206,1175,1145,30,9,9,10,2
2021,Pendle 014G,E01025207,1159,1143,16,3,7,4,2
2021,Pendle 014F,E01025208,1195,1180,15,6,6,2,1
2021,Pendle 012C,E01025209,1654,1532,122,32,53,32,5
2021,Pendle 010C,E01025210,1877,1607,270,74,120,70,6
2021,Pendle 008F,E01025211,1534,1514,20,5,6,5,4
2021,Pendle 013C,E01025212,1547,1405,142,29,49,54,10
2021,Pendle 013D,E01025213,1473,1275,198,53,83,42,20
2021,Pendle 013E,E01025214,1450,1358,92,28,40,22,2
2021,Pendle 013F,E01025215,1538,1195,343,63,121,134,25
2021,Pendle 012D,E01025216,2254,1980,274,80,125,59,10
2021,Pendle 010D,E01025217,1563,1065,498,69,222,174,33
2021,Pendle 010E,E01025218,1301,899,402,74,169,132,27
2021,Pendle 010F,E01025219,1325,739,586,114,242,202,28
2021,Pendle 014C,E01025220,1486,1396,90,29,41,18,2
2021,Pendle 014B,E01025221,1413,1345,68,25,32,8,3
2021,Pendle 014D,E01025222,1441,1429,12,2,8,2,0
2021,Pendle 014H,E01025223,1373,1339,34,10,16,7,1
2021,Pendle 011A,E01025224,2416,1597,819,166,357,232,64
2021,Pendle 011B,E01025225,1748,1490,258,55,127,61,15
2021,Pendle 007A,E01025226,1510,1468,42,7,21,12,2
2021,Pendle 007B,E01025227,1884,1761,123,28,47,40,8
2021,Pendle 007C,E01025228,1815,1766,49,21,15,11,2
2021,Pendle 011C,E01025229,2762,1759,1003,190,372,334,107
2021,Pendle 011D,E01025230,2144,1397,747,143,265,273,66
2021,Preston 013A,E01025231,1367,1317,50,28,18,4,0
2021,Preston 013B,E01025232,1470,1333,137,46,59,25,7
2021,Preston 008A,E01025233,1253,1231,22,14,6,2,0
2021,Preston 007A,E01025234,1476,1382,94,42,36,14,2
2021,Preston 007B,E01025235,1712,1552,160,67,67,20,6
2021,Preston 009A,E01025236,1518,1289,229,84,89,51,5
2021,Preston 007C,E01025237,1490,1329,161,66,62,28,5
2021,Preston 007D,E01025238,1426,1302,124,54,43,21,6
2021,Preston 006A,E01025239,1378,1298,80,39,28,13,0
2021,Preston 008B,E01025240,1550,1489,61,34,14,9,4
2021,Preston 006B,E01025241,1607,1474,133,61,47,18,7
2021,Preston 006C,E01025242,1660,1534,126,79,30,17,0
2021,Preston 006D,E01025243,2080,1881,199,81,73,40,5
2021,Preston 015A,E01025244,1684,1095,589,165,235,156,33
2021,Preston 007E,E01025245,2627,2242,385,154,139,73,19
2021,Preston 011A,E01025246,1706,1145,561,180,228,142,11
2021,Preston 016A,E01025247,1614,1049,565,166,239,130,30
2021,Preston 016B,E01025248,1275,979,296,79,118,76,23
2021,Preston 016C,E01025249,995,910,85,13,29,34,9
2021,Preston 016D,E01025250,1615,1152,463,110,196,135,22
2021,Preston 006E,E01025251,1424,1289,135,64,48,20,3
2021,Preston 007F,E01025252,1411,1315,96,39,38,18,1
2021,Preston 004A,E01025253,1715,1598,117,77,30,9,1
2021,Preston 004B,E01025254,1119,1047,72,40,24,5,3
2021,Preston 004C,E01025255,1428,1353,75,40,20,12,3
2021,Preston 003A,E01025256,1399,1293,106,47,40,18,1
2021,Preston 002A,E01025257,1458,1392,66,41,19,5,1
2021,Preston 003B,E01025258,1444,1334,110,50,41,17,2
2021,Preston 003C,E01025259,2741,2565,176,92,55,23,6
2021,Preston 005A,E01025260,1477,1312,165,68,76,19,2
2021,Preston 008C,E01025261,1405,1347,58,24,23,10,1
2021,Preston 005B,E01025262,1361,1266,95,40,41,12,2
2021,Preston 005C,E01025263,1372,1304,68,30,30,7,1
2021,Preston 005D,E01025264,1354,1272,82,36,31,13,2
2021,Preston 013C,E01025265,1358,1311,47,23,19,2,3
2021,Preston 008D,E01025266,1122,1098,24,10,10,4,0
2021,Preston 013D,E01025267,1305,1226,79,38,30,10,1
2021,Preston 013E,E01025268,1732,1604,128,51,58,17,2
2021,Preston 013F,E01025269,1723,1597,126,66,45,13,2
2021,Preston 010A,E01025270,1578,1534,44,21,10,11,2
2021,Preston 013G,E01025271,1482,1436,46,26,11,7,2
2021,Preston 010B,E01025272,2554,2478,76,42,23,10,1
2021,Preston 010C,E01025273,1246,1217,29,12,5,7,5
2021,Preston 011B,E01025274,1848,1442,406,189,175,36,6
2021,Preston 011C,E01025275,1571,1281,290,117,116,47,10
2021,Preston 012A,E01025276,1640,1377,263,92,102,61,8
2021,Preston 002B,E01025277,2380,2226,154,114,28,7,5
2021,Preston 001A,E01025278,2717,2685,32,26,5,1,0
2021,Preston 001B,E01025279,2385,2359,26,13,7,5,1
2021,Preston 002D,E01025281,2052,1988,64,47,15,1,1
2021,Preston 001C,E01025282,1826,1791,35,14,15,6,0
2021,Preston 009B,E01025283,1684,1487,197,85,75,32,5
2021,Preston 009C,E01025284,1637,1567,70,35,25,9,1
2021,Preston 009D,E01025285,1379,1241,138,39,66,28,5
2021,Preston 009E,E01025286,1794,1583,211,73,94,41,3
2021,Preston 009F,E01025287,1887,1643,244,93,97,47,7
2021,Preston 010D,E01025288,1668,1483,185,101,54,25,5
2021,Preston 017A,E01025289,1354,1091,263,106,95,57,5
2021,Preston 017B,E01025290,1736,1336,400,186,146,55,13
2021,Preston 017C,E01025291,1309,1113,196,74,74,40,8
2021,Preston 015B,E01025292,2397,1912,485,261,170,49,5
2021,Preston 015C,E01025293,2096,1498,598,176,237,161,24
2021,Preston 011D,E01025294,1731,1288,443,157,155,115,16
2021,Preston 014A,E01025295,2643,2045,598,210,240,126,22
2021,Preston 014B,E01025296,1956,1495,461,150,180,108,23
2021,Preston 014C,E01025297,2207,1503,704,187,314,174,29
2021,Preston 014D,E01025298,1704,1175,529,145,211,143,30
2021,Preston 003D,E01025299,1478,1353,125,74,30,21,0
2021,Preston 004D,E01025300,1126,984,142,89,44,6,3
2021,Preston 003E,E01025301,1050,945,105,56,32,14,3
2021,Preston 003F,E01025302,1146,1034,112,62,35,13,2
2021,Preston 004E,E01025303,1280,1197,83,51,22,10,0
2021,Preston 016E,E01025304,1830,1522,308,107,135,54,12
2021,Preston 016F,E01025305,1601,1150,451,139,185,107,20
2021,Preston 017D,E01025306,1885,1541,344,176,108,50,10
2021,Preston 012B,E01025308,1622,1327,295,138,97,54,6
2021,Preston 008E,E01025309,1176,1083,93,43,32,18,0
2021,Preston 012C,E01025310,1504,1322,182,65,77,39,1
2021,Preston 012D,E01025311,1171,1091,80,29,32,15,4
2021,Preston 012E,E01025312,1528,1408,120,43,57,17,3
2021,Preston 012F,E01025313,1905,1562,343,179,126,36,2
2021,Preston 012G,E01025314,2639,2293,346,197,116,30,3
2021,Ribble Valley 001A,E01025315,1652,1609,43,24,12,7,0
2021,Ribble Valley 006A,E01025316,1609,1600,9,3,5,1,0
2021,Ribble Valley 006B,E01025317,1047,1027,20,3,14,3,0
2021,Ribble Valley 007A,E01025318,1122,1120,2,0,2,0,0
2021,Ribble Valley 007B,E01025319,2004,1978,26,16,7,3,0
2021,Ribble Valley 001B,E01025320,1298,1291,7,5,1,1,0
2021,Ribble Valley 005A,E01025321,1302,1296,6,0,5,1,0
2021,Ribble Valley 004A,E01025322,1385,1375,10,8,1,1,0
2021,Ribble Valley 008A,E01025323,1116,1107,9,8,0,1,0
2021,Ribble Valley 008B,E01025324,1409,1406,3,3,0,0,0
2021,Ribble Valley 006C,E01025325,1473,1451,22,11,3,6,2
2021,Ribble Valley 004B,E01025326,1629,1613,16,7,4,5,0
2021,Ribble Valley 004C,E01025327,1264,1254,10,5,3,2,0
2021,Ribble Valley 006D,E01025328,1446,1436,10,5,4,1,0
2021,Ribble Valley 003A,E01025329,2196,2175,21,13,4,4,0
2021,Ribble Valley 003B,E01025330,1495,1456,39,24,10,5,0
2021,Ribble Valley 001C,E01025331,1410,1397,13,10,1,0,2
2021,Ribble Valley 007C,E01025333,1271,1258,13,3,7,3,0
2021,Ribble Valley 002A,E01025334,2004,1950,54,22,20,12,0
2021,Ribble Valley 003C,E01025335,1274,1215,59,20,24,15,0
2021,Ribble Valley 008D,E01025336,1089,1079,10,9,1,0,0
2021,Ribble Valley 008E,E01025337,1435,1426,9,5,4,0,0
2021,Ribble Valley 003D,E01025338,1499,1432,67,25,27,15,0
2021,Ribble Valley 003E,E01025339,2238,2205,33,20,9,2,2
2021,Ribble Valley 005B,E01025340,1380,1371,9,5,1,3,0
2021,Ribble Valley 005C,E01025341,1209,1203,6,5,1,0,0
2021,Ribble Valley 004D,E01025342,1494,1488,6,6,0,0,0
2021,Ribble Valley 005D,E01025343,1536,1527,9,5,4,0,0
2021,Ribble Valley 002B,E01025344,1285,1267,18,13,3,2,0
2021,Ribble Valley 002C,E01025345,1485,1467,18,9,6,3,0
2021,Ribble Valley 002D,E01025346,1433,1361,72,29,25,17,1
2021,Ribble Valley 002E,E01025347,1725,1675,50,13,25,9,3
2021,Ribble Valley 001D,E01025348,1562,1556,6,0,6,0,0
2021,Ribble Valley 001E,E01025349,1381,1379,2,1,1,0,0
2021,Ribble Valley 007D,E01025350,1576,1557,19,10,8,1,0
2021,Ribble Valley 007E,E01025351,2643,2613,30,16,8,6,0
2021,Ribble Valley 008F,E01025352,1454,1431,23,17,4,2,0
2021,Ribble Valley 005E,E01025354,2196,2185,11,5,1,5,0
2021,Rossendale 001A,E01025355,2336,2289,47,26,9,9,3
2021,Rossendale 004A,E01025356,1445,1359,86,13,35,33,5
2021,Rossendale 008A,E01025357,1308,1296,12,6,4,2,0
2021,Rossendale 008B,E01025358,2191,2175,16,6,2,5,3
2021,Rossendale 009A,E01025359,1690,1677,13,8,4,0,1
2021,Rossendale 009B,E01025360,1932,1921,11,5,6,0,0
2021,Rossendale 001B,E01025361,1966,1937,29,16,8,3,2
2021,Rossendale 001C,E01025362,1982,1970,12,6,2,3,1
2021,Rossendale 002A,E01025363,1334,1313,21,6,9,5,1
2021,Rossendale 002B,E01025364,1362,1327,35,12,13,10,0
2021,Rossendale 008C,E01025365,1412,1388,24,10,4,7,3
2021,Rossendale 002C,E01025366,1496,1347,149,38,67,35,9
2021,Rossendale 003A,E01025367,1799,1780,19,14,1,3,1
2021,Rossendale 003B,E01025368,1623,1612,11,6,4,0,1
2021,Rossendale 003C,E01025369,1279,1237,42,9,20,10,3
2021,Rossendale 010F,E01025370,1243,1233,10,7,2,1,0
2021,Rossendale 010A,E01025371,1365,1348,17,2,12,1,2
2021,Rossendale 004C,E01025373,1593,1545,48,18,15,10,5
2021,Rossendale 010B,E01025374,1411,1404,7,4,3,0,0
2021,Rossendale 009C,E01025375,1575,1553,22,9,9,3,1
2021,Rossendale 009D,E01025376,2388,2358,30,15,9,6,0
2021,Rossendale 007A,E01025377,1527,1515,12,8,2,2,0
2021,Rossendale 007B,E01025378,1518,1516,2,0,2,0,0
2021,Rossendale 007C,E01025379,1417,1392,25,10,11,4,0
2021,Rossendale 007D,E01025380,1479,1469,10,4,2,4,0
2021,Rossendale 003D,E01025381,1534,1492,42,14,13,13,2
2021,Rossendale 003E,E01025382,1697,1669,28,12,11,5,0
2021,Rossendale 003F,E01025383,2835,2805,30,17,8,5,0
2021,Rossendale 008D,E01025384,1209,1194,15,8,2,4,1
2021,Rossendale 004D,E01025385,1178,1160,18,8,8,2,0
2021,Rossendale 004F,E01025387,1812,1761,51,12,18,13,8
2021,Rossendale 010G,E01025388,1421,1408,13,7,5,0,1
2021,Rossendale 010H,E01025389,1377,1354,23,4,9,7,3
2021,Rossendale 010I,E01025390,1047,1037,10,3,1,4,2
2021,Rossendale 010C,E01025391,1489,1476,13,7,4,2,0
2021,Rossendale 010D,E01025392,1191,1181,10,2,5,3,0
2021,Rossendale 001D,E01025393,1385,1367,18,4,3,10,1
2021,Rossendale 010E,E01025394,1470,1452,18,8,7,3,0
2021,Rossendale 002D,E01025395,1525,1506,19,9,6,1,3
2021,Rossendale 002E,E01025396,1291,1207,84,31,19,29,5
2021,Rossendale 002F,E01025397,1658,1477,181,39,73,58,11
2021,Rossendale 002G,E01025398,1326,1207,119,32,49,34,4
2021,South Ribble 008A,E01025399,1372,1317,55,12,27,13,3
2021,South Ribble 008B,E01025400,2044,1996,48,20,19,5,4
2021,South Ribble 008C,E01025401,1540,1471,69,28,17,20,4
2021,South Ribble 008D,E01025402,1861,1791,70,23,31,16,0
2021,South Ribble 004A,E01025403,2117,2054,63,35,22,6,0
2021,South Ribble 007A,E01025404,1162,1148,14,9,2,3,0
2021,South Ribble 007B,E01025405,1196,1129,67,18,26,23,0
2021,South Ribble 007C,E01025406,1103,1066,37,15,17,4,1
2021,South Ribble 007D,E01025407,1840,1762,78,30,36,10,2
2021,South Ribble 003A,E01025408,1353,1336,17,6,5,6,0
2021,South Ribble 003B,E01025409,1245,1221,24,10,11,2,1
2021,South Ribble 003C,E01025410,1302,1281,21,13,6,1,1
2021,South Ribble 005A,E01025411,2129,2062,67,27,24,11,5
2021,South Ribble 006A,E01025412,1371,1334,37,16,9,6,6
2021,South Ribble 002A,E01025413,1632,1624,8,2,5,1,0
2021,South Ribble 002B,E01025414,1469,1461,8,5,2,1,0
2021,South Ribble 015A,E01025415,1917,1891,26,9,13,4,0
2021,South Ribble 014A,E01025416,1481,1459,22,9,7,6,0
2021,South Ribble 012A,E01025417,1448,1432,16,10,4,1,1
2021,South Ribble 012B,E01025418,1380,1356,24,8,10,4,2
2021,South Ribble 012C,E01025419,1506,1486,20,11,8,0,1
2021,South Ribble 013A,E01025421,2350,2286,64,34,20,8,2
2021,South Ribble 013B,E01025422,1363,1344,19,9,8,2,0
2021,South Ribble 015B,E01025423,1246,1195,51,16,21,13,1
2021,South Ribble 001A,E01025424,1253,1237,16,9,4,2,1
2021,South Ribble 001B,E01025425,1242,1225,17,8,6,3,0
2021,South Ribble 001C,E01025426,1209,1185,24,13,7,4,0
2021,South Ribble 006B,E01025427,1352,1311,41,15,20,5,1
2021,South Ribble 006C,E01025428,1457,1395,62,35,16,9,2
2021,South Ribble 006D,E01025429,1299,1240,59,31,21,7,0
2021,South Ribble 013C,E01025431,1896,1821,75,24,31,16,4
2021,South Ribble 013D,E01025433,1517,1507,10,3,4,1,2
2021,South Ribble 016C,E01025434,1792,1786,6,3,2,1,0
2021,South Ribble 015C,E01025435,1384,1365,19,7,7,4,1
2021,South Ribble 011A,E01025436,2233,2215,18,14,2,2,0
2021,South Ribble 011B,E01025437,1904,1876,28,14,8,5,1
2021,South Ribble 011C,E01025438,1295,1288,7,2,2,3,0
2021,South Ribble 010A,E01025439,1407,1403,4,1,3,0,0
2021,South Ribble 011D,E01025440,1313,1302,11,6,4,1,0
2021,South Ribble 011E,E01025441,1385,1371,14,4,5,4,1
2021,South Ribble 009A,E01025442,991,950,41,15,16,9,1
2021,South Ribble 009B,E01025443,1245,1225,20,8,8,3,1
2021,South Ribble 009C,E01025444,1203,1170,33,16,13,1,3
2021,South Ribble 017A,E01025445,1534,1472,62,24,15,20,3
2021,South Ribble 015D,E01025446,1390,1370,20,8,5,4,3
2021,South Ribble 017B,E01025447,1101,1055,46,19,14,12,1
2021,South Ribble 005B,E01025448,1494,1454,40,16,15,9,0
2021,South Ribble 014B,E01025451,1827,1808,19,10,6,3,0
2021,South Ribble 014C,E01025452,1617,1560,57,19,35,3,0
2021,South Ribble 010B,E01025453,1717,1703,14,9,3,2,0
2021,South Ribble 010C,E01025454,1272,1256,16,11,4,0,1
2021,South Ribble 010D,E01025455,1570,1554,16,9,3,4,0
2021,South Ribble 002C,E01025456,1154,1145,9,8,0,1,0
2021,South Ribble 004B,E01025457,1312,1278,34,12,12,8,2
2021,South Ribble 002D,E01025458,1547,1520,27,12,7,8,0
2021,South Ribble 017C,E01025459,1647,1627,20,5,11,4,0
2021,South Ribble 017D,E01025460,1839,1806,33,14,17,2,0
2021,South Ribble 009D,E01025461,1898,1859,39,17,15,5,2
2021,South Ribble 009E,E01025462,1962,1927,35,12,9,12,2
2021,South Ribble 004C,E01025463,1338,1306,32,16,9,2,5
2021,South Ribble 004D,E01025464,1186,1172,14,6,6,2,0
2021,South Ribble 004E,E01025465,995,957,38,22,11,5,0
2021,South Ribble 001D,E01025466,1496,1479,17,8,6,3,0
2021,South Ribble 003D,E01025467,1862,1832,30,16,9,5,0
2021,West Lancashire 009A,E01025468,1638,1605,33,18,12,3,0
2021,West Lancashire 009B,E01025469,1571,1510,61,25,29,6,1
2021,West Lancashire 009C,E01025470,1828,1795,33,15,11,6,1
2021,West Lancashire 010A,E01025471,1440,1306,134,46,62,23,3
2021,West Lancashire 012A,E01025472,1421,1412,9,7,1,1,0
2021,West Lancashire 012B,E01025473,1322,1310,12,6,6,0,0
2021,West Lancashire 003A,E01025474,1254,1248,6,1,3,1,1
2021,West Lancashire 012C,E01025475,1399,1385,14,13,1,0,0
2021,West Lancashire 012D,E01025476,1390,1381,9,6,3,0,0
2021,West Lancashire 012E,E01025477,1128,1119,9,8,0,1,0
2021,West Lancashire 012F,E01025478,1236,1226,10,7,1,2,0
2021,West Lancashire 008A,E01025479,2115,2078,37,25,6,6,0
2021,West Lancashire 010B,E01025480,1361,1239,122,35,56,23,8
2021,West Lancashire 010C,E01025481,1546,1393,153,51,59,40,3
2021,West Lancashire 010D,E01025482,1492,1336,156,53,67,28,8
2021,West Lancashire 004A,E01025483,2356,2329,27,9,13,5,0
2021,West Lancashire 004B,E01025484,2092,2065,27,7,10,8,2
2021,West Lancashire 004C,E01025485,1607,1588,19,7,6,3,3
2021,West Lancashire 004D,E01025486,1591,1569,22,9,11,2,0
2021,West Lancashire 004E,E01025487,1719,1697,22,13,5,3,1
2021,West Lancashire 007A,E01025488,2791,2725,66,31,30,4,1
2021,West Lancashire 007B,E01025489,1330,1303,27,11,12,4,0
2021,West Lancashire 007C,E01025490,2678,2642,36,35,1,0,0
2021,West Lancashire 008B,E01025491,2585,2554,31,28,1,2,0
2021,West Lancashire 013A,E01025492,1222,1182,40,16,17,5,2
2021,West Lancashire 014A,E01025493,1518,1256,262,80,118,51,13
2021,West Lancashire 014B,E01025494,1679,1406,273,74,113,78,8
2021,West Lancashire 003B,E01025495,2133,2119,14,8,3,3,0
2021,West Lancashire 001A,E01025496,1217,1167,50,22,20,8,0
2021,West Lancashire 001B,E01025497,1436,1422,14,6,4,4,0
2021,West Lancashire 001C,E01025498,1422,1387,35,10,17,5,3
2021,West Lancashire 006A,E01025499,1306,1270,36,18,11,5,2
2021,West Lancashire 007D,E01025500,1665,1643,22,16,5,1,0
2021,West Lancashire 006B,E01025501,1077,1068,9,4,4,1,0
2021,West Lancashire 006C,E01025502,1520,1502,18,8,4,5,1
2021,West Lancashire 014C,E01025503,1365,1186,179,56,72,43,8
2021,West Lancashire 014D,E01025504,1110,1004,106,24,51,25,6
2021,West Lancashire 014E,E01025505,1333,1272,61,25,19,16,1
2021,West Lancashire 008C,E01025506,1981,1965,16,4,7,3,2
2021,West Lancashire 002A,E01025507,1939,1888,51,23,20,7,1
2021,West Lancashire 002B,E01025508,1393,1356,37,13,19,4,1
2021,West Lancashire 002C,E01025509,1231,1196,35,15,15,5,0
2021,West Lancashire 005A,E01025510,1290,1275,15,8,4,3,0
2021,West Lancashire 005B,E01025511,1090,1076,14,12,2,0,0
2021,West Lancashire 005C,E01025512,1169,1150,19,5,12,1,1
2021,West Lancashire 002D,E01025513,2109,2100,9,5,4,0,0
2021,West Lancashire 003C,E01025514,2371,2337,34,22,10,1,1
2021,West Lancashire 003D,E01025515,1565,1556,9,4,5,0,0
2021,West Lancashire 006D,E01025516,1424,1412,12,7,4,1,0
2021,West Lancashire 006E,E01025517,2092,2058,34,22,7,5,0
2021,West Lancashire 007E,E01025518,1535,1513,22,15,5,2,0
2021,West Lancashire 006F,E01025519,1146,1128,18,10,6,2,0
2021,West Lancashire 010E,E01025520,1171,1107,64,24,27,11,2
2021,West Lancashire 010F,E01025521,1550,1453,97,31,44,21,1
2021,West Lancashire 009D,E01025522,1082,1049,33,8,17,8,0
2021,West Lancashire 011A,E01025523,1660,1602,58,16,25,16,1
2021,West Lancashire 011B,E01025524,1433,1308,125,40,56,21,8
2021,West Lancashire 011C,E01025525,1582,1533,49,14,23,8,4
2021,West Lancashire 011D,E01025526,1537,1492,45,18,14,8,5
2021,West Lancashire 013B,E01025527,1420,1282,138,35,59,43,1
2021,West Lancashire 013C,E01025528,1862,1698,164,44,94,24,2
2021,West Lancashire 013D,E01025529,1823,1680,143,50,67,25,1
2021,West Lancashire 001D,E01025530,1561,1530,31,8,18,3,2
2021,West Lancashire 002E,E01025531,1109,1086,23,6,8,9,0
2021,West Lancashire 001E,E01025532,1668,1642,26,11,9,4,2
2021,West Lancashire 001F,E01025533,1486,1383,103,28,41,29,5
2021,West Lancashire 015A,E01025534,1685,1670,15,6,2,5,2
2021,West Lancashire 015B,E01025535,1587,1555,32,11,15,5,1
2021,West Lancashire 015C,E01025536,1398,1372,26,15,9,2,0
2021,West Lancashire 015D,E01025537,1506,1486,20,13,3,3,1
2021,West Lancashire 005D,E01025538,1465,1451,14,8,3,3,0
2021,West Lancashire 005E,E01025539,1373,1358,15,8,5,2,0
2021,West Lancashire 015E,E01025540,1203,1195,8,4,0,1,3
2021,Wyre 011A,E01025541,2326,2298,28,7,11,9,1
2021,Wyre 010A,E01025542,1734,1720,14,7,3,4,0
2021,Wyre 011B,E01025543,1643,1626,17,8,5,4,0
2021,Wyre 011C,E01025544,1354,1342,12,3,6,2,1
2021,Wyre 013A,E01025545,2379,2332,47,30,13,4,0
2021,Wyre 013B,E01025546,1538,1519,19,12,4,1,2
2021,Wyre 006A,E01025547,2439,2405,34,19,12,3,0
2021,Wyre 007A,E01025548,1643,1637,6,4,0,2,0
2021,Wyre 006B,E01025549,2379,2351,28,21,4,3,0
2021,Wyre 012A,E01025550,1473,1467,6,2,3,1,0
2021,Wyre 013C,E01025551,1174,1156,18,10,6,1,1
2021,Wyre 012B,E01025552,1193,1185,8,6,2,0,0
2021,Wyre 007B,E01025553,2671,2651,20,11,9,0,0
2021,Wyre 008A,E01025554,1391,1379,12,9,3,0,0
2021,Wyre 010B,E01025555,1330,1320,10,5,4,1,0
2021,Wyre 008B,E01025556,1500,1485,15,6,9,0,0
2021,Wyre 005A,E01025557,1436,1426,10,6,1,2,1
2021,Wyre 007C,E01025558,1583,1574,9,5,4,0,0
2021,Wyre 007D,E01025559,1979,1957,22,10,8,4,0
2021,Wyre 007E,E01025560,1271,1250,21,8,8,5,0
2021,Wyre 009A,E01025561,1516,1509,7,5,2,0,0
2021,Wyre 009B,E01025562,2447,2437,10,5,3,1,1
2021,Wyre 004A,E01025563,1105,1091,14,10,2,2,0
2021,Wyre 004B,E01025564,1762,1751,11,9,2,0,0
2021,Wyre 004C,E01025565,1652,1647,5,5,0,0,0
2021,Wyre 014A,E01025566,1938,1924,14,5,5,4,0
2021,Wyre 013D,E01025567,1621,1600,21,14,3,3,1
2021,Wyre 014B,E01025568,1839,1801,38,20,15,3,0
2021,Wyre 014C,E01025569,1873,1855,18,9,6,3,0
2021,Wyre 008C,E01025570,1210,1189,21,7,12,2,0
2021,Wyre 008D,E01025571,1344,1312,32,13,2,7,10
2021,Wyre 008E,E01025572,1289,1284,5,3,2,0,0
2021,Wyre 001A,E01025573,1282,1277,5,1,4,0,0
2021,Wyre 001B,E01025574,1359,1292,67,15,31,18,3
2021,Wyre 005B,E01025575,1774,1729,45,17,13,15,0
2021,Wyre 011D,E01025576,2351,2323,28,14,12,1,1
2021,Wyre 011E,E01025577,1373,1367,6,3,1,1,1
2021,Wyre 005C,E01025578,1544,1513,31,10,16,4,1
2021,Wyre 005D,E01025579,1300,1268,32,10,13,9,0
2021,Wyre 005E,E01025580,1237,1228,9,6,3,0,0
2021,Wyre 001C,E01025581,1368,1334,34,6,15,10,3
2021,Wyre 001D,E01025582,1183,1108,75,17,27,30,1
2021,Wyre 001E,E01025583,1243,1193,50,15,23,11,1
2021,Wyre 001F,E01025584,1443,1369,74,11,23,27,13
2021,Wyre 009C,E01025585,2568,2559,9,3,3,1,2
2021,Wyre 004D,E01025586,1464,1461,3,1,1,1,0
2021,Wyre 004E,E01025587,1602,1592,10,6,2,1,1
2021,Wyre 004F,E01025588,1323,1310,13,7,6,0,0
2021,Wyre 004G,E01025589,1148,1142,6,6,0,0,0
2021,Wyre 003A,E01025590,1579,1564,15,8,3,4,0
2021,Wyre 003B,E01025591,1510,1502,8,7,1,0,0
2021,Wyre 003C,E01025592,1246,1225,21,5,9,5,2
2021,Wyre 003D,E01025593,1629,1561,68,23,36,7,2
2021,Wyre 012C,E01025594,1464,1455,9,4,3,1,1
2021,Wyre 012D,E01025595,1401,1392,9,6,3,0,0
2021,Wyre 012E,E01025596,2044,2037,7,1,5,1,0
2021,Wyre 012F,E01025597,1047,1041,6,3,3,0,0
2021,Wyre 013E,E01025598,1391,1369,22,11,6,4,1
2021,Wyre 014D,E01025599,1001,991,10,7,2,1,0
2021,Wyre 014E,E01025600,1462,1453,9,6,3,0,0
2021,Wyre 010C,E01025601,1390,1386,4,3,1,0,0
2021,Wyre 010D,E01025602,1585,1566,19,7,4,5,3
2021,Wyre 010E,E01025603,1371,1367,4,3,1,0,0
2021,Wyre 008F,E01025604,1392,1377,15,7,5,3,0
2021,Wyre 002A,E01025605,1372,1368,4,3,1,0,0
2021,Wyre 002B,E01025606,1267,1245,22,2,8,4,8
2021,Wyre 002C,E01025607,1508,1491,17,9,8,0,0
2021,Wyre 002D,E01025608,1549,1536,13,5,4,4,0
2021,Wyre 006C,E01025609,2268,2236,32,16,8,6,2
2021,Blaby 008A,E01025610,1529,1492,37,19,12,6,0
2021,Blaby 008B,E01025611,1535,1511,24,12,8,4,0
2021,Blaby 008C,E01025612,1995,1948,47,26,13,8,0
2021,Blaby 010A,E01025613,1474,1455,19,11,5,3,0
2021,Blaby 010B,E01025614,1569,1554,15,9,4,2,0
2021,Blaby 009A,E01025615,2265,2219,46,24,15,7,0
2021,Blaby 011A,E01025616,1956,1927,29,13,7,8,1
2021,Blaby 011B,E01025617,2043,2020,23,14,6,3,0
2021,Blaby 011C,E01025618,1626,1616,10,6,2,0,2
2021,Blaby 011D,E01025619,2132,2091,41,29,12,0,0
2021,Blaby 010C,E01025620,1178,1158,20,7,12,1,0
2021,Blaby 010D,E01025621,1264,1248,16,7,7,2,0
2021,Blaby 013A,E01025622,1658,1587,71,31,25,11,4
2021,Blaby 013B,E01025623,1683,1638,45,18,16,8,3
2021,Blaby 013C,E01025624,2429,2234,195,117,53,23,2
2021,Blaby 006A,E01025625,1185,1153,32,21,4,7,0
2021,Blaby 006B,E01025626,2396,2289,107,66,29,10,2
2021,Blaby 006C,E01025627,2340,2262,78,48,23,6,1
2021,Blaby 013D,E01025629,1535,1436,99,57,27,13,2
2021,Blaby 013E,E01025630,1795,1688,107,64,23,11,9
2021,Blaby 002A,E01025631,1487,1381,106,62,26,15,3
2021,Blaby 002B,E01025632,1328,1221,107,49,33,22,3
2021,Blaby 002C,E01025633,1795,1636,159,91,52,13,3
2021,Blaby 003A,E01025634,1944,1792,152,86,50,13,3
2021,Blaby 002D,E01025635,1229,1184,45,17,19,9,0
2021,Blaby 005A,E01025636,1304,1130,174,62,72,39,1
2021,Blaby 005B,E01025637,1297,1109,188,85,62,33,8
2021,Blaby 003B,E01025638,1443,1405,38,18,13,6,1
2021,Blaby 003C,E01025639,1266,1226,40,10,21,6,3
2021,Blaby 003D,E01025640,1555,1516,39,18,9,9,3
2021,Blaby 007A,E01025641,1861,1827,34,11,13,7,3
2021,Blaby 007B,E01025642,1794,1765,29,18,7,4,0
2021,Blaby 007C,E01025643,1590,1567,23,13,8,1,1
2021,Blaby 010E,E01025644,1708,1689,19,14,5,0,0
2021,Blaby 003E,E01025645,1130,1118,12,7,4,1,0
2021,Blaby 009B,E01025646,1567,1534,33,17,14,2,0
2021,Blaby 009C,E01025647,1484,1453,31,17,9,4,1
2021,Blaby 009D,E01025648,2033,1983,50,30,14,5,1
2021,Blaby 007D,E01025649,1788,1745,43,32,9,1,1
2021,Blaby 007E,E01025650,1402,1373,29,11,11,5,2
2021,Blaby 006D,E01025651,1505,1475,30,22,7,1,0
2021,Blaby 005C,E01025652,1318,1078,240,103,83,46,8
2021,Blaby 005D,E01025653,1559,1357,202,88,71,32,11
2021,Blaby 005E,E01025654,1263,1074,189,86,68,31,4
2021,Blaby 005F,E01025655,1620,1239,381,158,127,73,23
2021,Blaby 005G,E01025656,1308,951,357,166,141,36,14
2021,Blaby 006E,E01025657,1913,1855,58,24,23,9,2
2021,Blaby 008D,E01025658,1735,1674,61,33,18,10,0
2021,Blaby 008E,E01025659,1853,1790,63,32,21,7,3
2021,Blaby 006F,E01025660,1624,1546,78,43,22,10,3
2021,Blaby 012A,E01025661,2369,2351,18,10,8,0,0
2021,Blaby 012B,E01025662,1882,1841,41,27,12,2,0
2021,Blaby 012C,E01025663,1534,1508,26,8,14,4,0
2021,Blaby 012D,E01025664,1339,1320,19,8,5,6,0
2021,Blaby 012E,E01025665,1800,1771,29,18,8,3,0
2021,Blaby 004A,E01025666,1505,1375,130,54,53,21,2
2021,Blaby 004B,E01025667,1196,1096,100,42,42,12,4
2021,Blaby 004C,E01025668,2193,1846,347,158,142,39,8
2021,Blaby 004D,E01025669,2095,1685,410,190,144,67,9
2021,Charnwood 022A,E01025670,1240,1222,18,10,7,1,0
2021,Charnwood 022B,E01025671,2279,2225,54,36,14,4,0
2021,Charnwood 022C,E01025672,2222,2194,28,18,6,3,1
2021,Charnwood 022D,E01025673,1689,1600,89,50,23,13,3
2021,Charnwood 011A,E01025674,1844,1822,22,14,5,2,1
2021,Charnwood 011B,E01025675,1453,1439,14,12,2,0,0
2021,Charnwood 011C,E01025676,2418,2385,33,14,12,6,1
2021,Charnwood 011D,E01025677,1426,1411,15,9,3,3,0
2021,Charnwood 020A,E01025678,1700,1559,141,74,44,19,4
2021,Charnwood 019B,E01025680,1594,1418,176,89,61,25,1
2021,Charnwood 019C,E01025681,1693,1547,146,67,46,25,8
2021,Charnwood 019D,E01025682,1398,1295,103,48,33,22,0
2021,Charnwood 020B,E01025683,1594,1496,98,48,34,14,2
2021,Charnwood 020C,E01025684,1810,1687,123,63,45,10,5
2021,Charnwood 015A,E01025685,1273,1265,8,4,2,1,1
2021,Charnwood 015B,E01025686,1523,1506,17,12,5,0,0
2021,Charnwood 016A,E01025687,1577,1551,26,17,8,1,0
2021,Charnwood 016B,E01025688,1692,1652,40,34,5,1,0
2021,Charnwood 007A,E01025689,3027,2704,323,192,91,36,4
2021,Charnwood 007B,E01025690,4213,3827,386,267,98,18,3
2021,Charnwood 001B,E01025692,1964,1825,139,68,50,20,1
2021,Charnwood 001C,E01025693,2274,2231,43,22,18,3,0
2021,Charnwood 004A,E01025695,1390,1278,112,73,29,9,1
2021,Charnwood 004B,E01025696,1276,1168,108,46,39,18,5
2021,Charnwood 004C,E01025697,1296,1179,117,61,40,13,3
2021,Charnwood 004D,E01025698,1434,1291,143,71,57,12,3
2021,Charnwood 002A,E01025699,1462,1134,328,105,143,71,9
2021,Charnwood 002B,E01025700,2139,1682,457,142,181,109,25
2021,Charnwood 002C,E01025701,1636,1343,293,113,110,60,10
2021,Charnwood 009A,E01025702,1154,1057,97,43,36,17,1
2021,Charnwood 002D,E01025703,2024,1604,420,168,165,75,12
2021,Charnwood 002E,E01025704,1618,1448,170,70,68,30,2
2021,Charnwood 002F,E01025705,1562,1231,331,117,143,64,7
2021,Charnwood 002G,E01025706,1795,1414,381,130,151,86,14
2021,Charnwood 007C,E01025707,1604,1406,198,133,52,12,1
2021,Charnwood 010A,E01025708,1273,1153,120,75,36,9,0
2021,Charnwood 007D,E01025709,2271,2125,146,90,46,8,2
2021,Charnwood 010B,E01025710,1206,1143,63,33,18,3,9
2021,Charnwood 010C,E01025711,1425,1375,50,25,19,4,2
2021,Charnwood 010D,E01025712,1468,1401,67,31,19,11,6
2021,Charnwood 010E,E01025713,1463,1376,87,62,18,5,2
2021,Charnwood 009B,E01025715,1540,1402,138,57,54,22,5
2021,Charnwood 009C,E01025716,1539,1450,89,44,25,15,5
2021,Charnwood 009E,E01025718,1436,1189,247,100,113,33,1
2021,Charnwood 009F,E01025719,1527,1448,79,55,17,6,1
2021,Charnwood 003A,E01025720,2533,2129,404,166,189,46,3
2021,Charnwood 003B,E01025721,2047,1863,184,116,51,17,0
2021,Charnwood 003C,E01025722,1073,984,89,41,29,17,2
2021,Charnwood 003D,E01025723,2368,2151,217,103,74,36,4
2021,Charnwood 003E,E01025724,1818,1615,203,98,67,32,6
2021,Charnwood 003F,E01025725,1246,1107,139,58,60,17,4
2021,Charnwood 014A,E01025726,1843,1819,24,11,10,3,0
2021,Charnwood 014B,E01025727,1518,1491,27,19,6,2,0
2021,Charnwood 014C,E01025728,1954,1929,25,17,5,3,0
2021,Charnwood 014D,E01025729,1477,1463,14,5,6,3,0
2021,Charnwood 015C,E01025730,2839,2641,198,107,71,20,0
2021,Charnwood 015D,E01025731,1792,1741,51,33,10,8,0
2021,Charnwood 012A,E01025732,1846,1791,55,27,19,7,2
2021,Charnwood 012B,E01025733,1761,1731,30,16,11,3,0
2021,Charnwood 012C,E01025734,1672,1663,9,5,3,1,0
2021,Charnwood 012D,E01025735,1815,1770,45,17,20,5,3
2021,Charnwood 016C,E01025736,1397,1372,25,14,7,4,0
2021,Charnwood 014E,E01025737,2774,2722,52,38,11,3,0
2021,Charnwood 016D,E01025738,1539,1508,31,20,4,7,0
2021,Charnwood 014F,E01025739,2231,2204,27,13,10,4,0
2021,Charnwood 006A,E01025740,1461,1419,42,23,13,3,3
2021,Charnwood 006B,E01025741,1413,1395,18,10,6,1,1
2021,Charnwood 006C,E01025742,1636,1585,51,33,13,5,0
2021,Charnwood 006D,E01025743,2243,2195,48,32,11,5,0
2021,Charnwood 005A,E01025744,2575,2546,29,14,10,3,2
2021,Charnwood 005B,E01025745,1395,1377,18,13,4,1,0
2021,Charnwood 005C,E01025746,1939,1894,45,22,19,3,1
2021,Charnwood 005D,E01025747,1741,1703,38,23,5,6,4
2021,Charnwood 013A,E01025748,2071,2028,43,22,17,4,0
2021,Charnwood 013B,E01025749,2140,2093,47,22,12,9,4
2021,Charnwood 013C,E01025750,1837,1809,28,13,7,4,4
2021,Charnwood 013D,E01025751,2069,2040,29,13,11,5,0
2021,Charnwood 018A,E01025752,2848,2767,81,39,26,14,2
2021,Charnwood 018B,E01025753,1585,1553,32,11,14,5,2
2021,Charnwood 018C,E01025754,1183,1152,31,11,14,5,1
2021,Charnwood 018D,E01025755,1414,1373,41,20,14,5,2
2021,Charnwood 017A,E01025756,1818,1718,100,51,31,12,6
2021,Charnwood 017B,E01025757,1280,1148,132,88,34,10,0
2021,Charnwood 017C,E01025758,1657,1505,152,86,47,19,0
2021,Charnwood 017D,E01025759,1377,1315,62,28,23,11,0
2021,Charnwood 008A,E01025760,1328,1314,14,11,2,1,0
2021,Charnwood 008B,E01025761,1856,1838,18,14,4,0,0
2021,Charnwood 021A,E01025762,1543,1355,188,94,52,36,6
2021,Charnwood 021B,E01025763,1664,1402,262,124,88,43,7
2021,Charnwood 021C,E01025764,1375,1087,288,141,83,50,14
2021,Charnwood 021D,E01025765,1480,1103,377,172,131,63,11
2021,Charnwood 021E,E01025766,1996,1830,166,76,62,26,2
2021,Charnwood 021F,E01025767,1521,1348,173,81,57,28,7
2021,Charnwood 008C,E01025768,1432,1423,9,3,3,2,1
2021,Charnwood 008D,E01025769,1524,1481,43,23,17,3,0
2021,Harborough 002A,E01025770,1795,1778,17,14,3,0,0
2021,Harborough 004A,E01025772,2181,2157,24,12,9,3,0
2021,Harborough 004B,E01025773,1535,1518,17,8,3,6,0
2021,Harborough 004C,E01025774,1613,1589,24,15,7,2,0
2021,Harborough 004D,E01025775,2125,2110,15,10,3,1,1
2021,Harborough 004E,E01025776,1908,1899,9,3,2,3,1
2021,Harborough 006A,E01025777,2286,2272,14,10,4,0,0
2021,Harborough 005B,E01025778,1934,1868,66,54,8,4,0
2021,Harborough 005C,E01025779,1429,1408,21,17,3,1,0
2021,Harborough 005D,E01025780,1433,1414,19,13,3,3,0
2021,Harborough 003A,E01025781,1674,1555,119,69,28,17,5
2021,Harborough 003B,E01025782,1346,1304,42,26,11,5,0
2021,Harborough 003C,E01025783,2268,2148,120,80,34,5,1
2021,Harborough 005E,E01025784,1375,1359,16,8,2,4,2
2021,Harborough 003E,E01025786,2198,2161,37,25,9,2,1
2021,Harborough 003F,E01025787,1616,1597,19,13,3,2,1
2021,Harborough 005F,E01025788,1301,1281,20,15,3,2,0
2021,Harborough 007A,E01025789,1983,1900,83,45,23,15,0
2021,Harborough 010A,E01025790,2485,2429,56,29,22,4,1
2021,Harborough 010B,E01025791,2845,2715,130,65,48,17,0
2021,Harborough 010C,E01025792,2122,2051,71,37,27,7,0
2021,Harborough 007B,E01025794,1804,1774,30,18,11,1,0
2021,Harborough 008A,E01025795,1769,1679,90,41,40,9,0
2021,Harborough 008B,E01025796,1917,1869,48,26,16,6,0
2021,Harborough 007C,E01025797,2091,2049,42,22,7,10,3
2021,Harborough 009A,E01025798,2261,2183,78,37,33,7,1
2021,Harborough 009B,E01025799,2221,2176,45,33,10,1,1
2021,Harborough 009C,E01025800,1368,1312,56,31,18,7,0
2021,Harborough 008C,E01025801,1190,1134,56,33,17,5,1
2021,Harborough 007D,E01025802,1318,1288,30,19,7,4,0
2021,Harborough 007E,E01025803,1696,1679,17,16,1,0,0
2021,Harborough 009D,E01025804,1925,1864,61,35,23,3,0
2021,Harborough 008D,E01025806,1528,1474,54,27,17,10,0
2021,Harborough 009E,E01025807,1335,1294,41,18,16,5,2
2021,Harborough 006B,E01025808,2893,2844,49,25,16,5,3
2021,Harborough 002B,E01025809,2335,2322,13,8,4,1,0
2021,Harborough 006C,E01025810,2296,2269,27,12,11,4,0
2021,Harborough 011A,E01025812,1702,1581,121,46,51,21,3
2021,Harborough 011B,E01025813,2029,1813,216,116,56,38,6
2021,Harborough 011C,E01025814,1689,1609,80,46,20,14,0
2021,Harborough 002C,E01025815,2161,2137,24,15,6,3,0
2021,Harborough 006D,E01025816,2493,2467,26,17,5,2,2
2021,Hinckley and Bosworth 008A,E01025817,2214,2191,23,12,7,4,0
2021,Hinckley and Bosworth 008B,E01025818,1483,1438,45,27,13,5,0
2021,Hinckley and Bosworth 004A,E01025819,1634,1624,10,4,4,2,0
2021,Hinckley and Bosworth 004B,E01025820,1536,1529,7,4,1,2,0
2021,Hinckley and Bosworth 007A,E01025821,1672,1624,48,19,22,7,0
2021,Hinckley and Bosworth 007B,E01025822,1467,1419,48,19,19,9,1
2021,Hinckley and Bosworth 007C,E01025823,1568,1518,50,20,28,2,0
2021,Hinckley and Bosworth 007D,E01025824,1451,1424,27,11,12,3,1
2021,Hinckley and Bosworth 007E,E01025825,1379,1359,20,12,4,4,0
2021,Hinckley and Bosworth 007F,E01025826,1344,1315,29,11,13,4,1
2021,Hinckley and Bosworth 013A,E01025827,1388,1365,23,13,4,6,0
2021,Hinckley and Bosworth 013B,E01025828,1488,1471,17,4,10,1,2
2021,Hinckley and Bosworth 013C,E01025829,1502,1459,43,19,20,3,1
2021,Hinckley and Bosworth 013D,E01025830,1533,1489,44,28,11,4,1
2021,Hinckley and Bosworth 014A,E01025831,1216,1197,19,8,8,3,0
2021,Hinckley and Bosworth 014B,E01025832,1868,1816,52,26,18,7,1
2021,Hinckley and Bosworth 014C,E01025833,1995,1953,42,12,20,9,1
2021,Hinckley and Bosworth 014D,E01025834,1504,1483,21,17,4,0,0
2021,Hinckley and Bosworth 014E,E01025835,2433,2363,70,35,23,8,4
2021,Hinckley and Bosworth 014F,E01025836,1151,1138,13,10,3,0,0
2021,Hinckley and Bosworth 004C,E01025837,2108,2087,21,11,6,3,1
2021,Hinckley and Bosworth 004D,E01025838,1488,1476,12,4,7,1,0
2021,Hinckley and Bosworth 006A,E01025839,1590,1539,51,24,15,11,1
2021,Hinckley and Bosworth 006B,E01025840,1625,1576,49,24,18,7,0
2021,Hinckley and Bosworth 006C,E01025841,1862,1834,28,14,11,3,0
2021,Hinckley and Bosworth 006D,E01025842,1895,1840,55,35,11,8,1
2021,Hinckley and Bosworth 006E,E01025843,1746,1696,50,23,21,6,0
2021,Hinckley and Bosworth 006F,E01025844,1578,1515,63,27,25,11,0
2021,Hinckley and Bosworth 003A,E01025845,1453,1415,38,21,9,7,1
2021,Hinckley and Bosworth 002A,E01025846,2035,1993,42,26,12,3,1
2021,Hinckley and Bosworth 002B,E01025847,1606,1523,83,46,20,11,6
2021,Hinckley and Bosworth 002C,E01025848,1529,1492,37,22,10,5,0
2021,Hinckley and Bosworth 012A,E01025849,2087,1920,167,62,70,33,2
2021,Hinckley and Bosworth 010A,E01025850,1464,1399,65,41,17,7,0
2021,Hinckley and Bosworth 012B,E01025851,1317,1268,49,21,14,10,4
2021,Hinckley and Bosworth 010B,E01025852,1918,1703,215,75,99,32,9
2021,Hinckley and Bosworth 011B,E01025854,2104,2034,70,25,36,8,1
2021,Hinckley and Bosworth 011C,E01025855,1366,1318,48,24,20,4,0
2021,Hinckley and Bosworth 012C,E01025856,1239,1166,73,38,17,15,3
2021,Hinckley and Bosworth 012D,E01025857,1375,1335,40,21,12,4,3
2021,Hinckley and Bosworth 010C,E01025858,2124,1971,153,59,67,25,2
2021,Hinckley and Bosworth 009A,E01025859,1541,1506,35,19,9,5,2
2021,Hinckley and Bosworth 009B,E01025860,1327,1301,26,14,9,3,0
2021,Hinckley and Bosworth 009C,E01025861,1736,1660,76,30,33,12,1
2021,Hinckley and Bosworth 009D,E01025862,1859,1823,36,19,6,10,1
2021,Hinckley and Bosworth 010D,E01025863,1639,1580,59,40,16,1,2
2021,Hinckley and Bosworth 008C,E01025864,2213,2126,87,51,22,14,0
2021,Hinckley and Bosworth 010E,E01025865,1691,1640,51,22,22,6,1
2021,Hinckley and Bosworth 011D,E01025866,1811,1715,96,35,34,26,1
2021,Hinckley and Bosworth 011E,E01025867,1416,1356,60,17,32,11,0
2021,Hinckley and Bosworth 001A,E01025868,1375,1359,16,7,5,4,0
2021,Hinckley and Bosworth 001B,E01025869,1396,1363,33,18,10,4,1
2021,Hinckley and Bosworth 001C,E01025870,1629,1585,44,27,8,6,3
2021,Hinckley and Bosworth 001D,E01025871,1470,1443,27,17,4,3,3
2021,Hinckley and Bosworth 005A,E01025872,1430,1424,6,3,2,0,1
2021,Hinckley and Bosworth 005B,E01025873,1524,1502,22,8,12,2,0
2021,Hinckley and Bosworth 005C,E01025874,2019,1988,31,15,12,4,0
2021,Hinckley and Bosworth 005D,E01025875,1739,1700,39,18,15,6,0
2021,Hinckley and Bosworth 005E,E01025876,1938,1879,59,37,14,7,1
2021,Hinckley and Bosworth 003B,E01025877,1642,1621,21,16,4,0,1
2021,Hinckley and Bosworth 003C,E01025879,1158,1133,25,19,5,1,0
2021,Hinckley and Bosworth 003D,E01025880,1627,1619,8,6,2,0,0
2021,Hinckley and Bosworth 008D,E01025881,1346,1336,10,4,3,3,0
2021,Hinckley and Bosworth 004E,E01025882,1697,1677,20,9,8,3,0
2021,Melton 003A,E01025883,1816,1790,26,12,9,4,1
2021,Melton 003B,E01025884,1662,1639,23,16,6,0,1
2021,Melton 001A,E01025885,1941,1925,16,12,2,2,0
2021,Melton 001B,E01025886,1686,1669,17,11,5,1,0
2021,Melton 001C,E01025887,1785,1761,24,14,9,1,0
2021,Melton 003C,E01025888,1847,1824,23,12,7,4,0
2021,Melton 006A,E01025889,1673,1661,12,7,1,2,2
2021,Melton 001D,E01025890,1310,1300,10,4,5,1,0
2021,Melton 001E,E01025891,1208,1204,4,3,1,0,0
2021,Melton 001F,E01025892,1607,1594,13,7,4,2,0
2021,Melton 005A,E01025893,1860,1803,57,23,20,14,0
2021,Melton 005B,E01025894,1565,1443,122,55,43,23,1
2021,Melton 005C,E01025895,1609,1484,125,50,55,19,1
2021,Melton 004A,E01025896,1605,1547,58,27,18,10,3
2021,Melton 004B,E01025897,2120,1979,141,48,77,13,3
2021,Melton 004C,E01025898,1280,1223,57,22,23,10,2
2021,Melton 004D,E01025899,1268,1186,82,26,44,12,0
2021,Melton 004E,E01025900,1415,1336,79,23,38,16,2
2021,Melton 002A,E01025901,1970,1906,64,28,27,9,0
2021,Melton 002B,E01025902,1535,1500,35,15,13,5,2
2021,Melton 002C,E01025903,1721,1627,94,46,40,7,1
2021,Melton 002D,E01025904,2155,2122,33,19,12,2,0
2021,Melton 004F,E01025905,1579,1480,99,39,44,15,1
2021,Melton 002E,E01025906,1629,1598,31,20,11,0,0
2021,Melton 005D,E01025907,1798,1706,92,31,41,19,1
2021,Melton 005E,E01025908,1760,1717,43,15,19,6,3
2021,Melton 003D,E01025909,1898,1890,8,5,1,2,0
2021,Melton 006B,E01025910,1773,1754,19,15,2,1,1
2021,Melton 006C,E01025911,1760,1743,17,11,4,2,0
2021,Melton 006D,E01025912,1536,1523,13,5,5,3,0
2021,North West Leicestershire 012A,E01025913,2408,2392,16,12,4,0,0
2021,North West Leicestershire 006A,E01025914,1267,1259,8,6,0,1,1
2021,North West Leicestershire 003A,E01025915,1171,1143,28,13,10,5,0
2021,North West Leicestershire 003B,E01025916,1682,1638,44,30,6,8,0
2021,North West Leicestershire 003D,E01025918,1626,1598,28,16,10,2,0
2021,North West Leicestershire 006B,E01025919,1471,1452,19,8,9,2,0
2021,North West Leicestershire 006C,E01025920,1930,1897,33,26,7,0,0
2021,North West Leicestershire 006D,E01025921,1963,1933,30,14,10,5,1
2021,North West Leicestershire 002A,E01025923,1390,1379,11,6,5,0,0
2021,North West Leicestershire 001A,E01025924,1070,1057,13,13,0,0,0
2021,North West Leicestershire 001C,E01025926,2510,2450,60,33,21,5,1
2021,North West Leicestershire 001D,E01025927,1563,1528,35,12,20,3,0
2021,North West Leicestershire 001E,E01025928,1398,1376,22,14,2,4,2
2021,North West Leicestershire 010A,E01025929,1866,1765,101,36,37,26,2
2021,North West Leicestershire 010B,E01025930,1762,1518,244,64,93,72,15
2021,North West Leicestershire 010C,E01025931,1837,1670,167,41,86,38,2
2021,North West Leicestershire 009A,E01025932,1464,1365,99,37,41,19,2
2021,North West Leicestershire 009B,E01025933,1282,1229,53,31,16,5,1
2021,North West Leicestershire 009C,E01025934,1894,1787,107,53,39,14,1
2021,North West Leicestershire 009D,E01025935,1152,1142,10,7,3,0,0
2021,North West Leicestershire 009E,E01025936,1198,1167,31,15,10,6,0
2021,North West Leicestershire 011B,E01025937,2227,2136,91,42,41,7,1
2021,North West Leicestershire 013A,E01025938,1171,1157,14,3,8,3,0
2021,North West Leicestershire 013B,E01025939,2068,2018,50,22,19,9,0
2021,North West Leicestershire 013C,E01025940,1934,1919,15,11,4,0,0
2021,North West Leicestershire 013D,E01025941,1914,1888,26,11,12,3,0
2021,North West Leicestershire 013E,E01025942,2721,2676,45,29,13,2,1
2021,North West Leicestershire 013F,E01025943,1766,1720,46,18,18,9,1
2021,North West Leicestershire 002B,E01025944,1658,1619,39,26,11,1,1
2021,North West Leicestershire 002C,E01025945,1686,1628,58,40,15,2,1
2021,North West Leicestershire 002D,E01025946,1968,1875,93,68,18,5,2
2021,North West Leicestershire 012B,E01025947,2009,1974,35,13,14,7,1
2021,North West Leicestershire 012C,E01025948,1677,1627,50,19,22,9,0
2021,North West Leicestershire 012D,E01025949,1515,1367,148,51,59,37,1
2021,North West Leicestershire 008A,E01025950,2038,1989,49,16,25,8,0
2021,North West Leicestershire 008B,E01025951,1991,1972,19,11,4,4,0
2021,North West Leicestershire 008C,E01025952,1619,1610,9,5,1,3,0
2021,North West Leicestershire 008D,E01025953,1333,1324,9,7,2,0,0
2021,North West Leicestershire 008E,E01025954,1487,1473,14,5,7,2,0
2021,North West Leicestershire 005A,E01025955,1842,1818,24,14,6,3,1
2021,North West Leicestershire 005B,E01025956,1241,1208,33,18,10,4,1
2021,North West Leicestershire 010D,E01025957,2114,1904,210,64,99,40,7
2021,North West Leicestershire 011C,E01025958,2129,2035,94,25,42,24,3
2021,North West Leicestershire 011D,E01025959,2490,2435,55,21,23,11,0
2021,North West Leicestershire 004A,E01025960,1415,1384,31,8,15,7,1
2021,North West Leicestershire 004B,E01025961,1387,1366,21,8,9,4,0
2021,North West Leicestershire 004C,E01025962,1614,1575,39,15,19,5,0
2021,North West Leicestershire 005C,E01025963,1603,1584,19,10,8,1,0
2021,North West Leicestershire 005D,E01025964,1620,1599,21,11,8,2,0
2021,North West Leicestershire 004D,E01025965,1240,1216,24,15,7,2,0
2021,North West Leicestershire 007A,E01025966,1425,1387,38,22,9,6,1
2021,North West Leicestershire 007B,E01025967,1519,1507,12,2,7,3,0
2021,North West Leicestershire 007C,E01025968,1784,1766,18,10,5,3,0
2021,North West Leicestershire 007D,E01025969,1650,1603,47,21,19,7,0
2021,Oadby and Wigston 003A,E01025970,1669,1374,295,171,76,43,5
2021,Oadby and Wigston 003B,E01025971,1196,978,218,136,58,19,5
2021,Oadby and Wigston 003C,E01025972,1293,1082,211,112,75,24,0
2021,Oadby and Wigston 010C,E01025973,2550,2247,303,176,95,25,7
2021,Oadby and Wigston 010A,E01025974,1997,1761,236,127,57,38,14
2021,Oadby and Wigston 010D,E01025975,1374,1125,249,153,55,34,7
2021,Oadby and Wigston 003D,E01025976,1333,1159,174,75,63,32,4
2021,Oadby and Wigston 003E,E01025977,1498,1305,193,88,66,33,6
2021,Oadby and Wigston 003F,E01025978,1606,1404,202,89,57,48,8
2021,Oadby and Wigston 011C,E01025979,1363,1216,147,81,42,19,5
2021,Oadby and Wigston 010B,E01025980,1360,1068,292,150,91,47,4
2021,Oadby and Wigston 011E,E01025981,1658,1387,271,129,88,44,10
2021,Oadby and Wigston 011B,E01025982,1917,1575,342,237,73,26,6
2021,Oadby and Wigston 011D,E01025983,1225,1018,207,119,64,20,4
2021,Oadby and Wigston 011A,E01025984,1369,1116,253,140,64,48,1
2021,Oadby and Wigston 006A,E01025985,1227,1204,23,11,8,3,1
2021,Oadby and Wigston 006B,E01025986,1502,1427,75,29,29,9,8
2021,Oadby and Wigston 006C,E01025987,1601,1511,90,35,34,20,1
2021,Oadby and Wigston 006D,E01025988,1800,1677,123,70,37,11,5
2021,Oadby and Wigston 006E,E01025989,1695,1640,55,20,24,10,1
2021,Oadby and Wigston 007A,E01025990,1286,1251,35,17,12,3,3
2021,Oadby and Wigston 007B,E01025991,1385,1346,39,13,18,8,0
2021,Oadby and Wigston 005A,E01025992,1682,1630,52,27,15,10,0
2021,Oadby and Wigston 007C,E01025993,1388,1332,56,30,20,5,1
2021,Oadby and Wigston 005B,E01025994,1687,1600,87,39,34,11,3
2021,Oadby and Wigston 008A,E01025995,1498,1231,267,120,90,52,5
2021,Oadby and Wigston 005C,E01025997,1548,1422,126,63,47,11,5
2021,Oadby and Wigston 007D,E01025998,2160,2043,117,64,34,13,6
2021,Oadby and Wigston 005D,E01025999,1419,1332,87,36,42,7,2
2021,Oadby and Wigston 007E,E01026000,1200,1141,59,32,17,9,1
2021,Oadby and Wigston 007F,E01026001,1343,1303,40,25,10,5,0
2021,Oadby and Wigston 008B,E01026003,1586,1457,129,56,49,19,5
2021,Oadby and Wigston 008C,E01026004,1750,1609,141,74,45,17,5
2021,Oadby and Wigston 005E,E01026005,1645,1513,132,65,44,17,6
2021,Boston 001A,E01026007,1094,1072,22,12,10,0,0
2021,Boston 001B,E01026008,1588,1537,51,21,17,11,2
2021,Boston 001C,E01026009,1201,1159,42,17,19,4,2
2021,Boston 002A,E01026010,1755,976,779,206,299,231,43
2021,Boston 004A,E01026012,1108,963,145,50,63,27,5
2021,Boston 008A,E01026013,1425,1303,122,51,36,27,8
2021,Boston 008B,E01026014,1892,1694,198,69,80,42,7
2021,Boston 004B,E01026015,1611,1198,413,120,201,78,14
2021,Boston 006A,E01026016,2388,2316,72,29,25,14,4
2021,Boston 007A,E01026017,1604,1540,64,22,23,13,6
2021,Boston 007B,E01026018,1697,1623,74,34,27,13,0
2021,Boston 007C,E01026019,2714,2320,394,133,165,87,9
2021,Boston 007D,E01026020,2813,2485,328,104,132,79,13
2021,Boston 003B,E01026021,1726,1310,416,183,140,64,29
2021,Boston 008C,E01026022,2253,1813,440,230,129,75,6
2021,Boston 001D,E01026023,1349,1265,84,22,32,27,3
2021,Boston 001E,E01026024,2182,2045,137,55,51,27,4
2021,Boston 003C,E01026025,2332,1251,1081,273,432,338,38
2021,Boston 004C,E01026026,2206,1715,491,167,159,144,21
2021,Boston 004D,E01026027,1824,1320,504,138,210,117,39
2021,Boston 004E,E01026028,1834,1390,444,122,164,133,25
2021,Boston 002C,E01026030,2502,1529,973,247,355,306,65
2021,Boston 009B,E01026031,1607,1301,306,107,126,64,9
2021,Boston 002D,E01026032,1880,932,948,195,340,328,85
2021,Boston 006B,E01026033,2317,2241,76,26,24,26,0
2021,Boston 006C,E01026034,1814,1742,72,23,25,15,9
2021,Boston 009C,E01026035,2452,2187,265,109,102,46,8
2021,Boston 003D,E01026036,1542,887,655,132,266,210,47
2021,Boston 002E,E01026037,1549,1025,524,149,203,146,26
2021,Boston 008D,E01026038,1398,1136,262,95,93,70,4
2021,Boston 009D,E01026039,1164,1064,100,40,38,18,4
2021,Boston 008E,E01026040,1629,1411,218,95,87,32,4
2021,Boston 007E,E01026041,1332,1212,120,46,51,21,2
2021,East Lindsey 008A,E01026042,1676,1636,40,15,8,14,3
2021,East Lindsey 008B,E01026043,1758,1740,18,4,8,6,0
2021,East Lindsey 008C,E01026044,1357,1347,10,3,7,0,0
2021,East Lindsey 001A,E01026045,1854,1848,6,6,0,0,0
2021,East Lindsey 013A,E01026046,1302,1292,10,1,7,2,0
2021,East Lindsey 013B,E01026047,1251,1241,10,5,5,0,0
2021,East Lindsey 010A,E01026048,1561,1547,14,0,9,4,1
2021,East Lindsey 010B,E01026049,1540,1531,9,6,1,2,0
2021,East Lindsey 010C,E01026050,1574,1566,8,1,1,5,1
2021,East Lindsey 016A,E01026051,1352,1340,12,5,6,1,0
2021,East Lindsey 016B,E01026052,2417,2389,28,14,5,9,0
2021,East Lindsey 016C,E01026053,1923,1888,35,14,9,10,2
2021,East Lindsey 016D,E01026054,1583,1556,27,13,7,7,0
2021,East Lindsey 013C,E01026055,1125,1123,2,2,0,0,0
2021,East Lindsey 017A,E01026056,1245,1239,6,4,1,0,1
2021,East Lindsey 018A,E01026057,1915,1887,28,6,8,14,0
2021,East Lindsey 002A,E01026058,2264,2255,9,5,3,0,1
2021,East Lindsey 013D,E01026059,1189,1184,5,1,3,1,0
2021,East Lindsey 009A,E01026060,1270,1264,6,5,0,1,0
2021,East Lindsey 001B,E01026061,1091,1088,3,2,1,0,0
2021,East Lindsey 001C,E01026062,1125,1100,25,10,13,2,0
2021,East Lindsey 001D,E01026063,1510,1500,10,5,3,2,0
2021,East Lindsey 011A,E01026064,1583,1564,19,7,9,3,0
2021,East Lindsey 011B,E01026065,1881,1847,34,17,10,6,1
2021,East Lindsey 011C,E01026066,2034,2020,14,10,4,0,0
2021,East Lindsey 011D,E01026067,1847,1826,21,11,7,2,1
2021,East Lindsey 009B,E01026068,2069,2047,22,7,9,5,1
2021,East Lindsey 010D,E01026069,2235,2151,84,36,36,12,0
2021,East Lindsey 009C,E01026070,2136,2117,19,13,6,0,0
2021,East Lindsey 007A,E01026071,2065,2058,7,3,3,1,0
2021,East Lindsey 005A,E01026072,2272,2255,17,6,7,3,1
2021,East Lindsey 005B,E01026073,1910,1883,27,6,8,13,0
2021,East Lindsey 005C,E01026074,2119,2102,17,3,7,7,0
2021,East Lindsey 018B,E01026075,2141,2127,14,7,6,1,0
2021,East Lindsey 002B,E01026076,2231,2209,22,16,3,2,1
2021,East Lindsey 003A,E01026077,1463,1453,10,7,2,1,0
2021,East Lindsey 003B,E01026078,1063,1046,17,12,1,3,1
2021,East Lindsey 002C,E01026079,1898,1882,16,5,5,5,1
2021,East Lindsey 001E,E01026080,1937,1925,12,8,2,2,0
2021,East Lindsey 004A,E01026081,2272,2208,64,20,25,5,14
2021,East Lindsey 007B,E01026082,2325,2309,16,7,8,1,0
2021,East Lindsey 015A,E01026083,1700,1658,42,17,12,10,3
2021,East Lindsey 012A,E01026084,1537,1485,52,24,18,10,0
2021,East Lindsey 003C,E01026087,1414,1400,14,5,8,1,0
2021,East Lindsey 003D,E01026088,1371,1356,15,8,5,1,1
2021,East Lindsey 004C,E01026089,1973,1964,9,7,2,0,0
2021,East Lindsey 003E,E01026090,1318,1309,9,3,5,0,1
2021,East Lindsey 003F,E01026091,1113,1110,3,3,0,0,0
2021,East Lindsey 014A,E01026092,1391,1311,80,27,31,19,3
2021,East Lindsey 014B,E01026093,1764,1598,166,43,70,49,4
2021,East Lindsey 015B,E01026094,2159,2112,47,18,18,10,1
2021,East Lindsey 014C,E01026095,1312,1272,40,20,11,8,1
2021,East Lindsey 015C,E01026096,1480,1456,24,9,11,3,1
2021,East Lindsey 015D,E01026097,1465,1409,56,18,27,11,0
2021,East Lindsey 018C,E01026098,1996,1977,19,13,4,1,1
2021,East Lindsey 005D,E01026099,1991,1984,7,3,4,0,0
2021,East Lindsey 013E,E01026100,1780,1761,19,7,11,1,0
2021,East Lindsey 013F,E01026101,1356,1317,39,21,12,4,2
2021,East Lindsey 018D,E01026102,2260,2230,30,8,10,12,0
2021,East Lindsey 006A,E01026103,1998,1977,21,4,14,1,2
2021,East Lindsey 006B,E01026104,2131,2119,12,5,6,1,0
2021,East Lindsey 009D,E01026105,2152,2134,18,11,6,0,1
2021,East Lindsey 001F,E01026106,1191,1186,5,3,2,0,0
2021,East Lindsey 001G,E01026107,1279,1241,38,17,19,1,1
2021,East Lindsey 003G,E01026108,2405,2383,22,8,13,0,1
2021,East Lindsey 006C,E01026109,2042,2030,12,7,3,2,0
2021,East Lindsey 017B,E01026110,1443,1431,12,5,2,5,0
2021,East Lindsey 017C,E01026111,1526,1509,17,6,7,4,0
2021,East Lindsey 017D,E01026112,1197,1188,9,5,2,2,0
2021,East Lindsey 008D,E01026113,1946,1927,19,5,7,6,1
2021,East Lindsey 014D,E01026114,1580,1453,127,40,58,28,1
2021,East Lindsey 012C,E01026115,1661,1638,23,12,6,4,1
2021,East Lindsey 012D,E01026116,1649,1601,48,19,17,10,2
2021,East Lindsey 008E,E01026117,1900,1896,4,1,2,0,1
2021,East Lindsey 016E,E01026118,1802,1789,13,7,5,1,0
2021,East Lindsey 016F,E01026119,1104,1090,14,5,6,3,0
2021,East Lindsey 016G,E01026120,1467,1442,25,10,12,3,0
2021,East Lindsey 007C,E01026121,2526,2487,39,14,11,14,0
2021,Lincoln 004A,E01026122,2100,1702,398,168,152,63,15
2021,Lincoln 004B,E01026123,2485,2126,359,164,134,52,9
2021,Lincoln 004C,E01026124,1757,1252,505,141,218,122,24
2021,Lincoln 003A,E01026125,1457,1231,226,75,92,45,14
2021,Lincoln 004D,E01026126,1878,1416,462,115,207,122,18
2021,Lincoln 007A,E01026127,1357,1263,94,36,35,20,3
2021,Lincoln 007C,E01026129,1675,1535,140,53,54,33,0
2021,Lincoln 009A,E01026130,1345,1288,57,31,18,8,0
2021,Lincoln 007D,E01026131,1346,1253,93,40,42,8,3
2021,Lincoln 005A,E01026132,3658,3233,425,211,162,51,1
2021,Lincoln 006A,E01026134,1940,1605,335,124,144,62,5
2021,Lincoln 008B,E01026135,1715,1659,56,27,19,7,3
2021,Lincoln 008C,E01026136,1712,1612,100,55,26,15,4
2021,Lincoln 011A,E01026137,1159,1118,41,17,21,3,0
2021,Lincoln 011B,E01026138,1437,1394,43,17,22,4,0
2021,Lincoln 011C,E01026139,1325,1289,36,10,19,4,3
2021,Lincoln 011D,E01026140,1298,1241,57,18,28,8,3
2021,Lincoln 011E,E01026141,1520,1478,42,19,14,9,0
2021,Lincoln 011F,E01026142,1168,1111,57,24,26,7,0
2021,Lincoln 003B,E01026144,2216,2102,114,60,40,13,1
2021,Lincoln 005C,E01026145,1641,1532,109,50,43,14,2
2021,Lincoln 005D,E01026146,2009,1888,121,54,48,15,4
2021,Lincoln 003C,E01026147,2407,2336,71,38,25,7,1
2021,Lincoln 003D,E01026148,1833,1747,86,45,26,14,1
2021,Lincoln 001A,E01026149,1633,1518,115,30,59,23,3
2021,Lincoln 001B,E01026150,1700,1571,129,30,67,29,3
2021,Lincoln 003E,E01026151,2048,1941,107,56,36,13,2
2021,Lincoln 004E,E01026152,1475,1271,204,70,82,48,4
2021,Lincoln 002A,E01026153,2465,2317,148,74,55,17,2
2021,Lincoln 004F,E01026154,1350,1224,126,49,57,18,2
2021,Lincoln 002B,E01026155,1781,1699,82,43,20,15,4
2021,Lincoln 004G,E01026156,1251,1122,129,53,46,26,4
2021,Lincoln 002C,E01026157,1366,1233,133,67,40,25,1
2021,Lincoln 009B,E01026158,1397,1351,46,27,18,1,0
2021,Lincoln 009C,E01026159,1438,1389,49,23,15,7,4
2021,Lincoln 009D,E01026160,1284,1245,39,18,18,3,0
2021,Lincoln 010A,E01026161,1340,1275,65,18,32,9,6
2021,Lincoln 009E,E01026162,1458,1412,46,23,17,5,1
2021,Lincoln 009F,E01026163,1279,1213,66,34,17,11,4
2021,Lincoln 003F,E01026164,1534,1483,51,26,18,4,3
2021,Lincoln 002D,E01026165,1616,1513,103,42,39,19,3
2021,Lincoln 001C,E01026166,1365,1286,79,36,33,9,1
2021,Lincoln 003G,E01026167,1795,1720,75,49,12,11,3
2021,Lincoln 001D,E01026168,1654,1569,85,40,32,13,0
2021,Lincoln 011G,E01026169,1630,1560,70,26,30,12,2
2021,Lincoln 010B,E01026170,1462,1373,89,47,28,14,0
2021,Lincoln 011H,E01026171,1505,1450,55,35,15,5,0
2021,Lincoln 010C,E01026172,1577,1462,115,44,54,16,1
2021,Lincoln 010D,E01026173,1595,1436,159,56,70,32,1
2021,Lincoln 008D,E01026174,1458,1205,253,110,101,38,4
2021,Lincoln 010E,E01026175,1756,1453,303,101,119,73,10
2021,Lincoln 006B,E01026176,2061,1366,695,187,296,179,33
2021,Lincoln 006C,E01026177,2152,1354,798,215,332,211,40
2021,Lincoln 006D,E01026178,1925,1511,414,132,186,79,17
2021,North Kesteven 008A,E01026179,1261,1252,9,6,0,3,0
2021,North Kesteven 007A,E01026180,1420,1417,3,1,1,0,1
2021,North Kesteven 003B,E01026182,1476,1468,8,2,2,2,2
2021,North Kesteven 007B,E01026183,2704,2674,30,10,13,6,1
2021,North Kesteven 004A,E01026184,1858,1836,22,14,6,2,0
2021,North Kesteven 004B,E01026185,2160,2125,35,15,18,2,0
2021,North Kesteven 001A,E01026186,1632,1600,32,16,14,1,1
2021,North Kesteven 001B,E01026187,1874,1831,43,16,18,9,0
2021,North Kesteven 004C,E01026188,2137,2064,73,37,29,7,0
2021,North Kesteven 001C,E01026189,1698,1662,36,18,10,4,4
2021,North Kesteven 004D,E01026190,1847,1835,12,6,4,2,0
2021,North Kesteven 005A,E01026191,1803,1792,11,8,1,1,1
2021,North Kesteven 006A,E01026192,1212,1210,2,1,0,1,0
2021,North Kesteven 003C,E01026193,1575,1497,78,10,17,34,17
2021,North Kesteven 006B,E01026194,2073,2050,23,10,7,5,1
2021,North Kesteven 006C,E01026195,1867,1857,10,8,1,0,1
2021,North Kesteven 006D,E01026196,1443,1436,7,4,1,2,0
2021,North Kesteven 008B,E01026197,1437,1415,22,11,7,4,0
2021,North Kesteven 008C,E01026198,1517,1497,20,13,5,2,0
2021,North Kesteven 003D,E01026199,2535,2519,16,15,0,1,0
2021,North Kesteven 012A,E01026200,1684,1656,28,11,7,5,5
2021,North Kesteven 012B,E01026201,2027,2008,19,9,8,1,1
2021,North Kesteven 012C,E01026202,1876,1850,26,14,5,7,0
2021,North Kesteven 001D,E01026203,1920,1873,47,29,14,2,2
2021,North Kesteven 001E,E01026204,1566,1552,14,8,4,2,0
2021,North Kesteven 005B,E01026205,1653,1623,30,17,9,4,0
2021,North Kesteven 001F,E01026206,1812,1797,15,9,3,3,0
2021,North Kesteven 012D,E01026207,1261,1234,27,7,17,2,1
2021,North Kesteven 012E,E01026208,1602,1542,60,27,21,11,1
2021,North Kesteven 009A,E01026209,2037,2014,23,8,8,3,4
2021,North Kesteven 007C,E01026210,2386,2378,8,5,1,2,0
2021,North Kesteven 005C,E01026211,1922,1901,21,11,8,2,0
2021,North Kesteven 005D,E01026212,1462,1454,8,4,3,1,0
2021,North Kesteven 005E,E01026213,1660,1641,19,11,5,3,0
2021,North Kesteven 014A,E01026214,1076,1066,10,4,4,2,0
2021,North Kesteven 014B,E01026215,1022,1013,9,7,2,0,0
2021,North Kesteven 014C,E01026218,1140,1117,23,12,7,0,4
2021,North Kesteven 014D,E01026219,1112,1098,14,6,8,0,0
2021,North Kesteven 013A,E01026220,2188,2171,17,12,3,1,1
2021,North Kesteven 009B,E01026221,2421,2398,23,13,8,1,1
2021,North Kesteven 009C,E01026222,1785,1771,14,7,5,2,0
2021,North Kesteven 008D,E01026223,1965,1940,25,14,8,3,0
2021,North Kesteven 007D,E01026224,1771,1737,34,17,10,4,3
2021,North Kesteven 003E,E01026225,1666,1649,17,11,6,0,0
2021,North Kesteven 003F,E01026226,1824,1811,13,7,4,1,1
2021,North Kesteven 010A,E01026227,1503,1385,118,42,46,26,4
2021,North Kesteven 011A,E01026228,1677,1582,95,29,41,22,3
2021,North Kesteven 011B,E01026229,1847,1759,88,31,40,16,1
2021,North Kesteven 010B,E01026230,1728,1634,94,39,31,18,6
2021,North Kesteven 010C,E01026231,2619,2544,75,32,30,12,1
2021,North Kesteven 010D,E01026232,2069,1984,85,35,37,12,1
2021,North Kesteven 011C,E01026233,1676,1631,45,19,19,7,0
2021,North Kesteven 010E,E01026235,1607,1546,61,26,15,18,2
2021,North Kesteven 011E,E01026236,1121,1051,70,26,15,26,3
2021,North Kesteven 004E,E01026237,1110,1073,37,20,11,6,0
2021,North Kesteven 004F,E01026238,1454,1439,15,11,1,0,3
2021,South Holland 011A,E01026239,2026,1960,66,23,28,13,2
2021,South Holland 011B,E01026240,2685,2623,62,28,20,13,1
2021,South Holland 005A,E01026241,1901,1846,55,27,17,10,1
2021,South Holland 001A,E01026242,1731,1702,29,11,14,3,1
2021,South Holland 001B,E01026243,1373,1335,38,12,13,10,3
2021,South Holland 001C,E01026244,1304,1260,44,16,18,10,0
2021,South Holland 010A,E01026245,2408,2337,71,28,26,11,6
2021,South Holland 002A,E01026246,2268,2231,37,21,11,2,3
2021,South Holland 001D,E01026247,1907,1828,79,28,33,16,2
2021,South Holland 002B,E01026248,2233,2165,68,28,24,15,1
2021,South Holland 010B,E01026249,1956,1886,70,20,30,18,2
2021,South Holland 003A,E01026250,2083,1756,327,98,145,68,16
2021,South Holland 003B,E01026251,1772,1696,76,24,32,15,5
2021,South Holland 003C,E01026252,1728,1606,122,33,35,48,6
2021,South Holland 003D,E01026253,1917,1812,105,32,50,22,1
2021,South Holland 008A,E01026254,1763,1747,16,10,6,0,0
2021,South Holland 008B,E01026255,1933,1838,95,34,42,15,4
2021,South Holland 008C,E01026256,1601,1569,32,7,16,9,0
2021,South Holland 002C,E01026257,2108,2049,59,25,25,8,1
2021,South Holland 005B,E01026258,2198,2029,169,77,57,34,1
2021,South Holland 005C,E01026259,1697,1618,79,25,28,25,1
2021,South Holland 005D,E01026260,1931,1745,186,70,65,41,10
2021,South Holland 009A,E01026262,1427,1208,219,72,103,38,6
2021,South Holland 009B,E01026263,2298,1806,492,157,229,94,12
2021,South Holland 009C,E01026264,1604,1135,469,130,210,111,18
2021,South Holland 009D,E01026265,1408,1245,163,55,65,39,4
2021,South Holland 006B,E01026266,2184,1267,917,194,435,263,25
2021,South Holland 007A,E01026268,1923,1448,475,110,225,119,21
2021,South Holland 007B,E01026269,2087,1812,275,67,127,72,9
2021,South Holland 007C,E01026270,1805,1269,536,168,223,130,15
2021,South Holland 007D,E01026271,1710,1156,554,150,230,159,15
2021,South Holland 007E,E01026272,1340,1016,324,92,144,77,11
2021,South Holland 006C,E01026273,1720,1486,234,76,104,49,5
2021,South Holland 006E,E01026275,2601,1782,819,260,361,177,21
2021,South Holland 001E,E01026276,2288,2239,49,15,17,16,1
2021,South Holland 008D,E01026277,1643,1493,150,72,57,18,3
2021,South Holland 008E,E01026278,1421,1371,50,12,21,16,1
2021,South Holland 008F,E01026279,1322,1262,60,30,20,9,1
2021,South Holland 010C,E01026280,2617,2567,50,26,20,4,0
2021,South Holland 004A,E01026281,1333,1282,51,22,19,7,3
2021,South Holland 004B,E01026282,1812,1749,63,22,20,19,2
2021,South Holland 004C,E01026283,1715,1663,52,25,16,10,1
2021,South Holland 011C,E01026284,2250,2178,72,39,23,9,1
2021,South Holland 004D,E01026285,1385,1344,41,9,24,8,0
2021,South Holland 004E,E01026286,1218,1191,27,9,12,6,0
2021,South Kesteven 015A,E01026287,1295,1227,68,26,30,10,2
2021,South Kesteven 015B,E01026288,1558,1465,93,47,40,6,0
2021,South Kesteven 015C,E01026289,2226,2169,57,28,24,5,0
2021,South Kesteven 008A,E01026290,2197,2179,18,7,9,1,1
2021,South Kesteven 002A,E01026291,2003,1983,20,10,6,2,2
2021,South Kesteven 007A,E01026292,1349,1305,44,20,21,3,0
2021,South Kesteven 007B,E01026293,1987,1903,84,37,31,12,4
2021,South Kesteven 007C,E01026294,1546,1483,63,43,16,3,1
2021,South Kesteven 011B,E01026296,1491,1466,25,10,10,3,2
2021,South Kesteven 011C,E01026297,1485,1448,37,11,20,5,1
2021,South Kesteven 011D,E01026298,2041,1907,134,47,50,35,2
2021,South Kesteven 010A,E01026299,1635,1567,68,24,31,11,2
2021,South Kesteven 010B,E01026300,1436,1411,25,15,9,0,1
2021,South Kesteven 010D,E01026302,1114,1081,33,15,7,9,2
2021,South Kesteven 014A,E01026303,1221,1196,25,12,9,4,0
2021,South Kesteven 014B,E01026304,1453,1430,23,11,9,3,0
2021,South Kesteven 014C,E01026305,1275,1246,29,18,7,3,1
2021,South Kesteven 014D,E01026306,1871,1836,35,19,6,8,2
2021,South Kesteven 014E,E01026307,1246,1230,16,7,4,2,3
2021,South Kesteven 005A,E01026308,1556,1310,246,77,123,42,4
2021,South Kesteven 005B,E01026309,1543,1382,161,61,68,28,4
2021,South Kesteven 005C,E01026310,1132,1010,122,42,49,25,6
2021,South Kesteven 005D,E01026311,1583,1310,273,103,117,50,3
2021,South Kesteven 005E,E01026312,1332,1129,203,77,95,28,3
2021,South Kesteven 001A,E01026313,1459,1426,33,18,13,1,1
2021,South Kesteven 001B,E01026314,1312,1302,10,3,4,3,0
2021,South Kesteven 009A,E01026315,2158,2130,28,18,6,2,2
2021,South Kesteven 007D,E01026316,2385,2374,11,8,3,0,0
2021,South Kesteven 006A,E01026317,2221,1766,455,171,190,86,8
2021,South Kesteven 006B,E01026318,2110,1830,280,99,136,41,4
2021,South Kesteven 006C,E01026319,2527,2396,131,47,61,19,4
2021,South Kesteven 004B,E01026321,1359,1317,42,22,16,3,1
2021,South Kesteven 004C,E01026322,1183,1119,64,28,31,2,3
2021,South Kesteven 004D,E01026323,1910,1630,280,75,128,66,11
2021,South Kesteven 004E,E01026324,2016,1963,53,25,21,7,0
2021,South Kesteven 003A,E01026325,1554,1440,114,47,50,13,4
2021,South Kesteven 003B,E01026326,1456,1373,83,33,37,9,4
2021,South Kesteven 003C,E01026327,1359,1310,49,22,21,5,1
2021,South Kesteven 003D,E01026328,1471,1353,118,43,47,28,0
2021,South Kesteven 001C,E01026329,1792,1770,22,12,5,2,3
2021,South Kesteven 012A,E01026330,2139,2120,19,10,9,0,0
2021,South Kesteven 009B,E01026331,2434,2406,28,15,12,0,1
2021,South Kesteven 007E,E01026332,2114,2077,37,17,15,3,2
2021,South Kesteven 001D,E01026333,2490,2479,11,7,2,2,0
2021,South Kesteven 013A,E01026334,1514,1494,20,11,4,5,0
2021,South Kesteven 013B,E01026335,1515,1489,26,7,11,5,3
2021,South Kesteven 013C,E01026336,1684,1659,25,9,11,5,0
2021,South Kesteven 013D,E01026337,2202,2145,57,31,18,7,1
2021,South Kesteven 009C,E01026338,1214,1206,8,4,2,1,1
2021,South Kesteven 009D,E01026339,1213,1186,27,12,10,2,3
2021,South Kesteven 002B,E01026340,2174,2139,35,14,16,5,0
2021,South Kesteven 008B,E01026341,1562,1547,15,9,4,2,0
2021,South Kesteven 008C,E01026342,1369,1346,23,12,7,3,1
2021,South Kesteven 006D,E01026343,1774,1471,303,92,138,63,10
2021,South Kesteven 006E,E01026344,1444,1336,108,37,55,13,3
2021,South Kesteven 006F,E01026345,1753,1668,85,42,21,20,2
2021,South Kesteven 015D,E01026346,1151,1117,34,19,12,3,0
2021,South Kesteven 015E,E01026347,1523,1460,63,36,18,8,1
2021,South Kesteven 015F,E01026348,1218,1174,44,26,13,5,0
2021,South Kesteven 016A,E01026349,1497,1462,35,17,14,4,0
2021,South Kesteven 016B,E01026350,1807,1748,59,35,17,7,0
2021,South Kesteven 016C,E01026351,1463,1407,56,35,19,1,1
2021,South Kesteven 003E,E01026352,1287,1197,90,46,39,5,0
2021,South Kesteven 003F,E01026353,1524,1360,164,56,77,27,4
2021,South Kesteven 003G,E01026354,1104,1054,50,25,16,8,1
2021,South Kesteven 002C,E01026355,2472,2451,21,12,8,1,0
2021,South Kesteven 016D,E01026356,1405,1369,36,17,12,6,1
2021,South Kesteven 016E,E01026357,1296,1271,25,11,8,6,0
2021,South Kesteven 016F,E01026358,1334,1313,21,11,7,1,2
2021,South Kesteven 016G,E01026359,2406,2352,54,36,11,6,1
2021,South Kesteven 012B,E01026360,2097,2059,38,14,20,3,1
2021,South Kesteven 008D,E01026361,2582,2546,36,19,10,6,1
2021,South Kesteven 012C,E01026362,1685,1667,18,9,9,0,0
2021,South Kesteven 012D,E01026363,1842,1827,15,8,6,1,0
2021,South Kesteven 012E,E01026364,1831,1813,18,10,7,0,1
2021,South Kesteven 002D,E01026365,2273,2258,15,9,6,0,0
2021,West Lindsey 011A,E01026366,2378,2356,22,13,7,2,0
2021,West Lindsey 001A,E01026367,1628,1609,19,12,5,2,0
2021,West Lindsey 001B,E01026368,1919,1899,20,9,6,5,0
2021,West Lindsey 011B,E01026369,1310,1290,20,11,8,1,0
2021,West Lindsey 011C,E01026370,2469,2418,51,28,16,7,0
2021,West Lindsey 011D,E01026371,1217,1198,19,15,4,0,0
2021,West Lindsey 008A,E01026372,2497,2473,24,21,3,0,0
2021,West Lindsey 011E,E01026373,2133,2115,18,12,5,1,0
2021,West Lindsey 006A,E01026374,1434,1387,47,19,21,7,0
2021,West Lindsey 006B,E01026375,1973,1892,81,36,25,18,2
2021,West Lindsey 006C,E01026376,1656,1608,48,24,10,12,2
2021,West Lindsey 006D,E01026377,2128,2105,23,14,8,1,0
2021,West Lindsey 004A,E01026378,1678,1639,39,10,19,9,1
2021,West Lindsey 004B,E01026379,1775,1734,41,14,19,8,0
2021,West Lindsey 002A,E01026380,2459,2413,46,28,9,8,1
2021,West Lindsey 004C,E01026381,1665,1623,42,21,18,3,0
2021,West Lindsey 004D,E01026382,1702,1663,39,15,19,4,1
2021,West Lindsey 004E,E01026383,1255,1176,79,25,35,17,2
2021,West Lindsey 004F,E01026384,2066,1974,92,34,39,16,3
2021,West Lindsey 005A,E01026385,1062,1053,9,6,1,2,0
2021,West Lindsey 005B,E01026386,1205,1189,16,7,6,3,0
2021,West Lindsey 001C,E01026387,2628,2619,9,6,3,0,0
2021,West Lindsey 007A,E01026388,2086,2062,24,15,7,2,0
2021,West Lindsey 003A,E01026389,1743,1716,27,16,10,0,1
2021,West Lindsey 003B,E01026390,1776,1758,18,8,10,0,0
2021,West Lindsey 003C,E01026391,1938,1918,20,13,5,1,1
2021,West Lindsey 003D,E01026392,2975,2951,24,12,12,0,0
2021,West Lindsey 010A,E01026393,1498,1484,14,11,2,1,0
2021,West Lindsey 010B,E01026394,2271,2162,109,66,26,14,3
2021,West Lindsey 010C,E01026395,1479,1473,6,4,2,0,0
2021,West Lindsey 009A,E01026396,1282,1273,9,7,1,1,0
2021,West Lindsey 009C,E01026398,1537,1523,14,9,3,2,0
2021,West Lindsey 005C,E01026399,1478,1464,14,7,3,2,2
2021,West Lindsey 009D,E01026400,1545,1529,16,9,5,2,0
2021,West Lindsey 002B,E01026401,1582,1570,12,8,2,2,0
2021,West Lindsey 002C,E01026402,1821,1792,29,17,7,5,0
2021,West Lindsey 002D,E01026403,1331,1326,5,4,1,0,0
2021,West Lindsey 007B,E01026404,2380,2363,17,8,8,1,0
2021,West Lindsey 010D,E01026405,1481,1466,15,11,4,0,0
2021,West Lindsey 010E,E01026406,1169,1129,40,31,9,0,0
2021,West Lindsey 002E,E01026407,1340,1334,6,4,1,1,0
2021,West Lindsey 002F,E01026408,1352,1339,13,5,6,2,0
2021,West Lindsey 007C,E01026409,1203,1182,21,14,4,3,0
2021,West Lindsey 007D,E01026410,1602,1585,17,6,7,4,0
2021,West Lindsey 005D,E01026411,2394,2362,32,18,6,6,2
2021,West Lindsey 008B,E01026412,1916,1898,18,10,3,3,2
2021,West Lindsey 008C,E01026413,2070,2048,22,12,9,1,0
2021,West Lindsey 008D,E01026414,1866,1856,10,8,2,0,0
2021,West Lindsey 003E,E01026415,1051,1044,7,1,4,2,0
2021,West Lindsey 001D,E01026416,1289,1280,9,6,3,0,0
2021,Breckland 010A,E01026419,1267,1242,25,16,7,2,0
2021,Breckland 010B,E01026420,1240,1226,14,10,2,2,0
2021,Breckland 013A,E01026421,1753,1739,14,8,5,1,0
2021,Breckland 011B,E01026423,1832,1678,154,40,63,41,10
2021,Breckland 012A,E01026424,2073,2032,41,21,17,3,0
2021,Breckland 005A,E01026425,1989,1909,80,37,31,11,1
2021,Breckland 005B,E01026426,2243,2100,143,55,56,31,1
2021,Breckland 005C,E01026427,2410,2337,73,35,26,12,0
2021,Breckland 003A,E01026428,2617,2547,70,35,26,7,2
2021,Breckland 003B,E01026429,1398,1329,69,22,27,17,3
2021,Breckland 003C,E01026430,2282,2214,68,33,23,12,0
2021,Breckland 003D,E01026431,1141,1107,34,20,9,4,1
2021,Breckland 005D,E01026432,1423,1381,42,14,7,10,11
2021,Breckland 005E,E01026433,1346,1279,67,19,27,16,5
2021,Breckland 005F,E01026434,1881,1806,75,36,26,13,0
2021,Breckland 013B,E01026435,2149,2116,33,11,13,7,2
2021,Breckland 001A,E01026436,2416,2391,25,11,12,2,0
2021,Breckland 008A,E01026437,1226,1205,21,7,6,7,1
2021,Breckland 008B,E01026438,1034,1021,13,4,6,2,1
2021,Breckland 014A,E01026439,1814,1784,30,13,13,2,2
2021,Breckland 014B,E01026440,1160,1127,33,19,13,1,0
2021,Breckland 014C,E01026441,1568,1551,17,7,7,3,0
2021,Breckland 002A,E01026442,2107,2083,24,10,13,1,0
2021,Breckland 002B,E01026443,2125,2104,21,6,12,2,1
2021,Breckland 012B,E01026444,2055,2031,24,13,8,3,0
2021,Breckland 002C,E01026445,2453,2409,44,19,16,6,3
2021,Breckland 004A,E01026446,2109,2083,26,12,8,4,2
2021,Breckland 011C,E01026447,1660,1546,114,41,37,27,9
2021,Breckland 013C,E01026448,2416,2367,49,25,14,9,1
2021,Breckland 011D,E01026449,1893,1766,127,35,52,36,4
2021,Breckland 011E,E01026450,1805,1730,75,35,29,10,1
2021,Breckland 008C,E01026451,2393,2360,33,16,13,4,0
2021,Breckland 004B,E01026452,1664,1637,27,15,5,7,0
2021,Breckland 004C,E01026453,1512,1495,17,4,8,5,0
2021,Breckland 004D,E01026454,1542,1481,61,32,25,3,1
2021,Breckland 007B,E01026456,1178,1140,38,12,15,8,3
2021,Breckland 007C,E01026457,1304,1285,19,10,7,2,0
2021,Breckland 007D,E01026458,1676,1634,42,16,13,13,0
2021,Breckland 007E,E01026459,1493,1423,70,25,28,17,0
2021,Breckland 001C,E01026461,1566,1534,32,12,13,6,1
2021,Breckland 002D,E01026462,2380,2362,18,10,4,3,1
2021,Breckland 010D,E01026464,1270,1257,13,8,3,2,0
2021,Breckland 015A,E01026465,1794,1364,430,137,157,115,21
2021,Breckland 015B,E01026466,1789,1395,394,121,163,98,12
2021,Breckland 015C,E01026467,2142,1623,519,182,204,115,18
2021,Breckland 016A,E01026468,2358,1815,543,143,239,145,16
2021,Breckland 016B,E01026469,1601,1327,274,75,116,73,10
2021,Breckland 016C,E01026470,2705,2203,502,141,236,103,22
2021,Breckland 016D,E01026471,1157,974,183,70,72,32,9
2021,Breckland 016E,E01026472,1164,1046,118,34,60,21,3
2021,Breckland 016F,E01026473,1349,1122,227,87,94,39,7
2021,Breckland 017A,E01026474,1988,1641,347,116,154,67,10
2021,Breckland 017B,E01026475,1498,1342,156,53,51,48,4
2021,Breckland 017C,E01026476,1467,1108,359,117,154,73,15
2021,Breckland 017D,E01026477,1765,1445,320,126,124,68,2
2021,Breckland 017E,E01026478,1609,1261,348,110,152,68,18
2021,Breckland 006A,E01026479,1475,1468,7,3,4,0,0
2021,Breckland 006B,E01026480,1578,1565,13,7,5,0,1
2021,Breckland 006C,E01026481,1300,1288,12,9,3,0,0
2021,Breckland 001E,E01026483,1080,1071,9,3,5,1,0
2021,Breckland 006D,E01026484,1551,1545,6,2,1,0,3
2021,Breckland 006E,E01026485,1186,1180,6,5,0,0,1
2021,Breckland 009A,E01026486,1917,1711,206,50,96,53,7
2021,Breckland 009B,E01026487,2150,1871,279,57,132,77,13
2021,Breckland 009C,E01026488,1351,1009,342,58,127,120,37
2021,Breckland 009D,E01026489,1425,1288,137,31,51,44,11
2021,Breckland 009E,E01026490,1858,1703,155,32,68,42,13
2021,Breckland 010E,E01026491,2268,2243,25,9,12,2,2
2021,Breckland 012C,E01026492,1242,1218,24,10,12,2,0
2021,Breckland 012D,E01026493,1323,1258,65,24,34,7,0
2021,Breckland 014D,E01026494,2344,2324,20,11,5,3,1
2021,Breckland 008D,E01026495,1402,1377,25,9,14,2,0
2021,Breckland 008E,E01026496,1103,1092,11,7,3,0,1
2021,Broadland 018A,E01026497,1435,1417,18,7,8,3,0
2021,Broadland 018B,E01026498,1295,1293,2,2,0,0,0
2021,Broadland 001A,E01026499,1510,1497,13,11,2,0,0
2021,Broadland 001B,E01026500,1588,1586,2,2,0,0,0
2021,Broadland 001C,E01026501,1567,1546,21,14,5,2,0
2021,Broadland 001D,E01026502,1991,1970,21,8,11,2,0
2021,Broadland 001E,E01026503,2068,2047,21,13,6,2,0
2021,Broadland 014A,E01026504,1451,1444,7,3,2,2,0
2021,Broadland 014B,E01026505,1950,1911,39,27,11,1,0
2021,Broadland 014C,E01026506,1407,1397,10,7,1,1,1
2021,Broadland 014D,E01026507,1401,1383,18,11,7,0,0
2021,Broadland 017A,E01026508,1326,1300,26,9,12,3,2
2021,Broadland 017B,E01026509,1864,1830,34,27,6,1,0
2021,Broadland 017C,E01026510,1716,1693,23,20,2,1,0
2021,Broadland 017D,E01026511,1149,1142,7,5,2,0,0
2021,Broadland 014E,E01026512,1253,1239,14,8,5,1,0
2021,Broadland 014F,E01026513,1376,1367,9,4,4,1,0
2021,Broadland 003A,E01026514,1488,1481,7,4,3,0,0
2021,Broadland 003B,E01026515,1142,1129,13,9,4,0,0
2021,Broadland 003C,E01026516,1168,1160,8,2,1,4,1
2021,Broadland 003D,E01026517,1570,1549,21,12,7,1,1
2021,Broadland 007A,E01026518,1276,1250,26,12,14,0,0
2021,Broadland 007B,E01026519,1608,1538,70,34,22,11,3
2021,Broadland 007C,E01026520,1074,1064,10,6,3,0,1
2021,Broadland 007D,E01026521,1286,1266,20,15,4,1,0
2021,Broadland 002A,E01026522,1413,1406,7,5,2,0,0
2021,Broadland 002B,E01026523,1788,1773,15,5,8,2,0
2021,Broadland 002C,E01026524,1430,1415,15,12,1,2,0
2021,Broadland 002D,E01026525,1226,1216,10,7,2,1,0
2021,Broadland 010A,E01026526,1313,1293,20,13,5,2,0
2021,Broadland 010B,E01026527,1368,1341,27,11,11,3,2
2021,Broadland 010C,E01026528,1366,1335,31,11,12,6,2
2021,Broadland 010D,E01026529,1527,1465,62,37,21,4,0
2021,Broadland 011A,E01026530,1789,1665,124,39,58,22,5
2021,Broadland 011B,E01026531,1841,1744,97,46,37,13,1
2021,Broadland 011C,E01026532,1680,1625,55,34,15,5,1
2021,Broadland 004A,E01026533,1203,1190,13,6,7,0,0
2021,Broadland 004B,E01026534,1633,1624,9,6,3,0,0
2021,Broadland 004C,E01026535,2224,2199,25,14,10,0,1
2021,Broadland 004D,E01026536,1835,1812,23,10,12,1,0
2021,Broadland 004E,E01026537,1437,1408,29,16,7,6,0
2021,Broadland 018C,E01026538,1565,1549,16,9,6,0,1
2021,Broadland 018D,E01026539,1580,1566,14,9,3,0,2
2021,Broadland 009A,E01026540,1361,1342,19,8,4,5,2
2021,Broadland 009B,E01026541,2396,2332,64,33,20,10,1
2021,Broadland 009C,E01026542,1381,1364,17,6,9,2,0
2021,Broadland 009D,E01026543,1423,1397,26,15,7,4,0
2021,Broadland 009E,E01026544,1692,1625,67,36,22,7,2
2021,Broadland 008A,E01026545,2087,2055,32,17,8,7,0
2021,Broadland 008B,E01026546,1408,1398,10,9,1,0,0
2021,Broadland 002E,E01026547,1361,1358,3,2,1,0,0
2021,Broadland 002F,E01026548,1262,1255,7,3,2,2,0
2021,Broadland 005A,E01026549,1753,1740,13,6,6,0,1
2021,Broadland 005B,E01026550,1048,1030,18,9,6,2,1
2021,Broadland 005C,E01026551,1094,1085,9,3,4,2,0
2021,Broadland 005D,E01026552,1308,1294,14,4,7,3,0
2021,Broadland 012A,E01026553,1293,1264,29,15,12,0,2
2021,Broadland 012B,E01026554,1083,1055,28,12,9,5,2
2021,Broadland 012C,E01026555,1472,1442,30,17,10,3,0
2021,Broadland 012D,E01026556,1379,1332,47,22,18,4,3
2021,Broadland 013A,E01026557,1299,1259,40,19,13,7,1
2021,Broadland 013B,E01026558,2153,2077,76,40,24,9,3
2021,Broadland 013C,E01026559,1418,1393,25,12,9,4,0
2021,Broadland 013D,E01026560,1287,1254,33,17,11,5,0
2021,Broadland 006A,E01026562,1164,1133,31,15,9,5,2
2021,Broadland 006B,E01026563,1322,1290,32,18,7,4,3
2021,Broadland 006C,E01026564,1585,1533,52,25,18,9,0
2021,Broadland 006D,E01026565,1053,995,58,31,20,7,0
2021,Broadland 006E,E01026566,1423,1402,21,7,14,0,0
2021,Broadland 006F,E01026567,1568,1549,19,13,3,3,0
2021,Broadland 006G,E01026568,1491,1473,18,13,2,1,2
2021,Broadland 015A,E01026569,1407,1373,34,14,15,4,1
2021,Broadland 015B,E01026570,1613,1584,29,15,10,2,2
2021,Broadland 015C,E01026571,1449,1411,38,21,13,3,1
2021,Broadland 015D,E01026572,1366,1348,18,15,3,0,0
2021,Broadland 015E,E01026573,1349,1332,17,6,4,7,0
2021,Broadland 016A,E01026574,1665,1586,79,48,19,8,4
2021,Broadland 016B,E01026575,1771,1719,52,34,11,7,0
2021,Broadland 016C,E01026576,1948,1865,83,46,23,12,2
2021,Broadland 016D,E01026577,1609,1564,45,29,9,7,0
2021,Broadland 008C,E01026578,2074,2036,38,17,15,5,1
2021,Broadland 008D,E01026579,1545,1534,11,1,6,1,3
2021,Broadland 008E,E01026580,1781,1763,18,7,8,3,0
2021,Great Yarmouth 008A,E01026581,1642,1604,38,14,11,9,4
2021,Great Yarmouth 008B,E01026582,1963,1929,34,21,7,5,1
2021,Great Yarmouth 008C,E01026583,1294,1277,17,6,8,1,2
2021,Great Yarmouth 008D,E01026584,1441,1420,21,13,5,3,0
2021,Great Yarmouth 013C,E01026587,2856,2802,54,37,14,3,0
2021,Great Yarmouth 013D,E01026588,2506,2464,42,25,11,4,2
2021,Great Yarmouth 003A,E01026589,1282,1268,14,6,6,0,2
2021,Great Yarmouth 003B,E01026590,1338,1325,13,6,5,1,1
2021,Great Yarmouth 003C,E01026591,1637,1614,23,9,12,1,1
2021,Great Yarmouth 003D,E01026592,1317,1301,16,7,6,2,1
2021,Great Yarmouth 003E,E01026593,1299,1279,20,9,5,6,0
2021,Great Yarmouth 003F,E01026594,1778,1743,35,21,9,4,1
2021,Great Yarmouth 005A,E01026595,1683,1470,213,77,71,61,4
2021,Great Yarmouth 005B,E01026596,1516,1360,156,51,60,34,11
2021,Great Yarmouth 005C,E01026597,1919,1452,467,142,173,126,26
2021,Great Yarmouth 005D,E01026598,1799,1237,562,140,223,160,39
2021,Great Yarmouth 004A,E01026599,1373,1219,154,40,63,41,10
2021,Great Yarmouth 007A,E01026600,1428,1392,36,14,14,5,3
2021,Great Yarmouth 009A,E01026601,1363,1320,43,18,19,6,0
2021,Great Yarmouth 009B,E01026602,1562,1521,41,13,19,8,1
2021,Great Yarmouth 009C,E01026603,1574,1552,22,9,11,2,0
2021,Great Yarmouth 009D,E01026604,1515,1445,70,25,32,12,1
2021,Great Yarmouth 001A,E01026605,1765,1754,11,6,4,1,0
2021,Great Yarmouth 001B,E01026606,1393,1377,16,9,4,3,0
2021,Great Yarmouth 001C,E01026607,1729,1702,27,9,9,6,3
2021,Great Yarmouth 002A,E01026608,1460,1443,17,5,7,4,1
2021,Great Yarmouth 002B,E01026609,1177,1161,16,7,7,2,0
2021,Great Yarmouth 010A,E01026610,1453,1406,47,17,22,8,0
2021,Great Yarmouth 010B,E01026611,1315,1279,36,23,11,2,0
2021,Great Yarmouth 010C,E01026612,2407,2236,171,114,42,13,2
2021,Great Yarmouth 012A,E01026613,1243,1233,10,5,4,1,0
2021,Great Yarmouth 012B,E01026614,1740,1718,22,6,5,7,4
2021,Great Yarmouth 012C,E01026615,1323,1310,13,6,5,2,0
2021,Great Yarmouth 012D,E01026616,1171,1164,7,5,2,0,0
2021,Great Yarmouth 011A,E01026617,1220,1189,31,19,11,1,0
2021,Great Yarmouth 011B,E01026618,1485,1325,160,99,53,7,1
2021,Great Yarmouth 011C,E01026619,1394,1329,65,35,25,5,0
2021,Great Yarmouth 011D,E01026620,1533,1472,61,35,14,10,2
2021,Great Yarmouth 011E,E01026621,1539,1482,57,40,15,2,0
2021,Great Yarmouth 006A,E01026622,1577,1409,168,75,55,30,8
2021,Great Yarmouth 006B,E01026623,1764,1246,518,132,216,148,22
2021,Great Yarmouth 006C,E01026624,1883,1348,535,131,245,135,24
2021,Great Yarmouth 006D,E01026625,1741,1521,220,75,97,43,5
2021,Great Yarmouth 006E,E01026626,2010,1452,558,131,199,184,44
2021,Great Yarmouth 001D,E01026627,1326,1314,12,9,1,2,0
2021,Great Yarmouth 001E,E01026628,1822,1790,32,13,12,6,1
2021,Great Yarmouth 001F,E01026629,1451,1444,7,5,1,1,0
2021,Great Yarmouth 010D,E01026630,1549,1487,62,31,25,5,1
2021,Great Yarmouth 010E,E01026631,1576,1512,64,33,17,10,4
2021,Great Yarmouth 009E,E01026632,1620,1543,77,35,23,12,7
2021,Great Yarmouth 007B,E01026633,1697,1491,206,73,86,43,4
2021,Great Yarmouth 007C,E01026634,1455,1253,202,60,79,49,14
2021,Great Yarmouth 007D,E01026635,2281,1964,317,101,133,67,16
2021,Great Yarmouth 002C,E01026636,1531,1519,12,9,1,2,0
2021,Great Yarmouth 002D,E01026637,2066,2048,18,11,5,1,1
2021,Great Yarmouth 002E,E01026638,1612,1599,13,7,5,1,0
2021,Great Yarmouth 004B,E01026639,1520,1399,121,27,58,29,7
2021,Great Yarmouth 004C,E01026640,1475,1414,61,27,21,13,0
2021,Great Yarmouth 004D,E01026641,1374,1323,51,20,23,8,0
2021,King's Lynn and West Norfolk 014A,E01026642,1392,1383,9,3,6,0,0
2021,King's Lynn and West Norfolk 014B,E01026643,1344,1334,10,5,5,0,0
2021,King's Lynn and West Norfolk 014C,E01026644,1737,1712,25,18,6,1,0
2021,King's Lynn and West Norfolk 002A,E01026645,1108,1102,6,4,2,0,0
2021,King's Lynn and West Norfolk 002B,E01026646,1453,1441,12,9,3,0,0
2021,King's Lynn and West Norfolk 008A,E01026647,2181,2162,19,10,7,1,1
2021,King's Lynn and West Norfolk 019A,E01026648,1618,1594,24,16,5,2,1
2021,King's Lynn and West Norfolk 019B,E01026649,1753,1714,39,16,14,9,0
2021,King's Lynn and West Norfolk 019C,E01026650,1181,1128,53,28,15,7,3
2021,King's Lynn and West Norfolk 019D,E01026651,2511,2479,32,14,15,2,1
2021,King's Lynn and West Norfolk 019E,E01026652,1389,1360,29,12,9,8,0
2021,King's Lynn and West Norfolk 004A,E01026653,1760,1747,13,3,10,0,0
2021,King's Lynn and West Norfolk 004B,E01026654,1517,1505,12,6,5,1,0
2021,King's Lynn and West Norfolk 004C,E01026655,1393,1376,17,9,7,0,1
2021,King's Lynn and West Norfolk 002C,E01026656,1764,1737,27,13,10,2,2
2021,King's Lynn and West Norfolk 016A,E01026659,1649,1586,63,31,21,10,1
2021,King's Lynn and West Norfolk 016B,E01026660,1723,1678,45,19,16,8,2
2021,King's Lynn and West Norfolk 016C,E01026661,1639,1605,34,16,13,5,0
2021,King's Lynn and West Norfolk 010A,E01026662,2738,2180,558,217,238,93,10
2021,King's Lynn and West Norfolk 010B,E01026663,1688,1402,286,126,90,64,6
2021,King's Lynn and West Norfolk 010C,E01026664,2126,1646,480,257,177,42,4
2021,King's Lynn and West Norfolk 012A,E01026665,2402,2366,36,16,10,6,4
2021,King's Lynn and West Norfolk 009A,E01026666,1940,1510,430,152,163,98,17
2021,King's Lynn and West Norfolk 009B,E01026667,1442,1341,101,45,27,24,5
2021,King's Lynn and West Norfolk 009C,E01026668,1591,1373,218,63,105,49,1
2021,King's Lynn and West Norfolk 006A,E01026669,1901,1778,123,62,44,14,3
2021,King's Lynn and West Norfolk 006B,E01026670,1564,1465,99,32,37,28,2
2021,King's Lynn and West Norfolk 006C,E01026671,1315,1288,27,12,11,4,0
2021,King's Lynn and West Norfolk 006D,E01026672,1376,1356,20,7,9,2,2
2021,King's Lynn and West Norfolk 006E,E01026673,1377,1328,49,23,20,3,3
2021,King's Lynn and West Norfolk 012B,E01026674,1103,1094,9,3,5,1,0
2021,King's Lynn and West Norfolk 012C,E01026675,1208,1198,10,3,4,3,0
2021,King's Lynn and West Norfolk 003A,E01026676,1605,1596,9,3,4,2,0
2021,King's Lynn and West Norfolk 003B,E01026677,1430,1425,5,4,1,0,0
2021,King's Lynn and West Norfolk 003C,E01026678,1515,1500,15,7,4,4,0
2021,King's Lynn and West Norfolk 018A,E01026679,2376,2342,34,19,11,4,0
2021,King's Lynn and West Norfolk 001A,E01026680,1574,1544,30,13,15,2,0
2021,King's Lynn and West Norfolk 001B,E01026681,1196,1189,7,2,1,3,1
2021,King's Lynn and West Norfolk 001C,E01026682,1129,1114,15,2,8,4,1
2021,King's Lynn and West Norfolk 001D,E01026683,1253,1230,23,12,7,4,0
2021,King's Lynn and West Norfolk 013A,E01026684,1395,1359,36,18,11,5,2
2021,King's Lynn and West Norfolk 013B,E01026685,1216,1143,73,24,30,19,0
2021,King's Lynn and West Norfolk 007A,E01026687,1874,1373,501,165,195,128,13
2021,King's Lynn and West Norfolk 007B,E01026688,1622,1296,326,118,132,67,9
2021,King's Lynn and West Norfolk 007C,E01026689,1455,980,475,113,208,132,22
2021,King's Lynn and West Norfolk 007D,E01026690,1614,1324,290,98,112,70,10
2021,King's Lynn and West Norfolk 005A,E01026691,1173,1118,55,30,13,9,3
2021,King's Lynn and West Norfolk 005B,E01026692,1121,1092,29,10,10,9,0
2021,King's Lynn and West Norfolk 009D,E01026693,2171,1999,172,69,63,34,6
2021,King's Lynn and West Norfolk 012D,E01026694,2570,2524,46,18,17,11,0
2021,King's Lynn and West Norfolk 002D,E01026695,2088,2066,22,15,4,0,3
2021,King's Lynn and West Norfolk 015A,E01026696,1206,1179,27,10,9,6,2
2021,King's Lynn and West Norfolk 015B,E01026697,1316,1287,29,12,12,3,2
2021,King's Lynn and West Norfolk 011B,E01026699,1553,1108,445,115,202,115,13
2021,King's Lynn and West Norfolk 011C,E01026700,1356,1087,269,64,105,88,12
2021,King's Lynn and West Norfolk 003D,E01026701,1650,1641,9,7,1,1,0
2021,King's Lynn and West Norfolk 003E,E01026702,1301,1296,5,2,2,0,1
2021,King's Lynn and West Norfolk 003F,E01026703,1093,1081,12,7,3,0,2
2021,King's Lynn and West Norfolk 011D,E01026704,1772,1415,357,111,151,81,14
2021,King's Lynn and West Norfolk 011E,E01026705,1739,1662,77,38,27,8,4
2021,King's Lynn and West Norfolk 011F,E01026706,1962,1591,371,126,150,72,23
2021,King's Lynn and West Norfolk 005C,E01026708,1357,1332,25,10,13,2,0
2021,King's Lynn and West Norfolk 005D,E01026709,1886,1825,61,29,21,8,3
2021,King's Lynn and West Norfolk 005E,E01026710,1177,1140,37,25,7,4,1
2021,King's Lynn and West Norfolk 008B,E01026711,1514,1480,34,10,11,11,2
2021,King's Lynn and West Norfolk 008C,E01026712,1821,1784,37,20,13,3,1
2021,King's Lynn and West Norfolk 008D,E01026713,1650,1601,49,19,16,9,5
2021,King's Lynn and West Norfolk 010D,E01026714,2201,1902,299,183,89,27,0
2021,King's Lynn and West Norfolk 016D,E01026715,1560,1524,36,14,12,7,3
2021,King's Lynn and West Norfolk 016E,E01026716,1927,1883,44,23,11,7,3
2021,King's Lynn and West Norfolk 016F,E01026717,1635,1618,17,9,4,4,0
2021,King's Lynn and West Norfolk 004D,E01026718,2253,2243,10,5,5,0,0
2021,King's Lynn and West Norfolk 013C,E01026719,2422,2385,37,16,13,7,1
2021,King's Lynn and West Norfolk 013D,E01026720,1361,1345,16,6,7,1,2
2021,King's Lynn and West Norfolk 013E,E01026721,1440,1422,18,2,9,4,3
2021,King's Lynn and West Norfolk 015C,E01026722,2517,2484,33,10,12,9,2
2021,King's Lynn and West Norfolk 014D,E01026723,1636,1576,60,34,17,8,1
2021,King's Lynn and West Norfolk 014E,E01026724,1814,1751,63,22,30,10,1
2021,King's Lynn and West Norfolk 014F,E01026725,1448,1436,12,8,3,1,0
2021,King's Lynn and West Norfolk 015D,E01026726,2113,2077,36,12,18,6,0
2021,King's Lynn and West Norfolk 018B,E01026727,2543,2525,18,11,3,3,1
2021,King's Lynn and West Norfolk 018C,E01026728,2479,2440,39,16,13,10,0
2021,North Norfolk 008A,E01026729,2150,2119,31,14,7,7,3
2021,North Norfolk 008B,E01026730,2468,2454,14,9,5,0,0
2021,North Norfolk 006C,E01026733,2344,2332,12,7,2,2,1
2021,North Norfolk 003A,E01026734,1010,945,65,27,32,5,1
2021,North Norfolk 003B,E01026735,1131,1092,39,19,13,5,2
2021,North Norfolk 003C,E01026736,1274,1250,24,14,7,3,0
2021,North Norfolk 006D,E01026737,2309,2292,17,10,5,2,0
2021,North Norfolk 007A,E01026738,2345,2338,7,3,4,0,0
2021,North Norfolk 002A,E01026739,1883,1865,18,12,2,4,0
2021,North Norfolk 012A,E01026740,2334,2316,18,8,8,2,0
2021,North Norfolk 004A,E01026741,1713,1696,17,14,1,2,0
2021,North Norfolk 004B,E01026742,1798,1757,41,24,11,6,0
2021,North Norfolk 004C,E01026743,2121,2084,37,15,19,3,0
2021,North Norfolk 014A,E01026744,2251,2228,23,13,8,2,0
2021,North Norfolk 011A,E01026745,1803,1752,51,19,20,9,3
2021,North Norfolk 011B,E01026746,1667,1621,46,13,26,7,0
2021,North Norfolk 011C,E01026747,1292,1222,70,26,30,12,2
2021,North Norfolk 011D,E01026748,1453,1415,38,15,18,3,2
2021,North Norfolk 011E,E01026749,1577,1520,57,18,27,9,3
2021,North Norfolk 007B,E01026750,1322,1296,26,8,9,7,2
2021,North Norfolk 007C,E01026751,1396,1379,17,9,1,4,3
2021,North Norfolk 007D,E01026752,1488,1475,13,3,10,0,0
2021,North Norfolk 015D,E01026753,1517,1507,10,6,4,0,0
2021,North Norfolk 015C,E01026754,1313,1300,13,5,6,1,1
2021,North Norfolk 015E,E01026755,1168,1163,5,2,3,0,0
2021,North Norfolk 015B,E01026756,1229,1223,6,4,2,0,0
2021,North Norfolk 015A,E01026757,1423,1414,9,5,2,2,0
2021,North Norfolk 016B,E01026758,1279,1249,30,13,10,7,0
2021,North Norfolk 016C,E01026759,1396,1393,3,2,1,0,0
2021,North Norfolk 016D,E01026760,1866,1831,35,11,11,9,4
2021,North Norfolk 016A,E01026761,1496,1481,15,4,5,5,1
2021,North Norfolk 002B,E01026763,1279,1254,25,7,15,3,0
2021,North Norfolk 002C,E01026764,1240,1220,20,7,10,2,1
2021,North Norfolk 002D,E01026765,1320,1307,13,11,2,0,0
2021,North Norfolk 005B,E01026766,2306,2297,9,2,2,4,1
2021,North Norfolk 012B,E01026767,1197,1176,21,11,8,2,0
2021,North Norfolk 012C,E01026768,1854,1798,56,17,23,10,6
2021,North Norfolk 014B,E01026769,2033,2024,9,5,4,0,0
2021,North Norfolk 001A,E01026770,1737,1713,24,8,11,4,1
2021,North Norfolk 001B,E01026771,1483,1472,11,8,2,1,0
2021,North Norfolk 001C,E01026772,1741,1725,16,7,6,3,0
2021,North Norfolk 001D,E01026773,2029,2014,15,8,2,3,2
2021,North Norfolk 013A,E01026774,1651,1640,11,6,4,1,0
2021,North Norfolk 013B,E01026775,1258,1245,13,4,5,4,0
2021,North Norfolk 013C,E01026776,1759,1734,25,10,10,5,0
2021,North Norfolk 003D,E01026777,1291,1277,14,5,8,1,0
2021,North Norfolk 003E,E01026778,1351,1320,31,15,12,4,0
2021,North Norfolk 003F,E01026779,1367,1342,25,12,12,1,0
2021,North Norfolk 009A,E01026780,2647,2621,26,12,9,3,2
2021,North Norfolk 005C,E01026781,1986,1974,12,5,5,0,2
2021,North Norfolk 009B,E01026782,2076,2058,18,9,4,4,1
2021,North Norfolk 014C,E01026783,1794,1777,17,8,6,3,0
2021,North Norfolk 014D,E01026784,1050,1045,5,5,0,0,0
2021,North Norfolk 014E,E01026785,1335,1330,5,2,3,0,0
2021,North Norfolk 013D,E01026786,2003,1990,13,7,6,0,0
2021,North Norfolk 009C,E01026787,1054,1050,4,2,2,0,0
2021,North Norfolk 008C,E01026788,1212,1201,11,9,2,0,0
2021,North Norfolk 012D,E01026789,1140,1134,6,4,2,0,0
2021,North Norfolk 012E,E01026790,1172,1156,16,7,4,4,1
2021,Norwich 005A,E01026791,1456,1261,195,74,77,39,5
2021,Norwich 005B,E01026792,1356,1207,149,70,49,26,4
2021,Norwich 005C,E01026793,1824,1634,190,77,76,35,2
2021,Norwich 005D,E01026794,1973,1796,177,93,57,18,9
2021,Norwich 005F,E01026796,2029,1837,192,104,60,23,5
2021,Norwich 001A,E01026797,2570,2141,429,159,173,93,4
2021,Norwich 001B,E01026798,1496,1313,183,77,75,29,2
2021,Norwich 001C,E01026799,1507,1300,207,109,73,22,3
2021,Norwich 001D,E01026800,2051,1767,284,99,130,49,6
2021,Norwich 001E,E01026801,1527,1449,78,32,37,9,0
2021,Norwich 001F,E01026802,1617,1470,147,53,60,31,3
2021,Norwich 004A,E01026803,1503,1361,142,56,56,24,6
2021,Norwich 004B,E01026804,1477,1423,54,19,19,14,2
2021,Norwich 004C,E01026805,1480,1388,92,43,33,15,1
2021,Norwich 004D,E01026806,1544,1501,43,25,12,4,2
2021,Norwich 004E,E01026807,1297,1210,87,38,32,16,1
2021,Norwich 004F,E01026808,1265,1180,85,38,33,14,0
2021,Norwich 004G,E01026809,1449,1363,86,29,44,12,1
2021,Norwich 012A,E01026810,1586,1506,80,51,22,7,0
2021,Norwich 012B,E01026811,1549,1490,59,36,16,5,2
2021,Norwich 012C,E01026812,1576,1487,89,54,25,10,0
2021,Norwich 012D,E01026813,1393,1307,86,56,23,6,1
2021,Norwich 012E,E01026814,1614,1484,130,74,40,14,2
2021,Norwich 012F,E01026815,1469,1375,94,59,27,7,1
2021,Norwich 013A,E01026816,1830,1649,181,104,55,13,9
2021,Norwich 013B,E01026817,1451,1333,118,55,46,15,2
2021,Norwich 013C,E01026818,1521,1415,106,41,36,26,3
2021,Norwich 013D,E01026819,1423,1304,119,56,46,17,0
2021,Norwich 013E,E01026820,1816,1676,140,60,58,20,2
2021,Norwich 013F,E01026821,1560,1438,122,53,55,13,1
2021,Norwich 017A,E01026823,2124,1918,206,114,58,30,4
2021,Norwich 016D,E01026824,1707,1454,253,121,88,38,6
2021,Norwich 016A,E01026825,1400,1267,133,68,43,16,6
2021,Norwich 016B,E01026826,1595,1382,213,89,77,41,6
2021,Norwich 016C,E01026827,1534,1310,224,86,103,32,3
2021,Norwich 002A,E01026828,1636,1478,158,60,69,26,3
2021,Norwich 002B,E01026829,2104,1763,341,139,142,55,5
2021,Norwich 002C,E01026830,1319,1148,171,60,76,34,1
2021,Norwich 002D,E01026831,1271,1144,127,53,48,25,1
2021,Norwich 002E,E01026832,1450,1314,136,61,51,23,1
2021,Norwich 002F,E01026833,1505,1260,245,97,104,40,4
2021,Norwich 002G,E01026834,1549,1379,170,56,84,22,8
2021,Norwich 009A,E01026835,1484,1410,74,55,15,3,1
2021,Norwich 009B,E01026836,1467,1409,58,38,13,7,0
2021,Norwich 009C,E01026837,1446,1352,94,56,34,3,1
2021,Norwich 009D,E01026838,1496,1409,87,70,13,4,0
2021,Norwich 009E,E01026839,1514,1404,110,69,28,13,0
2021,Norwich 009F,E01026840,1567,1462,105,56,38,10,1
2021,Norwich 003A,E01026841,1388,1240,148,61,49,36,2
2021,Norwich 003B,E01026842,1700,1516,184,85,57,33,9
2021,Norwich 003C,E01026843,1857,1681,176,75,65,32,4
2021,Norwich 003D,E01026844,1802,1634,168,68,71,25,4
2021,Norwich 003E,E01026845,1518,1336,182,75,67,33,7
2021,Norwich 003F,E01026846,1755,1532,223,89,85,46,3
2021,Norwich 015A,E01026848,1802,1555,247,96,103,43,5
2021,Norwich 015B,E01026849,1743,1567,176,94,62,18,2
2021,Norwich 015C,E01026850,1847,1706,141,73,52,16,0
2021,Norwich 011A,E01026852,1289,1219,70,41,19,10,0
2021,Norwich 011B,E01026853,1896,1681,215,103,77,30,5
2021,Norwich 011D,E01026855,1676,1521,155,96,50,7,2
2021,Norwich 011E,E01026856,1746,1619,127,90,30,6,1
2021,Norwich 011F,E01026857,1514,1411,103,64,29,9,1
2021,Norwich 010A,E01026858,1608,1383,225,91,96,33,5
2021,Norwich 010B,E01026859,1587,1461,126,55,56,15,0
2021,Norwich 010C,E01026860,4467,3940,527,270,212,42,3
2021,Norwich 010D,E01026861,1717,1569,148,67,56,21,4
2021,Norwich 010E,E01026862,1324,1231,93,48,32,12,1
2021,Norwich 006A,E01026863,1930,1716,214,95,81,34,4
2021,Norwich 006B,E01026864,1491,1368,123,52,45,26,0
2021,Norwich 006C,E01026865,1963,1747,216,91,77,45,3
2021,Norwich 006D,E01026866,1638,1489,149,74,53,21,1
2021,Norwich 006E,E01026867,1618,1466,152,58,55,35,4
2021,Norwich 006F,E01026868,1716,1592,124,48,55,17,4
2021,Norwich 006G,E01026869,1479,1325,154,67,62,20,5
2021,South Norfolk 005A,E01026870,1512,1473,39,18,16,5,0
2021,South Norfolk 005B,E01026871,1196,1184,12,8,0,3,1
2021,South Norfolk 013A,E01026872,2249,2234,15,8,1,1,5
2021,South Norfolk 014A,E01026873,1210,1205,5,5,0,0,0
2021,South Norfolk 014B,E01026874,1519,1506,13,7,4,0,2
2021,South Norfolk 006A,E01026875,1086,1079,7,6,1,0,0
2021,South Norfolk 006B,E01026876,1508,1507,1,1,0,0,0
2021,South Norfolk 011A,E01026877,1533,1528,5,3,2,0,0
2021,South Norfolk 011B,E01026878,1197,1189,8,7,1,0,0
2021,South Norfolk 008A,E01026879,1212,1188,24,12,8,4,0
2021,South Norfolk 008B,E01026880,1419,1398,21,15,3,1,2
2021,South Norfolk 002A,E01026881,1768,1664,104,64,36,4,0
2021,South Norfolk 002C,E01026883,2133,2022,111,81,20,9,1
2021,South Norfolk 007A,E01026884,2390,2338,52,36,11,4,1
2021,South Norfolk 007B,E01026885,1572,1555,17,11,5,1,0
2021,South Norfolk 014C,E01026886,1299,1288,11,10,1,0,0
2021,South Norfolk 014D,E01026887,1554,1548,6,4,2,0,0
2021,South Norfolk 015A,E01026888,1616,1537,79,26,36,17,0
2021,South Norfolk 015B,E01026889,1509,1446,63,22,27,13,1
2021,South Norfolk 015D,E01026891,1690,1563,127,45,47,34,1
2021,South Norfolk 012A,E01026892,1243,1227,16,7,6,1,2
2021,South Norfolk 012B,E01026893,1260,1245,15,11,3,1,0
2021,South Norfolk 012C,E01026894,2491,2470,21,10,7,3,1
2021,South Norfolk 002D,E01026895,1404,1378,26,19,5,2,0
2021,South Norfolk 002E,E01026896,1123,1115,8,5,3,0,0
2021,South Norfolk 011C,E01026897,2740,2722,18,12,5,1,0
2021,South Norfolk 010A,E01026898,1433,1422,11,9,2,0,0
2021,South Norfolk 010B,E01026899,1589,1576,13,4,5,4,0
2021,South Norfolk 013B,E01026900,1464,1457,7,5,1,1,0
2021,South Norfolk 013C,E01026901,1288,1268,20,8,4,5,3
2021,South Norfolk 013D,E01026902,2374,2309,65,25,29,8,3
2021,South Norfolk 012D,E01026903,1146,1143,3,2,1,0,0
2021,South Norfolk 012E,E01026904,1342,1335,7,7,0,0,0
2021,South Norfolk 003A,E01026905,998,981,17,3,11,3,0
2021,South Norfolk 003B,E01026906,1713,1654,59,33,16,9,1
2021,South Norfolk 003C,E01026907,1857,1817,40,24,11,4,1
2021,South Norfolk 003D,E01026908,2383,2262,121,88,20,12,1
2021,South Norfolk 004A,E01026909,1422,1401,21,9,8,3,1
2021,South Norfolk 004B,E01026910,1571,1548,23,16,6,0,1
2021,South Norfolk 008C,E01026911,1417,1391,26,11,7,8,0
2021,South Norfolk 008D,E01026912,1646,1628,18,9,7,1,1
2021,South Norfolk 009A,E01026913,1609,1590,19,15,1,3,0
2021,South Norfolk 009B,E01026914,1899,1875,24,17,2,2,3
2021,South Norfolk 009C,E01026915,1993,1966,27,16,8,3,0
2021,South Norfolk 017A,E01026916,2000,1951,49,27,13,8,1
2021,South Norfolk 017C,E01026917,1372,1329,43,22,15,6,0
2021,South Norfolk 017B,E01026918,1608,1550,58,29,19,9,1
2021,South Norfolk 009D,E01026919,1444,1422,22,8,5,8,1
2021,South Norfolk 009E,E01026920,1169,1162,7,2,4,1,0
2021,South Norfolk 005C,E01026921,1256,1230,26,21,5,0,0
2021,South Norfolk 005D,E01026922,1400,1372,28,14,10,4,0
2021,South Norfolk 016D,E01026924,1590,1544,46,32,10,2,2
2021,South Norfolk 017D,E01026925,2380,2246,134,75,45,11,3
2021,South Norfolk 006D,E01026927,1746,1727,19,11,7,1,0
2021,South Norfolk 006E,E01026928,1841,1794,47,23,15,9,0
2021,South Norfolk 008E,E01026929,1352,1342,10,10,0,0,0
2021,South Norfolk 008F,E01026930,1546,1531,15,9,3,3,0
2021,South Norfolk 015E,E01026931,1064,1052,12,6,4,2,0
2021,South Norfolk 015F,E01026932,1306,1228,78,28,33,13,4
2021,South Norfolk 014E,E01026934,1020,1000,20,9,9,1,1
2021,South Norfolk 014F,E01026935,1322,1315,7,3,2,2,0
2021,South Norfolk 006F,E01026936,1691,1675,16,9,4,3,0
2021,South Norfolk 006G,E01026937,1496,1475,21,19,1,1,0
2021,South Norfolk 011D,E01026938,2092,2037,55,24,19,9,3
2021,South Norfolk 011E,E01026939,1671,1659,12,7,4,0,1
2021,South Norfolk 011F,E01026940,2020,1996,24,13,6,4,1
2021,South Norfolk 009F,E01026941,1216,1203,13,5,6,2,0
2021,South Norfolk 009G,E01026942,1080,1067,13,9,3,1,0
2021,South Norfolk 010C,E01026943,1489,1473,16,6,5,5,0
2021,South Norfolk 010D,E01026944,1225,1217,8,6,2,0,0
2021,South Norfolk 004C,E01026947,1388,1375,13,8,3,2,0
2021,South Norfolk 004D,E01026948,1872,1839,33,21,12,0,0
2021,North Northamptonshire 005A,E01026949,1355,1135,220,65,110,40,5
2021,North Northamptonshire 005B,E01026950,1576,1175,401,121,187,86,7
2021,North Northamptonshire 005C,E01026951,1304,1020,284,96,114,63,11
2021,North Northamptonshire 005D,E01026952,1403,1222,181,64,94,23,0
2021,North Northamptonshire 009A,E01026953,1369,1255,114,48,50,14,2
2021,North Northamptonshire 009B,E01026954,1527,1278,249,85,117,45,2
2021,North Northamptonshire 009C,E01026955,1350,1334,16,12,2,2,0
2021,North Northamptonshire 009D,E01026956,2215,1922,293,128,119,42,4
2021,North Northamptonshire 006A,E01026957,1810,1592,218,78,87,52,1
2021,North Northamptonshire 006B,E01026958,1884,1400,484,154,237,84,9
2021,North Northamptonshire 007A,E01026959,1480,1250,230,77,109,39,5
2021,North Northamptonshire 007B,E01026960,1543,1091,452,134,210,90,18
2021,North Northamptonshire 007C,E01026961,1288,1039,249,71,105,68,5
2021,North Northamptonshire 004A,E01026962,1397,1206,191,60,89,35,7
2021,North Northamptonshire 008A,E01026963,1309,1090,219,83,104,30,2
2021,North Northamptonshire 007D,E01026965,1549,1103,446,128,205,102,11
2021,North Northamptonshire 007E,E01026966,1442,1276,166,56,87,19,4
2021,North Northamptonshire 007F,E01026967,1791,1385,406,111,213,79,3
2021,North Northamptonshire 007G,E01026968,1700,1309,391,105,187,90,9
2021,North Northamptonshire 003A,E01026969,1730,1491,239,96,103,37,3
2021,North Northamptonshire 003B,E01026970,1660,1490,170,59,83,21,7
2021,North Northamptonshire 002A,E01026971,1720,1461,259,77,128,49,5
2021,North Northamptonshire 003C,E01026972,1777,1466,311,115,133,54,9
2021,North Northamptonshire 004B,E01026973,1421,1271,150,54,67,26,3
2021,North Northamptonshire 004C,E01026974,1105,1027,78,35,28,13,2
2021,North Northamptonshire 004D,E01026975,1344,1141,203,67,98,29,9
2021,North Northamptonshire 003D,E01026976,1603,1307,296,88,129,70,9
2021,North Northamptonshire 002B,E01026979,1597,1583,14,7,4,3,0
2021,North Northamptonshire 002C,E01026980,1598,1580,18,9,4,3,2
2021,North Northamptonshire 003E,E01026981,1206,1080,126,47,53,23,3
2021,North Northamptonshire 002D,E01026982,2182,1739,443,146,201,84,12
2021,North Northamptonshire 003F,E01026983,1070,888,182,45,86,50,1
2021,North Northamptonshire 004E,E01026984,1835,1578,257,86,124,41,6
2021,North Northamptonshire 004F,E01026985,1984,1751,233,78,115,36,4
2021,West Northamptonshire 016A,E01026986,2826,2411,415,123,205,68,19
2021,West Northamptonshire 010A,E01026987,1136,1051,85,33,31,17,4
2021,West Northamptonshire 016B,E01026988,1514,1310,204,66,92,42,4
2021,West Northamptonshire 010B,E01026989,1324,1219,105,34,48,18,5
2021,West Northamptonshire 016C,E01026991,1550,1470,80,25,37,18,0
2021,West Northamptonshire 016D,E01026992,1979,1698,281,77,126,70,8
2021,West Northamptonshire 042A,E01026993,2024,1986,38,20,12,6,0
2021,West Northamptonshire 004A,E01026994,1097,1080,17,14,1,2,0
2021,West Northamptonshire 005A,E01026998,2335,2276,59,38,13,5,3
2021,West Northamptonshire 004B,E01026999,1779,1755,24,14,8,0,2
2021,West Northamptonshire 002A,E01027000,1443,1420,23,17,4,2,0
2021,West Northamptonshire 002B,E01027001,1970,1940,30,22,4,4,0
2021,West Northamptonshire 002C,E01027002,1725,1707,18,15,2,1,0
2021,West Northamptonshire 002D,E01027003,1397,1372,25,14,9,2,0
2021,West Northamptonshire 042B,E01027004,1846,1819,27,16,9,1,1
2021,West Northamptonshire 001A,E01027005,2241,2221,20,13,4,3,0
2021,West Northamptonshire 004C,E01027006,2450,2403,47,23,17,7,0
2021,West Northamptonshire 022A,E01027007,1661,1374,287,86,125,71,5
2021,West Northamptonshire 022B,E01027008,1895,1688,207,60,107,40,0
2021,West Northamptonshire 022C,E01027009,1585,1304,281,95,115,63,8
2021,West Northamptonshire 016E,E01027010,1256,1198,58,25,22,10,1
2021,West Northamptonshire 027A,E01027011,2132,2095,37,20,13,3,1
2021,West Northamptonshire 010C,E01027012,2283,2061,222,95,84,39,4
2021,West Northamptonshire 022D,E01027013,1749,1514,235,82,107,39,7
2021,West Northamptonshire 005B,E01027015,1370,1348,22,11,8,3,0
2021,West Northamptonshire 005C,E01027016,1443,1420,23,15,5,3,0
2021,West Northamptonshire 027B,E01027017,1864,1809,55,33,14,6,2
2021,West Northamptonshire 003A,E01027018,2409,2327,82,52,23,3,4
2021,West Northamptonshire 003B,E01027019,2070,1992,78,46,26,3,3
2021,West Northamptonshire 003C,E01027020,1739,1686,53,31,13,7,2
2021,West Northamptonshire 005D,E01027021,1835,1816,19,9,7,2,1
2021,West Northamptonshire 002E,E01027022,1885,1860,25,12,9,3,1
2021,West Northamptonshire 003D,E01027023,2045,2008,37,18,15,4,0
2021,West Northamptonshire 027C,E01027024,1704,1684,20,10,8,2,0
2021,West Northamptonshire 027D,E01027025,1736,1696,40,22,9,7,2
2021,West Northamptonshire 001B,E01027026,2107,2073,34,14,12,8,0
2021,West Northamptonshire 005E,E01027027,2648,2600,48,25,8,13,2
2021,West Northamptonshire 042C,E01027028,2064,2021,43,26,9,8,0
2021,West Northamptonshire 042D,E01027029,2314,2248,66,37,22,7,0
2021,West Northamptonshire 001C,E01027030,1834,1806,28,16,8,4,0
2021,North Northamptonshire 010A,E01027031,2116,2074,42,21,15,6,0
2021,North Northamptonshire 011A,E01027032,1818,1799,19,7,5,7,0
2021,North Northamptonshire 001A,E01027033,1871,1848,23,18,4,1,0
2021,North Northamptonshire 035A,E01027034,1586,1546,40,23,11,4,2
2021,North Northamptonshire 035B,E01027035,1433,1388,45,22,17,4,2
2021,North Northamptonshire 035C,E01027037,2476,2452,24,16,2,5,1
2021,North Northamptonshire 027A,E01027038,1867,1792,75,35,28,9,3
2021,North Northamptonshire 027B,E01027039,2022,1947,75,27,37,10,1
2021,North Northamptonshire 027C,E01027040,1703,1642,61,31,21,7,2
2021,North Northamptonshire 027D,E01027041,1638,1534,104,48,35,20,1
2021,North Northamptonshire 027E,E01027042,1759,1681,78,37,33,7,1
2021,North Northamptonshire 001B,E01027043,2342,2266,76,28,24,24,0
2021,North Northamptonshire 010B,E01027044,2151,2112,39,20,16,3,0
2021,North Northamptonshire 011B,E01027045,1986,1958,28,19,9,0,0
2021,North Northamptonshire 010C,E01027046,1578,1540,38,29,8,1,0
2021,North Northamptonshire 010D,E01027047,1299,1253,46,15,18,9,4
2021,North Northamptonshire 010E,E01027048,2228,2159,69,46,20,3,0
2021,North Northamptonshire 010F,E01027049,1032,1009,23,12,7,4,0
2021,North Northamptonshire 001C,E01027050,2097,2067,30,22,6,2,0
2021,North Northamptonshire 025A,E01027051,2017,1939,78,34,25,15,4
2021,North Northamptonshire 025B,E01027052,1483,1454,29,17,8,3,1
2021,North Northamptonshire 025C,E01027053,2109,2051,58,36,14,8,0
2021,North Northamptonshire 025D,E01027054,1135,1118,17,5,7,3,2
2021,North Northamptonshire 025E,E01027055,1255,1221,34,8,23,2,1
2021,North Northamptonshire 025F,E01027056,1540,1509,31,14,13,2,2
2021,North Northamptonshire 024A,E01027057,2245,2198,47,30,10,7,0
2021,North Northamptonshire 037A,E01027058,1707,1616,91,33,49,9,0
2021,North Northamptonshire 037B,E01027059,1684,1556,128,54,51,18,5
2021,North Northamptonshire 037C,E01027060,2117,1917,200,97,81,18,4
2021,North Northamptonshire 034A,E01027061,2577,2376,201,80,87,31,3
2021,North Northamptonshire 034B,E01027062,2267,2169,98,53,30,11,4
2021,North Northamptonshire 034C,E01027063,1815,1743,72,33,26,10,3
2021,North Northamptonshire 034D,E01027064,1570,1513,57,30,20,7,0
2021,North Northamptonshire 037D,E01027065,1828,1671,157,47,82,24,4
2021,North Northamptonshire 039A,E01027066,2054,2003,51,26,18,6,1
2021,North Northamptonshire 039B,E01027067,1697,1614,83,38,32,11,2
2021,North Northamptonshire 037E,E01027069,1642,1557,85,30,29,21,5
2021,North Northamptonshire 039C,E01027070,1493,1423,70,34,23,13,0
2021,North Northamptonshire 039D,E01027071,1386,1341,45,23,17,3,2
2021,North Northamptonshire 034E,E01027072,1713,1628,85,26,38,14,7
2021,North Northamptonshire 034F,E01027073,1997,1916,81,31,33,16,1
2021,North Northamptonshire 024B,E01027074,2063,2035,28,13,11,4,0
2021,North Northamptonshire 011C,E01027075,1941,1868,73,24,39,9,1
2021,North Northamptonshire 011D,E01027076,2137,2077,60,20,27,12,1
2021,North Northamptonshire 024C,E01027078,2051,2033,18,12,4,0,2
2021,North Northamptonshire 015A,E01027079,1807,1663,144,52,68,22,2
2021,North Northamptonshire 015B,E01027080,1910,1828,82,43,27,9,3
2021,North Northamptonshire 016A,E01027081,1508,1319,189,82,82,25,0
2021,North Northamptonshire 016B,E01027082,1766,1533,233,104,94,33,2
2021,North Northamptonshire 016C,E01027083,1465,1296,169,77,62,23,7
2021,North Northamptonshire 021A,E01027084,2262,2209,53,30,22,1,0
2021,North Northamptonshire 021B,E01027085,1529,1457,72,39,26,3,4
2021,North Northamptonshire 021C,E01027086,2044,1962,82,30,32,15,5
2021,North Northamptonshire 015C,E01027087,1117,1015,102,44,47,9,2
2021,North Northamptonshire 015D,E01027088,1226,1117,109,45,38,20,6
2021,North Northamptonshire 015E,E01027089,2159,1968,191,92,62,27,10
2021,North Northamptonshire 012A,E01027090,1655,1597,58,24,20,11,3
2021,North Northamptonshire 023A,E01027091,1863,1804,59,27,20,11,1
2021,North Northamptonshire 023B,E01027092,1878,1782,96,34,30,24,8
2021,North Northamptonshire 013A,E01027094,1530,1522,8,5,0,1,2
2021,North Northamptonshire 013B,E01027095,1578,1538,40,27,7,6,0
2021,North Northamptonshire 019A,E01027096,1136,1034,102,29,50,18,5
2021,North Northamptonshire 019B,E01027097,1483,1335,148,65,63,16,4
2021,North Northamptonshire 019C,E01027098,1135,1058,77,33,30,12,2
2021,North Northamptonshire 019D,E01027099,1449,1358,91,45,27,16,3
2021,North Northamptonshire 022A,E01027100,1743,1587,156,63,68,23,2
2021,North Northamptonshire 023C,E01027102,1823,1739,84,45,32,7,0
2021,North Northamptonshire 012B,E01027103,1583,1562,21,10,10,1,0
2021,North Northamptonshire 018A,E01027104,2342,1857,485,210,182,84,9
2021,North Northamptonshire 017A,E01027105,2449,1777,672,230,297,132,13
2021,North Northamptonshire 017B,E01027106,2013,1434,579,195,250,117,17
2021,North Northamptonshire 013C,E01027107,1251,1224,27,11,11,5,0
2021,North Northamptonshire 013D,E01027108,1293,1272,21,9,6,6,0
2021,North Northamptonshire 013E,E01027109,1192,1165,27,13,13,0,1
2021,North Northamptonshire 017C,E01027111,2087,1692,395,135,177,69,14
2021,North Northamptonshire 017D,E01027112,2250,1777,473,168,210,88,7
2021,North Northamptonshire 018B,E01027113,2190,1989,201,89,80,28,4
2021,North Northamptonshire 022B,E01027114,1607,1478,129,63,49,14,3
2021,North Northamptonshire 018C,E01027115,2011,1857,154,90,53,10,1
2021,North Northamptonshire 018D,E01027116,2123,1764,359,202,118,28,11
2021,North Northamptonshire 018E,E01027117,1423,1168,255,143,79,31,2
2021,North Northamptonshire 020A,E01027119,1641,1609,32,16,13,2,1
2021,North Northamptonshire 021D,E01027120,1258,1176,82,30,37,13,2
2021,North Northamptonshire 021E,E01027121,2290,2180,110,56,40,14,0
2021,North Northamptonshire 019E,E01027122,1159,1099,60,30,21,5,4
2021,North Northamptonshire 014A,E01027123,1599,1561,38,16,14,8,0
2021,North Northamptonshire 014B,E01027125,1743,1709,34,15,14,4,1
2021,North Northamptonshire 014C,E01027126,2334,2266,68,41,18,8,1
2021,North Northamptonshire 016D,E01027127,1891,1732,159,61,69,28,1
2021,North Northamptonshire 016E,E01027128,1746,1531,215,91,100,21,3
2021,North Northamptonshire 012C,E01027129,2216,2194,22,12,9,1,0
2021,North Northamptonshire 022C,E01027130,1842,1718,124,58,50,12,4
2021,North Northamptonshire 022D,E01027131,2186,1954,232,102,97,26,7
2021,West Northamptonshire 030A,E01027132,2126,1464,662,235,286,124,17
2021,West Northamptonshire 030B,E01027133,1908,1415,493,170,230,80,13
2021,West Northamptonshire 030C,E01027134,1826,1281,545,188,210,128,19
2021,West Northamptonshire 030D,E01027135,1762,1577,185,85,70,27,3
2021,West Northamptonshire 019A,E01027136,1650,1388,262,106,89,63,4
2021,West Northamptonshire 024A,E01027137,1578,1221,357,116,162,69,10
2021,West Northamptonshire 024B,E01027138,1537,1352,185,70,80,33,2
2021,West Northamptonshire 024C,E01027139,1555,1262,293,108,132,48,5
2021,West Northamptonshire 026A,E01027140,1716,1455,261,89,101,63,8
2021,West Northamptonshire 024D,E01027141,2044,1863,181,89,61,24,7
2021,West Northamptonshire 026B,E01027142,1574,1367,207,91,82,27,7
2021,West Northamptonshire 008A,E01027143,1556,1427,129,56,50,16,7
2021,West Northamptonshire 008B,E01027144,1479,1448,31,16,14,1,0
2021,West Northamptonshire 006A,E01027145,1533,1365,168,50,78,32,8
2021,West Northamptonshire 008C,E01027146,1489,1408,81,27,36,16,2
2021,West Northamptonshire 008D,E01027147,2007,1785,222,91,85,39,7
2021,West Northamptonshire 006B,E01027148,1408,1348,60,31,24,5,0
2021,West Northamptonshire 006C,E01027149,1327,1246,81,41,26,13,1
2021,West Northamptonshire 033A,E01027151,1855,1235,620,207,267,124,22
2021,West Northamptonshire 032A,E01027152,1833,1216,617,192,284,126,15
2021,West Northamptonshire 032B,E01027153,2181,1400,781,267,336,153,25
2021,West Northamptonshire 032C,E01027154,2042,1251,791,218,387,167,19
2021,West Northamptonshire 031A,E01027155,2410,1356,1054,327,478,220,29
2021,West Northamptonshire 038A,E01027156,1346,1114,232,87,98,41,6
2021,West Northamptonshire 037A,E01027158,1551,1259,292,104,120,58,10
2021,West Northamptonshire 038B,E01027159,1255,1124,131,61,48,17,5
2021,West Northamptonshire 038C,E01027160,1894,1625,269,101,114,46,8
2021,West Northamptonshire 038D,E01027161,1567,1394,173,68,68,32,5
2021,West Northamptonshire 041A,E01027162,1609,1349,260,107,108,39,6
2021,West Northamptonshire 041B,E01027163,1373,1225,148,56,64,22,6
2021,West Northamptonshire 041C,E01027164,1510,1283,227,80,96,48,3
2021,West Northamptonshire 041D,E01027165,1303,1212,91,37,37,16,1
2021,West Northamptonshire 041E,E01027166,1576,1407,169,63,76,23,7
2021,West Northamptonshire 041F,E01027167,1385,1263,122,53,53,15,1
2021,West Northamptonshire 017A,E01027168,1836,1436,400,133,190,70,7
2021,West Northamptonshire 017B,E01027169,1555,1359,196,63,86,45,2
2021,West Northamptonshire 017C,E01027170,1611,1289,322,123,126,59,14
2021,West Northamptonshire 012A,E01027171,1596,1323,273,114,118,36,5
2021,West Northamptonshire 012B,E01027172,1631,1480,151,61,56,27,7
2021,West Northamptonshire 017D,E01027173,1742,1416,326,120,131,67,8
2021,West Northamptonshire 009A,E01027174,1282,1152,130,64,50,14,2
2021,West Northamptonshire 009B,E01027175,1614,1301,313,111,138,51,13
2021,West Northamptonshire 026C,E01027176,1403,1248,155,71,57,21,6
2021,West Northamptonshire 026D,E01027177,1735,1472,263,97,125,36,5
2021,West Northamptonshire 009C,E01027178,2062,1736,326,135,148,38,5
2021,West Northamptonshire 018A,E01027179,2151,1779,372,142,153,66,11
2021,West Northamptonshire 018B,E01027180,1913,1741,172,75,61,33,3
2021,West Northamptonshire 018C,E01027181,1753,1613,140,70,48,15,7
2021,West Northamptonshire 012C,E01027182,1382,1218,164,66,77,17,4
2021,West Northamptonshire 012D,E01027183,1615,1500,115,45,43,26,1
2021,West Northamptonshire 025A,E01027184,1634,1346,288,90,116,73,9
2021,West Northamptonshire 025B,E01027185,1292,1059,233,95,95,39,4
2021,West Northamptonshire 019B,E01027186,1749,1551,198,75,84,33,6
2021,West Northamptonshire 025C,E01027187,1339,1059,280,91,122,56,11
2021,West Northamptonshire 019C,E01027188,1870,1523,347,144,142,52,9
2021,West Northamptonshire 025D,E01027189,1717,1376,341,124,142,65,10
2021,West Northamptonshire 013A,E01027190,1546,1449,97,41,40,13,3
2021,West Northamptonshire 013B,E01027191,2040,1735,305,136,119,41,9
2021,West Northamptonshire 015A,E01027192,1421,1158,263,124,97,38,4
2021,West Northamptonshire 013C,E01027193,1449,1401,48,18,22,8,0
2021,West Northamptonshire 013D,E01027194,1355,1290,65,27,26,9,3
2021,West Northamptonshire 011A,E01027195,1729,1265,464,136,204,110,14
2021,West Northamptonshire 014A,E01027196,1592,1098,494,173,207,102,12
2021,West Northamptonshire 014B,E01027197,1543,1228,315,123,138,48,6
2021,West Northamptonshire 014C,E01027198,1827,1472,355,106,160,78,11
2021,West Northamptonshire 014D,E01027199,1448,1186,262,70,119,65,8
2021,West Northamptonshire 009D,E01027200,1531,1217,314,105,139,55,15
2021,West Northamptonshire 037B,E01027201,2248,2103,145,72,46,21,6
2021,West Northamptonshire 037C,E01027202,1554,1514,40,19,15,6,0
2021,West Northamptonshire 044A,E01027203,1596,1469,127,55,46,22,4
2021,West Northamptonshire 044B,E01027204,1758,1675,83,41,28,14,0
2021,West Northamptonshire 044C,E01027205,2173,1984,189,97,54,34,4
2021,West Northamptonshire 028A,E01027207,1374,1298,76,25,35,13,3
2021,West Northamptonshire 023A,E01027208,1386,1312,74,29,39,6,0
2021,West Northamptonshire 023B,E01027209,1147,1060,87,35,42,10,0
2021,West Northamptonshire 028B,E01027210,1156,1082,74,26,37,10,1
2021,West Northamptonshire 023C,E01027211,1355,1309,46,15,19,11,1
2021,West Northamptonshire 023D,E01027212,1478,1370,108,44,33,26,5
2021,West Northamptonshire 020A,E01027213,1620,1473,147,69,48,25,5
2021,West Northamptonshire 020B,E01027214,1656,1405,251,105,99,42,5
2021,West Northamptonshire 028C,E01027215,1461,1383,78,36,30,10,2
2021,West Northamptonshire 020C,E01027216,1988,1783,205,95,78,26,6
2021,West Northamptonshire 028D,E01027217,2399,2237,162,90,43,21,8
2021,West Northamptonshire 007A,E01027218,1488,1393,95,45,31,18,1
2021,West Northamptonshire 007B,E01027219,1796,1618,178,74,75,28,1
2021,West Northamptonshire 019D,E01027220,1333,1221,112,48,41,19,4
2021,West Northamptonshire 007C,E01027221,1831,1689,142,60,53,27,2
2021,West Northamptonshire 007D,E01027222,1143,1092,51,26,14,11,0
2021,West Northamptonshire 034A,E01027224,2184,1582,602,245,250,93,14
2021,West Northamptonshire 031B,E01027225,1685,1153,532,162,250,102,18
2021,West Northamptonshire 034B,E01027226,2088,1343,745,238,316,155,36
2021,West Northamptonshire 031C,E01027227,1789,1094,695,237,314,132,12
2021,West Northamptonshire 031D,E01027228,2290,1460,830,312,352,155,11
2021,West Northamptonshire 015B,E01027229,1659,1352,307,98,140,58,11
2021,West Northamptonshire 015C,E01027230,1757,1336,421,147,192,74,8
2021,West Northamptonshire 015D,E01027231,1825,1430,395,136,164,82,13
2021,West Northamptonshire 006D,E01027232,2469,2012,457,199,177,67,14
2021,West Northamptonshire 036A,E01027233,1371,1100,271,120,110,30,11
2021,West Northamptonshire 036B,E01027234,1653,1336,317,136,122,55,4
2021,West Northamptonshire 036C,E01027235,1608,1324,284,99,120,60,5
2021,West Northamptonshire 033B,E01027236,1559,1433,126,44,49,28,5
2021,West Northamptonshire 033C,E01027237,2013,1622,391,168,161,53,9
2021,West Northamptonshire 033D,E01027238,2023,1408,615,226,265,112,12
2021,West Northamptonshire 021A,E01027239,1842,1404,438,145,174,108,11
2021,West Northamptonshire 020D,E01027240,1290,1122,168,59,83,23,3
2021,West Northamptonshire 021B,E01027241,1820,1265,555,184,246,116,9
2021,West Northamptonshire 021C,E01027242,1689,1420,269,79,118,64,8
2021,West Northamptonshire 021D,E01027243,1735,1376,359,140,159,53,7
2021,West Northamptonshire 021E,E01027244,1668,1374,294,89,139,60,6
2021,West Northamptonshire 011B,E01027245,1648,1317,331,128,135,59,9
2021,West Northamptonshire 009E,E01027246,1901,1501,400,129,185,75,11
2021,West Northamptonshire 011C,E01027247,1760,1392,368,135,153,70,10
2021,West Northamptonshire 011D,E01027248,1628,1288,340,117,148,70,5
2021,West Northamptonshire 011E,E01027249,1831,1441,390,96,180,96,18
2021,West Northamptonshire 039A,E01027250,1323,1197,126,45,63,18,0
2021,West Northamptonshire 036D,E01027252,1551,1297,254,101,103,46,4
2021,West Northamptonshire 039B,E01027253,1766,1645,121,37,56,26,2
2021,West Northamptonshire 039C,E01027254,2080,1904,176,83,72,18,3
2021,West Northamptonshire 029A,E01027255,1539,1421,118,72,33,10,3
2021,West Northamptonshire 029B,E01027256,1498,1425,73,35,26,9,3
2021,West Northamptonshire 034C,E01027257,1291,1221,70,27,19,11,13
2021,West Northamptonshire 029C,E01027258,1314,1192,122,69,31,16,6
2021,West Northamptonshire 024E,E01027259,1557,1162,395,149,171,67,8
2021,West Northamptonshire 029D,E01027260,1561,1436,125,64,44,15,2
2021,West Northamptonshire 049A,E01027261,2006,1981,25,17,8,0,0
2021,West Northamptonshire 045A,E01027262,1690,1680,10,10,0,0,0
2021,West Northamptonshire 046A,E01027263,1810,1772,38,20,15,1,2
2021,West Northamptonshire 053A,E01027264,1418,1354,64,29,26,9,0
2021,West Northamptonshire 051A,E01027265,1434,1406,28,12,10,6,0
2021,West Northamptonshire 053B,E01027267,1113,1068,45,23,10,10,2
2021,West Northamptonshire 053C,E01027268,1202,1177,25,16,6,2,1
2021,West Northamptonshire 053D,E01027269,1587,1521,66,30,16,20,0
2021,West Northamptonshire 051B,E01027270,1527,1514,13,9,4,0,0
2021,West Northamptonshire 051C,E01027271,1502,1464,38,23,11,2,2
2021,West Northamptonshire 051D,E01027272,1457,1415,42,23,13,3,3
2021,West Northamptonshire 043A,E01027273,1806,1787,19,10,5,4,0
2021,West Northamptonshire 043B,E01027274,2528,2428,100,63,22,11,4
2021,West Northamptonshire 043C,E01027275,1440,1416,24,12,8,4,0
2021,West Northamptonshire 045B,E01027277,1745,1723,22,14,4,3,1
2021,West Northamptonshire 046B,E01027279,2094,2042,52,17,22,12,1
2021,West Northamptonshire 050A,E01027280,2672,2611,61,38,14,8,1
2021,West Northamptonshire 050B,E01027281,1657,1618,39,20,12,6,1
2021,West Northamptonshire 040A,E01027282,1835,1815,20,11,7,2,0
2021,West Northamptonshire 040B,E01027283,1650,1644,6,1,3,1,1
2021,West Northamptonshire 046C,E01027284,1880,1848,32,17,9,6,0
2021,West Northamptonshire 040C,E01027285,1734,1722,12,10,0,2,0
2021,West Northamptonshire 040D,E01027286,1510,1493,17,7,5,4,1
2021,West Northamptonshire 040E,E01027287,1669,1653,16,11,3,2,0
2021,West Northamptonshire 052A,E01027288,2250,2210,40,24,11,4,1
2021,West Northamptonshire 045C,E01027289,1780,1757,23,13,7,2,1
2021,West Northamptonshire 052B,E01027290,2365,2311,54,36,15,2,1
2021,West Northamptonshire 048A,E01027291,1790,1756,34,20,11,3,0
2021,West Northamptonshire 048B,E01027292,1197,1181,16,9,5,1,1
2021,West Northamptonshire 048C,E01027293,1290,1262,28,24,4,0,0
2021,West Northamptonshire 046D,E01027294,1971,1943,28,19,6,3,0
2021,West Northamptonshire 049B,E01027295,2749,2712,37,26,7,2,2
2021,West Northamptonshire 052C,E01027296,1966,1942,24,15,4,4,1
2021,West Northamptonshire 047A,E01027297,1794,1776,18,9,3,5,1
2021,West Northamptonshire 047B,E01027298,2807,2748,59,38,14,6,1
2021,West Northamptonshire 047C,E01027299,1459,1422,37,15,17,4,1
2021,West Northamptonshire 045D,E01027300,1528,1501,27,21,3,1,2
2021,West Northamptonshire 047D,E01027301,2118,2036,82,42,25,14,1
2021,West Northamptonshire 047E,E01027302,1518,1489,29,13,12,4,0
2021,West Northamptonshire 045E,E01027303,1714,1686,28,16,10,1,1
2021,West Northamptonshire 048D,E01027304,1691,1676,15,8,3,3,1
2021,West Northamptonshire 048E,E01027305,1868,1842,26,13,11,2,0
2021,West Northamptonshire 049C,E01027306,1750,1734,16,11,3,2,0
2021,West Northamptonshire 050C,E01027307,2169,2138,31,20,10,1,0
2021,West Northamptonshire 043D,E01027308,1578,1558,20,10,9,1,0
2021,North Northamptonshire 033A,E01027309,1454,1335,119,57,43,17,2
2021,North Northamptonshire 033B,E01027310,1610,1333,277,101,108,57,11
2021,North Northamptonshire 033C,E01027311,1312,1193,119,34,53,30,2
2021,North Northamptonshire 033D,E01027312,1485,1252,233,96,94,41,2
2021,North Northamptonshire 030A,E01027313,1710,945,765,191,351,196,27
2021,North Northamptonshire 030B,E01027314,2195,1321,874,251,429,170,24
2021,North Northamptonshire 030C,E01027316,2199,1555,644,219,284,118,23
2021,North Northamptonshire 036A,E01027317,1528,1334,194,80,77,37,0
2021,North Northamptonshire 036B,E01027318,1505,1351,154,64,63,24,3
2021,North Northamptonshire 036C,E01027319,1507,1339,168,82,61,19,6
2021,North Northamptonshire 036D,E01027320,2041,1722,319,144,123,45,7
2021,North Northamptonshire 036E,E01027321,1706,1530,176,64,87,22,3
2021,North Northamptonshire 038A,E01027322,1193,1155,38,17,13,7,1
2021,North Northamptonshire 038B,E01027323,1973,1923,50,27,17,6,0
2021,North Northamptonshire 038C,E01027324,1125,1119,6,2,3,1,0
2021,North Northamptonshire 038D,E01027325,1852,1824,28,11,12,4,1
2021,North Northamptonshire 026A,E01027326,1527,1489,38,27,7,4,0
2021,North Northamptonshire 026B,E01027327,1506,1469,37,18,11,8,0
2021,North Northamptonshire 026C,E01027328,1396,1343,53,25,21,6,1
2021,North Northamptonshire 038E,E01027329,1756,1722,34,14,13,7,0
2021,North Northamptonshire 028A,E01027330,1737,1379,358,131,144,69,14
2021,North Northamptonshire 028B,E01027331,1484,1171,313,87,158,57,11
2021,North Northamptonshire 028C,E01027332,1541,1361,180,57,84,34,5
2021,North Northamptonshire 028D,E01027333,2211,1976,235,96,81,50,8
2021,North Northamptonshire 028E,E01027334,1448,1224,224,92,88,36,8
2021,North Northamptonshire 040A,E01027335,1432,1408,24,9,12,3,0
2021,North Northamptonshire 040B,E01027336,1607,1548,59,26,27,5,1
2021,North Northamptonshire 040C,E01027337,1749,1700,49,19,22,7,1
2021,North Northamptonshire 026D,E01027338,2363,2320,43,23,15,4,1
2021,North Northamptonshire 031A,E01027339,1397,1204,193,69,96,22,6
2021,North Northamptonshire 031B,E01027340,1568,1342,226,76,101,43,6
2021,North Northamptonshire 031C,E01027341,1650,1371,279,112,111,49,7
2021,North Northamptonshire 031D,E01027342,1573,1355,218,75,98,40,5
2021,North Northamptonshire 029A,E01027343,1382,1244,138,59,62,14,3
2021,North Northamptonshire 029B,E01027344,1445,1301,144,59,67,17,1
2021,North Northamptonshire 029C,E01027345,1269,1184,85,44,32,9,0
2021,North Northamptonshire 029D,E01027346,1463,1271,192,87,68,34,3
2021,North Northamptonshire 029E,E01027347,1839,1722,117,65,39,12,1
2021,North Northamptonshire 040D,E01027348,2119,2089,30,21,8,1,0
2021,North Northamptonshire 032A,E01027350,1534,1327,207,69,96,37,5
2021,North Northamptonshire 032B,E01027351,1631,1448,183,75,79,25,4
2021,North Northamptonshire 032C,E01027352,1459,1105,354,140,137,68,9
2021,North Northamptonshire 038F,E01027353,2030,2007,23,16,7,0,0
2021,North Northamptonshire 040E,E01027354,2414,2372,42,18,15,8,1
2021,North Northamptonshire 040F,E01027355,1612,1601,11,7,4,0,0
2021,Northumberland 004A,E01027356,2177,2156,21,16,3,2,0
2021,Northumberland 004B,E01027357,1268,1265,3,1,1,1,0
2021,Northumberland 005A,E01027358,1910,1899,11,2,5,4,0
2021,Northumberland 005B,E01027359,2212,2172,40,14,8,16,2
2021,Northumberland 006A,E01027361,1607,1590,17,7,6,4,0
2021,Northumberland 006B,E01027362,1741,1733,8,5,3,0,0
2021,Northumberland 006C,E01027363,1224,1211,13,7,3,3,0
2021,Northumberland 006D,E01027364,1725,1718,7,4,2,0,1
2021,Northumberland 007A,E01027365,2395,2383,12,6,5,1,0
2021,Northumberland 004C,E01027366,1488,1482,6,2,4,0,0
2021,Northumberland 004D,E01027367,1624,1604,20,15,4,1,0
2021,Northumberland 007B,E01027368,1643,1627,16,10,6,0,0
2021,Northumberland 007C,E01027369,1463,1450,13,7,3,2,1
2021,Northumberland 006E,E01027370,2013,2011,2,1,0,1,0
2021,Northumberland 006F,E01027371,1744,1733,11,8,3,0,0
2021,Northumberland 006G,E01027372,2306,2296,10,8,1,1,0
2021,Northumberland 007D,E01027373,1979,1960,19,10,9,0,0
2021,Northumberland 003A,E01027374,1918,1911,7,4,2,1,0
2021,Northumberland 003B,E01027375,1778,1761,17,12,4,0,1
2021,Northumberland 001A,E01027376,1612,1579,33,14,12,6,1
2021,Northumberland 001B,E01027377,1527,1453,74,19,26,27,2
2021,Northumberland 002A,E01027378,1103,1072,31,7,11,10,3
2021,Northumberland 002B,E01027379,1580,1567,13,7,2,4,0
2021,Northumberland 002C,E01027380,1283,1271,12,5,5,1,1
2021,Northumberland 003C,E01027381,1848,1842,6,5,0,1,0
2021,Northumberland 002D,E01027382,1617,1611,6,6,0,0,0
2021,Northumberland 003D,E01027383,1096,1090,6,2,3,1,0
2021,Northumberland 003E,E01027384,1291,1276,15,10,3,2,0
2021,Northumberland 001C,E01027385,1228,1177,51,13,18,11,9
2021,Northumberland 002E,E01027386,1340,1321,19,6,5,7,1
2021,Northumberland 001D,E01027387,1678,1597,81,26,31,20,4
2021,Northumberland 001E,E01027388,1388,1327,61,20,22,18,1
2021,Northumberland 001F,E01027389,1519,1473,46,18,17,11,0
2021,Northumberland 003F,E01027390,1900,1886,14,4,8,1,1
2021,Northumberland 024A,E01027391,1423,1406,17,7,10,0,0
2021,Northumberland 022A,E01027392,1791,1772,19,6,11,2,0
2021,Northumberland 022B,E01027393,1430,1422,8,3,1,3,1
2021,Northumberland 031A,E01027394,992,988,4,1,2,0,1
2021,Northumberland 042J,E01027395,1801,1774,27,13,12,2,0
2021,Northumberland 042H,E01027396,1208,1177,31,3,17,9,2
2021,Northumberland 042I,E01027397,1333,1325,8,1,4,2,1
2021,Northumberland 029A,E01027398,2100,2068,32,13,12,4,3
2021,Northumberland 042E,E01027399,1354,1342,12,5,3,4,0
2021,Northumberland 042A,E01027400,1267,1264,3,1,1,1,0
2021,Northumberland 042C,E01027401,1375,1371,4,2,2,0,0
2021,Northumberland 042B,E01027402,1225,1223,2,1,1,0,0
2021,Northumberland 042D,E01027403,1081,1072,9,4,4,1,0
2021,Northumberland 042F,E01027404,2163,2141,22,14,4,1,3
2021,Northumberland 042G,E01027405,1336,1333,3,1,0,1,1
2021,Northumberland 031B,E01027406,1175,1174,1,1,0,0,0
2021,Northumberland 031C,E01027407,1177,1168,9,3,4,2,0
2021,Northumberland 031D,E01027408,1323,1312,11,3,2,6,0
2021,Northumberland 029B,E01027409,1462,1446,16,5,6,5,0
2021,Northumberland 031E,E01027410,1482,1474,8,4,3,1,0
2021,Northumberland 029C,E01027411,1313,1290,23,6,11,5,1
2021,Northumberland 029D,E01027412,1962,1948,14,8,4,2,0
2021,Northumberland 029E,E01027413,2119,2100,19,13,5,0,1
2021,Northumberland 023A,E01027414,1335,1297,38,13,14,8,3
2021,Northumberland 023B,E01027415,1520,1459,61,26,22,12,1
2021,Northumberland 022C,E01027416,1513,1459,54,14,27,13,0
2021,Northumberland 030A,E01027417,1446,1438,8,5,0,3,0
2021,Northumberland 030B,E01027418,1729,1722,7,4,3,0,0
2021,Northumberland 030C,E01027419,1467,1457,10,5,4,1,0
2021,Northumberland 030D,E01027420,1268,1264,4,2,2,0,0
2021,Northumberland 030E,E01027421,1313,1303,10,3,5,2,0
2021,Northumberland 024B,E01027422,1618,1588,30,9,11,6,4
2021,Northumberland 024C,E01027423,1349,1338,11,3,7,0,1
2021,Northumberland 022D,E01027424,1848,1821,27,8,13,2,4
2021,Northumberland 025B,E01027426,2031,1987,44,9,17,16,2
2021,Northumberland 025C,E01027427,1759,1743,16,8,5,3,0
2021,Northumberland 025D,E01027428,1392,1374,18,4,7,7,0
2021,Northumberland 024D,E01027429,1708,1675,33,11,14,8,0
2021,Northumberland 024E,E01027430,1470,1445,25,6,14,5,0
2021,Northumberland 023C,E01027431,1533,1505,28,9,10,7,2
2021,Northumberland 032A,E01027432,1446,1423,23,11,8,4,0
2021,Northumberland 032B,E01027433,2471,2449,22,19,1,2,0
2021,Northumberland 032C,E01027434,1269,1258,11,7,3,1,0
2021,Northumberland 032D,E01027435,1320,1312,8,8,0,0,0
2021,Northumberland 032E,E01027436,1429,1420,9,5,2,2,0
2021,Northumberland 026A,E01027437,1589,1584,5,2,1,2,0
2021,Northumberland 026B,E01027438,1314,1310,4,3,1,0,0
2021,Northumberland 026C,E01027439,1801,1792,9,8,1,0,0
2021,Northumberland 026D,E01027440,1426,1422,4,2,2,0,0
2021,Northumberland 023E,E01027442,1500,1472,28,10,14,4,0
2021,Northumberland 008A,E01027443,1560,1547,13,3,5,2,3
2021,Northumberland 008B,E01027444,2586,2536,50,8,19,15,8
2021,Northumberland 008C,E01027445,1600,1595,5,0,3,0,2
2021,Northumberland 008D,E01027446,1285,1282,3,1,1,1,0
2021,Northumberland 015A,E01027447,1713,1705,8,6,2,0,0
2021,Northumberland 034A,E01027449,1504,1494,10,4,2,1,3
2021,Northumberland 015C,E01027450,1649,1637,12,7,2,2,1
2021,Northumberland 008E,E01027451,1636,1622,14,8,5,1,0
2021,Northumberland 016A,E01027452,1283,1264,19,8,7,4,0
2021,Northumberland 016B,E01027453,1445,1413,32,18,6,7,1
2021,Northumberland 018A,E01027455,1399,1390,9,8,1,0,0
2021,Northumberland 018B,E01027456,1202,1184,18,12,3,2,1
2021,Northumberland 011A,E01027457,1669,1650,19,14,4,0,1
2021,Northumberland 018C,E01027458,2314,2299,15,11,3,0,1
2021,Northumberland 018D,E01027460,1573,1559,14,6,3,4,1
2021,Northumberland 016E,E01027461,1252,1240,12,5,6,1,0
2021,Northumberland 011B,E01027462,1901,1891,10,0,5,5,0
2021,Northumberland 011C,E01027463,1739,1726,13,8,3,2,0
2021,Northumberland 033A,E01027464,1283,1263,20,9,6,4,1
2021,Northumberland 033B,E01027465,1421,1410,11,3,4,3,1
2021,Northumberland 033C,E01027466,1288,1271,17,8,3,6,0
2021,Northumberland 034B,E01027468,1278,1247,31,20,5,2,4
2021,Northumberland 034C,E01027469,1308,1278,30,14,6,10,0
2021,Northumberland 034D,E01027471,1953,1901,52,39,12,1,0
2021,Northumberland 034E,E01027472,1690,1668,22,14,6,2,0
2021,Northumberland 015D,E01027473,2603,2587,16,11,3,1,1
2021,Northumberland 008F,E01027474,1814,1797,17,9,5,2,1
2021,Northumberland 008G,E01027475,1367,1345,22,13,6,3,0
2021,Northumberland 035A,E01027476,2213,2187,26,12,5,7,2
2021,Northumberland 040A,E01027477,1177,1172,5,3,0,2,0
2021,Northumberland 040B,E01027478,1047,1045,2,0,2,0,0
2021,Northumberland 019A,E01027479,2133,2123,10,7,3,0,0
2021,Northumberland 019B,E01027480,1197,1189,8,7,1,0,0
2021,Northumberland 043A,E01027481,1520,1511,9,5,3,0,1
2021,Northumberland 043B,E01027482,1519,1515,4,2,2,0,0
2021,Northumberland 036A,E01027483,1295,1289,6,5,1,0,0
2021,Northumberland 037A,E01027484,2032,2020,12,8,2,2,0
2021,Northumberland 037B,E01027485,1420,1411,9,7,1,1,0
2021,Northumberland 037C,E01027486,1056,1049,7,3,2,2,0
2021,Northumberland 037D,E01027487,1089,1088,1,0,1,0,0
2021,Northumberland 040C,E01027488,2304,2291,13,9,2,2,0
2021,Northumberland 035B,E01027489,1450,1427,23,15,8,0,0
2021,Northumberland 035C,E01027490,1685,1665,20,13,6,1,0
2021,Northumberland 035D,E01027491,1470,1461,9,6,2,0,1
2021,Northumberland 035E,E01027492,1653,1638,15,12,3,0,0
2021,Northumberland 035F,E01027493,1509,1465,44,23,19,2,0
2021,Northumberland 035G,E01027494,2398,2359,39,23,11,5,0
2021,Northumberland 040D,E01027495,1098,1087,11,6,2,3,0
2021,Northumberland 036B,E01027496,1128,1121,7,4,1,2,0
2021,Northumberland 038A,E01027497,2391,2370,21,14,5,1,1
2021,Northumberland 038B,E01027498,2577,2515,62,41,15,3,3
2021,Northumberland 038C,E01027499,1848,1828,20,12,7,0,1
2021,Northumberland 038D,E01027500,1600,1564,36,17,13,1,5
2021,Northumberland 019C,E01027503,1550,1539,11,8,1,0,2
2021,Northumberland 043C,E01027504,1861,1846,15,8,3,1,3
2021,Northumberland 040E,E01027505,1344,1341,3,3,0,0,0
2021,Northumberland 043E,E01027507,1368,1357,11,7,3,1,0
2021,Northumberland 036C,E01027508,1107,1103,4,1,3,0,0
2021,Northumberland 043D,E01027509,1272,1265,7,2,3,1,1
2021,Northumberland 040F,E01027510,1124,1123,1,1,0,0,0
2021,Northumberland 019D,E01027511,1056,1049,7,4,0,2,1
2021,Northumberland 037E,E01027512,978,975,3,0,1,2,0
2021,Northumberland 036D,E01027513,1949,1937,12,9,2,1,0
2021,Northumberland 021A,E01027514,1626,1616,10,6,4,0,0
2021,Northumberland 020A,E01027515,1445,1433,12,7,2,2,1
2021,Northumberland 021B,E01027516,1073,1068,5,4,1,0,0
2021,Northumberland 020B,E01027517,1790,1774,16,5,5,6,0
2021,Northumberland 020C,E01027518,1367,1357,10,5,3,2,0
2021,Northumberland 020D,E01027519,1289,1279,10,3,5,2,0
2021,Northumberland 021C,E01027520,1417,1405,12,2,7,1,2
2021,Northumberland 021D,E01027521,1776,1770,6,2,3,1,0
2021,Northumberland 021E,E01027522,1281,1273,8,5,2,0,1
2021,Northumberland 021F,E01027523,1094,1085,9,6,3,0,0
2021,Northumberland 041B,E01027524,1960,1942,18,8,4,3,3
2021,Northumberland 041A,E01027525,1703,1699,4,4,0,0,0
2021,Northumberland 041D,E01027526,1110,1104,6,1,4,1,0
2021,Northumberland 041C,E01027527,1242,1222,20,10,4,4,2
2021,Northumberland 010A,E01027528,1304,1292,12,3,6,3,0
2021,Northumberland 010B,E01027529,1038,1009,29,13,8,6,2
2021,Northumberland 017A,E01027530,1313,1308,5,1,2,2,0
2021,Northumberland 017B,E01027531,1600,1592,8,5,1,1,1
2021,Northumberland 041H,E01027532,1972,1946,26,9,11,6,0
2021,Northumberland 013A,E01027533,1634,1610,24,12,7,3,2
2021,Northumberland 017C,E01027534,1724,1717,7,3,2,1,1
2021,Northumberland 017D,E01027535,1300,1295,5,2,1,1,1
2021,Northumberland 041E,E01027536,1246,1226,20,7,7,6,0
2021,Northumberland 041F,E01027537,1282,1267,15,9,4,2,0
2021,Northumberland 041G,E01027538,1590,1581,9,4,4,1,0
2021,Northumberland 010C,E01027539,1446,1381,65,24,24,15,2
2021,Northumberland 013B,E01027540,1812,1766,46,18,18,9,1
2021,Northumberland 009A,E01027541,1643,1626,17,4,7,4,2
2021,Northumberland 009B,E01027542,1653,1636,17,0,14,1,2
2021,Northumberland 009C,E01027543,1244,1241,3,2,1,0,0
2021,Northumberland 009D,E01027544,1205,1200,5,1,2,2,0
2021,Northumberland 010D,E01027545,1666,1622,44,15,9,12,8
2021,Northumberland 010E,E01027546,1449,1427,22,9,7,4,2
2021,Northumberland 013E,E01027549,2754,2706,48,22,18,8,0
2021,Northumberland 020E,E01027550,1203,1185,18,13,5,0,0
2021,Northumberland 020F,E01027551,1470,1452,18,7,6,3,2
2021,Northumberland 020G,E01027552,1210,1207,3,1,1,1,0
2021,Northumberland 017E,E01027553,1542,1529,13,5,5,2,1
2021,Northumberland 017F,E01027554,1281,1278,3,1,0,2,0
2021,Craven 008A,E01027555,1877,1864,13,8,4,1,0
2021,Craven 007A,E01027556,1934,1924,10,7,2,1,0
2021,Craven 009D,E01027557,1538,1518,20,12,5,3,0
2021,Craven 001A,E01027558,1871,1860,11,5,3,3,0
2021,Craven 001B,E01027559,1652,1648,4,3,1,0,0
2021,Craven 007B,E01027560,2368,2353,15,10,3,2,0
2021,Craven 009E,E01027561,1868,1856,12,11,1,0,0
2021,Craven 009C,E01027562,1517,1506,11,3,5,3,0
2021,Craven 007C,E01027563,1420,1409,11,7,2,1,1
2021,Craven 008B,E01027564,1192,1167,25,14,6,2,3
2021,Craven 008C,E01027565,1535,1508,27,12,10,3,2
2021,Craven 008D,E01027566,1336,1328,8,5,3,0,0
2021,Craven 009B,E01027567,1511,1494,17,6,4,7,0
2021,Craven 003A,E01027568,2198,2186,12,8,4,0,0
2021,Craven 001C,E01027569,1338,1328,10,6,2,2,0
2021,Craven 001D,E01027570,2401,2385,16,9,6,1,0
2021,Craven 003B,E01027571,1840,1822,18,11,5,2,0
2021,Craven 003C,E01027572,2020,1974,46,19,23,4,0
2021,Craven 003D,E01027573,1683,1672,11,6,4,1,0
2021,Craven 005A,E01027574,1679,1655,24,11,6,5,2
2021,Craven 005B,E01027575,1807,1791,16,10,6,0,0
2021,Craven 009F,E01027576,1776,1758,18,7,3,6,2
2021,Craven 005C,E01027577,1893,1828,65,44,19,2,0
2021,Craven 006A,E01027578,1398,1318,80,44,27,8,1
2021,Craven 005D,E01027579,1129,1073,56,30,17,8,1
2021,Craven 006B,E01027580,1067,1030,37,20,16,1,0
2021,Craven 006D,E01027582,1578,1539,39,15,17,6,1
2021,Craven 008E,E01027583,1977,1959,18,13,5,0,0
2021,Craven 008F,E01027584,1870,1859,11,7,2,2,0
2021,Craven 009A,E01027585,1778,1770,8,1,6,1,0
2021,Craven 007D,E01027586,1899,1887,12,8,0,2,2
2021,Hambleton 006A,E01027587,1307,1290,17,6,9,2,0
2021,Hambleton 006B,E01027588,1660,1612,48,20,23,5,0
2021,Hambleton 006C,E01027589,1943,1898,45,20,14,9,2
2021,Hambleton 003A,E01027590,2378,2345,33,20,11,1,1
2021,Hambleton 001A,E01027591,1595,1586,9,7,2,0,0
2021,Hambleton 003B,E01027592,1677,1668,9,4,4,1,0
2021,Hambleton 006D,E01027593,1687,1681,6,4,2,0,0
2021,Hambleton 010A,E01027594,1819,1789,30,21,6,3,0
2021,Hambleton 010B,E01027595,1738,1704,34,16,10,8,0
2021,Hambleton 010C,E01027596,1618,1593,25,9,11,5,0
2021,Hambleton 001B,E01027597,1503,1497,6,5,0,1,0
2021,Hambleton 002A,E01027598,1651,1641,10,10,0,0,0
2021,Hambleton 001C,E01027599,1587,1579,8,7,1,0,0
2021,Hambleton 011A,E01027600,1853,1830,23,10,4,5,4
2021,Hambleton 010D,E01027601,1985,1962,23,14,4,5,0
2021,Hambleton 005A,E01027603,1993,1958,35,10,8,14,3
2021,Hambleton 005B,E01027604,1824,1795,29,18,11,0,0
2021,Hambleton 013D,E01027605,1466,1430,36,28,5,3,0
2021,Hambleton 012E,E01027606,1411,1397,14,8,2,4,0
2021,Hambleton 005C,E01027607,1124,1111,13,9,1,3,0
2021,Hambleton 013B,E01027608,1650,1593,57,18,28,10,1
2021,Hambleton 012D,E01027609,1300,1256,44,13,25,6,0
2021,Hambleton 012C,E01027610,1548,1511,37,14,19,4,0
2021,Hambleton 013A,E01027612,1581,1507,74,14,38,17,5
2021,Hambleton 003C,E01027613,1681,1675,6,4,1,1,0
2021,Hambleton 005D,E01027614,1188,1185,3,0,2,1,0
2021,Hambleton 005E,E01027615,1142,1136,6,3,3,0,0
2021,Hambleton 013C,E01027616,1422,1411,11,7,3,1,0
2021,Hambleton 003D,E01027617,1028,1028,0,0,0,0,0
2021,Hambleton 002B,E01027618,2322,2315,7,4,3,0,0
2021,Hambleton 011B,E01027619,2151,2114,37,23,6,7,1
2021,Hambleton 008A,E01027620,1863,1805,58,27,18,10,3
2021,Hambleton 010E,E01027622,1911,1896,15,8,5,2,0
2021,Hambleton 001D,E01027623,1157,1143,14,8,4,2,0
2021,Hambleton 002C,E01027624,1204,1196,8,5,2,1,0
2021,Hambleton 001E,E01027625,1676,1657,19,9,7,3,0
2021,Hambleton 002D,E01027626,1543,1533,10,9,0,1,0
2021,Hambleton 002E,E01027627,1703,1682,21,21,0,0,0
2021,Hambleton 007B,E01027628,1788,1767,21,8,7,6,0
2021,Hambleton 009B,E01027629,1450,1396,54,26,20,6,2
2021,Hambleton 008B,E01027630,1748,1662,86,23,36,20,7
2021,Hambleton 008C,E01027631,1336,1300,36,12,16,8,0
2021,Hambleton 008D,E01027632,1688,1659,29,13,13,2,1
2021,Hambleton 007C,E01027633,1772,1762,10,4,4,0,2
2021,Hambleton 011C,E01027634,2058,2050,8,4,4,0,0
2021,Hambleton 009C,E01027635,2577,2490,87,47,29,11,0
2021,Hambleton 009D,E01027636,1925,1916,9,6,3,0,0
2021,Hambleton 008E,E01027637,1799,1795,4,2,2,0,0
2021,Harrogate 010A,E01027638,1278,1246,32,17,8,6,1
2021,Harrogate 010B,E01027639,1198,1181,17,14,2,1,0
2021,Harrogate 010C,E01027640,1417,1380,37,18,12,6,1
2021,Harrogate 008A,E01027641,1203,1188,15,14,1,0,0
2021,Harrogate 007A,E01027642,1439,1432,7,7,0,0,0
2021,Harrogate 003A,E01027643,1477,1460,17,11,4,2,0
2021,Harrogate 005A,E01027644,1403,1377,26,6,14,5,1
2021,Harrogate 005B,E01027645,1913,1828,85,24,32,24,5
2021,Harrogate 007B,E01027646,1616,1600,16,10,4,0,2
2021,Harrogate 005C,E01027647,1767,1745,22,7,8,4,3
2021,Harrogate 014A,E01027648,1464,1383,81,47,29,4,1
2021,Harrogate 013A,E01027649,2061,1922,139,62,51,23,3
2021,Harrogate 014B,E01027650,1527,1475,52,32,15,5,0
2021,Harrogate 013B,E01027651,1424,1319,105,59,34,12,0
2021,Harrogate 015A,E01027652,1680,1609,71,41,21,7,2
2021,Harrogate 020A,E01027653,1693,1657,36,22,11,1,2
2021,Harrogate 020B,E01027654,1126,1104,22,10,11,1,0
2021,Harrogate 015B,E01027655,1295,1245,50,26,18,6,0
2021,Harrogate 019A,E01027656,1670,1553,117,60,40,16,1
2021,Harrogate 013C,E01027657,1158,1067,91,42,32,15,2
2021,Harrogate 013D,E01027658,1468,1339,129,64,48,15,2
2021,Harrogate 015C,E01027659,1663,1467,196,87,85,19,5
2021,Harrogate 017A,E01027660,1446,1427,19,10,3,6,0
2021,Harrogate 017B,E01027661,1378,1339,39,15,23,1,0
2021,Harrogate 017C,E01027662,1188,1159,29,24,3,2,0
2021,Harrogate 017D,E01027663,1328,1300,28,18,10,0,0
2021,Harrogate 008C,E01027665,1282,1265,17,14,3,0,0
2021,Harrogate 001A,E01027666,1754,1735,19,10,6,2,1
2021,Harrogate 001B,E01027667,1435,1424,11,5,5,1,0
2021,Harrogate 009A,E01027668,1494,1458,36,19,13,3,1
2021,Harrogate 009B,E01027669,1880,1844,36,23,10,3,0
2021,Harrogate 012A,E01027670,1510,1491,19,12,7,0,0
2021,Harrogate 012B,E01027671,1483,1474,9,7,2,0,0
2021,Harrogate 012C,E01027672,1572,1558,14,6,5,3,0
2021,Harrogate 009C,E01027673,1697,1658,39,18,17,3,1
2021,Harrogate 007C,E01027674,1285,1276,9,7,0,2,0
2021,Harrogate 007D,E01027675,2894,2839,55,31,15,6,3
2021,Harrogate 009D,E01027676,1732,1673,59,30,23,4,2
2021,Harrogate 015D,E01027677,1395,1272,123,60,42,21,0
2021,Harrogate 015E,E01027678,1725,1460,265,106,114,44,1
2021,Harrogate 019B,E01027679,1480,1427,53,37,13,2,1
2021,Harrogate 015F,E01027680,1252,1164,88,45,29,10,4
2021,Harrogate 006A,E01027681,1605,1590,15,9,5,0,1
2021,Harrogate 018A,E01027682,1615,1607,8,5,2,1,0
2021,Harrogate 016A,E01027683,1728,1713,15,7,7,1,0
2021,Harrogate 016B,E01027684,1396,1386,10,7,2,1,0
2021,Harrogate 001C,E01027685,1089,1083,6,1,5,0,0
2021,Harrogate 001D,E01027686,1107,1101,6,2,4,0,0
2021,Harrogate 005D,E01027687,1858,1823,35,16,14,5,0
2021,Harrogate 003B,E01027688,1580,1564,16,9,6,1,0
2021,Harrogate 011A,E01027689,1313,1180,133,55,58,17,3
2021,Harrogate 010D,E01027690,1348,1311,37,19,16,2,0
2021,Harrogate 011B,E01027691,1480,1412,68,31,27,9,1
2021,Harrogate 013E,E01027692,1113,1040,73,28,33,9,3
2021,Harrogate 006B,E01027693,1734,1728,6,4,2,0,0
2021,Harrogate 018B,E01027694,1144,1129,15,9,3,3,0
2021,Harrogate 016C,E01027695,1682,1670,12,7,4,1,0
2021,Harrogate 016D,E01027696,2370,2194,176,59,103,14,0
2021,Harrogate 017E,E01027697,1407,1386,21,11,9,1,0
2021,Harrogate 020C,E01027698,1511,1485,26,11,9,6,0
2021,Harrogate 021A,E01027699,1288,1274,14,13,1,0,0
2021,Harrogate 021B,E01027700,1523,1512,11,8,3,0,0
2021,Harrogate 006C,E01027701,1524,1516,8,4,3,1,0
2021,Harrogate 006D,E01027702,1039,1028,11,9,2,0,0
2021,Harrogate 016E,E01027703,1972,1955,17,6,7,2,2
2021,Harrogate 012D,E01027704,1194,1175,19,13,5,1,0
2021,Harrogate 004A,E01027705,1728,1642,86,34,34,16,2
2021,Harrogate 004B,E01027706,1740,1646,94,28,42,23,1
2021,Harrogate 004C,E01027707,1686,1623,63,21,28,12,2
2021,Harrogate 004D,E01027708,1373,1341,32,10,18,4,0
2021,Harrogate 004E,E01027709,1200,1193,7,5,1,1,0
2021,Harrogate 004F,E01027710,1101,1056,45,16,22,5,2
2021,Harrogate 004G,E01027711,1279,1200,79,28,39,10,2
2021,Harrogate 002A,E01027712,1839,1791,48,25,10,10,3
2021,Harrogate 002B,E01027713,1590,1508,82,26,34,20,2
2021,Harrogate 002C,E01027714,1572,1525,47,24,15,6,2
2021,Harrogate 002D,E01027715,1112,1085,27,14,10,3,0
2021,Harrogate 020D,E01027716,1474,1439,35,23,9,3,0
2021,Harrogate 020E,E01027717,1541,1500,41,23,10,8,0
2021,Harrogate 020F,E01027718,1978,1922,56,32,14,10,0
2021,Harrogate 020G,E01027719,1474,1403,71,38,21,11,1
2021,Harrogate 011C,E01027720,1778,1627,151,59,67,24,1
2021,Harrogate 011D,E01027721,1393,1345,48,29,9,6,4
2021,Harrogate 008D,E01027722,1433,1403,30,9,14,7,0
2021,Harrogate 011E,E01027723,1417,1336,81,31,31,18,1
2021,Harrogate 021C,E01027724,1652,1637,15,7,4,1,3
2021,Harrogate 021D,E01027725,1501,1488,13,7,5,1,0
2021,Harrogate 014C,E01027726,1681,1628,53,27,20,5,1
2021,Harrogate 014D,E01027727,1712,1628,84,40,37,5,2
2021,Harrogate 014E,E01027728,1292,1247,45,21,13,8,3
2021,Harrogate 014F,E01027729,1418,1326,92,44,34,13,1
2021,Harrogate 019C,E01027730,1455,1446,9,8,1,0,0
2021,Harrogate 019D,E01027731,1410,1365,45,23,13,8,1
2021,Harrogate 019E,E01027732,1205,1183,22,13,6,3,0
2021,Harrogate 017F,E01027733,1327,1302,25,15,7,3,0
2021,Harrogate 018C,E01027734,1658,1641,17,13,4,0,0
2021,Harrogate 018D,E01027735,1566,1564,2,2,0,0,0
2021,Harrogate 003C,E01027736,1616,1594,22,12,7,3,0
2021,Harrogate 003D,E01027737,1619,1544,75,39,29,7,0
2021,Harrogate 010E,E01027738,1218,1177,41,23,13,4,1
2021,Harrogate 010F,E01027739,991,947,44,18,20,4,2
2021,Harrogate 013F,E01027740,1492,1407,85,38,33,14,0
2021,Harrogate 010G,E01027741,1342,1289,53,37,14,2,0
2021,Richmondshire 005A,E01027742,1293,1280,13,4,7,2,0
2021,Richmondshire 001A,E01027743,1156,1152,4,3,1,0,0
2021,Richmondshire 006A,E01027744,1238,1228,10,6,4,0,0
2021,Richmondshire 003A,E01027745,1630,1614,16,8,4,4,0
2021,Richmondshire 003B,E01027746,1417,1410,7,6,0,0,1
2021,Richmondshire 003C,E01027747,1489,1470,19,13,6,0,0
2021,Richmondshire 003D,E01027748,1139,1131,8,6,1,1,0
2021,Richmondshire 004A,E01027749,1873,1845,28,17,11,0,0
2021,Richmondshire 001B,E01027751,1262,1257,5,2,2,1,0
2021,Richmondshire 001C,E01027752,1172,1163,9,6,2,1,0
2021,Richmondshire 005B,E01027753,1202,1182,20,5,13,2,0
2021,Richmondshire 006B,E01027756,1760,1739,21,15,4,2,0
2021,Richmondshire 006D,E01027758,1463,1454,9,3,4,2,0
2021,Richmondshire 001D,E01027759,1370,1363,7,5,2,0,0
2021,Richmondshire 006E,E01027760,1177,1165,12,7,4,1,0
2021,Richmondshire 001E,E01027761,1089,1080,9,6,2,1,0
2021,Richmondshire 001F,E01027762,1314,1305,9,6,3,0,0
2021,Richmondshire 005C,E01027763,1037,1035,2,2,0,0,0
2021,Richmondshire 005D,E01027764,1061,1054,7,3,4,0,0
2021,Richmondshire 002A,E01027765,1564,1545,19,10,2,3,4
2021,Richmondshire 002B,E01027766,1164,1161,3,2,1,0,0
2021,Richmondshire 002C,E01027767,1418,1401,17,8,4,5,0
2021,Richmondshire 002D,E01027768,1105,1100,5,5,0,0,0
2021,Richmondshire 002E,E01027769,1186,1167,19,14,1,4,0
2021,Richmondshire 002F,E01027770,1479,1473,6,3,1,0,2
2021,Richmondshire 004E,E01027771,2420,1791,629,284,339,6,0
2021,Richmondshire 004F,E01027772,1256,1163,93,34,32,24,3
2021,Richmondshire 005E,E01027773,1052,1046,6,5,1,0,0
2021,Ryedale 007A,E01027774,1872,1848,24,15,5,4,0
2021,Ryedale 003A,E01027775,1945,1862,83,39,34,8,2
2021,Ryedale 001A,E01027776,1507,1496,11,8,3,0,0
2021,Ryedale 001B,E01027777,1281,1276,5,4,1,0,0
2021,Ryedale 007B,E01027778,2192,2168,24,11,4,8,1
2021,Ryedale 004A,E01027779,1085,1078,7,4,0,2,1
2021,Ryedale 003B,E01027780,2093,2057,36,14,22,0,0
2021,Ryedale 003C,E01027781,1224,1186,38,20,13,5,0
2021,Ryedale 007C,E01027782,1663,1644,19,9,7,3,0
2021,Ryedale 001C,E01027783,1802,1778,24,11,11,1,1
2021,Ryedale 001D,E01027784,1617,1598,19,10,6,2,1
2021,Ryedale 010A,E01027786,1558,1515,43,15,15,10,3
2021,Ryedale 009A,E01027787,1822,1742,80,29,35,15,1
2021,Ryedale 010B,E01027788,1531,1492,39,16,16,6,1
2021,Ryedale 010D,E01027790,1860,1682,178,39,67,63,9
2021,Ryedale 010C,E01027791,1603,1567,36,15,9,11,1
2021,Ryedale 002A,E01027792,2180,2146,34,19,5,8,2
2021,Ryedale 002B,E01027793,1407,1391,16,7,5,4,0
2021,Ryedale 002C,E01027794,1950,1932,18,8,9,1,0
2021,Ryedale 002D,E01027795,1555,1541,14,6,4,2,2
2021,Ryedale 004B,E01027796,1793,1782,11,7,2,1,1
2021,Ryedale 007D,E01027797,1663,1627,36,17,10,9,0
2021,Ryedale 004C,E01027798,1980,1961,19,8,6,5,0
2021,Ryedale 007E,E01027799,1719,1708,11,8,3,0,0
2021,Ryedale 003D,E01027800,1690,1685,5,4,1,0,0
2021,Ryedale 002E,E01027801,1712,1706,6,2,0,3,1
2021,Ryedale 002F,E01027802,1574,1560,14,9,4,1,0
2021,Ryedale 004D,E01027803,1805,1791,14,5,8,1,0
2021,Scarborough 010A,E01027804,1445,1257,188,54,66,58,10
2021,Scarborough 006A,E01027805,1257,1191,66,23,25,17,1
2021,Scarborough 006B,E01027806,1595,1417,178,63,75,35,5
2021,Scarborough 011A,E01027807,1487,1479,8,4,4,0,0
2021,Scarborough 011B,E01027808,1571,1560,11,11,0,0,0
2021,Scarborough 011C,E01027809,1199,1191,8,7,0,1,0
2021,Scarborough 008A,E01027810,1461,1402,59,25,26,7,1
2021,Scarborough 008B,E01027811,1443,1364,79,26,29,19,5
2021,Scarborough 008C,E01027812,1697,1491,206,87,78,35,6
2021,Scarborough 002A,E01027813,1845,1824,21,18,2,0,1
2021,Scarborough 013A,E01027814,1646,1635,11,8,3,0,0
2021,Scarborough 013B,E01027815,1365,1359,6,4,1,1,0
2021,Scarborough 013C,E01027816,1663,1655,8,5,2,1,0
2021,Scarborough 012A,E01027817,1416,1397,19,7,9,3,0
2021,Scarborough 011D,E01027818,1854,1817,37,11,21,5,0
2021,Scarborough 012B,E01027819,2195,2123,72,35,21,12,4
2021,Scarborough 012C,E01027820,1383,1339,44,13,16,9,6
2021,Scarborough 004A,E01027821,1396,1385,11,11,0,0,0
2021,Scarborough 002B,E01027822,1351,1349,2,1,0,1,0
2021,Scarborough 004B,E01027823,1373,1370,3,3,0,0,0
2021,Scarborough 009A,E01027824,1500,1461,39,17,16,5,1
2021,Scarborough 009B,E01027825,2060,1887,173,67,86,18,2
2021,Scarborough 009C,E01027826,1363,1297,66,30,18,17,1
2021,Scarborough 014A,E01027827,1521,1497,24,8,9,6,1
2021,Scarborough 014B,E01027828,2030,2024,6,5,1,0,0
2021,Scarborough 014C,E01027829,1353,1347,6,4,0,0,2
2021,Scarborough 014D,E01027830,1628,1621,7,2,2,3,0
2021,Scarborough 014E,E01027833,1517,1500,17,9,8,0,0
2021,Scarborough 014F,E01027834,1547,1541,6,5,1,0,0
2021,Scarborough 014G,E01027835,1734,1722,12,8,3,1,0
2021,Scarborough 004E,E01027836,2133,2115,18,6,10,2,0
2021,Scarborough 001A,E01027837,1273,1268,5,1,2,2,0
2021,Scarborough 003A,E01027838,1548,1538,10,4,5,1,0
2021,Scarborough 001B,E01027839,1872,1855,17,7,7,3,0
2021,Scarborough 002C,E01027840,1930,1923,7,4,3,0,0
2021,Scarborough 002D,E01027841,1266,1255,11,4,3,4,0
2021,Scarborough 005A,E01027842,1587,1543,44,21,17,5,1
2021,Scarborough 005B,E01027843,1441,1428,13,6,2,5,0
2021,Scarborough 005C,E01027844,1465,1436,29,17,10,2,0
2021,Scarborough 005D,E01027845,1652,1635,17,10,6,1,0
2021,Scarborough 006D,E01027847,1660,1458,202,65,69,64,4
2021,Scarborough 007A,E01027849,1116,1108,8,4,3,1,0
2021,Scarborough 007B,E01027850,1251,1207,44,27,14,3,0
2021,Scarborough 008D,E01027851,1383,1354,29,14,6,7,2
2021,Scarborough 010B,E01027852,1456,1270,186,72,72,37,5
2021,Scarborough 010C,E01027853,1104,1040,64,25,28,9,2
2021,Scarborough 010D,E01027854,1288,1130,158,50,74,29,5
2021,Scarborough 005E,E01027855,1807,1781,26,17,6,3,0
2021,Scarborough 005F,E01027856,1207,1195,12,7,1,4,0
2021,Scarborough 004F,E01027857,1222,1211,11,7,2,2,0
2021,Scarborough 012D,E01027858,1314,1304,10,7,3,0,0
2021,Scarborough 013D,E01027859,1707,1690,17,10,3,4,0
2021,Scarborough 012E,E01027860,1553,1534,19,11,1,4,3
2021,Scarborough 009D,E01027861,1334,1272,62,30,21,8,3
2021,Scarborough 008E,E01027862,1496,1427,69,20,27,18,4
2021,Scarborough 009E,E01027863,1345,1319,26,16,7,3,0
2021,Scarborough 003B,E01027864,1383,1348,35,7,13,6,9
2021,Scarborough 003C,E01027865,1131,1114,17,5,3,8,1
2021,Scarborough 003D,E01027866,1993,1974,19,10,6,3,0
2021,Scarborough 011E,E01027867,1377,1352,25,15,2,7,1
2021,Scarborough 010E,E01027868,2199,2096,103,45,44,13,1
2021,Scarborough 001E,E01027871,1526,1516,10,3,6,1,0
2021,Scarborough 007C,E01027872,1336,1298,38,13,15,8,2
2021,Scarborough 009F,E01027873,1370,1296,74,38,24,12,0
2021,Scarborough 007D,E01027874,1697,1594,103,44,33,23,3
2021,Selby 002A,E01027875,1910,1900,10,6,2,2,0
2021,Selby 003A,E01027876,1530,1495,35,22,11,0,2
2021,Selby 003B,E01027877,1842,1803,39,17,15,6,1
2021,Selby 005A,E01027878,1203,1125,78,23,30,25,0
2021,Selby 007A,E01027879,1204,1173,31,8,17,6,0
2021,Selby 007B,E01027880,1450,1428,22,7,10,4,1
2021,Selby 006A,E01027881,1786,1721,65,25,26,13,1
2021,Selby 007C,E01027882,1726,1722,4,3,1,0,0
2021,Selby 008A,E01027883,1021,1015,6,3,2,1,0
2021,Selby 008B,E01027884,1599,1574,25,16,5,3,1
2021,Selby 008C,E01027885,1705,1689,16,7,3,6,0
2021,Selby 002B,E01027886,1403,1391,12,8,4,0,0
2021,Selby 002C,E01027887,1518,1490,28,15,8,5,0
2021,Selby 002D,E01027888,1885,1865,20,13,4,3,0
2021,Selby 010A,E01027889,1715,1674,41,16,23,2,0
2021,Selby 010B,E01027890,2334,2312,22,7,5,8,2
2021,Selby 009A,E01027891,1642,1622,20,7,9,2,2
2021,Selby 009B,E01027892,1760,1736,24,13,6,3,2
2021,Selby 009C,E01027893,2124,2116,8,5,2,1,0
2021,Selby 007D,E01027894,2654,2608,46,28,14,4,0
2021,Selby 007E,E01027895,1394,1385,9,5,3,1,0
2021,Selby 008D,E01027896,1946,1925,21,10,5,5,1
2021,Selby 008E,E01027897,2146,2125,21,15,3,3,0
2021,Selby 009D,E01027899,1672,1661,11,6,2,3,0
2021,Selby 003C,E01027900,1923,1912,11,7,4,0,0
2021,Selby 003D,E01027901,1710,1686,24,15,6,2,1
2021,Selby 003E,E01027902,1395,1381,14,9,4,1,0
2021,Selby 003F,E01027903,1177,1138,39,18,15,6,0
2021,Selby 002E,E01027904,2436,2417,19,14,4,1,0
2021,Selby 006B,E01027906,1523,1338,185,63,89,29,4
2021,Selby 005C,E01027907,1372,1182,190,69,81,31,9
2021,Selby 005D,E01027908,1534,1276,258,51,123,75,9
2021,Selby 005E,E01027909,2148,1860,288,70,135,73,10
2021,Selby 006E,E01027913,1150,1141,9,7,2,0,0
2021,Selby 004B,E01027914,1512,1498,14,8,4,2,0
2021,Selby 004C,E01027915,1981,1938,43,25,13,5,0
2021,Selby 004D,E01027916,1568,1527,41,16,17,8,0
2021,Selby 001A,E01027918,1422,1406,16,12,0,4,0
2021,Selby 001B,E01027919,1113,1102,11,9,2,0,0
2021,Selby 001C,E01027920,1060,1049,11,6,2,2,1
2021,Selby 001D,E01027921,1688,1680,8,1,4,3,0
2021,Selby 001E,E01027922,1995,1983,12,8,2,2,0
2021,Selby 010C,E01027923,2262,2240,22,8,9,3,2
2021,Selby 010D,E01027924,2249,2237,12,7,4,1,0
2021,Ashfield 015A,E01027925,2160,2132,28,15,10,1,2
2021,Ashfield 016A,E01027926,1440,1398,42,23,11,8,0
2021,Ashfield 014A,E01027927,2074,2035,39,22,12,4,1
2021,Ashfield 014B,E01027928,1999,1933,66,32,17,12,5
2021,Ashfield 016B,E01027930,1706,1649,57,23,30,4,0
2021,Ashfield 014C,E01027932,2197,2079,118,62,44,12,0
2021,Ashfield 014D,E01027933,1469,1415,54,29,18,7,0
2021,Ashfield 013C,E01027934,1268,1247,21,9,11,1,0
2021,Ashfield 013D,E01027935,1181,1170,11,9,2,0,0
2021,Ashfield 013E,E01027936,1399,1390,9,3,2,4,0
2021,Ashfield 014E,E01027937,1274,1228,46,21,16,6,3
2021,Ashfield 015B,E01027938,1190,1178,12,6,5,1,0
2021,Ashfield 016C,E01027939,1477,1454,23,8,12,1,2
2021,Ashfield 015C,E01027940,1279,1272,7,3,1,2,1
2021,Ashfield 016D,E01027941,1228,1194,34,10,21,3,0
2021,Ashfield 016E,E01027942,2670,2567,103,68,23,7,5
2021,Ashfield 015D,E01027943,1394,1363,31,14,9,7,1
2021,Ashfield 015E,E01027944,1421,1406,15,5,8,2,0
2021,Ashfield 012A,E01027945,1601,1572,29,8,10,11,0
2021,Ashfield 012B,E01027946,1356,1347,9,2,3,3,1
2021,Ashfield 009A,E01027947,1607,1578,29,10,14,4,1
2021,Ashfield 009B,E01027948,2112,2056,56,24,21,10,1
2021,Ashfield 007A,E01027949,1410,1380,30,11,15,3,1
2021,Ashfield 009C,E01027950,2256,2196,60,35,16,8,1
2021,Ashfield 007B,E01027951,1553,1469,84,38,27,15,4
2021,Ashfield 008A,E01027952,1777,1704,73,25,36,11,1
2021,Ashfield 007C,E01027953,1486,1458,28,11,11,5,1
2021,Ashfield 007D,E01027954,1582,1551,31,13,13,4,1
2021,Ashfield 008B,E01027955,1226,1162,64,23,24,17,0
2021,Ashfield 008C,E01027956,1479,1452,27,11,14,1,1
2021,Ashfield 009D,E01027957,1270,1244,26,12,10,4,0
2021,Ashfield 008D,E01027958,1458,1397,61,24,24,9,4
2021,Ashfield 009E,E01027959,1915,1852,63,29,23,9,2
2021,Ashfield 011A,E01027960,1512,1496,16,5,9,2,0
2021,Ashfield 011B,E01027961,1804,1780,24,10,9,4,1
2021,Ashfield 011C,E01027962,1458,1437,21,15,2,4,0
2021,Ashfield 011D,E01027963,1639,1624,15,5,8,2,0
2021,Ashfield 005A,E01027964,1426,1375,51,15,19,14,3
2021,Ashfield 005B,E01027965,1440,1369,71,22,34,13,2
2021,Ashfield 003A,E01027966,1303,1260,43,18,21,4,0
2021,Ashfield 004A,E01027967,1642,1460,182,66,80,33,3
2021,Ashfield 005C,E01027968,1160,1107,53,15,21,16,1
2021,Ashfield 006A,E01027969,1269,1246,23,5,12,5,1
2021,Ashfield 002A,E01027970,1315,1274,41,20,18,3,0
2021,Ashfield 002B,E01027971,1324,1309,15,5,9,0,1
2021,Ashfield 004B,E01027972,2315,2233,82,35,34,12,1
2021,Ashfield 007E,E01027973,1519,1482,37,21,11,3,2
2021,Ashfield 005D,E01027974,1477,1364,113,40,55,15,3
2021,Ashfield 006B,E01027975,1554,1501,53,24,26,3,0
2021,Ashfield 005E,E01027976,1963,1831,132,61,47,24,0
2021,Ashfield 004C,E01027977,2075,1987,88,36,39,12,1
2021,Ashfield 004D,E01027978,1812,1525,287,88,138,54,7
2021,Ashfield 001A,E01027979,1516,1503,13,1,9,2,1
2021,Ashfield 001B,E01027980,1507,1471,36,18,14,1,3
2021,Ashfield 001C,E01027981,1579,1539,40,19,16,4,1
2021,Ashfield 002C,E01027982,1345,1292,53,22,24,6,1
2021,Ashfield 001D,E01027983,1507,1439,68,20,28,17,3
2021,Ashfield 002D,E01027984,1426,1383,43,23,11,9,0
2021,Ashfield 004E,E01027985,2060,1906,154,82,52,15,5
2021,Ashfield 003B,E01027986,1290,1244,46,11,30,4,1
2021,Ashfield 003C,E01027987,2142,1997,145,63,60,18,4
2021,Ashfield 006C,E01027988,1431,1393,38,12,20,6,0
2021,Ashfield 006D,E01027989,1553,1514,39,24,13,2,0
2021,Ashfield 003D,E01027990,1734,1682,52,20,24,7,1
2021,Ashfield 006E,E01027991,1188,1164,24,6,12,6,0
2021,Ashfield 006F,E01027992,2556,2492,64,29,26,9,0
2021,Ashfield 012C,E01027993,1434,1419,15,10,2,3,0
2021,Ashfield 012D,E01027994,1351,1346,5,2,2,0,1
2021,Ashfield 010A,E01027995,1462,1446,16,10,2,4,0
2021,Ashfield 010B,E01027996,1928,1893,35,16,14,2,3
2021,Ashfield 010C,E01027997,2316,2269,47,26,16,5,0
2021,Ashfield 010D,E01027998,1758,1727,31,18,11,2,0
2021,Bassetlaw 002A,E01027999,2431,2416,15,9,2,4,0
2021,Bassetlaw 001A,E01028000,2258,2235,23,9,9,4,1
2021,Bassetlaw 004A,E01028001,1307,1201,106,40,41,23,2
2021,Bassetlaw 004B,E01028002,1304,1280,24,10,8,3,3
2021,Bassetlaw 004C,E01028003,1378,1349,29,13,9,6,1
2021,Bassetlaw 004D,E01028004,1515,1507,8,7,1,0,0
2021,Bassetlaw 002B,E01028005,1797,1780,17,11,4,2,0
2021,Bassetlaw 015A,E01028006,1261,1250,11,6,3,1,1
2021,Bassetlaw 015B,E01028007,1199,1192,7,3,3,1,0
2021,Bassetlaw 008A,E01028008,1294,1235,59,21,19,17,2
2021,Bassetlaw 008B,E01028009,1288,1270,18,7,9,1,1
2021,Bassetlaw 008C,E01028010,1556,1547,9,2,3,4,0
2021,Bassetlaw 008D,E01028011,1514,1468,46,10,25,11,0
2021,Bassetlaw 008E,E01028012,1285,1248,37,16,13,8,0
2021,Bassetlaw 005A,E01028013,1877,1842,35,20,9,5,1
2021,Bassetlaw 005B,E01028014,1445,1416,29,8,12,9,0
2021,Bassetlaw 005C,E01028015,1551,1516,35,20,11,3,1
2021,Bassetlaw 005D,E01028016,1327,1295,32,12,17,3,0
2021,Bassetlaw 010A,E01028017,2369,2330,39,16,16,6,1
2021,Bassetlaw 010B,E01028018,1343,1323,20,8,9,3,0
2021,Bassetlaw 010C,E01028019,1367,1350,17,3,9,2,3
2021,Bassetlaw 010D,E01028020,1731,1663,68,25,25,17,1
2021,Bassetlaw 010E,E01028021,1702,1675,27,19,5,3,0
2021,Bassetlaw 008F,E01028022,1591,1553,38,20,10,6,2
2021,Bassetlaw 003A,E01028023,2465,2455,10,6,2,2,0
2021,Bassetlaw 001B,E01028024,1955,1916,39,19,13,7,0
2021,Bassetlaw 001C,E01028025,1342,1309,33,20,11,1,1
2021,Bassetlaw 001D,E01028026,1474,1431,43,26,13,4,0
2021,Bassetlaw 001E,E01028027,1625,1565,60,32,14,12,2
2021,Bassetlaw 001F,E01028028,2119,2050,69,33,27,9,0
2021,Bassetlaw 004E,E01028029,1334,1297,37,11,14,8,4
2021,Bassetlaw 004F,E01028030,1178,1166,12,1,6,4,1
2021,Bassetlaw 002C,E01028031,1129,1122,7,2,4,0,1
2021,Bassetlaw 002D,E01028032,1337,1327,10,5,2,3,0
2021,Bassetlaw 015C,E01028033,2250,2230,20,9,5,3,3
2021,Bassetlaw 003B,E01028034,2349,2325,24,9,7,7,1
2021,Bassetlaw 002E,E01028035,2318,2305,13,5,5,3,0
2021,Bassetlaw 003C,E01028036,2872,2832,40,20,16,3,1
2021,Bassetlaw 015D,E01028037,1750,1722,28,12,10,6,0
2021,Bassetlaw 015E,E01028038,1501,1476,25,12,9,4,0
2021,Bassetlaw 015F,E01028039,1245,1240,5,3,1,1,0
2021,Bassetlaw 016E,E01028042,1362,1296,66,29,29,8,0
2021,Bassetlaw 014C,E01028043,1413,1339,74,27,39,7,1
2021,Bassetlaw 016F,E01028044,1604,1444,160,40,73,43,4
2021,Bassetlaw 016G,E01028045,1851,1740,111,33,44,27,7
2021,Bassetlaw 006A,E01028046,1500,1421,79,37,25,17,0
2021,Bassetlaw 006B,E01028047,2773,2706,67,35,21,9,2
2021,Bassetlaw 006C,E01028048,1596,1524,72,23,38,10,1
2021,Bassetlaw 006D,E01028049,1730,1649,81,35,34,12,0
2021,Bassetlaw 006E,E01028050,1792,1725,67,33,20,13,1
2021,Bassetlaw 016A,E01028051,1387,1326,61,21,30,10,0
2021,Bassetlaw 016B,E01028052,1617,1583,34,10,17,7,0
2021,Bassetlaw 016C,E01028053,1506,1370,136,35,62,36,3
2021,Bassetlaw 016D,E01028054,1444,1411,33,8,22,3,0
2021,Bassetlaw 009A,E01028055,1574,1308,266,63,119,77,7
2021,Bassetlaw 009B,E01028056,1384,1318,66,35,20,10,1
2021,Bassetlaw 012A,E01028057,1257,983,274,68,123,69,14
2021,Bassetlaw 009C,E01028058,2118,2071,47,21,22,4,0
2021,Bassetlaw 009D,E01028059,1737,1681,56,27,20,9,0
2021,Bassetlaw 013A,E01028060,1853,1805,48,13,17,15,3
2021,Bassetlaw 013B,E01028061,1374,1310,64,22,34,7,1
2021,Bassetlaw 013C,E01028062,1997,1613,384,97,179,98,10
2021,Bassetlaw 014D,E01028063,1652,1617,35,18,9,7,1
2021,Bassetlaw 014E,E01028064,1248,1155,93,30,34,26,3
2021,Bassetlaw 012B,E01028065,1711,1437,274,79,107,72,16
2021,Bassetlaw 012C,E01028066,1703,1392,311,86,155,64,6
2021,Bassetlaw 013D,E01028067,1518,1372,146,39,60,40,7
2021,Bassetlaw 012D,E01028068,1804,1398,406,113,181,101,11
2021,Broxtowe 014A,E01028069,1098,1057,41,27,10,3,1
2021,Broxtowe 014B,E01028070,1049,1040,9,6,3,0,0
2021,Broxtowe 011A,E01028073,1611,1388,223,106,88,26,3
2021,Broxtowe 011B,E01028074,2028,1693,335,178,121,31,5
2021,Broxtowe 011C,E01028075,1623,1373,250,115,97,34,4
2021,Broxtowe 009A,E01028076,1215,1071,144,73,51,16,4
2021,Broxtowe 009B,E01028077,1406,1232,174,65,70,28,11
2021,Broxtowe 009C,E01028078,1617,1413,204,79,85,33,7
2021,Broxtowe 009D,E01028079,1972,1725,247,116,101,28,2
2021,Broxtowe 012A,E01028080,1718,1578,140,67,52,19,2
2021,Broxtowe 012B,E01028081,1066,1015,51,15,22,14,0
2021,Broxtowe 012C,E01028082,1172,1120,52,34,14,4,0
2021,Broxtowe 012D,E01028083,1275,1138,137,79,43,15,0
2021,Broxtowe 009E,E01028084,1698,1602,96,55,34,7,0
2021,Broxtowe 011D,E01028085,2114,1839,275,142,93,35,5
2021,Broxtowe 011E,E01028086,1516,1398,118,58,52,8,0
2021,Broxtowe 007A,E01028087,1547,1430,117,59,45,11,2
2021,Broxtowe 007B,E01028088,1432,1298,134,82,35,13,4
2021,Broxtowe 007C,E01028089,1275,1206,69,45,18,5,1
2021,Broxtowe 007D,E01028090,1328,1292,36,24,9,3,0
2021,Broxtowe 007E,E01028091,1495,1413,82,50,19,12,1
2021,Broxtowe 001A,E01028092,1254,1244,10,4,4,2,0
2021,Broxtowe 001B,E01028093,989,985,4,3,1,0,0
2021,Broxtowe 014C,E01028094,1721,1639,82,38,30,9,5
2021,Broxtowe 014D,E01028095,1405,1369,36,15,12,6,3
2021,Broxtowe 014E,E01028096,1976,1897,79,37,28,13,1
2021,Broxtowe 013A,E01028097,1330,1285,45,25,12,5,3
2021,Broxtowe 013B,E01028098,1478,1365,113,61,34,12,6
2021,Broxtowe 013C,E01028099,1276,1228,48,26,17,2,3
2021,Broxtowe 013D,E01028100,1767,1656,111,47,47,15,2
2021,Broxtowe 013E,E01028101,1485,1381,104,42,40,20,2
2021,Broxtowe 004A,E01028102,1293,1274,19,10,8,1,0
2021,Broxtowe 004B,E01028103,1060,1052,8,2,3,2,1
2021,Broxtowe 004C,E01028104,1536,1520,16,6,8,0,2
2021,Broxtowe 016A,E01028105,1148,1123,25,11,9,4,1
2021,Broxtowe 016B,E01028106,1374,1351,23,14,7,2,0
2021,Broxtowe 001C,E01028107,1461,1453,8,6,2,0,0
2021,Broxtowe 001D,E01028108,1378,1362,16,6,7,3,0
2021,Broxtowe 003A,E01028109,1681,1664,17,6,5,6,0
2021,Broxtowe 002A,E01028110,1583,1550,33,20,11,0,2
2021,Broxtowe 002B,E01028111,1440,1428,12,7,1,4,0
2021,Broxtowe 002C,E01028112,1564,1518,46,24,17,5,0
2021,Broxtowe 002D,E01028113,1408,1376,32,16,11,5,0
2021,Broxtowe 001E,E01028114,1442,1423,19,8,9,2,0
2021,Broxtowe 003B,E01028115,1584,1568,16,8,5,3,0
2021,Broxtowe 003C,E01028116,1647,1630,17,11,5,1,0
2021,Broxtowe 003D,E01028117,1528,1491,37,21,9,7,0
2021,Broxtowe 003E,E01028118,1622,1614,8,7,1,0,0
2021,Broxtowe 016C,E01028119,1978,1753,225,136,69,20,0
2021,Broxtowe 016D,E01028120,1672,1605,67,39,18,8,2
2021,Broxtowe 016E,E01028121,1399,1289,110,54,30,22,4
2021,Broxtowe 004D,E01028122,1551,1531,20,13,3,4,0
2021,Broxtowe 004E,E01028123,1847,1826,21,11,9,1,0
2021,Broxtowe 004F,E01028124,1598,1564,34,12,10,10,2
2021,Broxtowe 008A,E01028125,1797,1751,46,29,11,6,0
2021,Broxtowe 008B,E01028126,1271,1232,39,15,11,13,0
2021,Broxtowe 008C,E01028127,1521,1441,80,35,28,16,1
2021,Broxtowe 010A,E01028128,1677,1639,38,23,11,4,0
2021,Broxtowe 010B,E01028129,1504,1443,61,44,9,5,3
2021,Broxtowe 010C,E01028130,1863,1785,78,44,29,4,1
2021,Broxtowe 010D,E01028131,1488,1446,42,15,17,6,4
2021,Broxtowe 010E,E01028132,1069,1015,54,22,19,8,5
2021,Broxtowe 010F,E01028133,1388,1332,56,29,15,11,1
2021,Broxtowe 008D,E01028134,1369,1310,59,33,16,8,2
2021,Broxtowe 015A,E01028135,1353,1317,36,27,5,3,1
2021,Broxtowe 015B,E01028136,1632,1568,64,30,26,8,0
2021,Broxtowe 015C,E01028137,2381,2236,145,87,44,13,1
2021,Broxtowe 015D,E01028138,1151,1106,45,24,18,3,0
2021,Broxtowe 015E,E01028139,1387,1339,48,26,14,5,3
2021,Gedling 016A,E01028142,2179,2119,60,29,21,10,0
2021,Gedling 004A,E01028143,1320,1294,26,12,10,4,0
2021,Gedling 006A,E01028144,1444,1403,41,26,11,3,1
2021,Gedling 016B,E01028146,1372,1318,54,29,17,7,1
2021,Gedling 016C,E01028147,1036,989,47,20,22,4,1
2021,Gedling 008A,E01028148,2395,2364,31,13,13,4,1
2021,Gedling 008B,E01028149,1594,1578,16,11,4,1,0
2021,Gedling 002A,E01028150,1327,1320,7,4,3,0,0
2021,Gedling 002B,E01028151,1089,1088,1,0,1,0,0
2021,Gedling 002C,E01028152,1776,1760,16,5,10,1,0
2021,Gedling 002D,E01028153,1288,1271,17,12,2,2,1
2021,Gedling 002E,E01028154,1617,1601,16,9,5,0,2
2021,Gedling 014A,E01028155,1355,1296,59,21,25,12,1
2021,Gedling 014B,E01028156,1312,1228,84,48,24,10,2
2021,Gedling 014C,E01028157,1234,1155,79,28,25,20,6
2021,Gedling 014D,E01028158,1606,1538,68,42,22,4,0
2021,Gedling 014E,E01028159,1282,1182,100,51,38,10,1
2021,Gedling 013A,E01028160,1428,1372,56,26,17,12,1
2021,Gedling 013B,E01028161,1478,1263,215,83,82,46,4
2021,Gedling 013C,E01028162,1519,1463,56,22,28,4,2
2021,Gedling 013D,E01028163,1443,1374,69,37,25,7,0
2021,Gedling 014F,E01028164,1233,1167,66,27,24,15,0
2021,Gedling 006B,E01028165,1466,1399,67,28,29,9,1
2021,Gedling 006C,E01028166,1710,1632,78,39,31,7,1
2021,Gedling 006D,E01028167,1866,1716,150,61,58,24,7
2021,Gedling 012A,E01028168,1239,1217,22,14,4,3,1
2021,Gedling 012B,E01028169,1370,1363,7,6,1,0,0
2021,Gedling 012C,E01028170,1468,1425,43,28,10,5,0
2021,Gedling 012D,E01028171,1303,1252,51,18,16,14,3
2021,Gedling 011A,E01028172,2091,2011,80,40,29,10,1
2021,Gedling 005A,E01028173,1007,981,26,16,5,5,0
2021,Gedling 005B,E01028174,1604,1563,41,23,12,6,0
2021,Gedling 005C,E01028175,1698,1656,42,23,11,8,0
2021,Gedling 009A,E01028176,1437,1397,40,27,12,1,0
2021,Gedling 009B,E01028177,1518,1476,42,14,23,5,0
2021,Gedling 008C,E01028178,2431,2384,47,25,14,8,0
2021,Gedling 007A,E01028179,1329,1276,53,30,11,11,1
2021,Gedling 007B,E01028180,1440,1398,42,23,8,11,0
2021,Gedling 007C,E01028181,1410,1369,41,23,14,4,0
2021,Gedling 007D,E01028182,1473,1406,67,32,18,16,1
2021,Gedling 007E,E01028183,1229,1198,31,17,8,6,0
2021,Gedling 015A,E01028184,1091,1053,38,26,9,3,0
2021,Gedling 015B,E01028185,1754,1697,57,30,20,6,1
2021,Gedling 015C,E01028186,1481,1401,80,31,42,5,2
2021,Gedling 015D,E01028187,1340,1260,80,30,39,11,0
2021,Gedling 015E,E01028188,1361,1279,82,47,20,15,0
2021,Gedling 001A,E01028189,2602,2548,54,28,20,4,2
2021,Gedling 011B,E01028190,1506,1455,51,32,14,4,1
2021,Gedling 012E,E01028191,1660,1641,19,10,7,2,0
2021,Gedling 012F,E01028192,1499,1445,54,32,12,10,0
2021,Gedling 010A,E01028193,1475,1434,41,21,11,9,0
2021,Gedling 010B,E01028194,1402,1360,42,23,15,4,0
2021,Gedling 010C,E01028195,1357,1314,43,27,14,1,1
2021,Gedling 010D,E01028196,1341,1317,24,16,6,2,0
2021,Gedling 010E,E01028197,1335,1314,21,15,6,0,0
2021,Gedling 001B,E01028198,1396,1386,10,5,3,2,0
2021,Gedling 001C,E01028199,1449,1422,27,12,11,2,2
2021,Gedling 001D,E01028200,1787,1741,46,29,10,6,1
2021,Gedling 001E,E01028201,1129,1114,15,9,3,2,1
2021,Gedling 011C,E01028202,1409,1373,36,20,14,1,1
2021,Gedling 011D,E01028203,1299,1250,49,29,11,7,2
2021,Gedling 010F,E01028204,1282,1240,42,23,12,6,1
2021,Gedling 004B,E01028205,1711,1678,33,24,5,3,1
2021,Gedling 004C,E01028206,1371,1348,23,10,7,6,0
2021,Gedling 004D,E01028207,1615,1555,60,22,27,9,2
2021,Gedling 004E,E01028208,1070,1030,40,22,11,7,0
2021,Gedling 005D,E01028209,1370,1308,62,24,21,16,1
2021,Gedling 014G,E01028210,1378,1351,27,16,9,2,0
2021,Gedling 013E,E01028211,1278,1235,43,26,13,4,0
2021,Gedling 011E,E01028212,1594,1530,64,43,12,5,4
2021,Gedling 002F,E01028213,1878,1856,22,7,9,5,1
2021,Gedling 009C,E01028214,1369,1336,33,18,14,1,0
2021,Gedling 009D,E01028215,1310,1279,31,22,8,0,1
2021,Gedling 009E,E01028216,1254,1229,25,15,7,3,0
2021,Gedling 009F,E01028217,1355,1288,67,39,16,8,4
2021,Gedling 009G,E01028218,1541,1490,51,24,18,9,0
2021,Mansfield 013A,E01028219,1450,1418,32,18,7,5,2
2021,Mansfield 013B,E01028220,1771,1633,138,51,68,19,0
2021,Mansfield 013D,E01028222,2447,2357,90,47,35,7,1
2021,Mansfield 002A,E01028223,1375,1338,37,10,23,4,0
2021,Mansfield 001A,E01028224,1385,1363,22,11,9,2,0
2021,Mansfield 002B,E01028225,1511,1478,33,16,12,5,0
2021,Mansfield 002C,E01028226,1420,1319,101,23,47,31,0
2021,Mansfield 008A,E01028227,1307,1076,231,67,115,37,12
2021,Mansfield 008B,E01028228,1233,967,266,75,119,60,12
2021,Mansfield 006A,E01028229,1341,1256,85,28,34,19,4
2021,Mansfield 010A,E01028230,1468,1339,129,36,61,28,4
2021,Mansfield 010B,E01028231,1443,1248,195,75,81,27,12
2021,Mansfield 006B,E01028232,1466,1330,136,44,60,26,6
2021,Mansfield 009A,E01028233,1914,1515,399,110,197,85,7
2021,Mansfield 009B,E01028234,1639,1424,215,75,81,55,4
2021,Mansfield 011A,E01028235,1522,1489,33,10,20,3,0
2021,Mansfield 011B,E01028236,1725,1567,158,53,63,35,7
2021,Mansfield 007A,E01028237,1555,1510,45,17,17,11,0
2021,Mansfield 007B,E01028238,1479,1436,43,17,21,3,2
2021,Mansfield 007C,E01028239,1631,1523,108,30,49,25,4
2021,Mansfield 007D,E01028240,1409,1375,34,18,12,2,2
2021,Mansfield 005A,E01028242,1412,1350,62,15,28,19,0
2021,Mansfield 007F,E01028243,1877,1811,66,28,30,6,2
2021,Mansfield 010C,E01028244,1475,1320,155,72,68,11,4
2021,Mansfield 010D,E01028245,1314,1224,90,41,33,14,2
2021,Mansfield 010E,E01028246,1624,1539,85,41,33,8,3
2021,Mansfield 008C,E01028247,1642,1180,462,133,210,111,8
2021,Mansfield 010F,E01028248,1605,1323,282,91,116,69,6
2021,Mansfield 010G,E01028249,1422,1306,116,42,43,26,5
2021,Mansfield 005B,E01028250,1358,1284,74,26,25,15,8
2021,Mansfield 003A,E01028251,1504,1472,32,11,13,8,0
2021,Mansfield 003B,E01028252,1846,1805,41,15,15,11,0
2021,Mansfield 003C,E01028253,1613,1593,20,8,7,5,0
2021,Mansfield 012A,E01028254,1292,1252,40,19,15,5,1
2021,Mansfield 013E,E01028255,1307,1267,40,25,11,0,4
2021,Mansfield 012B,E01028256,1764,1598,166,51,76,35,4
2021,Mansfield 001B,E01028257,1525,1488,37,15,12,7,3
2021,Mansfield 001C,E01028258,1591,1555,36,15,11,6,4
2021,Mansfield 001D,E01028259,1717,1666,51,13,23,13,2
2021,Mansfield 002D,E01028260,1719,1701,18,5,10,3,0
2021,Mansfield 012C,E01028261,1585,1510,75,25,31,16,3
2021,Mansfield 011C,E01028262,1355,1335,20,8,11,1,0
2021,Mansfield 012D,E01028263,1499,1386,113,31,51,24,7
2021,Mansfield 011D,E01028264,1810,1775,35,14,21,0,0
2021,Mansfield 006E,E01028267,2118,1980,138,61,52,24,1
2021,Mansfield 008D,E01028268,2130,1524,606,183,300,114,9
2021,Mansfield 008E,E01028269,1675,1281,394,118,186,81,9
2021,Mansfield 013F,E01028270,1521,1438,83,27,36,19,1
2021,Mansfield 004A,E01028271,1678,1480,198,48,100,44,6
2021,Mansfield 005C,E01028272,1736,1634,102,24,54,20,4
2021,Mansfield 005D,E01028273,1416,1363,53,15,19,16,3
2021,Mansfield 009C,E01028274,1463,1230,233,57,122,48,6
2021,Mansfield 009D,E01028275,1536,1329,207,84,74,45,4
2021,Mansfield 009E,E01028276,1583,1353,230,67,96,62,5
2021,Mansfield 003D,E01028277,1339,1301,38,18,13,5,2
2021,Mansfield 003E,E01028278,1340,1317,23,6,11,6,0
2021,Mansfield 004B,E01028279,1417,1384,33,11,15,7,0
2021,Mansfield 004C,E01028280,1323,1288,35,14,15,5,1
2021,Mansfield 004D,E01028281,1423,1319,104,40,55,9,0
2021,Mansfield 006F,E01028282,1160,1070,90,31,44,13,2
2021,Mansfield 004E,E01028283,2177,2018,159,50,70,31,8
2021,Mansfield 008F,E01028284,1778,1365,413,114,192,96,11
2021,Newark and Sherwood 011A,E01028285,1159,1097,62,22,25,15,0
2021,Newark and Sherwood 011B,E01028286,1279,1242,37,16,15,6,0
2021,Newark and Sherwood 011C,E01028287,1472,1436,36,16,13,6,1
2021,Newark and Sherwood 011D,E01028288,1429,1402,27,16,10,1,0
2021,Newark and Sherwood 011E,E01028289,1326,1281,45,24,16,5,0
2021,Newark and Sherwood 011F,E01028290,1393,1353,40,21,9,8,2
2021,Newark and Sherwood 011G,E01028291,1994,1894,100,47,37,15,1
2021,Newark and Sherwood 009A,E01028292,2658,2561,97,54,33,7,3
2021,Newark and Sherwood 009B,E01028293,1884,1660,224,85,96,37,6
2021,Newark and Sherwood 007A,E01028294,1856,1574,282,99,123,54,6
2021,Newark and Sherwood 005A,E01028295,1851,1830,21,8,8,3,2
2021,Newark and Sherwood 006A,E01028296,1733,1694,39,17,14,8,0
2021,Newark and Sherwood 005B,E01028297,1925,1906,19,10,5,2,2
2021,Newark and Sherwood 006B,E01028298,1476,1461,15,5,8,2,0
2021,Newark and Sherwood 006C,E01028299,1284,1255,29,20,8,1,0
2021,Newark and Sherwood 006D,E01028300,1413,1378,35,16,11,7,1
2021,Newark and Sherwood 001A,E01028301,1857,1787,70,19,26,21,4
2021,Newark and Sherwood 001B,E01028302,1487,1470,17,6,8,2,1
2021,Newark and Sherwood 003A,E01028303,1457,1447,10,5,5,0,0
2021,Newark and Sherwood 007B,E01028304,1404,1120,284,83,144,53,4
2021,Newark and Sherwood 007C,E01028305,1496,1235,261,78,136,45,2
2021,Newark and Sherwood 007D,E01028306,1638,1465,173,70,72,26,5
2021,Newark and Sherwood 007E,E01028307,1169,995,174,79,63,29,3
2021,Newark and Sherwood 010A,E01028308,1516,1437,79,37,31,9,2
2021,Newark and Sherwood 010B,E01028309,1373,1327,46,22,17,5,2
2021,Newark and Sherwood 007F,E01028310,2105,1678,427,143,194,86,4
2021,Newark and Sherwood 007G,E01028311,1588,1399,189,64,74,44,7
2021,Newark and Sherwood 003B,E01028312,2282,2265,17,7,6,4,0
2021,Newark and Sherwood 002A,E01028313,1978,1939,39,13,17,5,4
2021,Newark and Sherwood 004A,E01028315,1500,1490,10,8,2,0,0
2021,Newark and Sherwood 004B,E01028316,1670,1648,22,6,13,3,0
2021,Newark and Sherwood 004C,E01028317,1580,1576,4,3,1,0,0
2021,Newark and Sherwood 010C,E01028318,1483,1371,112,41,53,16,2
2021,Newark and Sherwood 010D,E01028319,1918,1770,148,51,59,32,6
2021,Newark and Sherwood 010E,E01028320,1638,1474,164,59,78,25,2
2021,Newark and Sherwood 002C,E01028321,1512,1494,18,7,5,5,1
2021,Newark and Sherwood 002D,E01028322,2016,2001,15,8,4,3,0
2021,Newark and Sherwood 002E,E01028323,1649,1635,14,8,3,3,0
2021,Newark and Sherwood 012B,E01028325,1268,1257,11,6,5,0,0
2021,Newark and Sherwood 012C,E01028326,1283,1256,27,11,10,6,0
2021,Newark and Sherwood 005C,E01028327,1938,1913,25,16,8,1,0
2021,Newark and Sherwood 005D,E01028328,1746,1735,11,5,3,3,0
2021,Newark and Sherwood 005E,E01028329,1591,1581,10,9,1,0,0
2021,Newark and Sherwood 013A,E01028330,1492,1477,15,6,6,2,1
2021,Newark and Sherwood 013B,E01028331,2266,2203,63,21,23,19,0
2021,Newark and Sherwood 013C,E01028332,1570,1558,12,7,1,4,0
2021,Newark and Sherwood 009C,E01028333,1423,1358,65,18,34,10,3
2021,Newark and Sherwood 009D,E01028334,1558,1397,161,73,64,20,4
2021,Newark and Sherwood 009E,E01028335,1813,1494,319,114,137,56,12
2021,Newark and Sherwood 012D,E01028336,1114,1101,13,10,3,0,0
2021,Newark and Sherwood 003C,E01028337,1445,1432,13,9,2,2,0
2021,Newark and Sherwood 001C,E01028338,1734,1705,29,14,8,6,1
2021,Newark and Sherwood 001D,E01028339,1814,1752,62,29,25,7,1
2021,Newark and Sherwood 001E,E01028340,1522,1493,29,14,10,5,0
2021,Newark and Sherwood 006E,E01028342,1429,1405,24,14,10,0,0
2021,Newark and Sherwood 006F,E01028343,2370,2317,53,26,19,6,2
2021,Newark and Sherwood 006G,E01028344,1317,1302,15,7,5,3,0
2021,Newark and Sherwood 008A,E01028345,2167,2133,34,12,9,9,4
2021,Newark and Sherwood 008B,E01028346,2098,2057,41,19,16,6,0
2021,Newark and Sherwood 008C,E01028347,1436,1423,13,9,4,0,0
2021,Newark and Sherwood 008D,E01028348,1734,1698,36,24,11,1,0
2021,Newark and Sherwood 003D,E01028349,1496,1479,17,7,7,3,0
2021,Newark and Sherwood 003E,E01028350,1213,1199,14,5,8,0,1
2021,Newark and Sherwood 013D,E01028351,1266,1263,3,3,0,0,0
2021,Newark and Sherwood 012E,E01028352,1122,1115,7,4,2,1,0
2021,Newark and Sherwood 004D,E01028353,2666,2624,42,21,12,6,3
2021,Rushcliffe 004A,E01028354,1472,1443,29,17,6,6,0
2021,Rushcliffe 004B,E01028355,1489,1438,51,30,19,2,0
2021,Rushcliffe 006A,E01028356,1394,1330,64,36,21,6,1
2021,Rushcliffe 002A,E01028357,1417,1408,9,5,3,0,1
2021,Rushcliffe 002B,E01028358,1293,1270,23,13,7,3,0
2021,Rushcliffe 002C,E01028359,1831,1802,29,18,5,4,2
2021,Rushcliffe 002D,E01028360,2714,2660,54,38,8,6,2
2021,Rushcliffe 002E,E01028361,1246,1224,22,12,4,5,1
2021,Rushcliffe 002F,E01028362,1293,1278,15,7,7,1,0
2021,Rushcliffe 007A,E01028363,1318,1174,144,102,36,5,1
2021,Rushcliffe 007B,E01028364,1680,1552,128,77,40,9,2
2021,Rushcliffe 007C,E01028365,1997,1798,199,136,49,11,3
2021,Rushcliffe 009A,E01028366,1245,1215,30,21,6,3,0
2021,Rushcliffe 009B,E01028367,2467,2418,49,38,9,2,0
2021,Rushcliffe 009C,E01028368,1446,1431,15,8,3,4,0
2021,Rushcliffe 009D,E01028369,1408,1394,14,10,1,3,0
2021,Rushcliffe 009E,E01028370,1346,1324,22,17,4,1,0
2021,Rushcliffe 001A,E01028371,2921,2879,42,19,10,12,1
2021,Rushcliffe 008A,E01028372,1266,1189,77,40,27,7,3
2021,Rushcliffe 008C,E01028374,1332,1272,60,33,17,9,1
2021,Rushcliffe 006B,E01028375,1831,1721,110,75,23,12,0
2021,Rushcliffe 006C,E01028376,1513,1428,85,64,14,6,1
2021,Rushcliffe 006D,E01028377,1843,1778,65,37,21,6,1
2021,Rushcliffe 014A,E01028378,1957,1934,23,15,6,2,0
2021,Rushcliffe 012A,E01028379,1698,1669,29,20,6,3,0
2021,Rushcliffe 013A,E01028380,1235,1218,17,14,3,0,0
2021,Rushcliffe 013B,E01028381,1278,1262,16,11,5,0,0
2021,Rushcliffe 013C,E01028382,1396,1378,18,14,3,0,1
2021,Rushcliffe 013D,E01028383,1039,1024,15,10,4,1,0
2021,Rushcliffe 004C,E01028384,1736,1663,73,53,16,4,0
2021,Rushcliffe 004D,E01028385,1709,1666,43,28,10,5,0
2021,Rushcliffe 004E,E01028386,1658,1595,63,37,12,11,3
2021,Rushcliffe 014B,E01028387,2421,2375,46,36,8,2,0
2021,Rushcliffe 015A,E01028388,1647,1632,15,8,5,2,0
2021,Rushcliffe 015B,E01028389,1829,1811,18,9,6,1,2
2021,Rushcliffe 015C,E01028390,2461,2428,33,22,7,4,0
2021,Rushcliffe 007D,E01028391,2024,1927,97,62,22,10,3
2021,Rushcliffe 007E,E01028392,2079,1821,258,148,71,34,5
2021,Rushcliffe 003A,E01028393,1074,1039,35,20,12,3,0
2021,Rushcliffe 003B,E01028394,1459,1442,17,7,9,1,0
2021,Rushcliffe 003C,E01028395,1296,1281,15,14,1,0,0
2021,Rushcliffe 005A,E01028396,1439,1378,61,44,16,0,1
2021,Rushcliffe 006E,E01028397,1717,1662,55,37,15,3,0
2021,Rushcliffe 005B,E01028398,1350,1274,76,35,26,12,3
2021,Rushcliffe 005C,E01028399,1339,1272,67,40,20,7,0
2021,Rushcliffe 008D,E01028400,1513,1467,46,24,18,4,0
2021,Rushcliffe 008E,E01028401,1226,1151,75,48,20,6,1
2021,Rushcliffe 010A,E01028402,1893,1879,14,8,4,2,0
2021,Rushcliffe 001B,E01028403,2102,2090,12,11,0,1,0
2021,Rushcliffe 011A,E01028404,1567,1553,14,11,3,0,0
2021,Rushcliffe 011B,E01028405,2127,2080,47,24,16,6,1
2021,Rushcliffe 011C,E01028406,1628,1590,38,25,8,4,1
2021,Rushcliffe 011D,E01028407,2101,2069,32,14,14,3,1
2021,Rushcliffe 014C,E01028408,2735,2600,135,87,44,4,0
2021,Rushcliffe 015D,E01028409,1254,1230,24,15,9,0,0
2021,Rushcliffe 015E,E01028410,1309,1287,22,12,6,4,0
2021,Rushcliffe 001C,E01028411,2113,2106,7,5,2,0,0
2021,Rushcliffe 012B,E01028412,1931,1908,23,20,3,0,0
2021,Rushcliffe 003D,E01028413,1647,1612,35,18,10,6,1
2021,Rushcliffe 003E,E01028414,1574,1552,22,9,6,7,0
2021,Rushcliffe 003F,E01028415,1995,1974,21,18,3,0,0
2021,Rushcliffe 005D,E01028416,1596,1477,119,73,31,14,1
2021,Rushcliffe 005E,E01028417,1526,1438,88,51,26,11,0
2021,Rushcliffe 005F,E01028418,1468,1419,49,32,11,5,1
2021,Rushcliffe 010B,E01028419,2376,2365,11,4,5,1,1
2021,Rushcliffe 010C,E01028420,1288,1283,5,4,1,0,0
2021,Rushcliffe 012C,E01028421,2189,2168,21,12,4,5,0
2021,Cherwell 008A,E01028422,1802,1773,29,16,11,2,0
2021,Cherwell 008B,E01028423,1598,1561,37,27,6,3,1
2021,Cherwell 007A,E01028426,1689,1554,135,73,49,12,1
2021,Cherwell 007B,E01028427,1409,1083,326,147,137,37,5
2021,Cherwell 007C,E01028428,1313,1235,78,39,35,3,1
2021,Cherwell 007D,E01028429,1053,926,127,66,46,11,4
2021,Cherwell 006A,E01028430,1829,1567,262,110,98,50,4
2021,Cherwell 006B,E01028431,1589,1486,103,54,33,13,3
2021,Cherwell 006C,E01028432,1923,1802,121,76,30,12,3
2021,Cherwell 006D,E01028433,1575,1517,58,24,28,5,1
2021,Cherwell 006E,E01028434,1890,1768,122,59,47,15,1
2021,Cherwell 004A,E01028435,2005,1456,549,192,236,111,10
2021,Cherwell 004C,E01028437,1570,1224,346,111,153,67,15
2021,Cherwell 004E,E01028439,1353,1161,192,81,82,28,1
2021,Cherwell 004F,E01028440,1579,1120,459,126,235,85,13
2021,Cherwell 002A,E01028441,2337,2029,308,131,142,28,7
2021,Cherwell 002C,E01028443,1397,1282,115,56,46,13,0
2021,Cherwell 002D,E01028444,1364,1256,108,45,41,13,9
2021,Cherwell 003A,E01028445,1419,1146,273,99,126,42,6
2021,Cherwell 003B,E01028446,1532,1293,239,78,114,38,9
2021,Cherwell 003C,E01028447,1243,993,250,88,95,61,6
2021,Cherwell 003D,E01028448,1612,1377,235,84,103,37,11
2021,Cherwell 005A,E01028449,1431,1193,238,89,106,34,9
2021,Cherwell 005B,E01028450,1443,1286,157,53,74,22,8
2021,Cherwell 005C,E01028451,1259,1136,123,58,49,14,2
2021,Cherwell 005D,E01028452,1432,1283,149,52,59,36,2
2021,Cherwell 005E,E01028453,1360,1179,181,77,78,23,3
2021,Cherwell 005F,E01028454,1663,1461,202,85,83,28,6
2021,Cherwell 013A,E01028455,1447,1343,104,61,33,9,1
2021,Cherwell 013B,E01028456,1412,1253,159,74,61,22,2
2021,Cherwell 013C,E01028457,1332,1205,127,59,53,13,2
2021,Cherwell 013D,E01028458,1510,1333,177,83,69,19,6
2021,Cherwell 012A,E01028459,1378,1190,188,87,74,24,3
2021,Cherwell 012B,E01028460,1975,1808,167,85,61,20,1
2021,Cherwell 012C,E01028461,1606,1401,205,113,61,31,0
2021,Cherwell 012D,E01028462,1531,1401,130,65,52,13,0
2021,Cherwell 015A,E01028463,2501,2153,348,183,130,33,2
2021,Cherwell 015B,E01028464,1577,1429,148,85,51,11,1
2021,Cherwell 015C,E01028465,1336,1268,68,35,26,5,2
2021,Cherwell 014A,E01028466,1702,1496,206,90,83,31,2
2021,Cherwell 013E,E01028467,1754,1503,251,97,112,35,7
2021,Cherwell 014B,E01028469,1402,1344,58,32,17,7,2
2021,Cherwell 014C,E01028470,1601,1532,69,33,24,12,0
2021,Cherwell 014D,E01028471,1307,1170,137,69,51,16,1
2021,Cherwell 014E,E01028472,1169,1055,114,65,40,8,1
2021,Cherwell 014F,E01028473,1404,1294,110,58,40,9,3
2021,Cherwell 009A,E01028474,1863,1820,43,20,16,5,2
2021,Cherwell 008D,E01028476,2778,2733,45,27,14,3,1
2021,Cherwell 011B,E01028477,2403,2244,159,96,46,16,1
2021,Cherwell 011C,E01028478,1320,1250,70,38,24,8,0
2021,Cherwell 001A,E01028479,1301,1284,17,11,4,2,0
2021,Cherwell 001B,E01028480,1505,1490,15,12,3,0,0
2021,Cherwell 010A,E01028481,1431,1413,18,13,3,2,0
2021,Cherwell 010B,E01028482,1348,1315,33,25,7,1,0
2021,Cherwell 011D,E01028483,1269,1242,27,15,10,2,0
2021,Cherwell 011E,E01028484,1063,1045,18,13,4,1,0
2021,Cherwell 009B,E01028485,1542,1519,23,14,6,1,2
2021,Cherwell 009C,E01028486,1217,1199,18,12,6,0,0
2021,Cherwell 017A,E01028487,1166,986,180,94,65,19,2
2021,Cherwell 019A,E01028488,1333,1137,196,98,69,25,4
2021,Cherwell 017B,E01028489,1350,1269,81,45,23,12,1
2021,Cherwell 017C,E01028490,1253,1148,105,52,36,13,4
2021,Cherwell 017D,E01028491,1539,1374,165,88,56,18,3
2021,Cherwell 018A,E01028492,1514,1308,206,105,67,30,4
2021,Cherwell 018B,E01028493,1360,1224,136,72,42,20,2
2021,Cherwell 017E,E01028494,1067,922,145,72,52,18,3
2021,Cherwell 018C,E01028495,1272,1106,166,80,64,22,0
2021,Cherwell 018D,E01028496,1371,1214,157,63,56,35,3
2021,Cherwell 016B,E01028497,1407,1365,42,27,11,4,0
2021,Cherwell 016C,E01028498,1620,1577,43,24,13,6,0
2021,Cherwell 011F,E01028499,1911,1864,47,28,14,5,0
2021,Cherwell 016D,E01028500,1966,1888,78,42,22,14,0
2021,Cherwell 016E,E01028501,1201,1178,23,16,2,0,5
2021,Cherwell 016F,E01028502,1200,1182,18,12,3,1,2
2021,Cherwell 009D,E01028503,1129,1114,15,12,2,1,0
2021,Cherwell 009E,E01028504,1417,1395,22,8,10,4,0
2021,Cherwell 010D,E01028506,1830,1793,37,26,8,1,2
2021,Cherwell 010E,E01028507,1420,1393,27,11,13,3,0
2021,Cherwell 001C,E01028508,1052,1037,15,12,1,2,0
2021,Cherwell 019B,E01028510,1585,1500,85,49,29,7,0
2021,Cherwell 019C,E01028511,1834,1651,183,90,57,32,4
2021,Cherwell 019D,E01028512,1837,1706,131,68,48,15,0
2021,Oxford 005A,E01028513,2503,1832,671,257,303,109,2
2021,Oxford 005B,E01028514,1539,1303,236,130,74,30,2
2021,Oxford 007A,E01028515,1689,1401,288,173,84,24,7
2021,Oxford 005C,E01028516,2302,1964,338,191,107,36,4
2021,Oxford 017A,E01028517,1308,1078,230,98,113,15,4
2021,Oxford 017B,E01028518,1538,1312,226,93,79,48,6
2021,Oxford 017C,E01028519,1672,1310,362,114,185,57,6
2021,Oxford 018A,E01028520,1637,1368,269,100,132,32,5
2021,Oxford 008A,E01028521,9871,8216,1655,1324,301,24,6
2021,Oxford 008B,E01028522,4066,3320,746,577,141,24,4
2021,Oxford 010A,E01028523,1563,1090,473,301,144,26,2
2021,Oxford 010B,E01028524,1669,1269,400,185,162,48,5
2021,Oxford 010C,E01028525,1964,1534,430,243,121,57,9
2021,Oxford 010D,E01028526,2215,1911,304,181,92,24,7
2021,Oxford 015A,E01028527,1747,1434,313,117,140,49,7
2021,Oxford 015B,E01028528,1644,1123,521,233,199,69,20
2021,Oxford 015C,E01028529,1689,1267,422,177,171,65,9
2021,Oxford 015D,E01028530,2060,1419,641,222,278,124,17
2021,Oxford 019B,E01028531,1994,1607,387,235,109,37,6
2021,Oxford 019A,E01028532,2868,2196,672,326,246,91,9
2021,Oxford 006A,E01028534,1218,1068,150,95,46,8,1
2021,Oxford 006B,E01028535,2130,1795,335,237,82,14,2
2021,Oxford 006C,E01028536,1400,1197,203,152,40,10,1
2021,Oxford 006D,E01028537,1799,1328,471,322,123,22,4
2021,Oxford 005D,E01028538,1735,1354,381,205,132,37,7
2021,Oxford 006E,E01028539,2075,1535,540,307,168,56,9
2021,Oxford 006F,E01028540,2292,1966,326,209,92,25,0
2021,Oxford 012A,E01028541,1369,1187,182,133,40,9,0
2021,Oxford 012B,E01028542,1762,1400,362,208,113,38,3
2021,Oxford 012C,E01028543,1180,964,216,115,70,28,3
2021,Oxford 012D,E01028544,1134,965,169,119,39,10,1
2021,Oxford 014A,E01028545,1838,1634,204,142,35,26,1
2021,Oxford 014B,E01028546,1821,1546,275,113,113,43,6
2021,Oxford 014C,E01028547,2213,1810,403,241,115,43,4
2021,Oxford 009A,E01028548,1820,1483,337,199,81,49,8
2021,Oxford 009B,E01028549,1484,1235,249,180,47,12,10
2021,Oxford 009C,E01028550,1400,1132,268,210,30,28,0
2021,Oxford 009D,E01028551,1676,1434,242,198,31,9,4
2021,Oxford 016A,E01028552,2057,1770,287,121,116,42,8
2021,Oxford 016B,E01028553,1760,1533,227,129,71,23,4
2021,Oxford 016C,E01028554,1518,1056,462,173,222,57,10
2021,Oxford 016D,E01028555,1591,1316,275,142,87,30,16
2021,Oxford 020B,E01028556,2651,2215,436,238,133,59,6
2021,Oxford 020D,E01028557,2007,1578,429,198,162,62,7
2021,Oxford 020C,E01028558,1684,1264,420,146,165,98,11
2021,Oxford 020A,E01028559,1854,1374,480,246,157,69,8
2021,Oxford 004A,E01028560,1742,1439,303,207,62,31,3
2021,Oxford 004B,E01028561,1939,1469,470,234,157,69,10
2021,Oxford 004C,E01028562,1898,1556,342,208,84,43,7
2021,Oxford 004D,E01028563,1534,1279,255,158,67,28,2
2021,Oxford 003A,E01028565,1255,1149,106,93,13,0,0
2021,Oxford 017D,E01028567,1805,1450,355,153,135,59,8
2021,Oxford 018B,E01028568,1449,1282,167,62,75,29,1
2021,Oxford 018C,E01028569,1558,1441,117,63,41,11,2
2021,Oxford 018D,E01028570,2021,1583,438,210,149,72,7
2021,Oxford 007B,E01028571,1606,1436,170,116,42,11,1
2021,Oxford 007C,E01028572,1817,1574,243,128,91,18,6
2021,Oxford 007D,E01028573,1710,1507,203,127,60,13,3
2021,Oxford 007E,E01028574,1394,1169,225,120,74,23,8
2021,Oxford 015E,E01028575,1504,1310,194,101,52,34,7
2021,Oxford 016E,E01028576,1648,1091,557,226,218,85,28
2021,Oxford 016F,E01028577,2182,1716,466,180,181,82,23
2021,Oxford 015F,E01028578,1473,1174,299,132,105,53,9
2021,Oxford 011A,E01028579,1666,1379,287,92,112,73,10
2021,Oxford 011B,E01028580,1325,1092,233,142,67,23,1
2021,Oxford 011C,E01028581,1471,1316,155,103,40,10,2
2021,Oxford 011D,E01028582,1196,974,222,157,46,11,8
2021,Oxford 003C,E01028584,2402,2084,318,230,61,24,3
2021,Oxford 011E,E01028586,1693,1301,392,145,204,42,1
2021,Oxford 011F,E01028587,1835,1569,266,151,68,39,8
2021,Oxford 011G,E01028588,1755,1500,255,194,51,8,2
2021,Oxford 002C,E01028591,1258,1109,149,109,26,13,1
2021,Oxford 002D,E01028592,1642,1485,157,105,35,17,0
2021,Oxford 001A,E01028594,1533,1380,153,109,29,13,2
2021,Oxford 001B,E01028595,1577,1462,115,72,32,8,3
2021,Oxford 001C,E01028596,1416,1277,139,95,34,8,2
2021,Oxford 001D,E01028597,1484,1225,259,150,70,34,5
2021,South Oxfordshire 005A,E01028598,2470,2433,37,25,11,1,0
2021,South Oxfordshire 011A,E01028599,1905,1863,42,26,12,3,1
2021,South Oxfordshire 007A,E01028600,1398,1384,14,8,3,2,1
2021,South Oxfordshire 011B,E01028601,1580,1543,37,21,12,4,0
2021,South Oxfordshire 011C,E01028602,1191,1143,48,35,11,2,0
2021,South Oxfordshire 007B,E01028603,1319,1282,37,20,8,9,0
2021,South Oxfordshire 006A,E01028604,1474,1312,162,97,47,15,3
2021,South Oxfordshire 006B,E01028605,1465,1399,66,37,23,6,0
2021,South Oxfordshire 007C,E01028606,1646,1603,43,30,10,1,2
2021,South Oxfordshire 006C,E01028607,1285,1253,32,14,12,5,1
2021,South Oxfordshire 012A,E01028608,1212,1197,15,10,5,0,0
2021,South Oxfordshire 007D,E01028609,1311,1283,28,22,4,2,0
2021,South Oxfordshire 007E,E01028610,1421,1406,15,8,7,0,0
2021,South Oxfordshire 018A,E01028611,1201,1174,27,22,4,0,1
2021,South Oxfordshire 019A,E01028612,1257,1222,35,24,7,3,1
2021,South Oxfordshire 005B,E01028613,1359,1327,32,21,5,4,2
2021,South Oxfordshire 005C,E01028614,2448,2393,55,28,22,4,1
2021,South Oxfordshire 005D,E01028615,1808,1771,37,20,16,1,0
2021,South Oxfordshire 005E,E01028616,1718,1689,29,21,6,2,0
2021,South Oxfordshire 012B,E01028617,2014,1970,44,33,11,0,0
2021,South Oxfordshire 015B,E01028619,1747,1715,32,23,6,2,1
2021,South Oxfordshire 010B,E01028622,1934,1723,211,129,66,14,2
2021,South Oxfordshire 010C,E01028623,1568,1434,134,76,39,15,4
2021,South Oxfordshire 010D,E01028624,2157,1961,196,107,54,32,3
2021,South Oxfordshire 009A,E01028625,1855,1607,248,139,77,31,1
2021,South Oxfordshire 009B,E01028626,1548,1445,103,65,33,4,1
2021,South Oxfordshire 009C,E01028627,1386,1264,122,63,45,13,1
2021,South Oxfordshire 009D,E01028628,1689,1553,136,82,39,11,4
2021,South Oxfordshire 009E,E01028629,1377,1228,149,85,50,13,1
2021,South Oxfordshire 013A,E01028630,1389,1175,214,101,85,24,4
2021,South Oxfordshire 013B,E01028631,1120,987,133,44,56,29,4
2021,South Oxfordshire 013C,E01028632,1433,1333,100,47,25,19,9
2021,South Oxfordshire 013D,E01028633,1403,1231,172,90,62,11,9
2021,South Oxfordshire 014A,E01028634,1274,1222,52,30,18,4,0
2021,South Oxfordshire 014B,E01028635,1510,1401,109,49,36,17,7
2021,South Oxfordshire 014C,E01028636,1290,1183,107,60,33,13,1
2021,South Oxfordshire 014D,E01028637,2088,1972,116,69,34,12,1
2021,South Oxfordshire 002A,E01028638,1487,1412,75,41,19,12,3
2021,South Oxfordshire 002B,E01028639,1458,1377,81,55,23,2,1
2021,South Oxfordshire 002C,E01028640,1360,1320,40,28,9,3,0
2021,South Oxfordshire 006D,E01028641,1131,1107,24,12,6,5,1
2021,South Oxfordshire 018B,E01028642,1448,1424,24,12,9,2,1
2021,South Oxfordshire 018C,E01028643,1381,1351,30,22,8,0,0
2021,South Oxfordshire 015C,E01028644,1634,1597,37,26,10,1,0
2021,South Oxfordshire 018D,E01028645,1476,1446,30,20,10,0,0
2021,South Oxfordshire 004A,E01028646,1164,1131,33,16,13,4,0
2021,South Oxfordshire 004B,E01028647,1557,1500,57,33,16,8,0
2021,South Oxfordshire 015E,E01028649,1477,1467,10,8,1,1,0
2021,South Oxfordshire 016A,E01028650,2109,1987,122,62,51,8,1
2021,South Oxfordshire 016B,E01028651,1605,1485,120,58,40,16,6
2021,South Oxfordshire 016C,E01028652,2066,1914,152,87,47,10,8
2021,South Oxfordshire 017A,E01028653,1550,1446,104,51,28,21,4
2021,South Oxfordshire 017B,E01028654,1553,1508,45,23,17,5,0
2021,South Oxfordshire 017C,E01028655,1663,1491,172,86,59,19,8
2021,South Oxfordshire 017D,E01028656,1335,1303,32,22,10,0,0
2021,South Oxfordshire 006E,E01028657,1178,1096,82,42,32,7,1
2021,South Oxfordshire 006F,E01028658,1281,1205,76,61,11,4,0
2021,South Oxfordshire 020A,E01028659,1641,1611,30,21,6,3,0
2021,South Oxfordshire 019B,E01028660,1922,1879,43,19,16,8,0
2021,South Oxfordshire 019C,E01028661,1676,1632,44,31,9,4,0
2021,South Oxfordshire 019D,E01028662,1356,1343,13,12,1,0,0
2021,South Oxfordshire 020B,E01028663,1545,1494,51,28,17,5,1
2021,South Oxfordshire 020C,E01028664,1470,1426,44,29,13,0,2
2021,South Oxfordshire 020D,E01028665,1335,1325,10,6,4,0,0
2021,South Oxfordshire 001A,E01028666,1438,1391,47,25,19,3,0
2021,South Oxfordshire 001B,E01028667,1261,1217,44,30,12,2,0
2021,South Oxfordshire 001C,E01028668,1244,1232,12,9,1,2,0
2021,South Oxfordshire 001D,E01028669,1279,1234,45,22,14,9,0
2021,South Oxfordshire 003A,E01028670,1455,1440,15,12,3,0,0
2021,South Oxfordshire 003B,E01028671,1581,1524,57,31,18,8,0
2021,South Oxfordshire 003C,E01028672,2680,2600,80,47,23,6,4
2021,South Oxfordshire 003D,E01028673,1921,1847,74,49,13,11,1
2021,South Oxfordshire 012C,E01028674,1316,1273,43,24,13,5,1
2021,South Oxfordshire 012D,E01028675,1301,1260,41,24,13,2,2
2021,South Oxfordshire 012E,E01028676,2170,2034,136,57,58,19,2
2021,South Oxfordshire 012F,E01028677,1379,1301,78,39,22,15,2
2021,South Oxfordshire 008A,E01028678,1582,1550,32,21,11,0,0
2021,South Oxfordshire 008B,E01028679,2140,2088,52,33,15,3,1
2021,South Oxfordshire 008C,E01028680,1642,1601,41,26,12,3,0
2021,South Oxfordshire 004C,E01028681,1267,1222,45,33,8,4,0
2021,South Oxfordshire 004D,E01028682,1221,1177,44,25,9,7,3
2021,South Oxfordshire 002D,E01028683,1430,1381,49,32,13,3,1
2021,South Oxfordshire 004E,E01028684,1363,1284,79,52,20,6,1
2021,South Oxfordshire 018E,E01028685,1209,1184,25,15,5,5,0
2021,South Oxfordshire 018F,E01028686,1350,1307,43,19,18,6,0
2021,Vale of White Horse 005A,E01028688,1096,984,112,67,32,11,2
2021,Vale of White Horse 005B,E01028689,1340,1221,119,57,47,15,0
2021,Vale of White Horse 008A,E01028690,1540,1413,127,65,42,17,3
2021,Vale of White Horse 008B,E01028691,1715,1578,137,88,28,19,2
2021,Vale of White Horse 008C,E01028692,1393,1293,100,36,35,23,6
2021,Vale of White Horse 004A,E01028693,1495,1413,82,57,18,7,0
2021,Vale of White Horse 004B,E01028694,1374,1290,84,46,29,9,0
2021,Vale of White Horse 005C,E01028695,1553,1465,88,52,28,8,0
2021,Vale of White Horse 006B,E01028696,1405,1326,79,59,17,2,1
2021,Vale of White Horse 006C,E01028697,1540,1403,137,69,48,20,0
2021,Vale of White Horse 006D,E01028698,1385,1268,117,70,35,9,3
2021,Vale of White Horse 005D,E01028699,1558,1445,113,71,31,11,0
2021,Vale of White Horse 006E,E01028700,1592,1511,81,51,18,11,1
2021,Vale of White Horse 004C,E01028701,1505,1374,131,77,39,11,4
2021,Vale of White Horse 008D,E01028702,1202,1156,46,22,17,4,3
2021,Vale of White Horse 006F,E01028703,1649,1479,170,85,53,24,8
2021,Vale of White Horse 008E,E01028704,1810,1698,112,68,33,11,0
2021,Vale of White Horse 004D,E01028705,1210,1140,70,40,25,5,0
2021,Vale of White Horse 004E,E01028706,1356,1269,87,59,25,2,1
2021,Vale of White Horse 004F,E01028707,1403,1324,79,55,20,4,0
2021,Vale of White Horse 001A,E01028708,1835,1645,190,98,68,17,7
2021,Vale of White Horse 001B,E01028709,1873,1668,205,112,71,20,2
2021,Vale of White Horse 001C,E01028710,2059,1904,155,98,37,18,2
2021,Vale of White Horse 001D,E01028711,1652,1603,49,35,4,7,3
2021,Vale of White Horse 015A,E01028712,2095,2069,26,21,4,1,0
2021,Vale of White Horse 016E,E01028713,2493,2459,34,24,7,3,0
2021,Vale of White Horse 016F,E01028715,2239,2176,63,47,13,1,2
2021,Vale of White Horse 009A,E01028716,2310,2202,108,66,38,3,1
2021,Vale of White Horse 009B,E01028717,1509,1437,72,35,24,11,2
2021,Vale of White Horse 009C,E01028718,1430,1388,42,23,15,3,1
2021,Vale of White Horse 009D,E01028719,1566,1531,35,20,9,5,1
2021,Vale of White Horse 016G,E01028720,2552,2506,46,30,9,5,2
2021,Vale of White Horse 011A,E01028721,1198,1172,26,20,5,1,0
2021,Vale of White Horse 011B,E01028722,1508,1458,50,35,12,1,2
2021,Vale of White Horse 011C,E01028723,2133,2079,54,33,17,4,0
2021,Vale of White Horse 011D,E01028724,1159,1133,26,13,12,1,0
2021,Vale of White Horse 011E,E01028725,2735,2592,143,89,38,11,5
2021,Vale of White Horse 007A,E01028726,2781,2704,77,52,18,6,1
2021,Vale of White Horse 015C,E01028728,1251,1217,34,14,16,3,1
2021,Vale of White Horse 015D,E01028729,1805,1730,75,59,11,5,0
2021,Vale of White Horse 015E,E01028730,1576,1541,35,24,8,3,0
2021,Vale of White Horse 010B,E01028731,2019,1973,46,25,18,3,0
2021,Vale of White Horse 010C,E01028732,1598,1520,78,46,24,7,1
2021,Vale of White Horse 002A,E01028733,1300,1210,90,52,28,9,1
2021,Vale of White Horse 002B,E01028734,1535,1429,106,57,42,5,2
2021,Vale of White Horse 002C,E01028735,1611,1516,95,48,29,18,0
2021,Vale of White Horse 007C,E01028737,2335,2301,34,24,9,1,0
2021,Vale of White Horse 003A,E01028738,1822,1514,308,169,121,13,5
2021,Vale of White Horse 003B,E01028739,2380,2250,130,78,40,11,1
2021,Vale of White Horse 002D,E01028740,1592,1374,218,127,70,20,1
2021,Vale of White Horse 002E,E01028741,1964,1763,201,134,54,13,0
2021,Vale of White Horse 002F,E01028742,2015,1680,335,218,88,25,4
2021,Vale of White Horse 003C,E01028743,1630,1577,53,41,8,2,2
2021,Vale of White Horse 003D,E01028744,1251,1203,48,35,8,5,0
2021,Vale of White Horse 016A,E01028745,1726,1678,48,25,18,5,0
2021,Vale of White Horse 016B,E01028746,1604,1576,28,14,11,1,2
2021,Vale of White Horse 016C,E01028747,1421,1347,74,42,22,9,1
2021,Vale of White Horse 016D,E01028748,1305,1235,70,46,16,5,3
2021,Vale of White Horse 009E,E01028749,2569,2540,29,25,3,0,1
2021,Vale of White Horse 003E,E01028750,1341,1253,88,56,25,7,0
2021,Vale of White Horse 003F,E01028751,1408,1327,81,52,23,6,0
2021,Vale of White Horse 003G,E01028752,1617,1545,72,53,14,5,0
2021,Vale of White Horse 010D,E01028753,1710,1616,94,72,13,7,2
2021,Vale of White Horse 010E,E01028754,1582,1505,77,61,15,1,0
2021,Vale of White Horse 014A,E01028755,1770,1732,38,22,12,2,2
2021,Vale of White Horse 015F,E01028757,2170,2075,95,65,18,12,0
2021,Vale of White Horse 014C,E01028758,1662,1609,53,42,9,2,0
2021,Vale of White Horse 014D,E01028759,1694,1647,47,23,20,4,0
2021,Vale of White Horse 014E,E01028760,1197,1171,26,14,11,1,0
2021,Vale of White Horse 014F,E01028761,1203,1162,41,26,6,6,3
2021,West Oxfordshire 012A,E01028762,1786,1766,20,15,5,0,0
2021,West Oxfordshire 003A,E01028763,2123,2092,31,24,5,2,0
2021,West Oxfordshire 015A,E01028764,1693,1664,29,12,12,5,0
2021,West Oxfordshire 015B,E01028765,2375,2351,24,12,12,0,0
2021,West Oxfordshire 012C,E01028767,1944,1900,44,18,23,3,0
2021,West Oxfordshire 014A,E01028771,1445,1366,79,36,33,10,0
2021,West Oxfordshire 013D,E01028772,2339,2237,102,63,30,8,1
2021,West Oxfordshire 014B,E01028773,1324,1282,42,24,17,0,1
2021,West Oxfordshire 014C,E01028774,1492,1455,37,15,17,4,1
2021,West Oxfordshire 014D,E01028775,1217,1183,34,12,17,5,0
2021,West Oxfordshire 003B,E01028776,1913,1861,52,17,19,11,5
2021,West Oxfordshire 005A,E01028777,1149,1127,22,16,5,1,0
2021,West Oxfordshire 005B,E01028778,1468,1443,25,17,8,0,0
2021,West Oxfordshire 005C,E01028779,1124,1111,13,9,3,1,0
2021,West Oxfordshire 001A,E01028780,2219,2117,102,45,43,14,0
2021,West Oxfordshire 001B,E01028781,1753,1676,77,39,34,4,0
2021,West Oxfordshire 001C,E01028782,1489,1430,59,30,20,9,0
2021,West Oxfordshire 001D,E01028783,1535,1436,99,55,40,4,0
2021,West Oxfordshire 007A,E01028784,2352,2283,69,40,19,7,3
2021,West Oxfordshire 011A,E01028785,1533,1452,81,48,24,7,2
2021,West Oxfordshire 011B,E01028786,1396,1327,69,43,19,5,2
2021,West Oxfordshire 011C,E01028787,1390,1336,54,26,18,6,4
2021,West Oxfordshire 006A,E01028788,1964,1894,70,46,15,6,3
2021,West Oxfordshire 006B,E01028789,1813,1759,54,42,9,3,0
2021,West Oxfordshire 006C,E01028790,1557,1514,43,28,13,2,0
2021,West Oxfordshire 006D,E01028791,1489,1466,23,21,2,0,0
2021,West Oxfordshire 007B,E01028792,1092,1084,8,6,2,0,0
2021,West Oxfordshire 007C,E01028793,1543,1522,21,9,8,4,0
2021,West Oxfordshire 007D,E01028794,1417,1385,32,16,15,0,1
2021,West Oxfordshire 002A,E01028795,1590,1539,51,15,16,19,1
2021,West Oxfordshire 002B,E01028796,1398,1343,55,35,15,5,0
2021,West Oxfordshire 002C,E01028797,1214,1185,29,19,8,2,0
2021,West Oxfordshire 003C,E01028798,2196,2154,42,28,7,7,0
2021,West Oxfordshire 005D,E01028799,2084,2037,47,22,19,5,1
2021,West Oxfordshire 011D,E01028800,1441,1418,23,14,7,2,0
2021,West Oxfordshire 015C,E01028801,1456,1436,20,14,4,2,0
2021,West Oxfordshire 015D,E01028802,1584,1556,28,14,12,2,0
2021,West Oxfordshire 004B,E01028804,1415,1397,18,15,2,1,0
2021,West Oxfordshire 002D,E01028806,1925,1883,42,27,12,2,1
2021,West Oxfordshire 010A,E01028807,2111,1908,203,90,88,21,4
2021,West Oxfordshire 010B,E01028808,2231,2120,111,59,32,15,5
2021,West Oxfordshire 009A,E01028809,1423,1365,58,20,23,11,4
2021,West Oxfordshire 008A,E01028810,1250,1194,56,34,21,1,0
2021,West Oxfordshire 008B,E01028811,1320,1267,53,29,19,5,0
2021,West Oxfordshire 008D,E01028813,1273,1236,37,17,13,3,4
2021,West Oxfordshire 008E,E01028814,1409,1358,51,26,18,7,0
2021,West Oxfordshire 008F,E01028815,1184,1168,16,10,6,0,0
2021,West Oxfordshire 010C,E01028816,1254,1123,131,50,54,25,2
2021,West Oxfordshire 010D,E01028817,1400,1301,99,37,46,16,0
2021,West Oxfordshire 010E,E01028818,1615,1494,121,57,44,20,0
2021,West Oxfordshire 010F,E01028819,1845,1743,102,48,39,14,1
2021,West Oxfordshire 009B,E01028820,2635,2514,121,73,37,11,0
2021,West Oxfordshire 009C,E01028821,1344,1245,99,49,38,10,2
2021,West Oxfordshire 009D,E01028822,1404,1285,119,49,46,23,1
2021,West Oxfordshire 004D,E01028823,1270,1200,70,41,21,7,1
2021,West Oxfordshire 004E,E01028824,1831,1728,103,77,23,2,1
2021,West Oxfordshire 004F,E01028825,1271,1221,50,37,12,0,1
2021,Shropshire 027A,E01028826,1751,1659,92,18,64,6,4
2021,Shropshire 027B,E01028827,1454,1445,9,5,4,0,0
2021,Shropshire 034A,E01028828,1672,1654,18,11,5,1,1
2021,Shropshire 034B,E01028829,1235,1230,5,1,3,1,0
2021,Shropshire 031A,E01028830,1400,1395,5,2,3,0,0
2021,Shropshire 031B,E01028831,1487,1482,5,2,3,0,0
2021,Shropshire 033A,E01028832,1569,1535,34,17,14,3,0
2021,Shropshire 033B,E01028833,1397,1387,10,7,3,0,0
2021,Shropshire 033C,E01028834,1594,1571,23,13,8,2,0
2021,Shropshire 033D,E01028835,1525,1514,11,7,4,0,0
2021,Shropshire 031C,E01028836,1359,1333,26,13,10,3,0
2021,Shropshire 031D,E01028837,1294,1288,6,3,1,2,0
2021,Shropshire 029A,E01028838,1595,1577,18,12,3,3,0
2021,Shropshire 029B,E01028839,1396,1382,14,10,4,0,0
2021,Shropshire 029C,E01028840,1348,1336,12,5,5,2,0
2021,Shropshire 029D,E01028841,1460,1453,7,2,4,1,0
2021,Shropshire 034C,E01028842,1696,1672,24,11,9,3,1
2021,Shropshire 035A,E01028843,1663,1662,1,0,1,0,0
2021,Shropshire 027C,E01028844,2632,2425,207,91,113,1,2
2021,Shropshire 027D,E01028845,1903,1875,28,15,11,2,0
2021,Shropshire 035B,E01028846,2210,2201,9,5,3,0,1
2021,Shropshire 034D,E01028847,1452,1448,4,4,0,0,0
2021,Shropshire 035C,E01028848,1739,1725,14,8,3,3,0
2021,Shropshire 035D,E01028849,1881,1861,20,12,4,3,1
2021,Shropshire 029E,E01028850,2382,2362,20,10,5,4,1
2021,Shropshire 029F,E01028851,1806,1792,14,10,3,1,0
2021,Shropshire 029G,E01028852,1585,1561,24,15,6,3,0
2021,Shropshire 025A,E01028853,1337,1333,4,3,0,1,0
2021,Shropshire 025B,E01028854,1359,1343,16,8,6,2,0
2021,Shropshire 025C,E01028855,2695,2636,59,22,21,16,0
2021,Shropshire 025D,E01028856,1548,1511,37,23,7,5,2
2021,Shropshire 035E,E01028858,2109,2096,13,7,4,2,0
2021,Shropshire 034E,E01028859,1671,1647,24,6,13,5,0
2021,Shropshire 010A,E01028860,2260,2234,26,11,9,5,1
2021,Shropshire 013A,E01028861,1391,1379,12,4,3,5,0
2021,Shropshire 010B,E01028862,1720,1709,11,5,4,2,0
2021,Shropshire 010C,E01028863,1347,1336,11,6,5,0,0
2021,Shropshire 004A,E01028864,1478,1445,33,17,12,3,1
2021,Shropshire 004B,E01028865,1789,1740,49,25,13,10,1
2021,Shropshire 004C,E01028866,1378,1309,69,26,22,18,3
2021,Shropshire 004D,E01028867,1702,1648,54,26,18,10,0
2021,Shropshire 009A,E01028868,1390,1376,14,7,2,4,1
2021,Shropshire 009B,E01028869,1682,1663,19,10,7,2,0
2021,Shropshire 013B,E01028870,1446,1427,19,11,3,4,1
2021,Shropshire 009C,E01028871,1353,1344,9,4,2,2,1
2021,Shropshire 004E,E01028872,1547,1518,29,17,11,1,0
2021,Shropshire 005A,E01028873,2125,1994,131,36,66,23,6
2021,Shropshire 005B,E01028874,1505,1494,11,7,3,1,0
2021,Shropshire 005C,E01028875,2635,2534,101,17,38,35,11
2021,Shropshire 005D,E01028876,1746,1682,64,30,19,15,0
2021,Shropshire 005E,E01028877,1230,1218,12,5,6,1,0
2021,Shropshire 005F,E01028878,1474,1442,32,13,10,8,1
2021,Shropshire 005G,E01028879,1504,1471,33,15,7,11,0
2021,Shropshire 002A,E01028880,1673,1657,16,6,9,1,0
2021,Shropshire 002B,E01028881,1325,1300,25,10,11,3,1
2021,Shropshire 002C,E01028882,1598,1578,20,15,5,0,0
2021,Shropshire 013C,E01028883,1585,1562,23,17,2,4,0
2021,Shropshire 013D,E01028884,1473,1465,8,3,5,0,0
2021,Shropshire 008A,E01028886,1623,1580,43,14,19,10,0
2021,Shropshire 008B,E01028887,1602,1573,29,7,14,6,2
2021,Shropshire 010D,E01028888,1702,1692,10,5,4,1,0
2021,Shropshire 008C,E01028889,1604,1596,8,4,4,0,0
2021,Shropshire 008D,E01028890,1295,1257,38,16,14,6,2
2021,Shropshire 001A,E01028891,1602,1510,92,28,32,27,5
2021,Shropshire 001B,E01028892,1783,1765,18,10,2,6,0
2021,Shropshire 002D,E01028893,1563,1540,23,14,7,0,2
2021,Shropshire 001C,E01028894,1340,1324,16,3,9,4,0
2021,Shropshire 001D,E01028895,1638,1569,69,38,22,8,1
2021,Shropshire 001E,E01028896,2071,1997,74,31,26,15,2
2021,Shropshire 001F,E01028897,1452,1417,35,22,9,3,1
2021,Shropshire 010E,E01028898,1531,1525,6,3,2,1,0
2021,Shropshire 002E,E01028899,1795,1786,9,6,3,0,0
2021,Shropshire 006C,E01028902,1206,1155,51,18,15,13,5
2021,Shropshire 006D,E01028903,1177,1101,76,22,25,21,8
2021,Shropshire 006E,E01028904,1653,1572,81,32,31,17,1
2021,Shropshire 006F,E01028905,1861,1589,272,46,106,104,16
2021,Shropshire 007A,E01028906,1300,1041,259,52,102,86,19
2021,Shropshire 007B,E01028907,1831,1772,59,32,16,9,2
2021,Shropshire 007C,E01028908,1464,1106,358,102,136,107,13
2021,Shropshire 006G,E01028909,1375,1256,119,29,35,42,13
2021,Shropshire 003A,E01028910,1361,1334,27,12,9,6,0
2021,Shropshire 003B,E01028911,1241,1229,12,7,5,0,0
2021,Shropshire 003C,E01028912,1391,1336,55,26,17,11,1
2021,Shropshire 011A,E01028913,1650,1640,10,9,1,0,0
2021,Shropshire 012A,E01028914,1028,1017,11,9,2,0,0
2021,Shropshire 012B,E01028915,1508,1491,17,8,8,1,0
2021,Shropshire 007D,E01028916,1453,1426,27,21,6,0,0
2021,Shropshire 007E,E01028917,1401,1331,70,28,25,16,1
2021,Shropshire 011B,E01028918,1564,1533,31,8,15,8,0
2021,Shropshire 011C,E01028919,1239,1233,6,3,1,1,1
2021,Shropshire 003D,E01028920,1215,1195,20,12,5,3,0
2021,Shropshire 003E,E01028921,1772,1756,16,10,4,2,0
2021,Shropshire 012C,E01028922,1218,1201,17,9,7,1,0
2021,Shropshire 012D,E01028923,1572,1551,21,16,0,3,2
2021,Shropshire 007F,E01028924,1912,1841,71,28,25,15,3
2021,Shropshire 003F,E01028925,1414,1363,51,23,23,5,0
2021,Shropshire 003G,E01028926,1342,1312,30,14,12,4,0
2021,Shropshire 011D,E01028927,1135,1099,36,22,9,4,1
2021,Shropshire 011E,E01028928,1614,1590,24,18,3,3,0
2021,Shropshire 014A,E01028929,1334,1286,48,21,17,10,0
2021,Shropshire 017A,E01028930,1759,1703,56,31,15,8,2
2021,Shropshire 017B,E01028931,2131,1984,147,68,45,21,13
2021,Shropshire 015A,E01028933,1444,1365,79,26,32,18,3
2021,Shropshire 015B,E01028934,1567,1469,98,42,37,16,3
2021,Shropshire 024A,E01028935,1541,1524,17,8,6,1,2
2021,Shropshire 024B,E01028936,2150,2125,25,15,7,3,0
2021,Shropshire 024C,E01028937,1388,1379,9,8,0,1,0
2021,Shropshire 022A,E01028938,1505,1461,44,18,17,4,5
2021,Shropshire 022B,E01028939,1530,1497,33,16,9,4,4
2021,Shropshire 023A,E01028940,1524,1509,15,9,4,0,2
2021,Shropshire 020B,E01028942,1586,1546,40,32,4,3,1
2021,Shropshire 020C,E01028943,2093,1963,130,51,49,20,10
2021,Shropshire 017C,E01028944,1919,1765,154,71,57,21,5
2021,Shropshire 017D,E01028945,1921,1732,189,77,74,31,7
2021,Shropshire 021A,E01028947,1673,1624,49,26,17,4,2
2021,Shropshire 021B,E01028948,1354,1336,18,13,5,0,0
2021,Shropshire 021C,E01028949,1482,1460,22,12,8,2,0
2021,Shropshire 028A,E01028950,2559,2509,50,25,21,3,1
2021,Shropshire 020D,E01028951,1964,1905,59,29,21,9,0
2021,Shropshire 023B,E01028952,1563,1526,37,29,7,1,0
2021,Shropshire 020E,E01028953,1515,1487,28,12,11,3,2
2021,Shropshire 026A,E01028954,1264,1259,5,4,1,0,0
2021,Shropshire 026B,E01028955,1209,1191,18,8,8,1,1
2021,Shropshire 015C,E01028956,1475,1426,49,17,20,5,7
2021,Shropshire 015D,E01028957,1769,1650,119,41,47,28,3
2021,Shropshire 015E,E01028958,1664,1597,67,41,17,9,0
2021,Shropshire 028B,E01028960,1470,1467,3,2,1,0,0
2021,Shropshire 028C,E01028961,1460,1381,79,40,34,3,2
2021,Shropshire 023C,E01028962,1525,1457,68,29,21,11,7
2021,Shropshire 023D,E01028963,1561,1538,23,16,6,0,1
2021,Shropshire 023E,E01028964,1859,1808,51,31,15,5,0
2021,Shropshire 018A,E01028965,1273,1245,28,12,9,6,1
2021,Shropshire 018B,E01028966,1233,1226,7,1,6,0,0
2021,Shropshire 018C,E01028967,1441,1415,26,17,6,3,0
2021,Shropshire 018D,E01028968,1326,1290,36,18,13,5,0
2021,Shropshire 014B,E01028969,1505,1473,32,15,10,3,4
2021,Shropshire 014C,E01028970,1471,1460,11,9,2,0,0
2021,Shropshire 014D,E01028971,2270,2246,24,15,9,0,0
2021,Shropshire 019B,E01028972,1854,1789,65,45,14,4,2
2021,Shropshire 019C,E01028973,1897,1799,98,39,37,16,6
2021,Shropshire 023F,E01028974,1722,1642,80,47,30,1,2
2021,Shropshire 026C,E01028975,1926,1872,54,23,23,6,2
2021,Shropshire 026D,E01028976,1678,1666,12,9,2,1,0
2021,Shropshire 026E,E01028977,1948,1929,19,15,2,2,0
2021,Shropshire 014E,E01028978,1879,1790,89,9,37,22,21
2021,Shropshire 014F,E01028979,1136,1128,8,4,3,1,0
2021,Shropshire 028D,E01028980,2149,2122,27,14,9,4,0
2021,Shropshire 016B,E01028981,1730,1686,44,14,21,9,0
2021,Shropshire 016C,E01028982,1547,1489,58,20,21,15,2
2021,Shropshire 016D,E01028983,1913,1845,68,28,27,13,0
2021,Shropshire 022C,E01028984,1275,1254,21,16,4,1,0
2021,Shropshire 021D,E01028985,1232,1210,22,9,8,4,1
2021,Shropshire 022D,E01028986,2101,2051,50,26,9,13,2
2021,Shropshire 018E,E01028988,1565,1518,47,18,18,9,2
2021,Shropshire 018F,E01028989,1524,1475,49,25,13,7,4
2021,Shropshire 032A,E01028990,1129,1126,3,1,2,0,0
2021,Shropshire 030B,E01028992,1461,1448,13,9,2,1,1
2021,Shropshire 036A,E01028993,1471,1459,12,7,4,1,0
2021,Shropshire 037A,E01028994,1214,1202,12,5,7,0,0
2021,Shropshire 039A,E01028995,1412,1392,20,8,7,4,1
2021,Shropshire 039B,E01028996,1269,1255,14,8,5,1,0
2021,Shropshire 032B,E01028997,2319,2294,25,14,9,2,0
2021,Shropshire 032C,E01028998,2229,2198,31,14,12,4,1
2021,Shropshire 039C,E01028999,1502,1497,5,5,0,0,0
2021,Shropshire 039D,E01029000,1138,1133,5,3,0,2,0
2021,Shropshire 039E,E01029001,2047,2039,8,5,3,0,0
2021,Shropshire 039F,E01029002,1362,1350,12,5,4,3,0
2021,Shropshire 037B,E01029003,2164,2156,8,4,2,2,0
2021,Shropshire 037C,E01029005,1181,1170,11,4,5,2,0
2021,Shropshire 038A,E01029006,1499,1477,22,14,6,2,0
2021,Shropshire 038B,E01029007,1092,1074,18,4,11,1,2
2021,Shropshire 038D,E01029009,1209,1187,22,12,6,4,0
2021,Shropshire 038E,E01029010,1224,1205,19,11,7,1,0
2021,Shropshire 038F,E01029011,1328,1309,19,8,8,1,2
2021,Shropshire 038G,E01029012,1853,1832,21,11,7,3,0
2021,Shropshire 036C,E01029013,1648,1546,102,19,35,42,6
2021,Shropshire 036D,E01029014,1126,1081,45,14,20,10,1
2021,Shropshire 037D,E01029016,1436,1418,18,13,3,2,0
2021,Mendip 006A,E01029018,2366,2342,24,15,8,1,0
2021,Mendip 013A,E01029019,2591,2551,40,22,11,7,0
2021,Mendip 010A,E01029020,1473,1457,16,8,6,2,0
2021,Mendip 010B,E01029021,1221,1217,4,3,0,0,1
2021,Mendip 001A,E01029022,1433,1414,19,11,7,1,0
2021,Mendip 001B,E01029023,1276,1269,7,5,2,0,0
2021,Mendip 002A,E01029024,2224,2197,27,13,12,2,0
2021,Mendip 002B,E01029025,1343,1329,14,7,5,0,2
2021,Mendip 010C,E01029027,1503,1472,31,14,14,3,0
2021,Mendip 010D,E01029028,1098,1075,23,7,12,3,1
2021,Mendip 007A,E01029029,1625,1565,60,33,19,8,0
2021,Mendip 003A,E01029030,1785,1761,24,14,3,7,0
2021,Mendip 003B,E01029031,1583,1547,36,15,11,8,2
2021,Mendip 003C,E01029032,1033,1025,8,4,3,1,0
2021,Mendip 003D,E01029033,1354,1305,49,22,21,6,0
2021,Mendip 003E,E01029034,1255,1223,32,16,14,2,0
2021,Mendip 004A,E01029036,1797,1728,69,31,27,11,0
2021,Mendip 007C,E01029037,1371,1327,44,31,8,5,0
2021,Mendip 007D,E01029038,1568,1526,42,23,13,5,1
2021,Mendip 007E,E01029039,1499,1472,27,13,11,3,0
2021,Mendip 007F,E01029040,1585,1541,44,23,14,7,0
2021,Mendip 004B,E01029041,1981,1904,77,42,21,8,6
2021,Mendip 004C,E01029042,1452,1403,49,22,21,5,1
2021,Mendip 004D,E01029043,1666,1615,51,29,17,2,3
2021,Mendip 001C,E01029044,1366,1322,44,19,16,7,2
2021,Mendip 004E,E01029045,1593,1536,57,29,19,9,0
2021,Mendip 011A,E01029046,1333,1261,72,31,26,8,7
2021,Mendip 012A,E01029047,1313,1277,36,23,13,0,0
2021,Mendip 011D,E01029050,2588,2507,81,45,23,10,3
2021,Mendip 011E,E01029051,1401,1371,30,19,5,3,3
2021,Mendip 005A,E01029052,2046,2030,16,9,3,4,0
2021,Mendip 001D,E01029053,2317,2300,17,12,2,3,0
2021,Mendip 012B,E01029054,1637,1632,5,3,2,0,0
2021,Mendip 012C,E01029055,1239,1231,8,4,2,2,0
2021,Mendip 006B,E01029056,2293,2264,29,18,11,0,0
2021,Mendip 001E,E01029057,2161,2138,23,16,5,2,0
2021,Mendip 010E,E01029058,2267,2252,15,12,2,0,1
2021,Mendip 013B,E01029059,2141,2120,21,14,5,2,0
2021,Mendip 005B,E01029060,1969,1947,22,18,4,0,0
2021,Mendip 009A,E01029062,1456,1122,334,106,178,45,5
2021,Mendip 009B,E01029063,2506,2342,164,85,62,15,2
2021,Mendip 006C,E01029064,1459,1364,95,42,41,10,2
2021,Mendip 009C,E01029065,1486,1460,26,11,9,5,1
2021,Mendip 009D,E01029066,1665,1559,106,51,38,15,2
2021,Mendip 009E,E01029067,1635,1532,103,47,42,13,1
2021,Mendip 002D,E01029068,1428,1383,45,15,25,5,0
2021,Mendip 014A,E01029070,2429,2311,118,55,43,14,6
2021,Mendip 014B,E01029071,1410,1372,38,20,11,4,3
2021,Mendip 014C,E01029072,1541,1477,64,36,16,10,2
2021,Mendip 014D,E01029073,1220,1187,33,13,18,2,0
2021,Mendip 012D,E01029074,2176,2114,62,33,24,5,0
2021,Mendip 014E,E01029075,1373,1346,27,14,9,4,0
2021,Mendip 012E,E01029076,2234,2198,36,14,14,7,1
2021,Mendip 013C,E01029077,2055,2037,18,13,3,1,1
2021,Mendip 008A,E01029078,1804,1751,53,21,20,8,4
2021,Mendip 008B,E01029079,1432,1396,36,23,7,6,0
2021,Mendip 008C,E01029080,1681,1633,48,19,19,9,1
2021,Mendip 008D,E01029081,1891,1821,70,43,20,5,2
2021,Mendip 008E,E01029082,1309,1287,22,15,4,1,2
2021,Mendip 005D,E01029083,1334,1239,95,44,49,2,0
2021,Mendip 006D,E01029084,1449,1415,34,17,11,6,0
2021,Sedgemoor 001A,E01029085,1958,1925,33,17,8,7,1
2021,Sedgemoor 003A,E01029086,2181,2171,10,4,3,3,0
2021,Sedgemoor 002C,E01029089,2298,2284,14,9,5,0,0
2021,Sedgemoor 010B,E01029091,1459,1355,104,44,44,13,3
2021,Sedgemoor 010C,E01029092,1361,1296,65,25,28,9,3
2021,Sedgemoor 008A,E01029093,1481,1319,162,57,69,28,8
2021,Sedgemoor 009A,E01029094,1851,1492,359,115,184,52,8
2021,Sedgemoor 009B,E01029095,1753,1329,424,106,208,96,14
2021,Sedgemoor 008B,E01029096,1664,1497,167,54,74,36,3
2021,Sedgemoor 013A,E01029097,1437,1329,108,51,33,22,2
2021,Sedgemoor 013B,E01029098,1670,1450,220,68,83,48,21
2021,Sedgemoor 013C,E01029099,1325,1246,79,31,27,10,11
2021,Sedgemoor 013D,E01029100,1477,1356,121,48,53,18,2
2021,Sedgemoor 014A,E01029101,1091,1004,87,36,35,14,2
2021,Sedgemoor 011A,E01029102,1885,1781,104,38,47,17,2
2021,Sedgemoor 011B,E01029103,1473,1456,17,4,11,2,0
2021,Sedgemoor 011C,E01029104,1940,1903,37,20,9,7,1
2021,Sedgemoor 013E,E01029105,1645,1498,147,73,53,18,3
2021,Sedgemoor 008C,E01029106,1598,1503,95,31,38,24,2
2021,Sedgemoor 008D,E01029107,1515,1423,92,32,39,18,3
2021,Sedgemoor 010D,E01029108,1995,1837,158,62,76,20,0
2021,Sedgemoor 008E,E01029109,1366,1272,94,34,34,21,5
2021,Sedgemoor 009C,E01029110,2117,1892,225,102,96,23,4
2021,Sedgemoor 009D,E01029111,2356,2148,208,103,75,25,5
2021,Sedgemoor 009E,E01029112,2127,1760,367,96,163,80,28
2021,Sedgemoor 002D,E01029113,1586,1569,17,8,7,2,0
2021,Sedgemoor 004A,E01029114,1456,1450,6,4,2,0,0
2021,Sedgemoor 002E,E01029115,1551,1539,12,8,2,1,1
2021,Sedgemoor 004B,E01029116,1547,1498,49,20,15,10,4
2021,Sedgemoor 004C,E01029117,1646,1577,69,30,24,15,0
2021,Sedgemoor 005A,E01029118,1684,1640,44,20,18,6,0
2021,Sedgemoor 004D,E01029119,1579,1542,37,11,22,3,1
2021,Sedgemoor 004E,E01029120,1424,1389,35,16,16,2,1
2021,Sedgemoor 007A,E01029121,1223,1205,18,10,5,1,2
2021,Sedgemoor 007B,E01029122,1501,1481,20,13,6,1,0
2021,Sedgemoor 007C,E01029123,1114,1098,16,12,2,1,1
2021,Sedgemoor 007D,E01029124,1793,1773,20,12,7,1,0
2021,Sedgemoor 007E,E01029125,1359,1342,17,11,5,1,0
2021,Sedgemoor 001B,E01029126,1499,1464,35,12,13,10,0
2021,Sedgemoor 001C,E01029127,1563,1546,17,10,6,1,0
2021,Sedgemoor 001D,E01029128,1850,1826,24,15,7,1,1
2021,Sedgemoor 001E,E01029129,2285,2249,36,19,14,3,0
2021,Sedgemoor 012A,E01029130,1991,1971,20,14,3,3,0
2021,Sedgemoor 005B,E01029131,2181,2051,130,55,53,20,2
2021,Sedgemoor 005C,E01029132,1499,1464,35,18,15,2,0
2021,Sedgemoor 005D,E01029133,1224,1214,10,6,3,1,0
2021,Sedgemoor 005E,E01029134,2048,1996,52,13,34,3,2
2021,Sedgemoor 006A,E01029135,1643,1632,11,5,5,1,0
2021,Sedgemoor 006B,E01029136,2187,2156,31,19,7,3,2
2021,Sedgemoor 012B,E01029137,1668,1660,8,3,2,2,1
2021,Sedgemoor 012C,E01029138,1419,1406,13,7,4,2,0
2021,Sedgemoor 012D,E01029139,1523,1515,8,8,0,0,0
2021,Sedgemoor 014C,E01029142,1478,1468,10,3,5,2,0
2021,Sedgemoor 014D,E01029143,1330,1307,23,9,9,3,2
2021,Sedgemoor 014E,E01029144,1218,1207,11,4,6,1,0
2021,Sedgemoor 006C,E01029145,2200,2157,43,22,16,5,0
2021,Sedgemoor 003B,E01029147,1683,1668,15,8,7,0,0
2021,Sedgemoor 003C,E01029148,1545,1532,13,10,2,1,0
2021,Sedgemoor 003D,E01029149,1378,1367,11,7,3,1,0
2021,Sedgemoor 012E,E01029150,1295,1279,16,9,2,4,1
2021,Sedgemoor 012F,E01029151,1288,1280,8,6,1,1,0
2021,Sedgemoor 006D,E01029152,2246,2221,25,16,5,4,0
2021,South Somerset 024A,E01029153,2351,2332,19,10,7,2,0
2021,South Somerset 008A,E01029154,1859,1836,23,13,4,5,1
2021,South Somerset 005A,E01029155,1763,1747,16,13,3,0,0
2021,South Somerset 008B,E01029156,1897,1879,18,15,3,0,0
2021,South Somerset 001A,E01029157,1412,1382,30,20,6,4,0
2021,South Somerset 001B,E01029158,1388,1353,35,24,10,1,0
2021,South Somerset 018A,E01029159,1914,1823,91,59,21,9,2
2021,South Somerset 013A,E01029161,1503,1426,77,38,32,7,0
2021,South Somerset 013B,E01029162,1465,1343,122,61,45,16,0
2021,South Somerset 010A,E01029163,2161,2146,15,10,4,1,0
2021,South Somerset 006A,E01029164,1628,1595,33,21,9,3,0
2021,South Somerset 006B,E01029165,1190,1177,13,4,9,0,0
2021,South Somerset 002A,E01029166,2399,2382,17,13,4,0,0
2021,South Somerset 002B,E01029167,1658,1634,24,8,7,8,1
2021,South Somerset 002C,E01029168,1709,1680,29,12,12,4,1
2021,South Somerset 022A,E01029169,1685,1513,172,67,71,32,2
2021,South Somerset 023A,E01029170,1209,1052,157,58,67,28,4
2021,South Somerset 023B,E01029171,2252,2053,199,67,93,35,4
2021,South Somerset 022B,E01029172,1458,1410,48,24,17,7,0
2021,South Somerset 022C,E01029173,1389,1258,131,42,51,30,8
2021,South Somerset 023C,E01029174,1058,1014,44,20,17,4,3
2021,South Somerset 023D,E01029175,2176,1929,247,67,103,67,10
2021,South Somerset 022D,E01029176,1331,1257,74,24,28,21,1
2021,South Somerset 022E,E01029177,1237,1154,83,27,41,12,3
2021,South Somerset 020A,E01029178,1519,1502,17,8,4,4,1
2021,South Somerset 020B,E01029179,1066,1062,4,4,0,0,0
2021,South Somerset 020C,E01029180,1442,1430,12,5,5,0,2
2021,South Somerset 020D,E01029181,1277,1260,17,9,7,1,0
2021,South Somerset 021A,E01029182,1633,1621,12,8,4,0,0
2021,South Somerset 021B,E01029183,1641,1611,30,13,11,6,0
2021,South Somerset 021C,E01029184,1741,1720,21,8,11,2,0
2021,South Somerset 021D,E01029185,1629,1563,66,36,21,8,1
2021,South Somerset 021E,E01029186,1507,1455,52,17,29,6,0
2021,South Somerset 007A,E01029187,1172,1157,15,5,4,4,2
2021,South Somerset 007B,E01029188,1487,1475,12,3,7,1,1
2021,South Somerset 017A,E01029189,1057,1049,8,3,2,1,2
2021,South Somerset 017B,E01029190,1411,1406,5,3,1,1,0
2021,South Somerset 017C,E01029191,1256,1243,13,6,4,2,1
2021,South Somerset 017D,E01029192,1373,1361,12,4,5,2,1
2021,South Somerset 019A,E01029193,1897,1861,36,13,18,5,0
2021,South Somerset 019B,E01029194,2579,2555,24,11,10,3,0
2021,South Somerset 019C,E01029195,1500,1495,5,3,2,0,0
2021,South Somerset 007C,E01029196,1718,1706,12,9,2,0,1
2021,South Somerset 007D,E01029197,1276,1267,9,6,2,1,0
2021,South Somerset 006C,E01029198,1141,1069,72,47,20,4,1
2021,South Somerset 006D,E01029199,2769,2746,23,14,6,3,0
2021,South Somerset 004A,E01029200,1551,1488,63,23,26,10,4
2021,South Somerset 004B,E01029201,1725,1688,37,20,13,3,1
2021,South Somerset 009A,E01029202,1169,1142,27,10,15,1,1
2021,South Somerset 009B,E01029203,1441,1420,21,9,8,3,1
2021,South Somerset 009C,E01029204,1199,1187,12,9,3,0,0
2021,South Somerset 009D,E01029205,1650,1602,48,29,13,6,0
2021,South Somerset 008C,E01029206,1680,1642,38,20,14,3,1
2021,South Somerset 008D,E01029207,1425,1398,27,18,4,5,0
2021,South Somerset 019D,E01029208,1256,1253,3,2,0,1,0
2021,South Somerset 019E,E01029209,1310,1301,9,4,4,0,1
2021,South Somerset 002D,E01029210,1784,1767,17,13,4,0,0
2021,South Somerset 002E,E01029211,1357,1349,8,4,3,1,0
2021,South Somerset 017E,E01029212,1086,1075,11,6,5,0,0
2021,South Somerset 017F,E01029213,1267,1228,39,8,14,17,0
2021,South Somerset 017G,E01029214,1184,1173,11,7,3,0,1
2021,South Somerset 017H,E01029215,1131,1117,14,9,3,2,0
2021,South Somerset 010B,E01029216,1578,1563,15,5,8,1,1
2021,South Somerset 010C,E01029217,1545,1541,4,2,2,0,0
2021,South Somerset 010D,E01029218,2035,2020,15,11,4,0,0
2021,South Somerset 024B,E01029219,1421,1410,11,5,4,2,0
2021,South Somerset 024C,E01029220,1260,1248,12,6,4,2,0
2021,South Somerset 001C,E01029221,2415,2369,46,22,15,8,1
2021,South Somerset 004C,E01029222,1671,1654,17,10,6,1,0
2021,South Somerset 004D,E01029223,1190,1184,6,2,2,0,2
2021,South Somerset 003A,E01029224,2043,2037,6,2,2,2,0
2021,South Somerset 003B,E01029225,2414,2381,33,23,6,3,1
2021,South Somerset 003C,E01029226,1595,1568,27,10,7,8,2
2021,South Somerset 005B,E01029227,2198,2070,128,49,60,18,1
2021,South Somerset 005C,E01029228,2079,2006,73,26,32,13,2
2021,South Somerset 005D,E01029229,2030,1920,110,51,30,23,6
2021,South Somerset 024D,E01029230,2303,2271,32,13,13,6,0
2021,South Somerset 014A,E01029231,1434,1257,177,91,68,15,3
2021,South Somerset 015A,E01029232,1532,1176,356,133,146,68,9
2021,South Somerset 014B,E01029233,1681,1412,269,139,87,34,9
2021,South Somerset 014C,E01029235,1366,1281,85,30,38,14,3
2021,South Somerset 014D,E01029236,1447,1317,130,56,51,22,1
2021,South Somerset 014E,E01029237,1651,1503,148,57,61,26,4
2021,South Somerset 011A,E01029238,1425,1319,106,43,53,10,0
2021,South Somerset 015C,E01029239,1724,1339,385,142,151,81,11
2021,South Somerset 015D,E01029240,1544,1371,173,64,76,28,5
2021,South Somerset 016A,E01029241,2084,1874,210,80,88,38,4
2021,South Somerset 018B,E01029242,1404,1343,61,28,24,6,3
2021,South Somerset 018C,E01029243,1544,1483,61,22,22,15,2
2021,South Somerset 018D,E01029244,1442,1408,34,23,9,2,0
2021,South Somerset 016B,E01029245,2165,2063,102,52,29,18,3
2021,South Somerset 016C,E01029246,1401,1292,109,44,38,19,8
2021,South Somerset 013C,E01029247,1536,1374,162,78,58,22,4
2021,South Somerset 012B,E01029248,1508,1331,177,80,61,29,7
2021,South Somerset 016D,E01029249,1305,1232,73,26,31,16,0
2021,South Somerset 012C,E01029250,1302,1254,48,18,21,8,1
2021,South Somerset 012D,E01029251,1739,1689,50,32,14,3,1
2021,South Somerset 011B,E01029252,1325,1257,68,30,31,7,0
2021,South Somerset 011D,E01029254,1300,1280,20,9,7,2,2
2021,South Somerset 013D,E01029255,1299,1240,59,28,27,2,2
2021,Somerset West and Taunton 012A,E01029256,2177,2109,68,48,17,2,1
2021,Somerset West and Taunton 012B,E01029257,2195,2059,136,66,56,12,2
2021,Somerset West and Taunton 006A,E01029258,1585,1565,20,11,9,0,0
2021,Somerset West and Taunton 006B,E01029259,1477,1471,6,5,0,1,0
2021,Somerset West and Taunton 006C,E01029260,2319,2269,50,32,13,5,0
2021,Somerset West and Taunton 019A,E01029261,2240,2221,19,14,4,1,0
2021,Somerset West and Taunton 017A,E01029262,2278,2261,17,11,5,1,0
2021,Somerset West and Taunton 016A,E01029263,1361,1278,83,57,17,8,1
2021,Somerset West and Taunton 016B,E01029264,1340,1281,59,36,17,6,0
2021,Somerset West and Taunton 016C,E01029265,1327,1285,42,24,12,6,0
2021,Somerset West and Taunton 015A,E01029266,1270,1146,124,62,54,8,0
2021,Somerset West and Taunton 013A,E01029267,1669,1661,8,4,2,0,2
2021,Somerset West and Taunton 006D,E01029268,1611,1593,18,14,4,0,0
2021,Somerset West and Taunton 017B,E01029269,2151,2132,19,9,6,4,0
2021,Somerset West and Taunton 019B,E01029270,2202,2173,29,18,8,2,1
2021,Somerset West and Taunton 009A,E01029271,1865,1838,27,15,9,3,0
2021,Somerset West and Taunton 009B,E01029273,1376,1356,20,13,3,2,2
2021,Somerset West and Taunton 009C,E01029274,1815,1790,25,16,8,1,0
2021,Somerset West and Taunton 009D,E01029275,1250,1235,15,9,4,2,0
2021,Somerset West and Taunton 007A,E01029276,1680,1514,166,65,80,21,0
2021,Somerset West and Taunton 012C,E01029277,1342,1254,88,40,33,11,4
2021,Somerset West and Taunton 007B,E01029278,1414,1384,30,13,8,9,0
2021,Somerset West and Taunton 009E,E01029279,1503,1482,21,8,6,7,0
2021,Somerset West and Taunton 014A,E01029280,1675,1537,138,65,60,11,2
2021,Somerset West and Taunton 014B,E01029281,1613,1533,80,45,24,11,0
2021,Somerset West and Taunton 008A,E01029282,1322,1216,106,61,43,2,0
2021,Somerset West and Taunton 014C,E01029283,1688,1635,53,26,18,8,1
2021,Somerset West and Taunton 015B,E01029284,1669,1387,282,109,116,54,3
2021,Somerset West and Taunton 011A,E01029285,2446,1938,508,215,193,96,4
2021,Somerset West and Taunton 015C,E01029286,1639,1424,215,81,92,38,4
2021,Somerset West and Taunton 011B,E01029287,1464,1303,161,73,67,18,3
2021,Somerset West and Taunton 011C,E01029288,1449,1387,62,31,26,4,1
2021,Somerset West and Taunton 011D,E01029289,1809,1579,230,103,94,29,4
2021,Somerset West and Taunton 007C,E01029290,1377,1292,85,34,38,13,0
2021,Somerset West and Taunton 008B,E01029291,1533,1446,87,45,29,12,1
2021,Somerset West and Taunton 014D,E01029292,1512,1346,166,75,63,27,1
2021,Somerset West and Taunton 014E,E01029293,1610,1431,179,74,67,33,5
2021,Somerset West and Taunton 008C,E01029294,1776,1669,107,51,38,18,0
2021,Somerset West and Taunton 019C,E01029295,1529,1475,54,25,26,3,0
2021,Somerset West and Taunton 019D,E01029296,2148,2019,129,52,69,7,1
2021,Somerset West and Taunton 010A,E01029297,1331,1199,132,64,46,22,0
2021,Somerset West and Taunton 010B,E01029298,1372,1279,93,45,32,15,1
2021,Somerset West and Taunton 011E,E01029299,1554,1401,153,77,56,18,2
2021,Somerset West and Taunton 011F,E01029300,2151,1934,217,124,74,19,0
2021,Somerset West and Taunton 015D,E01029301,2020,1810,210,114,64,29,3
2021,Somerset West and Taunton 016D,E01029302,1713,1564,149,79,50,18,2
2021,Somerset West and Taunton 015E,E01029303,1849,1779,70,36,23,10,1
2021,Somerset West and Taunton 010C,E01029304,1377,1320,57,28,17,11,1
2021,Somerset West and Taunton 010D,E01029305,1296,1257,39,18,13,6,2
2021,Somerset West and Taunton 007D,E01029306,1465,1413,52,19,20,9,4
2021,Somerset West and Taunton 010E,E01029307,1304,1247,57,28,19,9,1
2021,Somerset West and Taunton 016E,E01029308,2036,2006,30,22,5,2,1
2021,Somerset West and Taunton 017C,E01029310,1888,1805,83,25,46,12,0
2021,Somerset West and Taunton 018A,E01029311,2376,2258,118,56,35,14,13
2021,Somerset West and Taunton 018B,E01029312,1336,1305,31,16,10,5,0
2021,Somerset West and Taunton 018C,E01029313,1546,1507,39,23,11,5,0
2021,Somerset West and Taunton 017D,E01029315,1363,1327,36,20,14,2,0
2021,Somerset West and Taunton 018D,E01029316,1677,1603,74,37,21,10,6
2021,Somerset West and Taunton 008D,E01029317,1820,1750,70,37,27,3,3
2021,Somerset West and Taunton 007E,E01029319,1990,1860,130,81,34,14,1
2021,Somerset West and Taunton 013B,E01029320,1706,1680,26,11,9,5,1
2021,Somerset West and Taunton 013C,E01029321,2291,2274,17,16,1,0,0
2021,Somerset West and Taunton 002A,E01029322,1616,1537,79,37,36,5,1
2021,Somerset West and Taunton 001A,E01029324,1701,1659,42,19,18,5,0
2021,Somerset West and Taunton 005A,E01029325,1964,1947,17,9,6,0,2
2021,Somerset West and Taunton 003A,E01029326,1230,1218,12,6,6,0,0
2021,Somerset West and Taunton 004A,E01029327,1999,1977,22,20,1,0,1
2021,Somerset West and Taunton 005B,E01029328,1894,1879,15,11,3,1,0
2021,Somerset West and Taunton 001B,E01029329,1712,1636,76,37,26,12,1
2021,Somerset West and Taunton 001C,E01029330,1886,1812,74,34,31,9,0
2021,Somerset West and Taunton 002B,E01029331,1469,1429,40,23,15,2,0
2021,Somerset West and Taunton 002C,E01029333,1149,1117,32,20,9,3,0
2021,Somerset West and Taunton 003B,E01029334,1104,1100,4,4,0,0,0
2021,Somerset West and Taunton 004B,E01029335,1076,1071,5,3,2,0,0
2021,Somerset West and Taunton 002D,E01029336,2037,2016,21,14,2,4,1
2021,Somerset West and Taunton 004C,E01029337,2111,2073,38,22,15,1,0
2021,Somerset West and Taunton 005C,E01029338,1658,1639,19,11,8,0,0
2021,Somerset West and Taunton 003C,E01029339,1516,1508,8,5,1,2,0
2021,Somerset West and Taunton 003D,E01029341,1269,1253,16,10,4,2,0
2021,Somerset West and Taunton 004D,E01029342,1069,1061,8,5,2,1,0
2021,Somerset West and Taunton 004E,E01029343,1577,1558,19,8,8,2,1
2021,Cannock Chase 003A,E01029345,1928,1886,42,19,14,8,1
2021,Cannock Chase 003B,E01029346,1705,1659,46,18,21,5,2
2021,Cannock Chase 003C,E01029347,1467,1451,16,10,0,4,2
2021,Cannock Chase 003D,E01029348,1695,1659,36,18,10,5,3
2021,Cannock Chase 008A,E01029349,1333,1318,15,6,5,3,1
2021,Cannock Chase 008B,E01029350,1471,1445,26,10,8,6,2
2021,Cannock Chase 008C,E01029351,1498,1461,37,19,16,2,0
2021,Cannock Chase 008D,E01029352,1240,1221,19,8,9,1,1
2021,Cannock Chase 011A,E01029353,1329,1308,21,8,10,3,0
2021,Cannock Chase 007A,E01029354,1436,1406,30,8,16,6,0
2021,Cannock Chase 007B,E01029355,1370,1352,18,8,6,2,2
2021,Cannock Chase 007C,E01029356,1394,1369,25,8,10,5,2
2021,Cannock Chase 007D,E01029357,1604,1555,49,27,17,5,0
2021,Cannock Chase 007E,E01029358,1283,1247,36,16,15,5,0
2021,Cannock Chase 012A,E01029359,2257,2203,54,17,20,15,2
2021,Cannock Chase 012B,E01029360,1481,1390,91,33,35,22,1
2021,Cannock Chase 012C,E01029361,1353,1329,24,13,7,4,0
2021,Cannock Chase 012D,E01029362,1565,1522,43,22,14,4,3
2021,Cannock Chase 012E,E01029363,1292,1283,9,5,3,1,0
2021,Cannock Chase 011B,E01029364,1605,1558,47,23,11,7,6
2021,Cannock Chase 011C,E01029365,1483,1459,24,11,10,3,0
2021,Cannock Chase 011D,E01029366,1686,1667,19,9,7,1,2
2021,Cannock Chase 011E,E01029367,2141,2107,34,13,14,5,2
2021,Cannock Chase 001A,E01029368,1178,1170,8,4,4,0,0
2021,Cannock Chase 001B,E01029369,1169,1160,9,6,2,1,0
2021,Cannock Chase 001C,E01029370,1347,1335,12,7,4,1,0
2021,Cannock Chase 001D,E01029371,1440,1402,38,18,14,5,1
2021,Cannock Chase 002A,E01029372,1271,1233,38,12,20,5,1
2021,Cannock Chase 002B,E01029373,2191,2130,61,28,18,14,1
2021,Cannock Chase 003E,E01029374,2185,2133,52,24,20,5,3
2021,Cannock Chase 010A,E01029375,2314,2285,29,13,11,5,0
2021,Cannock Chase 010B,E01029376,1690,1667,23,5,12,5,1
2021,Cannock Chase 010C,E01029377,1334,1315,19,10,6,3,0
2021,Cannock Chase 010D,E01029378,1581,1554,27,15,8,4,0
2021,Cannock Chase 006A,E01029379,1683,1670,13,4,4,5,0
2021,Cannock Chase 009A,E01029380,1407,1401,6,3,1,2,0
2021,Cannock Chase 009B,E01029381,1367,1354,13,7,5,1,0
2021,Cannock Chase 009C,E01029382,1613,1590,23,5,9,7,2
2021,Cannock Chase 004A,E01029383,1822,1802,20,10,7,3,0
2021,Cannock Chase 004B,E01029385,1506,1498,8,1,5,2,0
2021,Cannock Chase 005B,E01029386,1389,1370,19,12,2,4,1
2021,Cannock Chase 005C,E01029387,1410,1394,16,10,4,2,0
2021,Cannock Chase 004C,E01029388,1325,1307,18,11,6,1,0
2021,Cannock Chase 005D,E01029389,1608,1580,28,17,9,1,1
2021,Cannock Chase 004D,E01029390,1009,995,14,5,5,4,0
2021,Cannock Chase 009D,E01029391,1651,1627,24,11,11,2,0
2021,Cannock Chase 009E,E01029392,2059,2033,26,19,2,3,2
2021,Cannock Chase 008E,E01029393,1537,1528,9,5,4,0,0
2021,Cannock Chase 013A,E01029394,1477,1459,18,6,9,2,1
2021,Cannock Chase 013B,E01029395,2432,2396,36,19,14,2,1
2021,Cannock Chase 013C,E01029396,1571,1559,12,7,3,2,0
2021,Cannock Chase 013D,E01029397,2535,2512,23,10,8,4,1
2021,Cannock Chase 006B,E01029398,1599,1585,14,9,0,4,1
2021,Cannock Chase 006C,E01029399,1381,1355,26,12,10,4,0
2021,Cannock Chase 006D,E01029400,1607,1589,18,11,4,2,1
2021,Cannock Chase 002C,E01029401,1483,1452,31,9,19,3,0
2021,Cannock Chase 001E,E01029402,2088,2049,39,14,19,4,2
2021,Cannock Chase 002D,E01029403,1353,1331,22,12,7,3,0
2021,Cannock Chase 002E,E01029404,1620,1525,95,32,49,14,0
2021,East Staffordshire 001A,E01029405,1577,1568,9,6,3,0,0
2021,East Staffordshire 001B,E01029406,1250,1247,3,3,0,0,0
2021,East Staffordshire 011A,E01029407,1585,1017,568,149,255,140,24
2021,East Staffordshire 011B,E01029408,2248,1370,878,259,416,182,21
2021,East Staffordshire 011C,E01029409,1957,1183,774,218,369,162,25
2021,East Staffordshire 011D,E01029410,1663,1155,508,145,246,99,18
2021,East Staffordshire 006A,E01029411,1416,1409,7,6,1,0,0
2021,East Staffordshire 006B,E01029412,1299,1293,6,2,3,1,0
2021,East Staffordshire 013A,E01029413,1393,1316,77,35,28,14,0
2021,East Staffordshire 013B,E01029414,1683,1507,176,61,83,28,4
2021,East Staffordshire 013C,E01029415,1592,1444,148,53,64,27,4
2021,East Staffordshire 013D,E01029416,2350,2191,159,75,56,26,2
2021,East Staffordshire 013E,E01029417,2007,1909,98,43,38,14,3
2021,East Staffordshire 012A,E01029418,1968,1932,36,14,18,4,0
2021,East Staffordshire 012B,E01029419,1508,1458,50,30,12,6,2
2021,East Staffordshire 012C,E01029420,1635,1584,51,29,19,3,0
2021,East Staffordshire 001C,E01029422,1273,1249,24,11,5,7,1
2021,East Staffordshire 001D,E01029423,1502,1464,38,12,13,13,0
2021,East Staffordshire 006C,E01029424,1010,1005,5,2,2,1,0
2021,East Staffordshire 006D,E01029425,2436,2361,75,38,21,13,3
2021,East Staffordshire 008A,E01029426,2235,1516,719,242,318,139,20
2021,East Staffordshire 008B,E01029427,1694,1288,406,144,175,78,9
2021,East Staffordshire 008C,E01029428,2320,2070,250,119,110,19,2
2021,East Staffordshire 008D,E01029429,1408,1040,368,121,165,65,17
2021,East Staffordshire 002A,E01029430,2409,2357,52,33,17,2,0
2021,East Staffordshire 002B,E01029431,1571,1540,31,15,7,7,2
2021,East Staffordshire 002C,E01029432,1356,1345,11,10,1,0,0
2021,East Staffordshire 002D,E01029433,1503,1442,61,27,23,9,2
2021,East Staffordshire 007A,E01029434,1566,1360,206,83,89,31,3
2021,East Staffordshire 007B,E01029435,1461,1328,133,54,49,28,2
2021,East Staffordshire 007C,E01029436,1773,1475,298,115,132,42,9
2021,East Staffordshire 007D,E01029437,2640,2260,380,171,155,47,7
2021,East Staffordshire 007E,E01029438,1405,1368,37,16,14,6,1
2021,East Staffordshire 015A,E01029439,1361,1348,13,5,2,6,0
2021,East Staffordshire 015B,E01029440,1262,1253,9,3,2,4,0
2021,East Staffordshire 015C,E01029441,1564,1551,13,7,3,2,1
2021,East Staffordshire 015D,E01029442,1648,1630,18,10,6,2,0
2021,East Staffordshire 004A,E01029443,1649,1632,17,8,5,4,0
2021,East Staffordshire 004B,E01029444,1520,1504,16,10,3,3,0
2021,East Staffordshire 009A,E01029445,2474,1661,813,274,365,157,17
2021,East Staffordshire 009B,E01029446,2092,1829,263,105,106,42,10
2021,East Staffordshire 009C,E01029447,1722,1064,658,157,305,159,37
2021,East Staffordshire 009D,E01029448,1810,1380,430,130,199,96,5
2021,East Staffordshire 014A,E01029449,1638,1463,175,67,88,16,4
2021,East Staffordshire 014B,E01029450,1540,1303,237,98,105,25,9
2021,East Staffordshire 014C,E01029451,1721,1607,114,35,57,21,1
2021,East Staffordshire 014D,E01029452,1553,1419,134,56,54,21,3
2021,East Staffordshire 014E,E01029453,1469,1300,169,67,83,17,2
2021,East Staffordshire 005A,E01029454,1528,1503,25,11,8,6,0
2021,East Staffordshire 005B,E01029455,1675,1637,38,23,11,3,1
2021,East Staffordshire 005C,E01029456,1388,1356,32,11,16,4,1
2021,East Staffordshire 005D,E01029457,1250,1221,29,17,7,4,1
2021,East Staffordshire 005E,E01029458,1746,1705,41,17,15,7,2
2021,East Staffordshire 003A,E01029459,1487,1461,26,16,10,0,0
2021,East Staffordshire 003B,E01029460,1691,1631,60,26,22,10,2
2021,East Staffordshire 003C,E01029461,1922,1851,71,29,34,8,0
2021,East Staffordshire 003D,E01029462,1632,1602,30,12,10,7,1
2021,East Staffordshire 004C,E01029463,1216,1205,11,6,4,1,0
2021,East Staffordshire 004D,E01029464,1498,1468,30,13,13,3,1
2021,East Staffordshire 004E,E01029465,2069,2043,26,18,6,2,0
2021,East Staffordshire 004F,E01029466,2228,2096,132,81,40,8,3
2021,East Staffordshire 001E,E01029467,1971,1955,16,9,6,1,0
2021,East Staffordshire 010A,E01029468,1567,1376,191,70,85,32,4
2021,East Staffordshire 010B,E01029469,1750,1671,79,40,31,7,1
2021,East Staffordshire 010C,E01029470,1559,1424,135,52,63,18,2
2021,East Staffordshire 010D,E01029471,1713,1609,104,44,47,7,6
2021,East Staffordshire 010E,E01029472,1538,1431,107,42,45,15,5
2021,East Staffordshire 006E,E01029473,1543,1537,6,4,2,0,0
2021,East Staffordshire 006F,E01029474,1155,1137,18,11,3,3,1
2021,Lichfield 009A,E01029475,1988,1980,8,1,5,2,0
2021,Lichfield 009B,E01029476,1332,1329,3,2,0,0,1
2021,Lichfield 002A,E01029477,1566,1551,15,11,3,1,0
2021,Lichfield 002B,E01029478,1483,1472,11,7,4,0,0
2021,Lichfield 001A,E01029480,1872,1816,56,29,21,4,2
2021,Lichfield 001C,E01029482,1534,1517,17,11,3,3,0
2021,Lichfield 005A,E01029483,1471,1449,22,13,7,2,0
2021,Lichfield 005B,E01029484,1664,1610,54,17,20,13,4
2021,Lichfield 005C,E01029485,1402,1383,19,11,4,4,0
2021,Lichfield 003A,E01029486,1384,1369,15,5,5,4,1
2021,Lichfield 006A,E01029487,1566,1558,8,1,3,3,1
2021,Lichfield 012A,E01029488,2275,2203,72,34,19,15,4
2021,Lichfield 009C,E01029489,1487,1482,5,1,2,2,0
2021,Lichfield 009D,E01029490,1374,1364,10,5,4,1,0
2021,Lichfield 007A,E01029491,1698,1629,69,37,21,10,1
2021,Lichfield 004A,E01029492,1888,1777,111,39,50,21,1
2021,Lichfield 006B,E01029493,1836,1822,14,8,4,2,0
2021,Lichfield 006C,E01029494,1515,1498,17,8,5,3,1
2021,Lichfield 006D,E01029495,1550,1533,17,8,4,1,4
2021,Lichfield 010A,E01029496,1859,1826,33,16,13,2,2
2021,Lichfield 001D,E01029498,1925,1914,11,3,5,3,0
2021,Lichfield 004B,E01029499,1608,1557,51,15,25,9,2
2021,Lichfield 005D,E01029500,1572,1533,39,24,11,4,0
2021,Lichfield 004C,E01029501,1552,1495,57,30,19,6,2
2021,Lichfield 012B,E01029502,1600,1575,25,10,11,2,2
2021,Lichfield 012C,E01029503,1550,1505,45,25,20,0,0
2021,Lichfield 012D,E01029504,1603,1549,54,10,38,5,1
2021,Lichfield 009E,E01029505,1553,1539,14,9,4,1,0
2021,Lichfield 009F,E01029506,1699,1696,3,2,1,0,0
2021,Lichfield 003B,E01029507,1592,1588,4,2,2,0,0
2021,Lichfield 003C,E01029508,2212,2191,21,15,5,1,0
2021,Lichfield 002D,E01029509,1668,1646,22,17,4,1,0
2021,Lichfield 007B,E01029511,1540,1514,26,17,7,2,0
2021,Lichfield 007C,E01029512,2085,2048,37,20,13,4,0
2021,Lichfield 011A,E01029513,1393,1287,106,58,26,19,3
2021,Lichfield 011B,E01029514,1599,1491,108,68,24,13,3
2021,Lichfield 003D,E01029515,1820,1812,8,4,1,3,0
2021,Lichfield 008A,E01029516,1972,1960,12,4,6,2,0
2021,Lichfield 008B,E01029517,2007,1971,36,18,11,6,1
2021,Lichfield 007D,E01029518,2680,2632,48,31,9,7,1
2021,Lichfield 007E,E01029519,2084,2033,51,28,18,3,2
2021,Lichfield 005E,E01029520,1531,1517,14,9,2,2,1
2021,Lichfield 011C,E01029521,1684,1662,22,5,13,4,0
2021,Lichfield 011D,E01029522,1579,1549,30,15,10,5,0
2021,Lichfield 011E,E01029523,1526,1510,16,12,4,0,0
2021,Lichfield 005F,E01029524,1728,1663,65,27,24,14,0
2021,Lichfield 005G,E01029525,1831,1759,72,25,37,8,2
2021,Lichfield 004E,E01029526,1619,1518,101,39,43,17,2
2021,Lichfield 010B,E01029527,1177,1164,13,4,8,1,0
2021,Lichfield 010C,E01029528,1266,1249,17,6,7,3,1
2021,Lichfield 010D,E01029529,1218,1192,26,12,11,3,0
2021,Lichfield 008D,E01029531,1657,1645,12,7,2,3,0
2021,Newcastle-under-Lyme 005A,E01029532,1441,1423,18,10,6,1,1
2021,Newcastle-under-Lyme 005B,E01029533,1432,1415,17,7,7,3,0
2021,Newcastle-under-Lyme 005C,E01029534,1417,1410,7,1,4,2,0
2021,Newcastle-under-Lyme 005D,E01029535,1341,1326,15,8,7,0,0
2021,Newcastle-under-Lyme 004A,E01029536,1405,1396,9,3,6,0,0
2021,Newcastle-under-Lyme 006A,E01029537,1484,1463,21,9,10,2,0
2021,Newcastle-under-Lyme 006B,E01029538,1629,1589,40,20,16,4,0
2021,Newcastle-under-Lyme 006C,E01029539,1422,1404,18,7,7,4,0
2021,Newcastle-under-Lyme 003A,E01029540,1285,1264,21,11,5,4,1
2021,Newcastle-under-Lyme 003B,E01029541,1761,1725,36,13,15,7,1
2021,Newcastle-under-Lyme 003C,E01029542,1518,1498,20,10,8,2,0
2021,Newcastle-under-Lyme 003D,E01029543,1186,1151,35,18,11,5,1
2021,Newcastle-under-Lyme 004B,E01029544,1310,1273,37,20,12,5,0
2021,Newcastle-under-Lyme 004C,E01029545,1439,1386,53,24,17,6,6
2021,Newcastle-under-Lyme 004D,E01029546,1250,1194,56,31,13,10,2
2021,Newcastle-under-Lyme 007A,E01029547,1427,1310,117,47,49,18,3
2021,Newcastle-under-Lyme 007B,E01029548,1258,1183,75,24,35,12,4
2021,Newcastle-under-Lyme 014A,E01029549,1585,1496,89,44,27,17,1
2021,Newcastle-under-Lyme 014B,E01029551,1571,1502,69,44,15,8,2
2021,Newcastle-under-Lyme 006D,E01029552,1421,1364,57,31,16,8,2
2021,Newcastle-under-Lyme 010A,E01029553,1608,1455,153,76,55,21,1
2021,Newcastle-under-Lyme 010B,E01029554,1784,1609,175,93,63,19,0
2021,Newcastle-under-Lyme 011A,E01029555,1746,1646,100,38,44,15,3
2021,Newcastle-under-Lyme 005E,E01029556,2467,2439,28,20,6,2,0
2021,Newcastle-under-Lyme 013A,E01029557,1222,1214,8,5,1,2,0
2021,Newcastle-under-Lyme 006E,E01029558,1657,1551,106,34,57,14,1
2021,Newcastle-under-Lyme 007C,E01029559,1412,1375,37,14,14,8,1
2021,Newcastle-under-Lyme 007D,E01029560,1514,1444,70,26,33,8,3
2021,Newcastle-under-Lyme 002A,E01029561,1411,1387,24,12,9,3,0
2021,Newcastle-under-Lyme 001A,E01029562,1189,1182,7,1,2,4,0
2021,Newcastle-under-Lyme 002B,E01029563,1259,1257,2,0,2,0,0
2021,Newcastle-under-Lyme 002C,E01029564,1292,1260,32,16,13,2,1
2021,Newcastle-under-Lyme 001B,E01029565,1122,1114,8,2,4,2,0
2021,Newcastle-under-Lyme 010C,E01029566,1177,1117,60,19,27,11,3
2021,Newcastle-under-Lyme 010D,E01029567,1599,1544,55,21,23,11,0
2021,Newcastle-under-Lyme 007E,E01029568,1339,1265,74,31,35,7,1
2021,Newcastle-under-Lyme 016A,E01029569,1403,1387,16,6,9,1,0
2021,Newcastle-under-Lyme 016B,E01029570,2627,2590,37,24,11,2,0
2021,Newcastle-under-Lyme 016C,E01029571,1227,1223,4,3,0,1,0
2021,Newcastle-under-Lyme 016D,E01029572,1544,1533,11,6,2,3,0
2021,Newcastle-under-Lyme 013B,E01029573,1377,1363,14,10,3,1,0
2021,Newcastle-under-Lyme 013C,E01029574,1440,1428,12,5,7,0,0
2021,Newcastle-under-Lyme 013D,E01029575,1009,1003,6,3,3,0,0
2021,Newcastle-under-Lyme 012A,E01029576,3150,2923,227,154,65,8,0
2021,Newcastle-under-Lyme 009A,E01029577,1442,1416,26,18,6,1,1
2021,Newcastle-under-Lyme 011B,E01029578,1621,1556,65,32,21,11,1
2021,Newcastle-under-Lyme 009B,E01029579,1602,1563,39,20,16,3,0
2021,Newcastle-under-Lyme 009C,E01029580,1335,1301,34,19,12,3,0
2021,Newcastle-under-Lyme 001C,E01029581,1525,1520,5,3,2,0,0
2021,Newcastle-under-Lyme 001D,E01029582,1785,1779,6,4,1,1,0
2021,Newcastle-under-Lyme 008A,E01029583,1336,1301,35,22,8,5,0
2021,Newcastle-under-Lyme 008B,E01029584,1188,1154,34,20,11,3,0
2021,Newcastle-under-Lyme 008C,E01029585,1299,1266,33,17,15,1,0
2021,Newcastle-under-Lyme 001E,E01029586,1144,1140,4,0,3,0,1
2021,Newcastle-under-Lyme 001F,E01029587,1141,1129,12,5,6,1,0
2021,Newcastle-under-Lyme 002D,E01029588,1562,1537,25,15,7,3,0
2021,Newcastle-under-Lyme 015B,E01029589,1135,1071,64,43,10,9,2
2021,Newcastle-under-Lyme 015C,E01029590,1334,1283,51,27,20,4,0
2021,Newcastle-under-Lyme 014C,E01029591,1465,1373,92,50,33,7,2
2021,Newcastle-under-Lyme 012B,E01029593,2504,2411,93,50,29,10,4
2021,Newcastle-under-Lyme 012C,E01029594,1769,1731,38,22,12,2,2
2021,Newcastle-under-Lyme 003E,E01029595,1166,1146,20,15,5,0,0
2021,Newcastle-under-Lyme 004E,E01029596,1014,997,17,11,5,0,1
2021,Newcastle-under-Lyme 003F,E01029597,1427,1400,27,9,13,5,0
2021,Newcastle-under-Lyme 010E,E01029598,1995,1817,178,103,50,20,5
2021,Newcastle-under-Lyme 010F,E01029599,1495,1421,74,26,30,17,1
2021,Newcastle-under-Lyme 014D,E01029600,1457,1415,42,28,9,3,2
2021,Newcastle-under-Lyme 015E,E01029601,1457,1394,63,42,13,6,2
2021,Newcastle-under-Lyme 011C,E01029602,1649,1459,190,115,60,15,0
2021,Newcastle-under-Lyme 011D,E01029603,1377,1252,125,52,51,20,2
2021,Newcastle-under-Lyme 011E,E01029604,1771,1599,172,63,69,36,4
2021,Newcastle-under-Lyme 014E,E01029605,1322,1290,32,22,8,2,0
2021,Newcastle-under-Lyme 015F,E01029606,1420,1392,28,19,7,2,0
2021,Newcastle-under-Lyme 014F,E01029607,1392,1343,49,29,19,1,0
2021,Newcastle-under-Lyme 015G,E01029608,1471,1362,109,78,25,6,0
2021,Newcastle-under-Lyme 008D,E01029609,1546,1476,70,33,28,8,1
2021,Newcastle-under-Lyme 009D,E01029610,1301,1279,22,6,10,6,0
2021,Newcastle-under-Lyme 008E,E01029611,1795,1715,80,42,20,14,4
2021,Newcastle-under-Lyme 009E,E01029612,1137,1122,15,8,3,3,1
2021,South Staffordshire 008A,E01029613,1271,1250,21,8,10,1,2
2021,South Staffordshire 008B,E01029614,1608,1573,35,18,12,4,1
2021,South Staffordshire 008C,E01029615,1159,1132,27,7,15,5,0
2021,South Staffordshire 006A,E01029616,1453,1442,11,5,2,1,3
2021,South Staffordshire 003A,E01029617,1584,1579,5,3,0,1,1
2021,South Staffordshire 003B,E01029618,1513,1503,10,6,2,2,0
2021,South Staffordshire 006B,E01029619,1884,1864,20,15,3,2,0
2021,South Staffordshire 004A,E01029620,1202,1198,4,2,0,2,0
2021,South Staffordshire 002A,E01029621,1442,1435,7,4,3,0,0
2021,South Staffordshire 004B,E01029622,1571,1559,12,4,7,1,0
2021,South Staffordshire 004C,E01029623,1122,1104,18,8,4,4,2
2021,South Staffordshire 004D,E01029624,1272,1267,5,5,0,0,0
2021,South Staffordshire 004E,E01029625,1001,998,3,0,3,0,0
2021,South Staffordshire 009A,E01029626,1508,1492,16,11,4,1,0
2021,South Staffordshire 008D,E01029627,1351,1335,16,14,2,0,0
2021,South Staffordshire 009B,E01029628,1592,1559,33,24,8,1,0
2021,South Staffordshire 009C,E01029629,1166,1159,7,0,5,2,0
2021,South Staffordshire 009D,E01029630,1339,1316,23,9,12,0,2
2021,South Staffordshire 009E,E01029631,1359,1322,37,15,13,4,5
2021,South Staffordshire 007A,E01029632,1687,1661,26,9,10,7,0
2021,South Staffordshire 007B,E01029633,1840,1817,23,11,9,2,1
2021,South Staffordshire 007C,E01029634,1556,1546,10,3,6,1,0
2021,South Staffordshire 007D,E01029635,1679,1651,28,14,12,2,0
2021,South Staffordshire 006C,E01029636,1367,1359,8,3,2,3,0
2021,South Staffordshire 006D,E01029637,4677,4461,216,92,75,40,9
2021,South Staffordshire 005A,E01029638,1907,1892,15,8,3,3,1
2021,South Staffordshire 005B,E01029639,1313,1304,9,2,3,2,2
2021,South Staffordshire 005C,E01029640,1288,1274,14,11,1,2,0
2021,South Staffordshire 004F,E01029641,1913,1901,12,8,4,0,0
2021,South Staffordshire 004G,E01029642,1429,1417,12,9,1,2,0
2021,South Staffordshire 005D,E01029643,1449,1437,12,8,4,0,0
2021,South Staffordshire 005E,E01029644,1345,1337,8,4,3,1,0
2021,South Staffordshire 013A,E01029645,2469,2451,18,5,9,3,1
2021,South Staffordshire 002B,E01029646,1507,1495,12,6,3,3,0
2021,South Staffordshire 002C,E01029647,2307,2277,30,11,10,9,0
2021,South Staffordshire 002D,E01029648,1351,1334,17,3,9,5,0
2021,South Staffordshire 014A,E01029649,1150,1141,9,6,1,2,0
2021,South Staffordshire 014B,E01029650,1450,1436,14,10,2,2,0
2021,South Staffordshire 014C,E01029651,1427,1424,3,2,0,0,1
2021,South Staffordshire 014D,E01029652,1736,1707,29,16,4,9,0
2021,South Staffordshire 014E,E01029653,1210,1205,5,2,2,1,0
2021,South Staffordshire 015G,E01029654,2203,2187,16,9,4,3,0
2021,South Staffordshire 001A,E01029655,1880,1871,9,5,1,3,0
2021,South Staffordshire 001B,E01029656,1748,1736,12,8,2,2,0
2021,South Staffordshire 001C,E01029657,1631,1625,6,2,1,3,0
2021,South Staffordshire 001D,E01029658,1962,1956,6,5,0,1,0
2021,South Staffordshire 001E,E01029659,1283,1276,7,3,2,2,0
2021,South Staffordshire 001F,E01029660,2114,2096,18,10,5,3,0
2021,South Staffordshire 015C,E01029661,1871,1833,38,23,11,4,0
2021,South Staffordshire 015D,E01029662,1972,1940,32,18,10,4,0
2021,South Staffordshire 015E,E01029663,1342,1325,17,8,7,2,0
2021,South Staffordshire 015F,E01029664,1399,1364,35,11,14,7,3
2021,South Staffordshire 015A,E01029665,1627,1589,38,16,12,10,0
2021,South Staffordshire 015B,E01029666,1411,1389,22,15,2,3,2
2021,South Staffordshire 013B,E01029667,2215,2187,28,13,11,3,1
2021,South Staffordshire 003C,E01029668,1283,1275,8,4,2,2,0
2021,South Staffordshire 003D,E01029669,1300,1291,9,7,2,0,0
2021,South Staffordshire 003E,E01029670,1504,1492,12,4,3,5,0
2021,South Staffordshire 012A,E01029671,1488,1482,6,1,1,4,0
2021,South Staffordshire 013C,E01029672,1563,1491,72,34,22,11,5
2021,South Staffordshire 012B,E01029673,1485,1448,37,19,6,7,5
2021,South Staffordshire 013D,E01029674,1662,1653,9,3,6,0,0
2021,South Staffordshire 013E,E01029675,1425,1422,3,3,0,0,0
2021,South Staffordshire 012C,E01029676,1070,1058,12,7,2,0,3
2021,South Staffordshire 013F,E01029677,1320,1315,5,1,4,0,0
2021,South Staffordshire 013G,E01029678,1542,1539,3,1,1,1,0
2021,South Staffordshire 012D,E01029679,1423,1415,8,3,3,2,0
2021,South Staffordshire 012E,E01029680,1478,1473,5,3,2,0,0
2021,Stafford 002A,E01029681,1180,1156,24,13,8,2,1
2021,Stafford 002B,E01029682,1580,1575,5,3,2,0,0
2021,Stafford 002C,E01029683,1222,1217,5,3,2,0,0
2021,Stafford 014A,E01029684,1415,1342,73,54,13,5,1
2021,Stafford 014B,E01029685,1483,1453,30,22,3,4,1
2021,Stafford 011A,E01029686,1306,1277,29,20,7,2,0
2021,Stafford 008A,E01029687,1921,1905,16,14,1,1,0
2021,Stafford 015A,E01029688,2357,2319,38,15,19,4,0
2021,Stafford 010A,E01029689,1578,1440,138,54,58,24,2
2021,Stafford 006A,E01029690,1412,1357,55,28,21,5,1
2021,Stafford 010B,E01029691,1319,1169,150,50,84,13,3
2021,Stafford 009A,E01029692,1366,1274,92,51,32,9,0
2021,Stafford 009B,E01029693,1353,1039,314,168,120,22,4
2021,Stafford 010C,E01029694,2185,1908,277,138,99,33,7
2021,Stafford 005A,E01029695,2263,2239,24,13,5,4,2
2021,Stafford 005B,E01029696,1369,1356,13,6,4,2,1
2021,Stafford 005C,E01029697,1537,1517,20,14,4,1,1
2021,Stafford 005D,E01029698,1706,1692,14,7,4,2,1
2021,Stafford 010D,E01029699,1883,1751,132,67,47,14,4
2021,Stafford 011B,E01029700,1186,1153,33,14,10,9,0
2021,Stafford 001A,E01029702,1504,1486,18,9,6,3,0
2021,Stafford 001B,E01029703,1587,1575,12,6,2,1,3
2021,Stafford 001C,E01029704,1372,1367,5,5,0,0,0
2021,Stafford 001D,E01029705,1389,1372,17,11,3,3,0
2021,Stafford 015B,E01029706,1763,1746,17,13,2,2,0
2021,Stafford 015C,E01029707,1384,1363,21,13,5,2,1
2021,Stafford 015D,E01029708,2074,2056,18,12,5,1,0
2021,Stafford 015E,E01029709,1425,1417,8,4,1,2,1
2021,Stafford 008B,E01029710,1355,1353,2,1,1,0,0
2021,Stafford 008C,E01029711,1499,1489,10,8,2,0,0
2021,Stafford 008D,E01029712,2019,2005,14,9,2,3,0
2021,Stafford 008E,E01029713,1751,1744,7,5,2,0,0
2021,Stafford 012A,E01029714,1437,1395,42,26,14,2,0
2021,Stafford 013A,E01029715,1388,1318,70,31,28,10,1
2021,Stafford 013B,E01029716,1531,1419,112,49,42,20,1
2021,Stafford 013C,E01029717,1680,1535,145,63,56,22,4
2021,Stafford 006B,E01029718,1855,1779,76,47,20,9,0
2021,Stafford 007A,E01029719,1514,1448,66,38,17,8,3
2021,Stafford 007B,E01029720,1466,1372,94,39,45,10,0
2021,Stafford 007C,E01029721,1564,1503,61,34,20,6,1
2021,Stafford 009C,E01029722,1621,1471,150,84,48,17,1
2021,Stafford 011C,E01029723,1432,1388,44,23,15,6,0
2021,Stafford 011D,E01029724,1629,1573,56,39,14,2,1
2021,Stafford 009D,E01029725,2643,2445,198,97,75,22,4
2021,Stafford 016A,E01029726,1676,1624,52,31,15,6,0
2021,Stafford 013D,E01029727,1418,1350,68,28,26,14,0
2021,Stafford 013E,E01029728,1398,1374,24,4,12,4,4
2021,Stafford 016B,E01029729,1506,1459,47,30,15,2,0
2021,Stafford 004A,E01029733,1878,1856,22,13,5,4,0
2021,Stafford 016C,E01029734,2128,2006,122,58,48,14,2
2021,Stafford 016D,E01029735,2126,2054,72,39,19,11,3
2021,Stafford 012B,E01029736,1654,1589,65,47,11,4,3
2021,Stafford 012C,E01029737,1677,1617,60,33,17,7,3
2021,Stafford 012D,E01029738,1292,1273,19,13,6,0,0
2021,Stafford 004B,E01029739,1462,1438,24,16,4,2,2
2021,Stafford 003A,E01029740,1510,1492,18,15,2,1,0
2021,Stafford 004C,E01029741,1522,1498,24,18,4,2,0
2021,Stafford 012E,E01029742,2046,2025,21,13,7,1,0
2021,Stafford 006C,E01029743,2382,2271,111,67,34,9,1
2021,Stafford 003B,E01029744,2341,2301,40,26,9,5,0
2021,Stafford 003C,E01029745,1684,1615,69,34,25,10,0
2021,Stafford 003D,E01029746,1447,1434,13,6,5,1,1
2021,Stafford 005E,E01029747,2074,2051,23,17,4,2,0
2021,Stafford 002D,E01029748,1282,1257,25,15,8,0,2
2021,Stafford 002E,E01029749,1781,1750,31,18,11,2,0
2021,Stafford 007D,E01029750,2361,2234,127,65,31,31,0
2021,Stafford 006D,E01029751,1586,1547,39,17,17,3,2
2021,Stafford 007E,E01029752,1197,1156,41,14,19,6,2
2021,Stafford 003E,E01029753,1906,1873,33,24,5,3,1
2021,Stafford 004D,E01029754,1721,1687,34,19,9,5,1
2021,Stafford 004E,E01029755,1312,1295,17,4,6,6,1
2021,Stafford 003F,E01029756,1869,1815,54,18,27,7,2
2021,Stafford 014E,E01029757,1422,1378,44,21,19,4,0
2021,Stafford 014F,E01029758,1534,1495,39,23,12,4,0
2021,Stafford 014G,E01029759,1670,1608,62,39,18,3,2
2021,Stafford 014H,E01029760,1736,1665,71,56,13,2,0
2021,Staffordshire Moorlands 010A,E01029761,1330,1326,4,2,2,0,0
2021,Staffordshire Moorlands 008A,E01029762,1597,1591,6,4,0,2,0
2021,Staffordshire Moorlands 003A,E01029763,1495,1488,7,4,1,2,0
2021,Staffordshire Moorlands 003B,E01029764,1717,1710,7,3,2,0,2
2021,Staffordshire Moorlands 003C,E01029765,1272,1260,12,8,4,0,0
2021,Staffordshire Moorlands 003D,E01029766,1388,1368,20,9,7,4,0
2021,Staffordshire Moorlands 002A,E01029767,1536,1530,6,6,0,0,0
2021,Staffordshire Moorlands 004A,E01029768,1526,1520,6,6,0,0,0
2021,Staffordshire Moorlands 002B,E01029769,1736,1728,8,6,2,0,0
2021,Staffordshire Moorlands 002C,E01029770,2013,2001,12,6,3,2,1
2021,Staffordshire Moorlands 004B,E01029771,1567,1559,8,5,1,1,1
2021,Staffordshire Moorlands 004C,E01029772,1577,1574,3,2,1,0,0
2021,Staffordshire Moorlands 004D,E01029773,1462,1459,3,1,0,0,2
2021,Staffordshire Moorlands 003E,E01029774,1873,1841,32,16,4,12,0
2021,Staffordshire Moorlands 008B,E01029775,1404,1403,1,1,0,0,0
2021,Staffordshire Moorlands 008C,E01029776,1710,1707,3,1,2,0,0
2021,Staffordshire Moorlands 008D,E01029777,1510,1498,12,4,6,2,0
2021,Staffordshire Moorlands 012A,E01029778,1747,1734,13,5,3,5,0
2021,Staffordshire Moorlands 009A,E01029779,1552,1545,7,1,5,1,0
2021,Staffordshire Moorlands 009B,E01029780,1565,1555,10,8,1,1,0
2021,Staffordshire Moorlands 011A,E01029781,1377,1367,10,5,2,1,2
2021,Staffordshire Moorlands 010B,E01029782,1920,1894,26,16,8,1,1
2021,Staffordshire Moorlands 011B,E01029783,1399,1383,16,7,4,5,0
2021,Staffordshire Moorlands 013A,E01029784,2057,2053,4,1,3,0,0
2021,Staffordshire Moorlands 013B,E01029785,1717,1710,7,4,2,0,1
2021,Staffordshire Moorlands 011C,E01029786,1352,1344,8,6,1,0,1
2021,Staffordshire Moorlands 011D,E01029787,1856,1791,65,30,14,17,4
2021,Staffordshire Moorlands 013C,E01029788,1268,1262,6,4,2,0,0
2021,Staffordshire Moorlands 012B,E01029789,982,976,6,3,2,0,1
2021,Staffordshire Moorlands 013D,E01029790,1756,1742,14,7,5,2,0
2021,Staffordshire Moorlands 013E,E01029791,1413,1403,10,5,3,2,0
2021,Staffordshire Moorlands 006A,E01029792,2305,2293,12,6,4,1,1
2021,Staffordshire Moorlands 006B,E01029793,1483,1477,6,6,0,0,0
2021,Staffordshire Moorlands 009C,E01029794,1394,1361,33,9,18,5,1
2021,Staffordshire Moorlands 010C,E01029795,1665,1656,9,8,1,0,0
2021,Staffordshire Moorlands 010D,E01029796,1460,1456,4,3,1,0,0
2021,Staffordshire Moorlands 001A,E01029797,1560,1553,7,4,3,0,0
2021,Staffordshire Moorlands 012C,E01029798,1578,1572,6,1,3,2,0
2021,Staffordshire Moorlands 012D,E01029799,1805,1803,2,0,2,0,0
2021,Staffordshire Moorlands 012E,E01029800,1566,1546,20,10,6,2,2
2021,Staffordshire Moorlands 007A,E01029801,1698,1695,3,2,1,0,0
2021,Staffordshire Moorlands 002D,E01029802,1816,1803,13,6,6,0,1
2021,Staffordshire Moorlands 007B,E01029803,1711,1705,6,4,1,1,0
2021,Staffordshire Moorlands 005A,E01029804,1709,1642,67,32,30,5,0
2021,Staffordshire Moorlands 006C,E01029805,1645,1628,17,5,6,3,3
2021,Staffordshire Moorlands 001B,E01029806,1425,1413,12,7,2,2,1
2021,Staffordshire Moorlands 005B,E01029807,1087,1084,3,0,1,2,0
2021,Staffordshire Moorlands 001C,E01029808,1468,1435,33,17,11,5,0
2021,Staffordshire Moorlands 001D,E01029809,1451,1430,21,15,2,3,1
2021,Staffordshire Moorlands 001E,E01029810,1358,1323,35,15,17,3,0
2021,Staffordshire Moorlands 005C,E01029811,1458,1438,20,9,7,3,1
2021,Staffordshire Moorlands 005D,E01029812,1945,1907,38,16,19,3,0
2021,Staffordshire Moorlands 006D,E01029813,2184,2158,26,11,13,2,0
2021,Staffordshire Moorlands 005E,E01029814,1565,1536,29,10,16,3,0
2021,Staffordshire Moorlands 006E,E01029815,1407,1402,5,3,1,1,0
2021,Staffordshire Moorlands 006F,E01029816,1331,1320,11,3,3,3,2
2021,Staffordshire Moorlands 007C,E01029817,1676,1668,8,6,2,0,0
2021,Staffordshire Moorlands 009D,E01029818,1431,1422,9,6,3,0,0
2021,Staffordshire Moorlands 009E,E01029819,1616,1612,4,2,1,0,1
2021,Tamworth 003A,E01029820,2222,2069,153,61,71,17,4
2021,Tamworth 003B,E01029821,1346,1321,25,6,16,2,1
2021,Tamworth 003C,E01029822,1449,1423,26,13,7,6,0
2021,Tamworth 004A,E01029823,1390,1347,43,23,17,3,0
2021,Tamworth 003D,E01029824,1653,1568,85,32,36,17,0
2021,Tamworth 006A,E01029825,1224,1183,41,13,23,5,0
2021,Tamworth 006B,E01029826,1669,1626,43,16,22,4,1
2021,Tamworth 006C,E01029827,1445,1352,93,38,38,16,1
2021,Tamworth 006D,E01029828,1229,1125,104,36,53,14,1
2021,Tamworth 010A,E01029829,2079,2005,74,35,27,11,1
2021,Tamworth 006E,E01029830,1113,1010,103,33,48,21,1
2021,Tamworth 004B,E01029831,1459,1351,108,45,46,15,2
2021,Tamworth 004C,E01029832,1560,1501,59,27,21,9,2
2021,Tamworth 005A,E01029833,1574,1535,39,19,15,4,1
2021,Tamworth 004D,E01029834,1567,1515,52,30,13,8,1
2021,Tamworth 002A,E01029835,1667,1489,178,72,82,19,5
2021,Tamworth 002B,E01029836,1614,1528,86,39,33,12,2
2021,Tamworth 005B,E01029837,1493,1435,58,28,26,4,0
2021,Tamworth 005C,E01029838,1492,1296,196,65,102,25,4
2021,Tamworth 005D,E01029839,1108,1095,13,5,3,4,1
2021,Tamworth 007A,E01029840,1306,1208,98,40,48,10,0
2021,Tamworth 003E,E01029841,1350,1292,58,22,30,6,0
2021,Tamworth 007B,E01029842,1202,1121,81,24,45,10,2
2021,Tamworth 007C,E01029843,1397,1302,95,40,48,7,0
2021,Tamworth 004E,E01029844,1152,1115,37,23,7,7,0
2021,Tamworth 007D,E01029845,1030,1015,15,5,8,1,1
2021,Tamworth 001A,E01029846,1613,1575,38,19,14,4,1
2021,Tamworth 001B,E01029847,1335,1313,22,10,9,3,0
2021,Tamworth 001C,E01029848,1161,1130,31,16,13,2,0
2021,Tamworth 002C,E01029849,1488,1396,92,39,47,5,1
2021,Tamworth 002D,E01029850,1294,1192,102,51,42,7,2
2021,Tamworth 002E,E01029851,2105,1884,221,96,95,27,3
2021,Tamworth 001D,E01029852,1698,1661,37,14,19,4,0
2021,Tamworth 001E,E01029853,1682,1606,76,28,30,18,0
2021,Tamworth 001F,E01029854,2384,2336,48,20,19,8,1
2021,Tamworth 008A,E01029855,1461,1439,22,12,8,2,0
2021,Tamworth 008B,E01029856,1385,1359,26,19,6,1,0
2021,Tamworth 008C,E01029857,1411,1333,78,27,35,14,2
2021,Tamworth 008D,E01029858,1435,1389,46,24,19,3,0
2021,Tamworth 007E,E01029859,1659,1541,118,47,57,14,0
2021,Tamworth 009A,E01029860,1277,1254,23,15,7,1,0
2021,Tamworth 009B,E01029861,1291,1276,15,5,8,2,0
2021,Tamworth 009C,E01029862,1262,1252,10,6,3,1,0
2021,Tamworth 009D,E01029863,1749,1697,52,20,19,11,2
2021,Tamworth 009E,E01029864,1550,1517,33,19,9,5,0
2021,Tamworth 008E,E01029865,1563,1528,35,20,10,4,1
2021,Tamworth 010C,E01029867,1538,1467,71,32,30,7,2
2021,Tamworth 010D,E01029868,1344,1334,10,6,1,1,2
2021,Tamworth 010E,E01029869,1532,1515,17,13,3,0,1
2021,Babergh 010A,E01029870,1123,1114,9,8,1,0,0
2021,Babergh 011A,E01029871,1318,1305,13,5,6,2,0
2021,Babergh 010B,E01029872,1427,1413,14,5,4,4,1
2021,Babergh 011B,E01029873,2112,2083,29,14,13,2,0
2021,Babergh 011C,E01029874,1603,1587,16,10,5,1,0
2021,Babergh 009A,E01029875,2327,2296,31,25,5,1,0
2021,Babergh 001A,E01029876,2146,2129,17,9,7,1,0
2021,Babergh 005A,E01029877,1348,1327,21,9,9,3,0
2021,Babergh 005B,E01029878,1182,1166,16,13,3,0,0
2021,Babergh 005C,E01029879,1654,1634,20,14,3,1,2
2021,Babergh 006A,E01029880,1838,1829,9,5,3,1,0
2021,Babergh 002A,E01029881,2061,2046,15,13,2,0,0
2021,Babergh 010C,E01029882,1494,1482,12,7,4,1,0
2021,Babergh 010D,E01029883,1991,1968,23,17,4,2,0
2021,Babergh 002B,E01029884,1644,1624,20,8,8,3,1
2021,Babergh 002C,E01029885,2292,2270,22,10,6,6,0
2021,Babergh 008A,E01029886,1285,1246,39,16,17,5,1
2021,Babergh 008B,E01029887,1955,1915,40,21,15,4,0
2021,Babergh 008C,E01029888,1267,1228,39,20,14,4,1
2021,Babergh 008D,E01029889,1331,1289,42,22,15,4,1
2021,Babergh 008E,E01029890,1667,1646,21,12,7,2,0
2021,Babergh 008F,E01029891,2127,2099,28,8,15,5,0
2021,Babergh 004A,E01029892,1932,1884,48,19,25,4,0
2021,Babergh 004C,E01029894,1109,1096,13,5,5,2,1
2021,Babergh 004D,E01029895,1144,1135,9,1,4,4,0
2021,Babergh 004E,E01029896,1274,1255,19,10,6,1,2
2021,Babergh 011D,E01029897,2401,2350,51,33,14,1,3
2021,Babergh 001B,E01029898,1876,1847,29,22,5,2,0
2021,Babergh 009B,E01029899,1762,1746,16,12,3,1,0
2021,Babergh 003A,E01029900,1760,1745,15,10,4,1,0
2021,Babergh 003B,E01029901,2337,2310,27,16,8,3,0
2021,Babergh 009C,E01029902,2122,2098,24,14,10,0,0
2021,Babergh 010E,E01029903,1459,1453,6,5,1,0,0
2021,Babergh 010F,E01029904,1580,1566,14,10,4,0,0
2021,Babergh 010G,E01029905,1146,1140,6,4,2,0,0
2021,Babergh 009D,E01029906,1813,1795,18,13,3,2,0
2021,Babergh 001C,E01029907,2267,2251,16,9,6,0,1
2021,Babergh 005D,E01029908,1551,1491,60,29,23,7,1
2021,Babergh 005E,E01029909,1507,1434,73,36,28,7,2
2021,Babergh 005F,E01029910,1166,1106,60,21,29,8,2
2021,Babergh 004F,E01029911,2224,2211,13,7,4,2,0
2021,Babergh 007A,E01029912,1809,1711,98,33,42,23,0
2021,Babergh 007B,E01029913,1064,1054,10,4,5,0,1
2021,Babergh 007C,E01029914,1522,1452,70,34,29,7,0
2021,Babergh 007D,E01029915,1180,1148,32,21,8,2,1
2021,Babergh 007E,E01029916,1301,1249,52,21,17,11,3
2021,Babergh 003C,E01029917,1941,1918,23,22,1,0,0
2021,Babergh 007F,E01029918,1095,1062,33,14,18,1,0
2021,Babergh 007G,E01029919,1518,1481,37,19,13,4,1
2021,Babergh 007H,E01029920,1799,1720,79,33,26,19,1
2021,Babergh 006B,E01029921,1214,1208,6,4,2,0,0
2021,Babergh 006C,E01029922,1536,1514,22,10,9,3,0
2021,Babergh 006D,E01029923,1382,1367,15,7,5,3,0
2021,West Suffolk 015A,E01029925,1801,1618,183,86,74,23,0
2021,West Suffolk 002A,E01029926,1635,1579,56,12,25,19,0
2021,West Suffolk 002B,E01029927,2337,2035,302,97,131,59,15
2021,West Suffolk 002C,E01029928,1800,1692,108,42,47,17,2
2021,West Suffolk 002D,E01029929,2088,1965,123,52,40,26,5
2021,West Suffolk 002E,E01029930,1561,1460,101,43,47,11,0
2021,West Suffolk 008A,E01029937,2231,2158,73,37,19,12,5
2021,West Suffolk 004A,E01029938,1467,1278,189,90,74,22,3
2021,West Suffolk 004B,E01029939,1560,1519,41,22,19,0,0
2021,West Suffolk 004C,E01029940,1293,1227,66,30,27,7,2
2021,West Suffolk 007A,E01029941,1805,1786,19,15,4,0,0
2021,West Suffolk 001A,E01029942,1522,1493,29,14,10,3,2
2021,West Suffolk 001B,E01029944,1634,1611,23,10,10,2,1
2021,West Suffolk 003A,E01029945,2239,2176,63,44,16,3,0
2021,West Suffolk 004D,E01029946,2073,1965,108,50,44,12,2
2021,West Suffolk 004E,E01029947,2185,2100,85,30,35,13,7
2021,West Suffolk 015B,E01029949,1482,1358,124,51,51,22,0
2021,West Suffolk 015C,E01029950,1701,1331,370,142,155,69,4
2021,West Suffolk 015D,E01029951,1306,1197,109,43,42,22,2
2021,West Suffolk 015E,E01029952,1196,1081,115,44,48,19,4
2021,West Suffolk 008B,E01029953,1312,1104,208,85,93,28,2
2021,West Suffolk 008C,E01029955,1701,1489,212,85,86,33,8
2021,West Suffolk 008D,E01029956,1384,1053,331,134,147,43,7
2021,West Suffolk 007B,E01029957,2175,2109,66,32,27,4,3
2021,Ipswich 007A,E01029958,1345,1231,114,52,44,17,1
2021,Ipswich 007C,E01029960,1940,1652,288,143,92,40,13
2021,Ipswich 007D,E01029961,1463,1292,171,65,57,45,4
2021,Ipswich 007E,E01029962,1577,1219,358,105,165,76,12
2021,Ipswich 009A,E01029963,1586,1525,61,30,18,12,1
2021,Ipswich 009B,E01029964,1338,1247,91,28,46,12,5
2021,Ipswich 009C,E01029965,1436,1385,51,27,11,11,2
2021,Ipswich 009D,E01029966,1593,1432,161,104,37,16,4
2021,Ipswich 009E,E01029967,1286,1262,24,9,10,4,1
2021,Ipswich 012A,E01029968,1513,1157,356,119,140,90,7
2021,Ipswich 012B,E01029969,1484,1365,119,40,53,21,5
2021,Ipswich 012C,E01029970,1676,1503,173,79,69,23,2
2021,Ipswich 012D,E01029971,1486,1374,112,46,42,19,5
2021,Ipswich 002A,E01029973,1441,1416,25,9,11,5,0
2021,Ipswich 002B,E01029974,1513,1437,76,37,20,15,4
2021,Ipswich 002C,E01029975,1254,1192,62,30,22,7,3
2021,Ipswich 002D,E01029976,1518,1453,65,30,21,13,1
2021,Ipswich 002E,E01029977,1482,1455,27,13,8,6,0
2021,Ipswich 016A,E01029978,1232,1156,76,22,36,16,2
2021,Ipswich 016B,E01029979,1570,1436,134,48,56,21,9
2021,Ipswich 016C,E01029980,1569,1417,152,63,57,30,2
2021,Ipswich 016D,E01029981,1178,1125,53,20,17,13,3
2021,Ipswich 016E,E01029982,1429,1309,120,46,50,19,5
2021,Ipswich 016F,E01029983,1535,1397,138,47,63,25,3
2021,Ipswich 010A,E01029984,1590,1362,228,71,109,40,8
2021,Ipswich 010B,E01029985,2421,1952,469,190,184,80,15
2021,Ipswich 010C,E01029986,1523,1368,155,67,56,24,8
2021,Ipswich 010D,E01029987,1502,1397,105,47,42,14,2
2021,Ipswich 010E,E01029988,2016,1399,617,160,263,158,36
2021,Ipswich 011B,E01029990,1475,1344,131,49,49,24,9
2021,Ipswich 011C,E01029991,1547,1504,43,16,18,6,3
2021,Ipswich 011D,E01029992,1288,1192,96,39,38,18,1
2021,Ipswich 014B,E01029994,1607,1370,237,84,88,58,7
2021,Ipswich 014C,E01029995,1631,1525,106,42,39,21,4
2021,Ipswich 014D,E01029996,1630,1448,182,61,67,47,7
2021,Ipswich 004A,E01029997,1514,1466,48,18,20,7,3
2021,Ipswich 004B,E01029998,1834,1708,126,54,43,23,6
2021,Ipswich 004C,E01029999,1585,1487,98,55,31,11,1
2021,Ipswich 004D,E01030000,1562,1451,111,55,31,24,1
2021,Ipswich 004E,E01030001,1733,1621,112,42,43,20,7
2021,Ipswich 008A,E01030002,1911,1687,224,100,84,34,6
2021,Ipswich 008B,E01030003,1721,1499,222,101,95,24,2
2021,Ipswich 008C,E01030004,1224,1146,78,53,21,4,0
2021,Ipswich 008D,E01030005,2818,2482,336,196,104,34,2
2021,Ipswich 008E,E01030006,1705,1525,180,96,58,23,3
2021,Ipswich 005A,E01030007,2023,1863,160,77,54,26,3
2021,Ipswich 005B,E01030008,1324,1256,68,30,22,15,1
2021,Ipswich 005C,E01030009,1383,1285,98,59,28,9,2
2021,Ipswich 005D,E01030010,1908,1600,308,90,124,70,24
2021,Ipswich 005E,E01030011,1538,1483,55,35,10,8,2
2021,Ipswich 013A,E01030012,1132,1051,81,38,35,8,0
2021,Ipswich 013B,E01030013,1483,1387,96,34,35,24,3
2021,Ipswich 013C,E01030014,1426,1349,77,41,27,7,2
2021,Ipswich 013D,E01030015,1230,1182,48,23,9,13,3
2021,Ipswich 013E,E01030016,1318,1252,66,33,23,7,3
2021,Ipswich 015A,E01030017,1376,1269,107,32,41,30,4
2021,Ipswich 015B,E01030018,1472,1339,133,40,59,28,6
2021,Ipswich 015C,E01030019,1439,1351,88,32,40,16,0
2021,Ipswich 015D,E01030020,1345,1262,83,33,37,12,1
2021,Ipswich 015E,E01030021,1346,1237,109,32,55,18,4
2021,Ipswich 006A,E01030022,2106,1691,415,139,174,90,12
2021,Ipswich 006B,E01030023,1958,1190,768,202,344,186,36
2021,Ipswich 006C,E01030024,1916,1169,747,178,309,220,40
2021,Ipswich 006D,E01030025,1859,1449,410,123,170,104,13
2021,Ipswich 006E,E01030026,1906,1658,248,95,92,52,9
2021,Ipswich 003A,E01030027,1975,1708,267,99,120,42,6
2021,Ipswich 003B,E01030028,1630,1513,117,35,52,25,5
2021,Ipswich 003C,E01030029,1591,1446,145,53,57,32,3
2021,Ipswich 003D,E01030030,2104,1871,233,86,100,41,6
2021,Ipswich 003E,E01030031,1446,1306,140,50,66,23,1
2021,Ipswich 001A,E01030032,1463,1304,159,66,55,36,2
2021,Ipswich 001B,E01030033,1455,1416,39,11,20,6,2
2021,Ipswich 001C,E01030034,1411,1385,26,9,9,4,4
2021,Ipswich 001D,E01030035,1840,1664,176,65,76,32,3
2021,Ipswich 001E,E01030036,1821,1653,168,62,64,37,5
2021,Mid Suffolk 005A,E01030037,1184,1166,18,14,3,1,0
2021,Mid Suffolk 005B,E01030038,1137,1133,4,3,0,1,0
2021,Mid Suffolk 002A,E01030039,1385,1380,5,4,1,0,0
2021,Mid Suffolk 004A,E01030040,1242,1237,5,2,1,2,0
2021,Mid Suffolk 011A,E01030041,2279,2270,9,7,2,0,0
2021,Mid Suffolk 012A,E01030042,1669,1650,19,5,4,9,1
2021,Mid Suffolk 011B,E01030043,2349,2305,44,26,13,3,2
2021,Mid Suffolk 012B,E01030044,1293,1285,8,5,0,3,0
2021,Mid Suffolk 012C,E01030045,1688,1674,14,9,2,3,0
2021,Mid Suffolk 012D,E01030046,1646,1635,11,9,1,1,0
2021,Mid Suffolk 012E,E01030047,1199,1183,16,10,5,1,0
2021,Mid Suffolk 007A,E01030048,2393,2380,13,5,4,4,0
2021,Mid Suffolk 004B,E01030049,1829,1818,11,6,5,0,0
2021,Mid Suffolk 004C,E01030050,2276,2237,39,17,17,2,3
2021,Mid Suffolk 006A,E01030051,1736,1721,15,11,1,2,1
2021,Mid Suffolk 001A,E01030052,2169,2118,51,24,15,10,2
2021,Mid Suffolk 003A,E01030053,2243,2234,9,1,5,3,0
2021,Mid Suffolk 002B,E01030054,1407,1397,10,8,1,1,0
2021,Mid Suffolk 002C,E01030055,1447,1437,10,4,5,0,1
2021,Mid Suffolk 006B,E01030056,2148,2134,14,5,4,4,1
2021,Mid Suffolk 007B,E01030057,2269,2256,13,9,1,3,0
2021,Mid Suffolk 001B,E01030058,2000,1981,19,15,3,1,0
2021,Mid Suffolk 005C,E01030059,2363,2357,6,2,4,0,0
2021,Mid Suffolk 010A,E01030060,1511,1488,23,16,5,1,1
2021,Mid Suffolk 011C,E01030061,1659,1627,32,12,12,8,0
2021,Mid Suffolk 011D,E01030062,1430,1415,15,4,10,0,1
2021,Mid Suffolk 009A,E01030063,2495,2473,22,10,11,1,0
2021,Mid Suffolk 001C,E01030064,2439,2419,20,15,1,4,0
2021,Mid Suffolk 006C,E01030065,2103,2089,14,5,8,1,0
2021,Mid Suffolk 002D,E01030066,1556,1532,24,10,5,8,1
2021,Mid Suffolk 002E,E01030067,1291,1266,25,9,10,6,0
2021,Mid Suffolk 002F,E01030068,1720,1706,14,10,4,0,0
2021,Mid Suffolk 009B,E01030069,1431,1423,8,5,1,2,0
2021,Mid Suffolk 011E,E01030070,1780,1638,142,80,57,5,0
2021,Mid Suffolk 010B,E01030071,1402,1356,46,19,15,12,0
2021,Mid Suffolk 009C,E01030072,1580,1529,51,26,13,11,1
2021,Mid Suffolk 008A,E01030073,1506,1462,44,17,16,10,1
2021,Mid Suffolk 009D,E01030075,2007,1952,55,34,17,4,0
2021,Mid Suffolk 010D,E01030076,1564,1510,54,23,24,6,1
2021,Mid Suffolk 008B,E01030077,1448,1413,35,11,17,7,0
2021,Mid Suffolk 010E,E01030078,1561,1511,50,23,21,6,0
2021,Mid Suffolk 008C,E01030079,1453,1428,25,11,11,3,0
2021,Mid Suffolk 008D,E01030080,1599,1563,36,15,14,7,0
2021,Mid Suffolk 005D,E01030081,2500,2474,26,17,8,1,0
2021,Mid Suffolk 007C,E01030083,2252,2233,19,8,7,4,0
2021,Mid Suffolk 004D,E01030084,1682,1656,26,10,8,5,3
2021,Mid Suffolk 004E,E01030085,1568,1548,20,8,8,4,0
2021,Mid Suffolk 006D,E01030086,1174,1159,15,11,3,1,0
2021,Mid Suffolk 007D,E01030087,1296,1292,4,3,1,0,0
2021,Mid Suffolk 001D,E01030088,1205,1202,3,1,2,0,0
2021,Mid Suffolk 006E,E01030089,2043,2019,24,13,6,5,0
2021,Mid Suffolk 003C,E01030090,2452,2428,24,9,11,2,2
2021,West Suffolk 011A,E01030091,1784,1636,148,66,62,20,0
2021,West Suffolk 014A,E01030092,1445,1379,66,36,23,7,0
2021,West Suffolk 011B,E01030093,1591,1468,123,65,43,14,1
2021,West Suffolk 006A,E01030094,1377,1358,19,10,7,2,0
2021,West Suffolk 005A,E01030095,1216,1211,5,4,1,0,0
2021,West Suffolk 005B,E01030096,1420,1406,14,8,5,0,1
2021,West Suffolk 005C,E01030097,1211,1199,12,5,4,3,0
2021,West Suffolk 010A,E01030098,2520,2503,17,12,3,2,0
2021,West Suffolk 017A,E01030099,1927,1919,8,6,1,1,0
2021,West Suffolk 010B,E01030100,2160,2142,18,12,5,0,1
2021,West Suffolk 017B,E01030101,2242,2226,16,10,4,1,1
2021,West Suffolk 016A,E01030104,2509,2453,56,35,10,10,1
2021,West Suffolk 020A,E01030105,1720,1511,209,79,88,40,2
2021,West Suffolk 020B,E01030106,2214,2025,189,86,87,14,2
2021,West Suffolk 020C,E01030107,1555,1517,38,28,8,1,1
2021,West Suffolk 020D,E01030108,1779,1612,167,66,71,24,6
2021,West Suffolk 019A,E01030109,1758,1590,168,71,63,31,3
2021,West Suffolk 019B,E01030110,2661,2493,168,83,70,11,4
2021,West Suffolk 019C,E01030111,1306,1262,44,25,18,1,0
2021,West Suffolk 019D,E01030112,1751,1625,126,59,41,25,1
2021,West Suffolk 020E,E01030113,2039,1822,217,86,86,42,3
2021,West Suffolk 020F,E01030114,1443,1259,184,68,81,32,3
2021,West Suffolk 021A,E01030115,2215,1955,260,88,112,53,7
2021,West Suffolk 021B,E01030116,2188,2091,97,53,34,10,0
2021,West Suffolk 021C,E01030117,1475,1323,152,72,62,15,3
2021,West Suffolk 021D,E01030118,1426,1295,131,68,43,18,2
2021,West Suffolk 010C,E01030119,2153,2122,31,20,8,3,0
2021,West Suffolk 006B,E01030121,2242,2217,25,16,9,0,0
2021,West Suffolk 018A,E01030122,2164,2118,46,19,14,11,2
2021,West Suffolk 014B,E01030123,1471,1437,34,12,18,3,1
2021,West Suffolk 014C,E01030124,1556,1490,66,28,23,13,2
2021,West Suffolk 014D,E01030125,1334,1275,59,24,27,6,2
2021,West Suffolk 012A,E01030127,1099,1028,71,42,20,6,3
2021,West Suffolk 012B,E01030128,1265,1202,63,39,17,4,3
2021,West Suffolk 012C,E01030129,1286,1234,52,21,25,5,1
2021,West Suffolk 009A,E01030130,1357,1293,64,38,21,4,1
2021,West Suffolk 009B,E01030131,1211,1117,94,32,42,17,3
2021,West Suffolk 006C,E01030132,1457,1420,37,27,8,2,0
2021,West Suffolk 006D,E01030133,1345,1317,28,7,15,6,0
2021,West Suffolk 010D,E01030134,1197,1183,14,10,4,0,0
2021,West Suffolk 010E,E01030135,1465,1429,36,19,13,4,0
2021,West Suffolk 011C,E01030137,1561,1469,92,44,38,9,1
2021,West Suffolk 016B,E01030138,2395,2366,29,14,10,4,1
2021,West Suffolk 009C,E01030139,1569,1466,103,39,48,16,0
2021,West Suffolk 009D,E01030140,1190,1111,79,37,30,12,0
2021,West Suffolk 009E,E01030141,1455,1336,119,52,48,13,6
2021,West Suffolk 013A,E01030142,1601,1480,121,97,23,1,0
2021,West Suffolk 013B,E01030143,1366,1190,176,101,62,11,2
2021,West Suffolk 013C,E01030144,1244,1176,68,37,25,6,0
2021,West Suffolk 005D,E01030145,1401,1392,9,5,3,1,0
2021,West Suffolk 005E,E01030146,1430,1409,21,11,8,2,0
2021,West Suffolk 013D,E01030147,1451,1388,63,36,22,3,2
2021,West Suffolk 014E,E01030148,1161,1118,43,22,12,8,1
2021,West Suffolk 014F,E01030149,1425,1373,52,33,15,4,0
2021,West Suffolk 017C,E01030150,2240,2214,26,14,10,2,0
2021,West Suffolk 018B,E01030151,2475,2350,125,78,39,7,1
2021,East Suffolk 019A,E01030152,2012,1998,14,11,1,1,1
2021,East Suffolk 019B,E01030153,1154,1128,26,17,3,6,0
2021,East Suffolk 017A,E01030154,2134,2108,26,14,9,2,1
2021,East Suffolk 022A,E01030155,1962,1942,20,10,8,2,0
2021,East Suffolk 028A,E01030158,1432,1404,28,15,7,5,1
2021,East Suffolk 028B,E01030159,1449,1405,44,23,16,5,0
2021,East Suffolk 029A,E01030160,1503,1447,56,19,24,11,2
2021,East Suffolk 029B,E01030161,1605,1517,88,32,38,17,1
2021,East Suffolk 030A,E01030162,1443,1326,117,34,57,22,4
2021,East Suffolk 030B,E01030163,1730,1602,128,41,60,26,1
2021,East Suffolk 028C,E01030164,1511,1469,42,15,25,2,0
2021,East Suffolk 030C,E01030165,1668,1568,100,35,46,18,1
2021,East Suffolk 028D,E01030166,1444,1404,40,17,17,6,0
2021,East Suffolk 030D,E01030167,1311,1272,39,20,16,3,0
2021,East Suffolk 029C,E01030168,1367,1310,57,14,28,12,3
2021,East Suffolk 029D,E01030169,1511,1385,126,34,71,20,1
2021,East Suffolk 029E,E01030170,1659,1587,72,29,29,14,0
2021,East Suffolk 027A,E01030171,1800,1720,80,33,34,11,2
2021,East Suffolk 017B,E01030172,2096,2068,28,16,8,4,0
2021,East Suffolk 017C,E01030173,2187,2139,48,30,16,2,0
2021,East Suffolk 017D,E01030174,1376,1357,19,12,6,1,0
2021,East Suffolk 021A,E01030175,2349,2327,22,13,8,1,0
2021,East Suffolk 017E,E01030176,2028,2018,10,7,2,1,0
2021,East Suffolk 024A,E01030179,2653,2550,103,65,26,8,4
2021,East Suffolk 024B,E01030180,1348,1304,44,27,5,12,0
2021,East Suffolk 025A,E01030181,1882,1783,99,57,30,11,1
2021,East Suffolk 024C,E01030183,1858,1824,34,13,14,7,0
2021,East Suffolk 024D,E01030184,1665,1624,41,21,14,4,2
2021,East Suffolk 022B,E01030185,1952,1912,40,14,18,7,1
2021,East Suffolk 018A,E01030186,1601,1581,20,13,5,2,0
2021,East Suffolk 019C,E01030187,1555,1523,32,12,10,7,3
2021,East Suffolk 019D,E01030188,1635,1545,90,34,39,17,0
2021,East Suffolk 019E,E01030189,1536,1484,52,39,12,1,0
2021,East Suffolk 025B,E01030190,2284,2251,33,16,14,3,0
2021,East Suffolk 025C,E01030191,1475,1435,40,21,16,3,0
2021,East Suffolk 025D,E01030192,1331,1303,28,25,2,1,0
2021,East Suffolk 020A,E01030193,2001,1972,29,19,10,0,0
2021,East Suffolk 020B,E01030194,1751,1718,33,21,8,4,0
2021,East Suffolk 020C,E01030195,1558,1541,17,14,2,1,0
2021,East Suffolk 026A,E01030196,1526,1454,72,41,18,10,3
2021,East Suffolk 026B,E01030197,1793,1749,44,20,19,5,0
2021,East Suffolk 025E,E01030198,1313,1308,5,2,0,3,0
2021,East Suffolk 023A,E01030199,1729,1714,15,7,8,0,0
2021,East Suffolk 021B,E01030200,2193,2184,9,8,0,1,0
2021,East Suffolk 016A,E01030201,2112,2097,15,10,1,3,1
2021,East Suffolk 022C,E01030203,1948,1924,24,13,6,4,1
2021,East Suffolk 026C,E01030204,1871,1832,39,20,13,6,0
2021,East Suffolk 026D,E01030205,1261,1223,38,20,14,4,0
2021,East Suffolk 026E,E01030206,1455,1413,42,32,9,1,0
2021,East Suffolk 024E,E01030207,1573,1548,25,12,10,3,0
2021,East Suffolk 018B,E01030208,1267,1263,4,4,0,0,0
2021,East Suffolk 018C,E01030209,2192,2136,56,32,13,11,0
2021,East Suffolk 018D,E01030210,2416,2381,35,20,9,6,0
2021,East Suffolk 022D,E01030211,1881,1834,47,27,17,3,0
2021,East Suffolk 018E,E01030212,1960,1935,25,12,11,2,0
2021,East Suffolk 027B,E01030214,1183,1150,33,18,10,5,0
2021,East Suffolk 027C,E01030215,1619,1581,38,16,15,6,1
2021,East Suffolk 027D,E01030216,1451,1425,26,12,10,4,0
2021,East Suffolk 027E,E01030217,1386,1378,8,5,2,1,0
2021,East Suffolk 027F,E01030218,1461,1430,31,15,8,7,1
2021,East Suffolk 016B,E01030219,1975,1957,18,9,5,4,0
2021,East Suffolk 020D,E01030220,2178,2160,18,14,2,2,0
2021,East Suffolk 021C,E01030221,2117,2090,27,16,8,2,1
2021,East Suffolk 016C,E01030222,2067,2053,14,6,4,2,2
2021,East Suffolk 010A,E01030223,1749,1731,18,10,6,1,1
2021,East Suffolk 010B,E01030224,1617,1598,19,6,11,1,1
2021,East Suffolk 010C,E01030225,1560,1509,51,28,16,5,2
2021,East Suffolk 011A,E01030226,1802,1789,13,8,3,2,0
2021,East Suffolk 010D,E01030227,1448,1432,16,10,5,0,1
2021,East Suffolk 010E,E01030228,1662,1648,14,10,4,0,0
2021,East Suffolk 015A,E01030229,2113,2092,21,10,9,1,1
2021,East Suffolk 013A,E01030230,1759,1703,56,24,24,6,2
2021,East Suffolk 013B,E01030231,1474,1432,42,21,16,4,1
2021,East Suffolk 013C,E01030232,1627,1576,51,31,14,4,2
2021,East Suffolk 007A,E01030233,1432,1428,4,4,0,0,0
2021,East Suffolk 008A,E01030234,1486,1475,11,7,2,2,0
2021,East Suffolk 007B,E01030235,1471,1452,19,8,6,4,1
2021,East Suffolk 008B,E01030236,1825,1805,20,8,9,3,0
2021,East Suffolk 008C,E01030237,2830,2811,19,7,4,8,0
2021,East Suffolk 008D,E01030238,1706,1697,9,3,3,3,0
2021,East Suffolk 012A,E01030239,1855,1832,23,15,4,4,0
2021,East Suffolk 001A,E01030240,1552,1534,18,10,5,2,1
2021,East Suffolk 001B,E01030241,1459,1438,21,9,7,4,1
2021,East Suffolk 001C,E01030242,1373,1358,15,10,3,2,0
2021,East Suffolk 015B,E01030243,1473,1450,23,12,8,2,1
2021,East Suffolk 015C,E01030244,1765,1739,26,10,6,8,2
2021,East Suffolk 015D,E01030245,1564,1558,6,4,1,1,0
2021,East Suffolk 004A,E01030246,1354,1308,46,22,12,10,2
2021,East Suffolk 006A,E01030247,1794,1678,116,31,51,29,5
2021,East Suffolk 004B,E01030248,1509,1464,45,22,11,7,5
2021,East Suffolk 004C,E01030249,1696,1629,67,26,27,12,2
2021,East Suffolk 004D,E01030250,1963,1844,119,28,64,21,6
2021,East Suffolk 012B,E01030251,1464,1455,9,4,4,1,0
2021,East Suffolk 012C,E01030252,1671,1651,20,8,10,2,0
2021,East Suffolk 012D,E01030253,1766,1753,13,9,3,1,0
2021,East Suffolk 006B,E01030254,1351,1287,64,24,20,18,2
2021,East Suffolk 005A,E01030255,1238,1222,16,5,8,3,0
2021,East Suffolk 006C,E01030256,1480,1448,32,14,11,7,0
2021,East Suffolk 009A,E01030257,1502,1481,21,9,7,4,1
2021,East Suffolk 006D,E01030258,1572,1476,96,29,41,21,5
2021,East Suffolk 001D,E01030259,1113,1108,5,4,0,1,0
2021,East Suffolk 001E,E01030260,1034,1018,16,10,6,0,0
2021,East Suffolk 002A,E01030261,1463,1443,20,7,13,0,0
2021,East Suffolk 002B,E01030262,1226,1212,14,8,6,0,0
2021,East Suffolk 005B,E01030263,1451,1430,21,13,5,3,0
2021,East Suffolk 004E,E01030264,1427,1378,49,14,24,10,1
2021,East Suffolk 004F,E01030265,1384,1324,60,21,27,9,3
2021,East Suffolk 003A,E01030266,1587,1565,22,8,11,1,2
2021,East Suffolk 003B,E01030267,2113,2088,25,17,4,3,1
2021,East Suffolk 007C,E01030268,1283,1277,6,4,1,1,0
2021,East Suffolk 007D,E01030269,1611,1601,10,3,2,5,0
2021,East Suffolk 005C,E01030270,1528,1508,20,6,9,4,1
2021,East Suffolk 003C,E01030271,1401,1389,12,8,2,1,1
2021,East Suffolk 012E,E01030272,1513,1493,20,5,9,4,2
2021,East Suffolk 012F,E01030273,1432,1423,9,5,4,0,0
2021,East Suffolk 009B,E01030274,1173,1165,8,3,2,3,0
2021,East Suffolk 009C,E01030275,1135,1116,19,12,1,5,1
2021,East Suffolk 006E,E01030276,1179,1158,21,15,4,1,1
2021,East Suffolk 002C,E01030277,1121,1111,10,5,4,1,0
2021,East Suffolk 003D,E01030278,1501,1482,19,15,3,1,0
2021,East Suffolk 002D,E01030279,1381,1363,18,5,5,7,1
2021,East Suffolk 003E,E01030280,1343,1331,12,7,3,1,1
2021,East Suffolk 002E,E01030281,2532,2505,27,19,8,0,0
2021,East Suffolk 014A,E01030283,1279,1262,17,10,5,2,0
2021,East Suffolk 013D,E01030285,2222,2181,41,27,10,4,0
2021,East Suffolk 011B,E01030286,2063,2052,11,6,3,1,1
2021,East Suffolk 009D,E01030287,1352,1330,22,8,13,1,0
2021,East Suffolk 007E,E01030288,1396,1389,7,6,1,0,0
2021,East Suffolk 005D,E01030289,1463,1441,22,13,6,3,0
2021,East Suffolk 005E,E01030290,1422,1394,28,26,1,0,1
2021,East Suffolk 009E,E01030291,1429,1377,52,22,19,10,1
2021,East Suffolk 011C,E01030292,1412,1398,14,5,3,6,0
2021,East Suffolk 011D,E01030293,1628,1611,17,8,8,1,0
2021,East Suffolk 011E,E01030294,1393,1369,24,8,10,5,1
2021,East Suffolk 014B,E01030295,2292,2273,19,9,7,3,0
2021,Elmbridge 015A,E01030296,1766,1692,74,48,20,6,0
2021,Elmbridge 015B,E01030297,2076,1996,80,40,31,7,2
2021,Elmbridge 015C,E01030298,1581,1527,54,28,20,5,1
2021,Elmbridge 015D,E01030299,1623,1590,33,20,12,1,0
2021,Elmbridge 017A,E01030300,1584,1441,143,64,55,21,3
2021,Elmbridge 017B,E01030301,1561,1431,130,79,32,17,2
2021,Elmbridge 017C,E01030302,1736,1628,108,66,31,11,0
2021,Elmbridge 018A,E01030303,1685,1624,61,47,9,4,1
2021,Elmbridge 017D,E01030304,1614,1478,136,57,50,28,1
2021,Elmbridge 017E,E01030305,1623,1490,133,98,25,9,1
2021,Elmbridge 017F,E01030306,1551,1368,183,129,42,10,2
2021,Elmbridge 013A,E01030307,1781,1666,115,75,30,8,2
2021,Elmbridge 013B,E01030308,1709,1569,140,82,42,16,0
2021,Elmbridge 013C,E01030309,1630,1555,75,53,16,5,1
2021,Elmbridge 013D,E01030310,1803,1675,128,85,34,7,2
2021,Elmbridge 014A,E01030311,1499,1410,89,62,21,5,1
2021,Elmbridge 014B,E01030312,1449,1348,101,65,29,6,1
2021,Elmbridge 010A,E01030313,2049,1917,132,71,46,12,3
2021,Elmbridge 010B,E01030314,1687,1597,90,57,29,3,1
2021,Elmbridge 014C,E01030315,1656,1592,64,45,16,3,0
2021,Elmbridge 014D,E01030316,1617,1520,97,66,24,7,0
2021,Elmbridge 014E,E01030317,1880,1742,138,84,38,14,2
2021,Elmbridge 014F,E01030318,1476,1389,87,57,12,14,4
2021,Elmbridge 009A,E01030319,1943,1852,91,60,24,6,1
2021,Elmbridge 009B,E01030320,1719,1603,116,75,32,9,0
2021,Elmbridge 009C,E01030321,1553,1488,65,39,22,4,0
2021,Elmbridge 006A,E01030322,1758,1627,131,93,29,8,1
2021,Elmbridge 006B,E01030323,1343,1260,83,54,23,6,0
2021,Elmbridge 006C,E01030324,1591,1538,53,42,8,3,0
2021,Elmbridge 006D,E01030325,1593,1502,91,53,28,10,0
2021,Elmbridge 002A,E01030326,1658,1484,174,90,61,21,2
2021,Elmbridge 002B,E01030327,1876,1709,167,91,53,22,1
2021,Elmbridge 002C,E01030328,1624,1568,56,44,7,4,1
2021,Elmbridge 002D,E01030329,1519,1437,82,51,21,9,1
2021,Elmbridge 001A,E01030330,1601,1488,113,73,33,5,2
2021,Elmbridge 001B,E01030331,1590,1498,92,37,37,17,1
2021,Elmbridge 001C,E01030332,1544,1442,102,52,34,16,0
2021,Elmbridge 001D,E01030333,1390,1299,91,53,27,9,2
2021,Elmbridge 003A,E01030334,1492,1320,172,60,76,34,2
2021,Elmbridge 003B,E01030335,1789,1677,112,63,34,13,2
2021,Elmbridge 003C,E01030336,1904,1737,167,86,59,16,6
2021,Elmbridge 003D,E01030337,1745,1600,145,71,59,14,1
2021,Elmbridge 011A,E01030338,1605,1512,93,63,19,11,0
2021,Elmbridge 011B,E01030339,1460,1366,94,56,33,2,3
2021,Elmbridge 011C,E01030340,1539,1437,102,55,33,11,3
2021,Elmbridge 011D,E01030341,1888,1787,101,71,26,3,1
2021,Elmbridge 018B,E01030342,1767,1603,164,98,41,23,2
2021,Elmbridge 018C,E01030343,1769,1655,114,77,30,5,2
2021,Elmbridge 018D,E01030344,1492,1390,102,66,31,5,0
2021,Elmbridge 018E,E01030345,1612,1530,82,56,20,5,1
2021,Elmbridge 016A,E01030346,1482,1299,183,88,72,19,4
2021,Elmbridge 016B,E01030347,1705,1597,108,70,28,8,2
2021,Elmbridge 016C,E01030348,1597,1477,120,80,29,11,0
2021,Elmbridge 016D,E01030349,1675,1547,128,91,28,9,0
2021,Elmbridge 005A,E01030350,1730,1649,81,55,16,9,1
2021,Elmbridge 005B,E01030351,1518,1445,73,55,15,3,0
2021,Elmbridge 005C,E01030352,1575,1510,65,41,15,9,0
2021,Elmbridge 005D,E01030353,1544,1478,66,49,10,6,1
2021,Elmbridge 008A,E01030354,1752,1597,155,67,65,19,4
2021,Elmbridge 008B,E01030355,1373,1320,53,33,16,4,0
2021,Elmbridge 008C,E01030356,1376,1307,69,36,25,8,0
2021,Elmbridge 007A,E01030357,1574,1506,68,35,22,7,4
2021,Elmbridge 007B,E01030358,1541,1413,128,64,43,14,7
2021,Elmbridge 007D,E01030360,1644,1472,172,103,57,12,0
2021,Elmbridge 004A,E01030361,2190,2001,189,114,62,11,2
2021,Elmbridge 004B,E01030362,1367,1242,125,58,53,11,3
2021,Elmbridge 004C,E01030363,1793,1656,137,66,51,19,1
2021,Elmbridge 004D,E01030364,1527,1329,198,106,72,17,3
2021,Elmbridge 008D,E01030365,1472,1400,72,28,34,10,0
2021,Elmbridge 010C,E01030366,1878,1645,233,146,66,21,0
2021,Elmbridge 010D,E01030367,1589,1443,146,86,42,17,1
2021,Elmbridge 008E,E01030368,1598,1513,85,52,22,8,3
2021,Elmbridge 009D,E01030369,2095,2022,73,50,15,7,1
2021,Elmbridge 009E,E01030370,1621,1558,63,32,27,4,0
2021,Elmbridge 012A,E01030371,1546,1377,169,77,65,25,2
2021,Elmbridge 012B,E01030372,1404,1327,77,45,22,10,0
2021,Elmbridge 012C,E01030373,1570,1465,105,50,38,16,1
2021,Elmbridge 012D,E01030374,1694,1509,185,107,56,18,4
2021,Elmbridge 012E,E01030375,1799,1633,166,97,49,20,0
2021,Elmbridge 012F,E01030376,1270,1165,105,70,27,7,1
2021,Epsom and Ewell 003A,E01030377,2352,2184,168,90,53,23,2
2021,Epsom and Ewell 003B,E01030378,1626,1496,130,75,37,15,3
2021,Epsom and Ewell 009A,E01030379,1517,1447,70,42,15,11,2
2021,Epsom and Ewell 009B,E01030380,1422,1378,44,24,14,3,3
2021,Epsom and Ewell 008A,E01030381,1422,1325,97,59,27,9,2
2021,Epsom and Ewell 010A,E01030382,1498,1365,133,79,46,8,0
2021,Epsom and Ewell 005B,E01030384,2630,2289,341,186,104,44,7
2021,Epsom and Ewell 007A,E01030385,1700,1496,204,84,82,34,4
2021,Epsom and Ewell 001A,E01030386,1437,1307,130,66,42,22,0
2021,Epsom and Ewell 001B,E01030387,1488,1390,98,63,29,3,3
2021,Epsom and Ewell 001C,E01030388,1305,1129,176,87,49,29,11
2021,Epsom and Ewell 001D,E01030389,1493,1311,182,90,63,23,6
2021,Epsom and Ewell 010B,E01030390,1949,1795,154,86,47,19,2
2021,Epsom and Ewell 007B,E01030391,1852,1703,149,83,46,17,3
2021,Epsom and Ewell 010C,E01030392,2001,1868,133,66,42,17,8
2021,Epsom and Ewell 001E,E01030393,1946,1691,255,128,80,40,7
2021,Epsom and Ewell 002A,E01030394,1764,1640,124,68,39,13,4
2021,Epsom and Ewell 004A,E01030395,1695,1599,96,56,34,6,0
2021,Epsom and Ewell 010D,E01030396,2399,2213,186,133,33,16,4
2021,Epsom and Ewell 010E,E01030398,1670,1577,93,68,15,9,1
2021,Epsom and Ewell 002B,E01030399,2297,2003,294,142,122,24,6
2021,Epsom and Ewell 002C,E01030400,1569,1318,251,116,94,36,5
2021,Epsom and Ewell 005C,E01030401,2447,2258,189,106,58,23,2
2021,Epsom and Ewell 005D,E01030402,2362,2159,203,132,53,13,5
2021,Epsom and Ewell 007C,E01030403,1579,1488,91,59,18,12,2
2021,Epsom and Ewell 007D,E01030404,1553,1502,51,34,14,3,0
2021,Epsom and Ewell 009C,E01030405,1786,1707,79,42,25,7,5
2021,Epsom and Ewell 003C,E01030406,1514,1373,141,84,35,16,6
2021,Epsom and Ewell 003D,E01030407,1371,1283,88,67,11,10,0
2021,Epsom and Ewell 003E,E01030408,1742,1649,93,62,21,10,0
2021,Epsom and Ewell 007E,E01030409,1556,1308,248,124,89,33,2
2021,Epsom and Ewell 007F,E01030410,1669,1429,240,120,87,32,1
2021,Epsom and Ewell 008C,E01030412,1989,1683,306,140,117,37,12
2021,Epsom and Ewell 004B,E01030413,1936,1811,125,62,33,22,8
2021,Epsom and Ewell 002D,E01030414,1278,1213,65,46,13,6,0
2021,Epsom and Ewell 004C,E01030415,1603,1508,95,48,27,18,2
2021,Epsom and Ewell 004D,E01030416,1335,1254,81,43,15,15,8
2021,Epsom and Ewell 009D,E01030417,1296,1253,43,26,12,4,1
2021,Epsom and Ewell 009E,E01030418,1469,1408,61,32,17,11,1
2021,Epsom and Ewell 008D,E01030419,1735,1585,150,95,33,20,2
2021,Epsom and Ewell 009F,E01030420,1312,1242,70,38,21,11,0
2021,Guildford 014A,E01030421,1695,1632,63,38,19,5,1
2021,Guildford 014B,E01030422,1732,1646,86,54,20,8,4
2021,Guildford 014C,E01030423,1663,1629,34,26,8,0,0
2021,Guildford 010A,E01030424,1440,1357,83,48,28,7,0
2021,Guildford 014D,E01030425,1840,1773,67,49,14,4,0
2021,Guildford 004A,E01030426,1465,1384,81,46,29,4,2
2021,Guildford 004B,E01030427,1360,1318,42,26,11,4,1
2021,Guildford 004C,E01030428,1234,1182,52,31,15,5,1
2021,Guildford 004D,E01030429,1412,1316,96,59,28,9,0
2021,Guildford 004E,E01030430,1401,1377,24,16,7,1,0
2021,Guildford 010B,E01030431,1405,1357,48,24,19,4,1
2021,Guildford 010C,E01030432,1466,1397,69,37,21,11,0
2021,Guildford 010D,E01030433,1597,1509,88,37,39,10,2
2021,Guildford 008A,E01030434,1536,1422,114,71,34,8,1
2021,Guildford 008B,E01030435,1945,1828,117,90,21,6,0
2021,Guildford 011A,E01030436,2194,1991,203,123,55,22,3
2021,Guildford 011B,E01030437,2291,2096,195,124,55,12,4
2021,Guildford 013A,E01030438,1777,1556,221,139,60,16,6
2021,Guildford 011C,E01030439,1695,1540,155,98,45,12,0
2021,Guildford 001A,E01030440,1639,1604,35,25,6,3,1
2021,Guildford 003A,E01030441,1346,1317,29,22,6,0,1
2021,Guildford 003B,E01030442,1439,1422,17,15,2,0,0
2021,Guildford 003C,E01030443,1336,1317,19,15,3,1,0
2021,Guildford 003D,E01030444,1517,1494,23,15,6,2,0
2021,Guildford 003E,E01030445,1420,1349,71,37,27,6,1
2021,Guildford 003F,E01030446,1359,1297,62,34,21,7,0
2021,Guildford 003G,E01030447,1317,1285,32,23,7,2,0
2021,Guildford 016A,E01030448,1518,1412,106,74,26,6,0
2021,Guildford 016B,E01030449,1330,1173,157,119,35,3,0
2021,Guildford 013B,E01030450,2510,2110,400,219,123,56,2
2021,Guildford 013C,E01030451,1940,1570,370,209,118,37,6
2021,Guildford 015A,E01030452,2507,2004,503,309,154,38,2
2021,Guildford 013D,E01030453,1443,1235,208,105,70,28,5
2021,Guildford 016C,E01030454,1653,1503,150,96,41,12,1
2021,Guildford 013E,E01030455,1805,1496,309,177,96,33,3
2021,Guildford 016D,E01030456,1472,1427,45,36,5,4,0
2021,Guildford 013F,E01030457,1629,1306,323,164,111,41,7
2021,Guildford 001B,E01030458,1181,1134,47,25,22,0,0
2021,Guildford 001C,E01030459,1374,1326,48,26,14,6,2
2021,Guildford 011D,E01030460,1574,1466,108,56,43,7,2
2021,Guildford 011E,E01030461,1622,1529,93,63,23,7,0
2021,Guildford 008C,E01030462,1566,1404,162,108,33,20,1
2021,Guildford 008D,E01030463,1405,1278,127,80,35,10,2
2021,Guildford 008E,E01030464,1686,1508,178,91,72,13,2
2021,Guildford 002A,E01030465,1477,1437,40,28,6,6,0
2021,Guildford 002B,E01030466,1592,1552,40,35,5,0,0
2021,Guildford 015B,E01030467,1681,1595,86,58,20,8,0
2021,Guildford 015C,E01030468,3184,2517,667,458,192,16,1
2021,Guildford 015D,E01030469,1426,1347,79,46,27,5,1
2021,Guildford 012A,E01030470,4651,3611,1040,584,399,55,2
2021,Guildford 017A,E01030471,1235,1215,20,14,5,1,0
2021,Guildford 017B,E01030472,1262,1225,37,19,15,3,0
2021,Guildford 002C,E01030473,1645,1590,55,45,4,6,0
2021,Guildford 002D,E01030474,2757,2573,184,99,73,12,0
2021,Guildford 001D,E01030475,1371,1323,48,30,15,3,0
2021,Guildford 001E,E01030476,1121,1106,15,12,3,0,0
2021,Guildford 001F,E01030477,1647,1592,55,36,15,3,1
2021,Guildford 017C,E01030478,1818,1751,67,41,19,5,2
2021,Guildford 017D,E01030479,1791,1713,78,45,24,7,2
2021,Guildford 017E,E01030480,1808,1764,44,34,7,1,2
2021,Guildford 007A,E01030481,1709,1536,173,83,65,24,1
2021,Guildford 007B,E01030482,1369,1235,134,68,46,16,4
2021,Guildford 007C,E01030483,1426,1270,156,81,54,18,3
2021,Guildford 007D,E01030484,1649,1457,192,72,75,42,3
2021,Guildford 006A,E01030485,1709,1521,188,90,78,19,1
2021,Guildford 009A,E01030486,1521,1441,80,41,27,9,3
2021,Guildford 006B,E01030487,1533,1359,174,103,55,8,8
2021,Guildford 006C,E01030488,2080,1807,273,165,83,20,5
2021,Guildford 006D,E01030489,2400,2241,159,100,47,10,2
2021,Guildford 018A,E01030490,1621,1582,39,27,9,2,1
2021,Guildford 018B,E01030491,1952,1904,48,28,13,5,2
2021,Guildford 018C,E01030492,1960,1930,30,22,5,3,0
2021,Guildford 009B,E01030493,1256,1126,130,65,42,20,3
2021,Guildford 012B,E01030494,1738,1485,253,128,92,31,2
2021,Guildford 009C,E01030495,1862,1658,204,129,58,17,0
2021,Guildford 012C,E01030496,1671,1422,249,139,87,23,0
2021,Guildford 012D,E01030497,1536,1353,183,87,74,21,1
2021,Guildford 009D,E01030498,1350,1254,96,54,30,11,1
2021,Guildford 005A,E01030499,1464,1437,27,18,4,5,0
2021,Guildford 005B,E01030500,1512,1314,198,95,71,30,2
2021,Guildford 005C,E01030501,1603,1530,73,45,18,10,0
2021,Guildford 005D,E01030502,1194,1142,52,36,15,1,0
2021,Guildford 005E,E01030503,1310,1174,136,77,46,10,3
2021,Guildford 005F,E01030504,1101,1062,39,25,9,5,0
2021,Mole Valley 002A,E01030505,1518,1460,58,42,15,0,1
2021,Mole Valley 001A,E01030506,1285,1264,21,15,3,2,1
2021,Mole Valley 002B,E01030507,1242,1199,43,24,16,3,0
2021,Mole Valley 001B,E01030508,1419,1356,63,43,12,6,2
2021,Mole Valley 001C,E01030509,1176,1124,52,28,18,4,2
2021,Mole Valley 004A,E01030510,1836,1760,76,56,11,9,0
2021,Mole Valley 002C,E01030511,1575,1535,40,24,12,3,1
2021,Mole Valley 002D,E01030512,1561,1523,38,26,4,8,0
2021,Mole Valley 001D,E01030513,1389,1356,33,16,9,5,3
2021,Mole Valley 001E,E01030514,1456,1404,52,24,21,7,0
2021,Mole Valley 013A,E01030515,1889,1843,46,27,9,10,0
2021,Mole Valley 006A,E01030516,1281,1235,46,29,14,2,1
2021,Mole Valley 006B,E01030517,1608,1570,38,25,10,3,0
2021,Mole Valley 006C,E01030518,1371,1355,16,9,7,0,0
2021,Mole Valley 006D,E01030519,1561,1533,28,19,6,3,0
2021,Mole Valley 007A,E01030520,1353,1324,29,21,7,1,0
2021,Mole Valley 007B,E01030521,1612,1574,38,25,10,3,0
2021,Mole Valley 007C,E01030522,1396,1369,27,14,7,5,1
2021,Mole Valley 007D,E01030523,1195,1149,46,26,13,7,0
2021,Mole Valley 008A,E01030524,1820,1797,23,15,7,1,0
2021,Mole Valley 008B,E01030525,1455,1426,29,16,12,1,0
2021,Mole Valley 008C,E01030526,1251,1245,6,2,3,1,0
2021,Mole Valley 008D,E01030527,1604,1584,20,13,6,1,0
2021,Mole Valley 013B,E01030528,1382,1369,13,9,4,0,0
2021,Mole Valley 012A,E01030529,1587,1563,24,18,6,0,0
2021,Mole Valley 013C,E01030530,1185,1175,10,9,1,0,0
2021,Mole Valley 013D,E01030531,2329,2274,55,30,22,3,0
2021,Mole Valley 009A,E01030532,1572,1485,87,54,25,4,4
2021,Mole Valley 009B,E01030533,1401,1352,49,24,20,5,0
2021,Mole Valley 009C,E01030534,1362,1301,61,27,21,10,3
2021,Mole Valley 010A,E01030535,1799,1719,80,37,31,8,4
2021,Mole Valley 010B,E01030536,1793,1731,62,43,15,3,1
2021,Mole Valley 010C,E01030537,1689,1631,58,35,16,6,1
2021,Mole Valley 010D,E01030538,1866,1688,178,68,79,26,5
2021,Mole Valley 005A,E01030539,1667,1624,43,19,18,6,0
2021,Mole Valley 005B,E01030540,2107,2076,31,26,4,1,0
2021,Mole Valley 005C,E01030541,1242,1224,18,15,2,1,0
2021,Mole Valley 005D,E01030542,1198,1169,29,18,4,5,2
2021,Mole Valley 005E,E01030543,1596,1521,75,52,19,4,0
2021,Mole Valley 011A,E01030544,1612,1578,34,21,12,1,0
2021,Mole Valley 011B,E01030545,1447,1399,48,24,15,8,1
2021,Mole Valley 011C,E01030546,1507,1466,41,24,14,3,0
2021,Mole Valley 011D,E01030547,1626,1524,102,42,39,16,5
2021,Mole Valley 003A,E01030548,2179,1994,185,103,60,19,3
2021,Mole Valley 003B,E01030549,1804,1619,185,97,55,27,6
2021,Mole Valley 003C,E01030550,1746,1592,154,73,64,17,0
2021,Mole Valley 003D,E01030551,1637,1496,141,60,52,27,2
2021,Mole Valley 004B,E01030552,1486,1315,171,94,65,11,1
2021,Mole Valley 004C,E01030553,1661,1609,52,30,17,3,2
2021,Mole Valley 004D,E01030554,1134,1107,27,16,7,4,0
2021,Mole Valley 012B,E01030555,1607,1572,35,18,16,1,0
2021,Mole Valley 009D,E01030556,1850,1749,101,47,44,10,0
2021,Mole Valley 012C,E01030557,1913,1892,21,14,4,3,0
2021,Mole Valley 012D,E01030558,2228,2158,70,40,16,12,2
2021,Reigate and Banstead 002A,E01030559,1216,1189,27,15,7,4,1
2021,Reigate and Banstead 002B,E01030560,1542,1443,99,52,33,14,0
2021,Reigate and Banstead 002C,E01030561,1339,1296,43,27,11,5,0
2021,Reigate and Banstead 002D,E01030562,1261,1217,44,27,13,4,0
2021,Reigate and Banstead 002E,E01030563,2301,2152,149,62,58,29,0
2021,Reigate and Banstead 002F,E01030564,1356,1325,31,12,12,4,3
2021,Reigate and Banstead 004A,E01030565,1452,1397,55,31,16,7,1
2021,Reigate and Banstead 004B,E01030566,1414,1384,30,19,7,4,0
2021,Reigate and Banstead 004C,E01030567,1617,1589,28,17,7,2,2
2021,Reigate and Banstead 004D,E01030568,1444,1401,43,35,7,1,0
2021,Reigate and Banstead 004E,E01030569,2634,2536,98,62,25,10,1
2021,Reigate and Banstead 014A,E01030570,1664,1518,146,98,41,6,1
2021,Reigate and Banstead 014B,E01030571,1540,1442,98,64,25,9,0
2021,Reigate and Banstead 014C,E01030572,2127,1831,296,198,74,17,7
2021,Reigate and Banstead 014D,E01030573,1775,1662,113,62,32,16,3
2021,Reigate and Banstead 014E,E01030574,1878,1664,214,111,74,27,2
2021,Reigate and Banstead 018B,E01030576,1655,1527,128,53,56,15,4
2021,Reigate and Banstead 018C,E01030577,1589,1452,137,75,48,11,3
2021,Reigate and Banstead 018D,E01030578,1444,1317,127,62,47,15,3
2021,Reigate and Banstead 018E,E01030579,1568,1470,98,55,31,6,6
2021,Reigate and Banstead 017A,E01030580,2150,2032,118,74,35,9,0
2021,Reigate and Banstead 017B,E01030581,2334,2243,91,64,20,6,1
2021,Reigate and Banstead 017C,E01030582,1357,1251,106,59,34,9,4
2021,Reigate and Banstead 017D,E01030583,1603,1563,40,25,9,6,0
2021,Reigate and Banstead 016B,E01030585,1486,1442,44,31,10,2,1
2021,Reigate and Banstead 016C,E01030586,1856,1755,101,58,36,7,0
2021,Reigate and Banstead 016D,E01030587,1569,1507,62,23,30,7,2
2021,Reigate and Banstead 016E,E01030588,1456,1321,135,73,39,21,2
2021,Reigate and Banstead 007A,E01030589,1762,1692,70,45,21,4,0
2021,Reigate and Banstead 007B,E01030590,1848,1803,45,23,15,6,1
2021,Reigate and Banstead 007C,E01030591,1674,1602,72,31,22,15,4
2021,Reigate and Banstead 007D,E01030592,1796,1707,89,50,32,7,0
2021,Reigate and Banstead 012A,E01030593,1467,1373,94,51,32,11,0
2021,Reigate and Banstead 013A,E01030594,1849,1781,68,42,22,4,0
2021,Reigate and Banstead 013B,E01030595,1595,1553,42,25,16,0,1
2021,Reigate and Banstead 012B,E01030596,1519,1484,35,23,6,5,1
2021,Reigate and Banstead 012C,E01030597,1647,1575,72,52,16,4,0
2021,Reigate and Banstead 009A,E01030598,1626,1556,70,30,32,8,0
2021,Reigate and Banstead 008A,E01030599,1611,1491,120,72,37,10,1
2021,Reigate and Banstead 008B,E01030600,1592,1504,88,47,21,19,1
2021,Reigate and Banstead 008C,E01030601,1600,1484,116,63,43,10,0
2021,Reigate and Banstead 008D,E01030602,1775,1714,61,42,13,6,0
2021,Reigate and Banstead 001A,E01030603,1476,1412,64,46,14,2,2
2021,Reigate and Banstead 001B,E01030604,1554,1472,82,56,16,9,1
2021,Reigate and Banstead 001C,E01030605,1634,1582,52,35,11,6,0
2021,Reigate and Banstead 003A,E01030606,1629,1565,64,46,11,6,1
2021,Reigate and Banstead 001D,E01030607,1903,1842,61,40,15,5,1
2021,Reigate and Banstead 005A,E01030608,1490,1400,90,50,29,9,2
2021,Reigate and Banstead 005B,E01030609,2245,2039,206,120,60,20,6
2021,Reigate and Banstead 011A,E01030610,1448,1332,116,59,42,15,0
2021,Reigate and Banstead 011D,E01030613,1896,1502,394,230,115,40,9
2021,Reigate and Banstead 011E,E01030614,1648,1564,84,56,21,6,1
2021,Reigate and Banstead 010A,E01030615,1961,1447,514,310,152,46,6
2021,Reigate and Banstead 010B,E01030616,1667,1571,96,63,27,3,3
2021,Reigate and Banstead 010C,E01030617,1670,1473,197,126,60,10,1
2021,Reigate and Banstead 010D,E01030618,1875,1736,139,81,37,17,4
2021,Reigate and Banstead 010E,E01030619,1449,1349,100,52,31,14,3
2021,Reigate and Banstead 012D,E01030620,1880,1710,170,80,57,29,4
2021,Reigate and Banstead 012E,E01030621,1602,1546,56,31,18,7,0
2021,Reigate and Banstead 010F,E01030622,1910,1752,158,104,44,9,1
2021,Reigate and Banstead 009B,E01030623,2240,2170,70,48,15,6,1
2021,Reigate and Banstead 009C,E01030624,1417,1387,30,20,10,0,0
2021,Reigate and Banstead 009D,E01030625,1655,1596,59,39,17,3,0
2021,Reigate and Banstead 009E,E01030626,1048,994,54,29,18,6,1
2021,Reigate and Banstead 009F,E01030627,1828,1661,167,102,40,23,2
2021,Reigate and Banstead 015A,E01030628,1524,1495,29,21,4,3,1
2021,Reigate and Banstead 015B,E01030629,1349,1288,61,29,18,12,2
2021,Reigate and Banstead 013C,E01030630,1545,1510,35,19,8,6,2
2021,Reigate and Banstead 013D,E01030631,1578,1522,56,35,10,8,3
2021,Reigate and Banstead 015C,E01030632,1318,1281,37,20,13,3,1
2021,Reigate and Banstead 015D,E01030633,1432,1307,125,71,36,14,4
2021,Reigate and Banstead 015E,E01030634,1514,1451,63,36,17,8,2
2021,Reigate and Banstead 006A,E01030635,1613,1579,34,23,6,5,0
2021,Reigate and Banstead 006B,E01030636,1141,1095,46,28,13,4,1
2021,Reigate and Banstead 006C,E01030637,1192,1167,25,17,8,0,0
2021,Reigate and Banstead 006D,E01030638,1471,1439,32,18,8,3,3
2021,Reigate and Banstead 006E,E01030639,1491,1452,39,30,7,2,0
2021,Reigate and Banstead 005C,E01030640,1496,1435,61,34,18,6,3
2021,Reigate and Banstead 003B,E01030641,1523,1473,50,28,18,4,0
2021,Reigate and Banstead 003C,E01030642,1656,1585,71,35,27,9,0
2021,Reigate and Banstead 005D,E01030643,1413,1362,51,25,18,6,2
2021,Reigate and Banstead 003D,E01030644,1230,1181,49,35,9,5,0
2021,Runnymede 009A,E01030645,2104,1895,209,90,84,34,1
2021,Runnymede 009B,E01030646,2182,1909,273,116,91,57,9
2021,Runnymede 007A,E01030647,1586,1511,75,40,23,10,2
2021,Runnymede 007B,E01030648,1676,1540,136,68,53,12,3
2021,Runnymede 007C,E01030649,2414,2116,298,150,103,38,7
2021,Runnymede 007D,E01030650,1284,1164,120,53,50,16,1
2021,Runnymede 007E,E01030651,1323,1235,88,48,35,4,1
2021,Runnymede 006A,E01030652,1809,1714,95,41,43,6,5
2021,Runnymede 006B,E01030653,1749,1576,173,94,56,20,3
2021,Runnymede 006C,E01030654,1426,1352,74,41,22,8,3
2021,Runnymede 007F,E01030655,1776,1626,150,88,50,12,0
2021,Runnymede 004A,E01030656,1522,1450,72,40,23,8,1
2021,Runnymede 006D,E01030657,1485,1348,137,83,42,9,3
2021,Runnymede 004B,E01030658,1408,1345,63,39,17,6,1
2021,Runnymede 006E,E01030659,1834,1718,116,61,35,20,0
2021,Runnymede 009C,E01030660,2617,2515,102,65,32,4,1
2021,Runnymede 009D,E01030661,1967,1903,64,33,22,8,1
2021,Runnymede 007G,E01030662,1682,1611,71,30,35,6,0
2021,Runnymede 003A,E01030663,1684,1511,173,101,48,20,4
2021,Runnymede 003B,E01030664,1722,1591,131,82,36,9,4
2021,Runnymede 003C,E01030665,1539,1378,161,82,58,15,6
2021,Runnymede 003D,E01030666,1691,1522,169,109,42,13,5
2021,Runnymede 001A,E01030667,1490,1283,207,131,50,25,1
2021,Runnymede 001B,E01030668,1914,1645,269,159,88,21,1
2021,Runnymede 001C,E01030669,1830,1661,169,112,43,13,1
2021,Runnymede 001D,E01030670,1525,1406,119,92,23,4,0
2021,Runnymede 002A,E01030671,1394,1236,158,105,50,3,0
2021,Runnymede 002B,E01030672,4497,4008,489,366,112,6,5
2021,Runnymede 002C,E01030673,1426,1287,139,91,43,5,0
2021,Runnymede 002D,E01030674,1398,1270,128,82,37,8,1
2021,Runnymede 002E,E01030675,1480,1337,143,93,37,13,0
2021,Runnymede 002F,E01030676,1427,1242,185,99,59,25,2
2021,Runnymede 008A,E01030677,1436,1275,161,89,61,8,3
2021,Runnymede 008B,E01030678,1370,1281,89,50,29,7,3
2021,Runnymede 008C,E01030679,1235,1169,66,51,13,2,0
2021,Runnymede 008D,E01030680,1464,1414,50,22,18,8,2
2021,Runnymede 010A,E01030681,1660,1578,82,47,21,12,2
2021,Runnymede 010B,E01030682,1316,1227,89,42,36,11,0
2021,Runnymede 010C,E01030683,1373,1286,87,48,27,11,1
2021,Runnymede 009E,E01030684,1459,1362,97,59,30,8,0
2021,Runnymede 004C,E01030685,1455,1348,107,61,38,8,0
2021,Runnymede 004D,E01030686,1421,1303,118,63,39,11,5
2021,Runnymede 003E,E01030687,1213,1124,89,42,34,11,2
2021,Runnymede 003F,E01030688,1526,1438,88,56,22,10,0
2021,Runnymede 005A,E01030689,1458,1313,145,85,39,20,1
2021,Runnymede 005B,E01030690,1761,1553,208,148,49,9,2
2021,Runnymede 005C,E01030691,1525,1394,131,76,38,17,0
2021,Runnymede 005D,E01030692,1430,1257,173,102,49,20,2
2021,Runnymede 010D,E01030693,1250,1209,41,23,14,3,1
2021,Runnymede 010E,E01030694,1320,1234,86,41,32,11,2
2021,Runnymede 010F,E01030695,1188,1155,33,22,7,1,3
2021,Runnymede 010G,E01030696,1515,1449,66,33,28,5,0
2021,Spelthorne 006A,E01030697,1676,1542,134,66,57,8,3
2021,Spelthorne 006B,E01030698,1672,1511,161,90,46,22,3
2021,Spelthorne 006C,E01030699,1470,1392,78,40,24,14,0
2021,Spelthorne 006D,E01030700,1704,1519,185,92,68,20,5
2021,Spelthorne 005A,E01030701,1546,1410,136,70,47,16,3
2021,Spelthorne 005B,E01030702,1255,1157,98,50,35,10,3
2021,Spelthorne 005C,E01030703,1577,1466,111,56,38,17,0
2021,Spelthorne 005D,E01030704,1552,1462,90,45,31,12,2
2021,Spelthorne 005E,E01030705,1601,1492,109,75,19,11,4
2021,Spelthorne 005F,E01030706,1456,1287,169,83,59,25,2
2021,Spelthorne 003A,E01030707,1986,1578,408,213,139,46,10
2021,Spelthorne 003B,E01030708,1633,1453,180,102,51,25,2
2021,Spelthorne 002A,E01030709,1740,1457,283,168,77,31,7
2021,Spelthorne 002B,E01030710,2014,1596,418,203,146,59,10
2021,Spelthorne 002C,E01030711,1897,1602,295,142,113,36,4
2021,Spelthorne 003C,E01030712,1724,1476,248,116,99,30,3
2021,Spelthorne 003D,E01030713,1290,1160,130,67,39,22,2
2021,Spelthorne 003E,E01030714,1456,1361,95,55,27,13,0
2021,Spelthorne 003F,E01030715,1489,1377,112,58,37,17,0
2021,Spelthorne 003G,E01030716,1431,1321,110,76,25,6,3
2021,Spelthorne 011A,E01030717,1608,1501,107,61,34,10,2
2021,Spelthorne 011B,E01030718,1341,1268,73,42,24,6,1
2021,Spelthorne 011C,E01030719,1566,1510,56,31,20,3,2
2021,Spelthorne 011D,E01030720,1770,1689,81,57,20,4,0
2021,Spelthorne 012A,E01030721,1461,1411,50,24,18,6,2
2021,Spelthorne 012B,E01030722,1583,1532,51,27,14,9,1
2021,Spelthorne 012C,E01030723,1552,1499,53,36,9,7,1
2021,Spelthorne 012D,E01030724,1447,1380,67,32,25,9,1
2021,Spelthorne 006E,E01030725,1991,1705,286,137,97,47,5
2021,Spelthorne 009A,E01030726,1690,1606,84,52,26,4,2
2021,Spelthorne 009B,E01030727,1783,1615,168,92,58,17,1
2021,Spelthorne 009C,E01030728,1648,1583,65,52,13,0,0
2021,Spelthorne 007A,E01030729,1459,1362,97,61,29,5,2
2021,Spelthorne 013A,E01030730,1780,1713,67,47,16,4,0
2021,Spelthorne 013B,E01030731,1803,1747,56,36,18,2,0
2021,Spelthorne 013C,E01030732,1599,1535,64,37,21,6,0
2021,Spelthorne 013D,E01030733,1636,1529,107,58,36,13,0
2021,Spelthorne 004A,E01030734,1482,1314,168,97,58,13,0
2021,Spelthorne 004B,E01030735,1586,1388,198,134,53,8,3
2021,Spelthorne 004D,E01030737,1453,1259,194,129,46,18,1
2021,Spelthorne 004E,E01030738,1478,1328,150,95,41,11,3
2021,Spelthorne 007B,E01030739,1674,1530,144,93,35,15,1
2021,Spelthorne 007C,E01030740,1801,1649,152,79,45,26,2
2021,Spelthorne 007D,E01030741,1634,1534,100,69,22,7,2
2021,Spelthorne 009D,E01030742,1850,1706,144,92,40,10,2
2021,Spelthorne 001A,E01030743,1614,1343,271,145,97,25,4
2021,Spelthorne 001B,E01030744,1682,1331,351,172,150,28,1
2021,Spelthorne 001C,E01030745,1780,1452,328,154,128,44,2
2021,Spelthorne 002D,E01030746,1801,1464,337,168,132,31,6
2021,Spelthorne 001D,E01030747,1381,1205,176,112,45,15,4
2021,Spelthorne 008A,E01030748,1705,1499,206,92,91,20,3
2021,Spelthorne 008B,E01030749,1521,1392,129,61,39,25,4
2021,Spelthorne 008C,E01030750,1501,1360,141,66,54,21,0
2021,Spelthorne 008D,E01030751,1741,1471,270,139,81,45,5
2021,Spelthorne 008E,E01030752,1705,1470,235,112,79,38,6
2021,Spelthorne 010A,E01030753,1766,1674,92,63,25,4,0
2021,Spelthorne 010B,E01030754,2125,1973,152,98,32,17,5
2021,Spelthorne 010C,E01030755,1986,1789,197,123,52,20,2
2021,Spelthorne 010D,E01030756,1620,1541,79,52,20,4,3
2021,Surrey Heath 002A,E01030757,1610,1520,90,56,18,11,5
2021,Surrey Heath 002B,E01030758,1146,1091,55,39,12,3,1
2021,Surrey Heath 002C,E01030759,1518,1434,84,39,32,12,1
2021,Surrey Heath 002D,E01030760,1597,1542,55,32,12,10,1
2021,Surrey Heath 006A,E01030761,2491,2385,106,80,21,4,1
2021,Surrey Heath 006B,E01030762,1781,1728,53,28,16,8,1
2021,Surrey Heath 001A,E01030763,1199,1154,45,18,21,4,2
2021,Surrey Heath 001B,E01030764,1282,1239,43,21,17,4,1
2021,Surrey Heath 001C,E01030765,1512,1474,38,20,18,0,0
2021,Surrey Heath 010A,E01030766,1772,1473,299,163,103,25,8
2021,Surrey Heath 010B,E01030767,1719,1534,185,100,56,22,7
2021,Surrey Heath 010C,E01030768,1319,1185,134,68,45,18,3
2021,Surrey Heath 010D,E01030769,1462,1401,61,36,18,5,2
2021,Surrey Heath 011A,E01030770,1434,1382,52,35,12,5,0
2021,Surrey Heath 011B,E01030771,1195,1156,39,24,6,7,2
2021,Surrey Heath 011C,E01030772,1468,1396,72,43,21,8,0
2021,Surrey Heath 011D,E01030773,1301,1260,41,19,11,11,0
2021,Surrey Heath 007A,E01030774,1478,1398,80,56,20,4,0
2021,Surrey Heath 007B,E01030775,1465,1413,52,33,13,5,1
2021,Surrey Heath 007C,E01030776,1585,1508,77,64,7,6,0
2021,Surrey Heath 007D,E01030777,1536,1447,89,58,23,5,3
2021,Surrey Heath 003A,E01030778,1638,1588,50,35,11,4,0
2021,Surrey Heath 003B,E01030779,1682,1628,54,33,13,5,3
2021,Surrey Heath 003C,E01030780,1524,1464,60,39,12,7,2
2021,Surrey Heath 003D,E01030781,1540,1492,48,31,11,5,1
2021,Surrey Heath 012A,E01030782,1553,1504,49,33,6,8,2
2021,Surrey Heath 012B,E01030783,1605,1548,57,35,14,7,1
2021,Surrey Heath 012C,E01030784,2380,2194,186,107,55,19,5
2021,Surrey Heath 012D,E01030785,1427,1401,26,20,5,1,0
2021,Surrey Heath 004A,E01030786,1752,1515,237,99,87,41,10
2021,Surrey Heath 004B,E01030787,1422,1297,125,60,45,15,5
2021,Surrey Heath 004C,E01030788,1326,1188,138,66,52,16,4
2021,Surrey Heath 009A,E01030789,1616,1545,71,45,20,5,1
2021,Surrey Heath 009B,E01030790,1763,1638,125,71,38,13,3
2021,Surrey Heath 009C,E01030791,1696,1566,130,68,44,14,4
2021,Surrey Heath 009D,E01030792,1294,1263,31,24,4,2,1
2021,Surrey Heath 008A,E01030793,2060,1626,434,166,171,79,18
2021,Surrey Heath 008B,E01030794,1527,1355,172,78,66,18,10
2021,Surrey Heath 008C,E01030795,2196,1924,272,158,74,32,8
2021,Surrey Heath 005A,E01030796,1375,1357,18,12,4,2,0
2021,Surrey Heath 005B,E01030797,1379,1314,65,36,23,6,0
2021,Surrey Heath 005C,E01030798,1535,1495,40,32,7,1,0
2021,Surrey Heath 005D,E01030799,1345,1282,63,48,11,3,1
2021,Surrey Heath 005E,E01030800,1949,1678,271,127,112,28,4
2021,Surrey Heath 004D,E01030801,1657,1479,178,91,59,28,0
2021,Surrey Heath 004E,E01030802,1790,1646,144,77,47,16,4
2021,Surrey Heath 008D,E01030803,1718,1460,258,103,94,53,8
2021,Surrey Heath 008E,E01030804,1691,1609,82,54,19,6,3
2021,Surrey Heath 008F,E01030805,1651,1368,283,120,103,50,10
2021,Surrey Heath 006C,E01030806,1479,1439,40,37,2,1,0
2021,Surrey Heath 006D,E01030807,2679,2560,119,83,26,8,2
2021,Surrey Heath 006E,E01030808,1603,1561,42,33,6,3,0
2021,Surrey Heath 001D,E01030809,1435,1403,32,14,12,5,1
2021,Surrey Heath 001E,E01030810,1271,1235,36,26,6,3,1
2021,Surrey Heath 001F,E01030811,1446,1406,40,29,5,6,0
2021,Tandridge 008A,E01030812,1637,1602,35,16,11,5,3
2021,Tandridge 008B,E01030813,1475,1431,44,30,12,2,0
2021,Tandridge 008C,E01030814,1266,1233,33,19,9,2,3
2021,Tandridge 008D,E01030815,1520,1483,37,20,11,5,1
2021,Tandridge 011A,E01030816,1608,1579,29,19,6,4,0
2021,Tandridge 011B,E01030817,1391,1367,24,16,6,2,0
2021,Tandridge 011C,E01030818,1209,1192,17,11,3,3,0
2021,Tandridge 011D,E01030819,1680,1617,63,27,29,7,0
2021,Tandridge 005A,E01030820,1781,1740,41,29,8,4,0
2021,Tandridge 010A,E01030821,1947,1889,58,36,15,3,4
2021,Tandridge 010B,E01030822,1972,1946,26,15,7,4,0
2021,Tandridge 011E,E01030823,2285,2245,40,26,9,5,0
2021,Tandridge 009A,E01030824,1524,1482,42,28,9,4,1
2021,Tandridge 009B,E01030825,1321,1296,25,18,5,2,0
2021,Tandridge 009C,E01030826,1459,1419,40,32,6,2,0
2021,Tandridge 009D,E01030827,1698,1666,32,19,7,6,0
2021,Tandridge 004A,E01030828,1400,1332,68,43,20,2,3
2021,Tandridge 004B,E01030829,1652,1519,133,78,47,6,2
2021,Tandridge 004C,E01030830,1303,1242,61,36,19,6,0
2021,Tandridge 006A,E01030831,2179,2127,52,39,10,3,0
2021,Tandridge 006B,E01030832,1332,1303,29,18,8,3,0
2021,Tandridge 010C,E01030833,1385,1337,48,18,22,6,2
2021,Tandridge 010D,E01030834,1429,1399,30,18,8,4,0
2021,Tandridge 010E,E01030835,1431,1405,26,15,7,3,1
2021,Tandridge 006C,E01030836,1551,1470,81,33,33,12,3
2021,Tandridge 006D,E01030837,1432,1400,32,20,8,4,0
2021,Tandridge 006E,E01030838,1303,1286,17,14,3,0,0
2021,Tandridge 006F,E01030839,1386,1360,26,20,6,0,0
2021,Tandridge 007A,E01030840,1385,1364,21,15,2,4,0
2021,Tandridge 007B,E01030841,1330,1320,10,8,2,0,0
2021,Tandridge 007C,E01030842,2231,2188,43,29,11,3,0
2021,Tandridge 007D,E01030843,1457,1430,27,13,11,3,0
2021,Tandridge 003A,E01030844,1768,1711,57,35,12,8,2
2021,Tandridge 003B,E01030845,1220,1196,24,15,5,3,1
2021,Tandridge 003C,E01030846,1523,1481,42,31,6,3,2
2021,Tandridge 005B,E01030847,1557,1506,51,30,13,7,1
2021,Tandridge 005C,E01030848,2162,2087,75,44,22,9,0
2021,Tandridge 004D,E01030850,2344,2226,118,68,35,14,1
2021,Tandridge 004E,E01030851,1983,1910,73,46,19,6,2
2021,Tandridge 012A,E01030852,1897,1851,46,34,7,5,0
2021,Tandridge 012B,E01030853,1738,1705,33,18,10,3,2
2021,Tandridge 012C,E01030854,1926,1868,58,30,16,5,7
2021,Tandridge 002A,E01030855,1994,1929,65,56,6,3,0
2021,Tandridge 002B,E01030856,1490,1444,46,33,11,2,0
2021,Tandridge 003D,E01030857,2128,2069,59,37,13,8,1
2021,Tandridge 003E,E01030858,2503,2364,139,84,43,11,1
2021,Tandridge 002C,E01030859,1967,1859,108,65,37,5,1
2021,Tandridge 004F,E01030861,2485,2315,170,109,55,4,2
2021,Waverley 015A,E01030862,1924,1873,51,30,10,9,2
2021,Waverley 008A,E01030863,1833,1794,39,26,12,1,0
2021,Waverley 012A,E01030864,1762,1670,92,40,25,17,10
2021,Waverley 008B,E01030865,1561,1475,86,58,22,6,0
2021,Waverley 008C,E01030866,1518,1480,38,26,9,3,0
2021,Waverley 015B,E01030867,1521,1476,45,25,14,2,4
2021,Waverley 015C,E01030868,1266,1245,21,13,5,3,0
2021,Waverley 015D,E01030869,1159,1129,30,22,5,2,1
2021,Waverley 013A,E01030870,1573,1549,24,20,3,1,0
2021,Waverley 013B,E01030871,1861,1797,64,31,28,5,0
2021,Waverley 013C,E01030872,1769,1693,76,35,25,15,1
2021,Waverley 013D,E01030873,1375,1340,35,22,9,3,1
2021,Waverley 013E,E01030874,1695,1664,31,17,9,4,1
2021,Waverley 013F,E01030875,1683,1594,89,43,37,8,1
2021,Waverley 013G,E01030876,1521,1478,43,23,17,3,0
2021,Waverley 011A,E01030877,1122,1085,37,16,17,3,1
2021,Waverley 011B,E01030878,1653,1623,30,22,8,0,0
2021,Waverley 012B,E01030879,1104,1073,31,16,12,3,0
2021,Waverley 015E,E01030880,2317,2239,78,39,30,8,1
2021,Waverley 004A,E01030881,1520,1486,34,29,5,0,0
2021,Waverley 006A,E01030882,1430,1401,29,22,5,1,1
2021,Waverley 004B,E01030883,1461,1425,36,26,8,1,1
2021,Waverley 003A,E01030884,1550,1471,79,31,38,6,4
2021,Waverley 003B,E01030885,1713,1532,181,102,56,23,0
2021,Waverley 003C,E01030886,1370,1318,52,28,18,5,1
2021,Waverley 006B,E01030887,1406,1380,26,15,9,2,0
2021,Waverley 004C,E01030888,1603,1514,89,50,29,9,1
2021,Waverley 006C,E01030889,1525,1462,63,25,28,6,4
2021,Waverley 001A,E01030890,1494,1454,40,23,12,4,1
2021,Waverley 002A,E01030891,1624,1595,29,21,8,0,0
2021,Waverley 002B,E01030892,1239,1162,77,45,22,5,5
2021,Waverley 003D,E01030893,1996,1920,76,54,15,6,1
2021,Waverley 004D,E01030894,1697,1649,48,30,15,2,1
2021,Waverley 003E,E01030895,1561,1449,112,75,30,6,1
2021,Waverley 006D,E01030896,1262,1171,91,56,26,8,1
2021,Waverley 006E,E01030897,1331,1305,26,16,8,1,1
2021,Waverley 009A,E01030898,1598,1568,30,23,4,3,0
2021,Waverley 002C,E01030899,1535,1502,33,22,9,2,0
2021,Waverley 002D,E01030900,1244,1201,43,25,15,2,1
2021,Waverley 002E,E01030901,1349,1227,122,54,58,9,1
2021,Waverley 001B,E01030902,1259,1235,24,15,3,3,3
2021,Waverley 001C,E01030903,1838,1775,63,42,18,3,0
2021,Waverley 001D,E01030904,1461,1414,47,30,14,3,0
2021,Waverley 009B,E01030905,1687,1611,76,27,31,11,7
2021,Waverley 009C,E01030906,1887,1837,50,31,11,6,2
2021,Waverley 009D,E01030907,1399,1381,18,12,5,1,0
2021,Waverley 018A,E01030908,1640,1516,124,58,47,15,4
2021,Waverley 018B,E01030909,1285,1253,32,24,6,2,0
2021,Waverley 018C,E01030910,1143,1119,24,11,13,0,0
2021,Waverley 005A,E01030911,1467,1427,40,26,8,5,1
2021,Waverley 005B,E01030912,1294,1253,41,25,14,2,0
2021,Waverley 005C,E01030913,1281,1222,59,26,24,9,0
2021,Waverley 010A,E01030914,1362,1300,62,31,22,8,1
2021,Waverley 010B,E01030915,1443,1387,56,28,23,4,1
2021,Waverley 007A,E01030916,2154,2001,153,105,37,11,0
2021,Waverley 007B,E01030917,1131,1060,71,52,15,4,0
2021,Waverley 007C,E01030918,1145,1108,37,22,11,3,1
2021,Waverley 007D,E01030919,1959,1885,74,60,14,0,0
2021,Waverley 005D,E01030920,1515,1429,86,50,26,8,2
2021,Waverley 005E,E01030921,1639,1563,76,43,25,8,0
2021,Waverley 007E,E01030922,1755,1685,70,51,15,4,0
2021,Waverley 010C,E01030923,1526,1495,31,21,7,1,2
2021,Waverley 010D,E01030924,1164,1126,38,24,7,5,2
2021,Waverley 010E,E01030925,1637,1602,35,27,4,4,0
2021,Waverley 017A,E01030926,1517,1471,46,25,13,8,0
2021,Waverley 017B,E01030927,1262,1244,18,8,5,5,0
2021,Waverley 017C,E01030928,1677,1548,129,66,40,20,3
2021,Waverley 017D,E01030929,1510,1381,129,63,60,6,0
2021,Waverley 016A,E01030930,1493,1458,35,16,17,2,0
2021,Waverley 016B,E01030931,1701,1628,73,40,22,10,1
2021,Waverley 016C,E01030932,1603,1570,33,23,9,0,1
2021,Waverley 016D,E01030933,1775,1721,54,28,21,5,0
2021,Waverley 018D,E01030934,1393,1366,27,17,7,3,0
2021,Waverley 018E,E01030935,1264,1223,41,23,17,1,0
2021,Waverley 011C,E01030937,1594,1548,46,25,20,1,0
2021,Waverley 011D,E01030938,1247,1210,37,21,13,2,1
2021,Waverley 011E,E01030939,1147,1134,13,12,1,0,0
2021,Waverley 008D,E01030940,1885,1842,43,32,10,1,0
2021,Waverley 012C,E01030941,1469,1414,55,40,14,1,0
2021,Waverley 012D,E01030942,1329,1307,22,15,5,2,0
2021,Waverley 012E,E01030943,1305,1270,35,26,7,2,0
2021,Woking 012A,E01030944,1313,1261,52,29,15,6,2
2021,Woking 012B,E01030945,1183,1144,39,25,9,3,2
2021,Woking 001A,E01030946,1388,1312,76,28,38,8,2
2021,Woking 001B,E01030947,1430,1353,77,46,19,8,4
2021,Woking 001C,E01030948,1583,1478,105,52,47,6,0
2021,Woking 001D,E01030949,1808,1664,144,79,56,8,1
2021,Woking 001E,E01030950,1529,1406,123,66,32,20,5
2021,Woking 005A,E01030951,1238,1059,179,82,60,31,6
2021,Woking 005B,E01030952,1534,1253,281,108,111,49,13
2021,Woking 005C,E01030953,1381,1220,161,91,59,10,1
2021,Woking 008A,E01030954,2319,1806,513,299,154,54,6
2021,Woking 010A,E01030955,1321,1175,146,87,49,10,0
2021,Woking 005D,E01030956,1227,1133,94,46,34,12,2
2021,Woking 005E,E01030957,1199,1075,124,59,38,23,4
2021,Woking 005F,E01030958,1397,1261,136,79,40,13,4
2021,Woking 005G,E01030959,975,890,85,35,41,8,1
2021,Woking 009A,E01030960,1664,1534,130,63,42,19,6
2021,Woking 009B,E01030961,1872,1796,76,43,15,15,3
2021,Woking 009C,E01030962,1586,1468,118,61,43,11,3
2021,Woking 003A,E01030963,1478,1434,44,28,13,1,2
2021,Woking 003B,E01030964,1700,1520,180,115,50,11,4
2021,Woking 003C,E01030965,1479,1407,72,48,17,4,3
2021,Woking 003D,E01030966,1396,1315,81,41,33,7,0
2021,Woking 003E,E01030967,1606,1565,41,31,10,0,0
2021,Woking 003F,E01030968,1304,1184,120,50,47,20,3
2021,Woking 008B,E01030969,1434,1344,90,58,26,5,1
2021,Woking 008C,E01030970,1398,1268,130,79,37,11,3
2021,Woking 011A,E01030971,2375,2094,281,160,83,33,5
2021,Woking 011B,E01030972,1961,1729,232,129,74,28,1
2021,Woking 007A,E01030974,1501,1351,150,67,61,19,3
2021,Woking 007B,E01030975,1389,1268,121,55,48,17,1
2021,Woking 007C,E01030976,1456,1374,82,43,30,9,0
2021,Woking 007D,E01030977,1728,1602,126,71,36,19,0
2021,Woking 012C,E01030978,2173,2010,163,112,28,18,5
2021,Woking 007E,E01030979,2018,1870,148,87,45,11,5
2021,Woking 004A,E01030980,1662,993,669,206,302,127,34
2021,Woking 004B,E01030981,1715,1227,488,134,214,123,17
2021,Woking 004D,E01030983,1877,1284,593,229,240,101,23
2021,Woking 004E,E01030984,2149,1669,480,199,186,75,20
2021,Woking 012D,E01030986,1025,983,42,30,10,1,1
2021,Woking 012E,E01030987,1325,1281,44,27,11,6,0
2021,Woking 006A,E01030988,1968,1648,320,179,91,46,4
2021,Woking 006B,E01030989,1793,1564,229,124,73,26,6
2021,Woking 006C,E01030990,1390,1319,71,53,16,2,0
2021,Woking 008D,E01030991,1961,1597,364,212,103,44,5
2021,Woking 010B,E01030992,1685,1500,185,123,40,20,2
2021,Woking 011D,E01030994,1907,1742,165,105,43,14,3
2021,Woking 011E,E01030995,1687,1451,236,108,80,39,9
2021,Woking 002A,E01030996,1487,1439,48,29,12,7,0
2021,Woking 006D,E01030997,1450,1401,49,20,19,7,3
2021,Woking 002B,E01030998,1834,1777,57,33,15,8,1
2021,Woking 010C,E01030999,1332,1276,56,47,7,2,0
2021,Woking 009D,E01031000,1456,1369,87,60,24,3,0
2021,Woking 010D,E01031001,1671,1523,148,89,41,16,2
2021,Woking 002C,E01031002,1710,1631,79,54,16,8,1
2021,Woking 002D,E01031003,1859,1770,89,60,24,5,0
2021,Woking 002E,E01031004,2157,1964,193,111,58,22,2
2021,North Warwickshire 005A,E01031005,1565,1547,18,8,10,0,0
2021,North Warwickshire 007A,E01031006,1427,1384,43,19,22,2,0
2021,North Warwickshire 007B,E01031007,1249,1227,22,13,8,1,0
2021,North Warwickshire 005B,E01031008,1492,1470,22,11,7,4,0
2021,North Warwickshire 003A,E01031009,2116,1977,139,65,52,18,4
2021,North Warwickshire 003B,E01031010,1907,1768,139,70,59,7,3
2021,North Warwickshire 003C,E01031011,2170,2100,70,28,30,7,5
2021,North Warwickshire 003D,E01031012,1460,1437,23,17,6,0,0
2021,North Warwickshire 003E,E01031013,993,976,17,7,6,4,0
2021,North Warwickshire 003F,E01031014,1193,1174,19,8,4,5,2
2021,North Warwickshire 003G,E01031015,1525,1509,16,8,6,2,0
2021,North Warwickshire 002A,E01031016,1491,1476,15,9,3,3,0
2021,North Warwickshire 005C,E01031017,1659,1633,26,13,9,4,0
2021,North Warwickshire 005D,E01031018,1080,1077,3,1,2,0,0
2021,North Warwickshire 006A,E01031019,1645,1624,21,14,4,1,2
2021,North Warwickshire 006B,E01031020,1476,1450,26,13,13,0,0
2021,North Warwickshire 006C,E01031021,1753,1709,44,19,17,8,0
2021,North Warwickshire 006D,E01031022,1831,1808,23,15,7,0,1
2021,North Warwickshire 004A,E01031023,1571,1539,32,20,10,1,1
2021,North Warwickshire 004B,E01031024,1749,1734,15,4,11,0,0
2021,North Warwickshire 002B,E01031025,1618,1505,113,37,54,16,6
2021,North Warwickshire 002C,E01031026,1510,1471,39,16,21,2,0
2021,North Warwickshire 007C,E01031027,1687,1655,32,12,9,7,4
2021,North Warwickshire 007D,E01031028,1856,1830,26,17,5,4,0
2021,North Warwickshire 005E,E01031029,1484,1447,37,24,12,1,0
2021,North Warwickshire 005F,E01031030,2246,2202,44,25,12,5,2
2021,North Warwickshire 002D,E01031031,2503,2487,16,12,3,1,0
2021,North Warwickshire 002E,E01031032,1365,1353,12,5,5,1,1
2021,North Warwickshire 004C,E01031033,1743,1729,14,5,8,1,0
2021,North Warwickshire 004D,E01031034,1735,1710,25,9,10,6,0
2021,North Warwickshire 001A,E01031035,1930,1910,20,10,7,3,0
2021,North Warwickshire 001B,E01031036,1689,1687,2,1,1,0,0
2021,North Warwickshire 001C,E01031037,1927,1885,42,25,12,5,0
2021,North Warwickshire 001D,E01031038,1920,1899,21,14,6,1,0
2021,North Warwickshire 001E,E01031039,1508,1488,20,9,5,5,1
2021,North Warwickshire 001F,E01031040,1699,1665,34,19,12,3,0
2021,North Warwickshire 006E,E01031041,1590,1572,18,6,11,0,1
2021,North Warwickshire 006F,E01031042,1799,1783,16,9,5,2,0
2021,Nuneaton and Bedworth 005A,E01031043,1717,1466,251,106,88,48,9
2021,Nuneaton and Bedworth 005B,E01031044,1660,1448,212,78,91,36,7
2021,Nuneaton and Bedworth 005C,E01031045,1847,1537,310,131,118,51,10
2021,Nuneaton and Bedworth 005D,E01031046,1687,1180,507,139,208,134,26
2021,Nuneaton and Bedworth 005E,E01031047,1911,1404,507,188,191,100,28
2021,Nuneaton and Bedworth 008A,E01031048,1222,1147,75,39,24,7,5
2021,Nuneaton and Bedworth 008B,E01031049,2688,2429,259,142,88,26,3
2021,Nuneaton and Bedworth 008C,E01031050,1777,1693,84,40,29,14,1
2021,Nuneaton and Bedworth 008D,E01031051,1286,1223,63,34,20,8,1
2021,Nuneaton and Bedworth 010A,E01031052,1447,1248,199,69,88,35,7
2021,Nuneaton and Bedworth 010B,E01031053,1365,1280,85,41,33,11,0
2021,Nuneaton and Bedworth 010C,E01031054,1540,1472,68,25,32,9,2
2021,Nuneaton and Bedworth 010D,E01031055,1606,1540,66,35,27,4,0
2021,Nuneaton and Bedworth 010E,E01031056,1466,1422,44,27,10,7,0
2021,Nuneaton and Bedworth 006A,E01031057,1481,1322,159,71,66,18,4
2021,Nuneaton and Bedworth 006B,E01031058,1421,1340,81,26,31,19,5
2021,Nuneaton and Bedworth 006C,E01031059,1570,1410,160,64,70,23,3
2021,Nuneaton and Bedworth 006D,E01031060,1344,1268,76,24,32,17,3
2021,Nuneaton and Bedworth 006E,E01031061,1395,1335,60,16,28,15,1
2021,Nuneaton and Bedworth 013A,E01031062,1163,1126,37,16,16,5,0
2021,Nuneaton and Bedworth 013B,E01031063,1207,1173,34,17,13,2,2
2021,Nuneaton and Bedworth 013C,E01031064,1275,1227,48,23,18,7,0
2021,Nuneaton and Bedworth 013D,E01031065,1551,1491,60,34,19,7,0
2021,Nuneaton and Bedworth 013E,E01031066,1518,1454,64,30,23,9,2
2021,Nuneaton and Bedworth 014A,E01031067,1390,1359,31,16,9,3,3
2021,Nuneaton and Bedworth 014B,E01031068,1705,1661,44,25,17,2,0
2021,Nuneaton and Bedworth 014C,E01031069,1453,1417,36,19,14,3,0
2021,Nuneaton and Bedworth 014D,E01031070,1383,1353,30,15,12,3,0
2021,Nuneaton and Bedworth 002C,E01031073,1982,1839,143,73,48,18,4
2021,Nuneaton and Bedworth 002D,E01031074,1512,1406,106,39,50,15,2
2021,Nuneaton and Bedworth 002E,E01031075,2133,1961,172,86,61,23,2
2021,Nuneaton and Bedworth 018A,E01031077,1725,1502,223,113,90,19,1
2021,Nuneaton and Bedworth 018B,E01031078,2075,1899,176,76,77,19,4
2021,Nuneaton and Bedworth 018C,E01031079,1511,1415,96,28,41,26,1
2021,Nuneaton and Bedworth 018D,E01031080,1585,1420,165,69,70,20,6
2021,Nuneaton and Bedworth 004A,E01031081,1586,1521,65,35,23,7,0
2021,Nuneaton and Bedworth 004B,E01031082,1355,1317,38,22,13,2,1
2021,Nuneaton and Bedworth 004C,E01031083,1741,1707,34,16,9,7,2
2021,Nuneaton and Bedworth 004D,E01031084,2125,2065,60,30,23,4,3
2021,Nuneaton and Bedworth 004E,E01031085,1300,1270,30,15,13,2,0
2021,Nuneaton and Bedworth 016A,E01031086,2009,1835,174,77,67,28,2
2021,Nuneaton and Bedworth 016B,E01031087,2127,1986,141,70,50,16,5
2021,Nuneaton and Bedworth 016C,E01031088,1945,1846,99,44,37,18,0
2021,Nuneaton and Bedworth 016D,E01031089,1403,1349,54,32,17,5,0
2021,Nuneaton and Bedworth 007A,E01031090,1592,1478,114,47,49,16,2
2021,Nuneaton and Bedworth 007B,E01031091,1582,1512,70,28,27,10,5
2021,Nuneaton and Bedworth 007C,E01031092,1444,1362,82,41,32,9,0
2021,Nuneaton and Bedworth 007D,E01031093,1269,1217,52,27,18,3,4
2021,Nuneaton and Bedworth 007E,E01031094,1165,1090,75,35,25,12,3
2021,Nuneaton and Bedworth 015A,E01031095,1224,1184,40,17,18,4,1
2021,Nuneaton and Bedworth 015B,E01031096,1302,1188,114,47,53,14,0
2021,Nuneaton and Bedworth 015C,E01031097,1639,1585,54,26,24,4,0
2021,Nuneaton and Bedworth 015D,E01031098,1380,1039,341,157,125,51,8
2021,Nuneaton and Bedworth 015E,E01031099,2212,1863,349,142,148,55,4
2021,Nuneaton and Bedworth 003A,E01031100,1273,1208,65,34,22,9,0
2021,Nuneaton and Bedworth 003B,E01031101,1324,1261,63,37,17,9,0
2021,Nuneaton and Bedworth 003C,E01031102,1266,1193,73,30,28,13,2
2021,Nuneaton and Bedworth 003E,E01031104,1385,1339,46,23,9,12,2
2021,Nuneaton and Bedworth 012A,E01031105,1496,1459,37,15,14,7,1
2021,Nuneaton and Bedworth 012B,E01031106,1406,1361,45,19,18,5,3
2021,Nuneaton and Bedworth 012C,E01031107,1095,1038,57,23,26,6,2
2021,Nuneaton and Bedworth 012D,E01031108,1363,1295,68,32,20,14,2
2021,Nuneaton and Bedworth 012E,E01031109,1516,1450,66,28,28,9,1
2021,Nuneaton and Bedworth 001A,E01031110,1562,1482,80,53,19,8,0
2021,Nuneaton and Bedworth 001B,E01031111,990,975,15,9,4,1,1
2021,Nuneaton and Bedworth 001C,E01031112,1535,1508,27,12,12,3,0
2021,Nuneaton and Bedworth 001E,E01031114,1499,1457,42,15,17,9,1
2021,Nuneaton and Bedworth 009A,E01031115,1726,1310,416,130,170,94,22
2021,Nuneaton and Bedworth 009B,E01031116,1661,1530,131,54,59,16,2
2021,Nuneaton and Bedworth 009C,E01031117,1503,1356,147,61,63,18,5
2021,Nuneaton and Bedworth 009D,E01031118,1166,1062,104,43,49,9,3
2021,Nuneaton and Bedworth 009E,E01031119,1620,1229,391,126,151,93,21
2021,Nuneaton and Bedworth 011A,E01031120,1305,1275,30,13,13,3,1
2021,Nuneaton and Bedworth 011B,E01031121,1112,1086,26,10,8,6,2
2021,Nuneaton and Bedworth 011C,E01031122,1368,1321,47,20,18,7,2
2021,Nuneaton and Bedworth 011D,E01031123,1182,1160,22,14,4,4,0
2021,Nuneaton and Bedworth 011E,E01031124,1488,1451,37,17,15,3,2
2021,Rugby 007A,E01031125,1445,1289,156,78,59,18,1
2021,Rugby 007C,E01031127,1639,1465,174,71,72,28,3
2021,Rugby 014D,E01031129,1187,1156,31,13,14,2,2
2021,Rugby 005A,E01031130,1858,1331,527,197,254,67,9
2021,Rugby 005B,E01031131,1776,1122,654,214,310,116,14
2021,Rugby 005C,E01031132,1887,1420,467,157,214,92,4
2021,Rugby 005D,E01031133,1383,1172,211,85,87,35,4
2021,Rugby 011A,E01031134,1609,1549,60,31,22,7,0
2021,Rugby 011B,E01031135,1522,1448,74,37,29,7,1
2021,Rugby 011C,E01031136,1793,1632,161,87,55,18,1
2021,Rugby 002A,E01031137,1136,946,190,86,84,17,3
2021,Rugby 002B,E01031138,1126,1032,94,56,34,4,0
2021,Rugby 002C,E01031139,1675,1513,162,72,60,24,6
2021,Rugby 002D,E01031140,1313,1129,184,83,79,18,4
2021,Rugby 002F,E01031142,1666,1342,324,119,153,47,5
2021,Rugby 009A,E01031143,1426,1317,109,57,35,16,1
2021,Rugby 009B,E01031144,1467,1253,214,84,87,39,4
2021,Rugby 009C,E01031145,1521,1334,187,93,70,19,5
2021,Rugby 009D,E01031146,1561,1436,125,57,48,18,2
2021,Rugby 012B,E01031148,1907,1823,84,52,23,9,0
2021,Rugby 012C,E01031149,1498,1474,24,14,8,2,0
2021,Rugby 012D,E01031150,1149,1129,20,9,11,0,0
2021,Rugby 004A,E01031151,1492,1421,71,35,21,14,1
2021,Rugby 004B,E01031152,1019,986,33,21,10,1,1
2021,Rugby 004C,E01031153,1594,1551,43,23,17,3,0
2021,Rugby 004D,E01031154,1676,1653,23,11,5,6,1
2021,Rugby 008A,E01031155,1370,1310,60,33,21,4,2
2021,Rugby 008B,E01031156,1486,1370,116,61,48,5,2
2021,Rugby 008C,E01031157,2312,1981,331,175,105,47,4
2021,Rugby 008D,E01031158,1071,1005,66,41,13,9,3
2021,Rugby 013C,E01031159,1539,1505,34,16,14,3,1
2021,Rugby 013B,E01031160,2059,2039,20,10,4,6,0
2021,Rugby 010A,E01031161,2055,1908,147,70,55,21,1
2021,Rugby 010B,E01031162,2103,1938,165,87,58,18,2
2021,Rugby 010C,E01031163,1634,1536,98,39,42,14,3
2021,Rugby 007E,E01031165,1552,1452,100,36,50,10,4
2021,Rugby 012E,E01031166,1961,1938,23,14,8,1,0
2021,Rugby 006A,E01031167,1335,1198,137,57,49,24,7
2021,Rugby 006B,E01031168,2781,2145,636,262,281,81,12
2021,Rugby 006C,E01031169,2039,1494,545,188,249,103,5
2021,Rugby 006D,E01031170,1674,1251,423,134,185,94,10
2021,Rugby 003A,E01031171,1425,1218,207,86,93,28,0
2021,Rugby 003B,E01031172,1613,1396,217,81,101,29,6
2021,Rugby 003C,E01031173,1854,1371,483,174,200,91,18
2021,Rugby 003D,E01031174,2144,1489,655,224,278,134,19
2021,Rugby 011D,E01031175,1450,1368,82,44,27,9,2
2021,Rugby 011E,E01031176,1521,1300,221,93,104,21,3
2021,Rugby 011F,E01031177,1476,1229,247,101,111,32,3
2021,Rugby 011G,E01031178,1403,1284,119,60,46,12,1
2021,Rugby 010D,E01031179,2056,1900,156,102,43,10,1
2021,Rugby 010E,E01031180,2041,1869,172,92,63,16,1
2021,Rugby 004E,E01031181,1770,1724,46,35,8,3,0
2021,Rugby 013A,E01031182,2292,2067,225,131,83,9,2
2021,Stratford-on-Avon 006A,E01031183,1554,1511,43,20,16,6,1
2021,Stratford-on-Avon 006B,E01031184,1395,1369,26,15,7,4,0
2021,Stratford-on-Avon 006C,E01031185,1277,1249,28,20,7,1,0
2021,Stratford-on-Avon 006D,E01031186,1508,1488,20,13,4,3,0
2021,Stratford-on-Avon 007A,E01031187,1830,1817,13,8,4,1,0
2021,Stratford-on-Avon 007B,E01031188,2529,2445,84,60,19,5,0
2021,Stratford-on-Avon 012A,E01031189,1697,1662,35,12,15,6,2
2021,Stratford-on-Avon 012B,E01031190,2371,2303,68,48,10,6,4
2021,Stratford-on-Avon 012C,E01031191,2007,1977,30,14,10,5,1
2021,Stratford-on-Avon 012D,E01031192,2345,2268,77,36,30,11,0
2021,Stratford-on-Avon 015A,E01031193,2086,2069,17,14,3,0,0
2021,Stratford-on-Avon 013A,E01031194,2271,2203,68,31,29,8,0
2021,Stratford-on-Avon 002A,E01031195,2232,2205,27,16,9,1,1
2021,Stratford-on-Avon 014A,E01031196,2432,2403,29,20,4,4,1
2021,Stratford-on-Avon 005A,E01031197,1223,1197,26,19,3,3,1
2021,Stratford-on-Avon 005B,E01031198,1304,1295,9,6,2,0,1
2021,Stratford-on-Avon 005C,E01031199,2082,2049,33,21,6,6,0
2021,Stratford-on-Avon 005D,E01031200,1698,1668,30,18,11,1,0
2021,Stratford-on-Avon 005E,E01031201,1590,1573,17,8,9,0,0
2021,Stratford-on-Avon 002B,E01031202,1583,1564,19,14,5,0,0
2021,Stratford-on-Avon 002C,E01031203,1574,1539,35,19,9,3,4
2021,Stratford-on-Avon 002D,E01031204,1416,1406,10,8,1,0,1
2021,Stratford-on-Avon 013B,E01031205,1791,1738,53,29,19,4,1
2021,Stratford-on-Avon 013C,E01031206,1535,1484,51,25,18,7,1
2021,Stratford-on-Avon 013D,E01031207,1382,1308,74,48,24,2,0
2021,Stratford-on-Avon 007C,E01031208,2352,2316,36,21,12,2,1
2021,Stratford-on-Avon 015B,E01031209,2166,2131,35,21,12,2,0
2021,Stratford-on-Avon 005F,E01031210,1169,1159,10,5,3,2,0
2021,Stratford-on-Avon 005G,E01031211,1737,1701,36,26,5,3,2
2021,Stratford-on-Avon 001A,E01031213,1921,1906,15,12,3,0,0
2021,Stratford-on-Avon 015C,E01031214,2360,2312,48,27,17,3,1
2021,Stratford-on-Avon 015D,E01031215,1776,1739,37,20,13,4,0
2021,Stratford-on-Avon 015E,E01031216,1573,1554,19,13,3,3,0
2021,Stratford-on-Avon 008A,E01031217,1246,1232,14,6,6,1,1
2021,Stratford-on-Avon 008B,E01031218,1195,1172,23,16,4,3,0
2021,Stratford-on-Avon 004A,E01031219,2182,2126,56,40,11,4,1
2021,Stratford-on-Avon 004B,E01031220,1409,1366,43,24,18,1,0
2021,Stratford-on-Avon 004C,E01031221,1852,1795,57,39,17,1,0
2021,Stratford-on-Avon 004D,E01031222,2410,2351,59,40,13,6,0
2021,Stratford-on-Avon 004E,E01031223,1465,1450,15,8,6,1,0
2021,Stratford-on-Avon 004F,E01031224,1380,1372,8,6,2,0,0
2021,Stratford-on-Avon 010A,E01031225,1734,1645,89,60,22,6,1
2021,Stratford-on-Avon 010C,E01031227,2101,2052,49,22,21,4,2
2021,Stratford-on-Avon 009A,E01031228,1532,1447,85,37,26,15,7
2021,Stratford-on-Avon 009B,E01031229,2051,1781,270,117,83,67,3
2021,Stratford-on-Avon 009D,E01031231,2300,1928,372,161,148,59,4
2021,Stratford-on-Avon 011A,E01031232,2040,1965,75,40,24,9,2
2021,Stratford-on-Avon 011B,E01031233,1639,1571,68,33,26,7,2
2021,Stratford-on-Avon 011C,E01031234,1722,1600,122,54,51,15,2
2021,Stratford-on-Avon 011D,E01031235,1800,1696,104,50,36,14,4
2021,Stratford-on-Avon 009E,E01031236,1508,1319,189,84,69,34,2
2021,Stratford-on-Avon 011E,E01031237,1494,1410,84,37,35,9,3
2021,Stratford-on-Avon 009F,E01031238,1243,1056,187,71,70,37,9
2021,Stratford-on-Avon 003A,E01031239,1611,1565,46,22,17,5,2
2021,Stratford-on-Avon 003B,E01031240,1327,1315,12,6,4,0,2
2021,Stratford-on-Avon 003C,E01031241,1453,1439,14,9,4,1,0
2021,Stratford-on-Avon 003D,E01031242,1494,1470,24,11,9,4,0
2021,Stratford-on-Avon 001B,E01031243,2012,1980,32,15,11,6,0
2021,Stratford-on-Avon 001C,E01031244,1832,1800,32,18,7,6,1
2021,Stratford-on-Avon 014C,E01031245,1229,1217,12,9,3,0,0
2021,Stratford-on-Avon 014D,E01031246,1334,1305,29,16,9,4,0
2021,Stratford-on-Avon 013E,E01031247,2372,2340,32,17,11,3,1
2021,Stratford-on-Avon 012E,E01031248,2409,2389,20,13,4,3,0
2021,Stratford-on-Avon 008C,E01031249,1072,1037,35,19,13,3,0
2021,Stratford-on-Avon 008E,E01031251,1085,1071,14,7,3,4,0
2021,Stratford-on-Avon 008F,E01031252,1272,1249,23,14,6,2,1
2021,Stratford-on-Avon 008G,E01031253,1386,1366,20,15,5,0,0
2021,Warwick 001A,E01031254,1668,1629,39,24,10,3,2
2021,Warwick 001B,E01031255,1403,1377,26,18,7,1,0
2021,Warwick 001C,E01031256,1624,1557,67,34,20,11,2
2021,Warwick 001D,E01031257,1443,1365,78,57,16,5,0
2021,Warwick 001E,E01031258,1657,1534,123,83,32,8,0
2021,Warwick 014A,E01031259,2718,2452,266,158,58,43,7
2021,Warwick 014B,E01031260,2174,2052,122,86,29,6,1
2021,Warwick 013A,E01031261,1896,1603,293,128,109,49,7
2021,Warwick 013B,E01031262,1340,1131,209,83,81,39,6
2021,Warwick 013C,E01031263,1713,1381,332,158,105,50,19
2021,Warwick 013D,E01031264,1643,1413,230,89,91,42,8
2021,Warwick 013E,E01031265,1690,1399,291,147,107,36,1
2021,Warwick 013F,E01031266,1786,1392,394,259,99,29,7
2021,Warwick 014C,E01031267,1701,1667,34,22,9,2,1
2021,Warwick 014D,E01031268,2553,2497,56,43,11,2,0
2021,Warwick 014E,E01031269,2015,1958,57,43,8,6,0
2021,Warwick 010A,E01031271,1761,1595,166,107,38,18,3
2021,Warwick 007B,E01031272,1674,1461,213,152,44,14,3
2021,Warwick 006A,E01031273,1225,1086,139,61,57,20,1
2021,Warwick 006B,E01031274,1485,1353,132,67,39,25,1
2021,Warwick 006C,E01031275,1188,1139,49,32,5,12,0
2021,Warwick 006D,E01031276,1426,1330,96,56,26,12,2
2021,Warwick 005A,E01031277,1496,1431,65,43,17,5,0
2021,Warwick 005B,E01031278,1686,1620,66,43,14,4,5
2021,Warwick 005C,E01031279,1348,1323,25,17,7,1,0
2021,Warwick 005D,E01031280,1236,1215,21,13,5,2,1
2021,Warwick 004A,E01031281,1562,1543,19,11,6,1,1
2021,Warwick 004B,E01031282,1609,1588,21,12,3,6,0
2021,Warwick 004C,E01031283,1261,1244,17,6,2,8,1
2021,Warwick 004D,E01031284,1224,1194,30,24,3,3,0
2021,Warwick 007C,E01031285,2234,2036,198,151,33,13,1
2021,Warwick 007D,E01031286,1363,1277,86,51,23,8,4
2021,Warwick 007E,E01031287,1470,1410,60,33,20,3,4
2021,Warwick 007F,E01031288,1709,1635,74,43,21,5,5
2021,Warwick 007G,E01031289,1545,1494,51,31,16,4,0
2021,Warwick 009A,E01031290,1639,1462,177,129,32,14,2
2021,Warwick 009B,E01031291,1871,1633,238,158,53,25,2
2021,Warwick 009C,E01031292,1453,1331,122,86,30,5,1
2021,Warwick 009D,E01031293,1526,1406,120,82,31,3,4
2021,Warwick 009E,E01031294,1451,1341,110,64,27,14,5
2021,Warwick 009F,E01031295,1173,1104,69,45,14,7,3
2021,Warwick 002A,E01031296,1476,1395,81,54,19,7,1
2021,Warwick 002B,E01031297,1970,1875,95,67,21,7,0
2021,Warwick 002C,E01031298,1590,1530,60,41,16,3,0
2021,Warwick 002D,E01031299,1363,1337,26,15,9,2,0
2021,Warwick 002E,E01031300,1834,1762,72,55,11,4,2
2021,Warwick 005E,E01031301,1802,1730,72,45,17,10,0
2021,Warwick 005F,E01031302,995,937,58,36,17,4,1
2021,Warwick 003A,E01031303,1443,1371,72,53,17,2,0
2021,Warwick 003B,E01031304,1471,1426,45,30,12,3,0
2021,Warwick 003C,E01031305,1454,1431,23,19,3,1,0
2021,Warwick 003D,E01031306,1403,1354,49,36,11,2,0
2021,Warwick 003E,E01031307,1367,1344,23,8,11,3,1
2021,Warwick 005G,E01031308,4040,3431,609,384,197,28,0
2021,Warwick 008A,E01031309,1962,1787,175,108,57,10,0
2021,Warwick 008B,E01031310,1297,1211,86,55,25,6,0
2021,Warwick 008C,E01031311,1321,1229,92,46,24,8,14
2021,Warwick 008D,E01031312,1245,1186,59,32,18,9,0
2021,Warwick 008E,E01031313,1296,1254,42,31,10,1,0
2021,Warwick 008F,E01031314,1253,1174,79,48,19,10,2
2021,Warwick 012A,E01031315,2366,2125,241,157,59,24,1
2021,Warwick 012B,E01031316,1418,1313,105,64,28,11,2
2021,Warwick 012C,E01031317,1525,1403,122,91,21,10,0
2021,Warwick 012E,E01031319,1928,1812,116,77,31,6,2
2021,Warwick 012F,E01031320,1330,1189,141,102,25,12,2
2021,Warwick 011A,E01031321,1245,1165,80,45,28,7,0
2021,Warwick 011B,E01031322,1898,1759,139,96,26,14,3
2021,Warwick 011C,E01031323,1627,1512,115,75,24,16,0
2021,Warwick 011D,E01031324,2052,1861,191,106,68,13,4
2021,Warwick 011E,E01031325,1397,1327,70,34,27,8,1
2021,Warwick 015A,E01031327,1429,1284,145,52,76,17,0
2021,Warwick 015B,E01031328,2832,2508,324,197,82,40,5
2021,Warwick 015C,E01031329,2438,2155,283,160,82,38,3
2021,Warwick 015D,E01031330,1454,1332,122,61,40,16,5
2021,Warwick 015E,E01031331,1777,1616,161,78,56,21,6
2021,Warwick 010B,E01031332,1293,904,389,151,154,74,10
2021,Warwick 010C,E01031333,1311,823,488,164,218,93,13
2021,Warwick 010D,E01031334,1411,1196,215,99,76,39,1
2021,Warwick 010E,E01031335,1401,1213,188,118,51,17,2
2021,Warwick 010F,E01031336,1971,1719,252,170,64,17,1
2021,Warwick 010G,E01031337,1758,1560,198,132,47,18,1
2021,Adur 002A,E01031338,1257,1222,35,7,16,9,3
2021,Adur 002B,E01031339,1161,1133,28,16,10,2,0
2021,Adur 002C,E01031340,1499,1483,16,13,2,1,0
2021,Adur 008A,E01031341,1431,1346,85,48,26,10,1
2021,Adur 008B,E01031342,1563,1503,60,29,16,10,5
2021,Adur 008C,E01031343,1345,1317,28,18,9,1,0
2021,Adur 006A,E01031344,1402,1358,44,12,20,12,0
2021,Adur 003A,E01031345,1556,1526,30,19,6,4,1
2021,Adur 006B,E01031346,1420,1393,27,14,6,5,2
2021,Adur 004A,E01031347,1633,1534,99,44,32,20,3
2021,Adur 004B,E01031348,1684,1539,145,63,53,27,2
2021,Adur 001A,E01031349,1360,1302,58,32,20,6,0
2021,Adur 001B,E01031350,1279,1203,76,37,21,15,3
2021,Adur 001C,E01031351,1576,1531,45,22,13,9,1
2021,Adur 001D,E01031352,1504,1476,28,16,6,5,1
2021,Adur 003B,E01031353,1357,1304,53,43,8,1,1
2021,Adur 003C,E01031354,1284,1274,10,10,0,0,0
2021,Adur 003D,E01031355,1771,1738,33,13,15,5,0
2021,Adur 005A,E01031356,2354,2291,63,43,14,5,1
2021,Adur 005B,E01031357,2184,2137,47,35,11,0,1
2021,Adur 007A,E01031358,1456,1429,27,15,9,3,0
2021,Adur 003E,E01031359,1358,1315,43,17,18,5,3
2021,Adur 007B,E01031360,1498,1459,39,23,12,4,0
2021,Adur 006C,E01031361,1467,1413,54,32,15,6,1
2021,Adur 006D,E01031362,1313,1275,38,20,9,8,1
2021,Adur 006E,E01031363,1497,1476,21,12,7,1,1
2021,Adur 005C,E01031364,1807,1738,69,27,22,18,2
2021,Adur 002D,E01031365,1890,1844,46,29,10,6,1
2021,Adur 004C,E01031366,1381,1329,52,15,24,13,0
2021,Adur 002E,E01031367,1359,1339,20,15,4,1,0
2021,Adur 005D,E01031368,1448,1396,52,27,16,9,0
2021,Adur 005E,E01031369,1230,1202,28,15,11,1,1
2021,Adur 001E,E01031370,1478,1423,55,26,22,6,1
2021,Adur 004D,E01031371,1229,1188,41,14,19,7,1
2021,Adur 004E,E01031372,1423,1382,41,24,13,3,1
2021,Adur 004F,E01031373,1407,1369,38,23,8,6,1
2021,Adur 001F,E01031374,1633,1575,58,35,18,4,1
2021,Adur 004G,E01031375,1435,1393,42,18,16,5,3
2021,Adur 007C,E01031376,1244,1217,27,18,6,3,0
2021,Adur 008D,E01031377,1633,1533,100,49,30,20,1
2021,Adur 007D,E01031378,1347,1311,36,8,13,13,2
2021,Adur 008E,E01031379,1577,1535,42,17,21,4,0
2021,Arun 018A,E01031380,1543,1493,50,35,11,4,0
2021,Arun 018B,E01031381,1630,1504,126,56,50,18,2
2021,Arun 018C,E01031382,1683,1643,40,15,17,4,4
2021,Arun 018D,E01031383,1550,1528,22,9,6,3,4
2021,Arun 018E,E01031384,1667,1627,40,14,17,5,4
2021,Arun 019A,E01031385,1522,1480,42,12,22,6,2
2021,Arun 002A,E01031386,1477,1466,11,7,3,1,0
2021,Arun 002B,E01031387,1535,1521,14,8,3,2,1
2021,Arun 005B,E01031389,2124,2100,24,13,8,2,1
2021,Arun 001A,E01031390,1323,1307,16,12,2,2,0
2021,Arun 001B,E01031391,1451,1425,26,17,5,3,1
2021,Arun 001C,E01031392,1518,1480,38,18,12,8,0
2021,Arun 003A,E01031393,2418,2379,39,17,14,7,1
2021,Arun 003B,E01031394,1592,1524,68,35,22,9,2
2021,Arun 003C,E01031395,1618,1588,30,23,7,0,0
2021,Arun 003D,E01031396,2348,2265,83,40,22,13,8
2021,Arun 003E,E01031397,1810,1776,34,16,11,7,0
2021,Arun 009A,E01031398,1437,1410,27,17,9,0,1
2021,Arun 009B,E01031399,1635,1604,31,15,8,7,1
2021,Arun 011A,E01031400,1542,1430,112,48,46,15,3
2021,Arun 012B,E01031402,1639,1519,120,53,48,16,3
2021,Arun 012C,E01031403,1444,1282,162,59,61,36,6
2021,Arun 014A,E01031404,1127,989,138,38,61,32,7
2021,Arun 012D,E01031405,1353,1266,87,30,47,7,3
2021,Arun 012E,E01031406,1310,1175,135,57,45,31,2
2021,Arun 007A,E01031407,1472,1444,28,22,6,0,0
2021,Arun 007B,E01031408,2024,1955,69,35,21,12,1
2021,Arun 009C,E01031409,1401,1351,50,30,14,3,3
2021,Arun 007C,E01031410,1251,1200,51,24,22,4,1
2021,Arun 010A,E01031411,1339,1327,12,9,2,1,0
2021,Arun 008A,E01031412,1382,1368,14,10,2,2,0
2021,Arun 010B,E01031413,1382,1346,36,15,10,11,0
2021,Arun 005C,E01031414,1464,1434,30,17,8,5,0
2021,Arun 005D,E01031415,1562,1548,14,11,3,0,0
2021,Arun 015A,E01031416,1504,1492,12,5,3,3,1
2021,Arun 013A,E01031417,1647,1612,35,15,16,3,1
2021,Arun 015B,E01031418,2023,1994,29,13,9,7,0
2021,Arun 015C,E01031419,1540,1481,59,21,21,14,3
2021,Arun 015D,E01031420,1731,1705,26,11,11,3,1
2021,Arun 008B,E01031422,1544,1526,18,13,4,1,0
2021,Arun 008C,E01031423,1835,1810,25,11,8,6,0
2021,Arun 008D,E01031424,1405,1375,30,13,6,9,2
2021,Arun 002C,E01031425,1319,1296,23,12,7,2,2
2021,Arun 002D,E01031426,1168,1153,15,8,2,2,3
2021,Arun 004A,E01031427,1624,1461,163,64,56,29,14
2021,Arun 011B,E01031428,1485,1306,179,60,82,34,3
2021,Arun 004B,E01031429,1492,1352,140,39,62,39,0
2021,Arun 004C,E01031430,1379,1247,132,47,54,17,14
2021,Arun 017A,E01031431,1080,965,115,33,48,33,1
2021,Arun 017B,E01031432,1894,1308,586,161,244,165,16
2021,Arun 014B,E01031433,1377,1314,63,24,25,10,4
2021,Arun 014C,E01031434,1601,1389,212,70,79,57,6
2021,Arun 017C,E01031435,1831,1609,222,59,95,53,15
2021,Arun 017D,E01031436,1921,1353,568,174,219,145,30
2021,Arun 017E,E01031437,2049,1597,452,132,201,99,20
2021,Arun 013B,E01031438,1484,1449,35,18,8,8,1
2021,Arun 013C,E01031439,1854,1826,28,16,12,0,0
2021,Arun 013D,E01031440,1498,1468,30,14,12,4,0
2021,Arun 014D,E01031441,1654,1406,248,97,107,38,6
2021,Arun 014E,E01031442,1694,1372,322,82,154,63,23
2021,Arun 016A,E01031443,1361,1240,121,39,55,23,4
2021,Arun 016B,E01031444,1621,1269,352,101,124,106,21
2021,Arun 019B,E01031445,1888,1739,149,18,61,64,6
2021,Arun 019C,E01031446,1295,1268,27,11,10,5,1
2021,Arun 019D,E01031447,1623,1611,12,6,3,2,1
2021,Arun 019E,E01031448,1518,1492,26,16,4,6,0
2021,Arun 019F,E01031449,1668,1614,54,26,19,9,0
2021,Arun 016C,E01031450,1412,1178,234,59,105,63,7
2021,Arun 016D,E01031451,1667,1464,203,72,91,37,3
2021,Arun 016E,E01031452,1445,1304,141,47,52,36,6
2021,Arun 017F,E01031453,1670,1320,350,92,148,98,12
2021,Arun 011C,E01031454,2415,2080,335,115,160,50,10
2021,Arun 009D,E01031455,1607,1512,95,40,43,11,1
2021,Arun 011D,E01031456,1696,1471,225,81,90,45,9
2021,Arun 010C,E01031457,1669,1639,30,19,9,2,0
2021,Arun 010D,E01031458,1781,1765,16,12,2,1,1
2021,Arun 005E,E01031459,1820,1726,94,59,22,13,0
2021,Arun 010E,E01031460,1701,1668,33,13,7,12,1
2021,Arun 009E,E01031461,1734,1708,26,10,9,6,1
2021,Arun 007D,E01031462,1473,1446,27,9,12,4,2
2021,Arun 007E,E01031463,1613,1568,45,22,18,2,3
2021,Arun 007F,E01031464,1653,1624,29,11,14,3,1
2021,Arun 001D,E01031465,1338,1312,26,13,10,3,0
2021,Arun 003F,E01031466,1526,1493,33,14,6,9,4
2021,Arun 009F,E01031469,1601,1518,83,37,25,21,0
2021,Arun 006A,E01031470,1784,1739,45,16,21,5,3
2021,Arun 006B,E01031471,2167,2103,64,39,16,8,1
2021,Arun 006C,E01031472,1553,1527,26,14,11,1,0
2021,Arun 006D,E01031473,1197,1150,47,21,19,6,1
2021,Chichester 011A,E01031474,1353,1309,44,24,13,5,2
2021,Chichester 009A,E01031475,1850,1821,29,14,9,6,0
2021,Chichester 009B,E01031476,1545,1518,27,18,8,1,0
2021,Chichester 006A,E01031477,2187,2148,39,23,9,7,0
2021,Chichester 005A,E01031478,1277,1240,37,18,8,9,2
2021,Chichester 005B,E01031479,1006,990,16,10,2,2,2
2021,Chichester 010A,E01031480,1272,1150,122,65,42,12,3
2021,Chichester 010B,E01031481,1507,1394,113,61,35,16,1
2021,Chichester 008A,E01031482,1473,1367,106,40,44,16,6
2021,Chichester 008B,E01031483,2313,2119,194,85,81,22,6
2021,Chichester 010C,E01031484,1784,1624,160,85,42,33,0
2021,Chichester 006B,E01031485,1487,1458,29,24,5,0,0
2021,Chichester 008C,E01031486,1807,1715,92,56,27,8,1
2021,Chichester 006C,E01031487,1495,1464,31,23,5,3,0
2021,Chichester 012A,E01031489,1482,1431,51,26,14,9,2
2021,Chichester 010D,E01031490,2337,2201,136,74,42,17,3
2021,Chichester 010E,E01031491,1798,1679,119,69,37,10,3
2021,Chichester 012B,E01031492,1797,1693,104,40,35,22,7
2021,Chichester 011B,E01031493,1770,1705,65,37,21,5,2
2021,Chichester 008E,E01031494,1589,1520,69,31,25,13,0
2021,Chichester 008F,E01031495,1455,1403,52,27,22,2,1
2021,Chichester 011C,E01031496,2583,2508,75,37,23,15,0
2021,Chichester 004A,E01031497,1562,1533,29,9,13,6,1
2021,Chichester 005C,E01031498,1039,1023,16,7,6,3,0
2021,Chichester 013A,E01031499,1684,1660,24,11,9,4,0
2021,Chichester 013B,E01031500,2297,2266,31,19,6,5,1
2021,Chichester 013C,E01031501,1408,1393,15,6,5,4,0
2021,Chichester 001A,E01031502,1557,1542,15,14,1,0,0
2021,Chichester 001B,E01031503,1556,1512,44,20,18,3,3
2021,Chichester 001C,E01031504,2065,2025,40,27,11,2,0
2021,Chichester 011D,E01031505,2597,2521,76,52,17,7,0
2021,Chichester 007A,E01031506,1236,1220,16,9,3,3,1
2021,Chichester 007B,E01031507,1315,1296,19,9,9,0,1
2021,Chichester 003A,E01031508,2019,1991,28,17,8,3,0
2021,Chichester 004C,E01031511,1460,1425,35,19,12,3,1
2021,Chichester 004D,E01031512,1908,1861,47,20,17,7,3
2021,Chichester 005D,E01031514,1575,1545,30,19,7,4,0
2021,Chichester 005E,E01031515,1632,1594,38,15,14,9,0
2021,Chichester 005F,E01031516,1476,1461,15,11,3,1,0
2021,Chichester 002A,E01031517,1934,1915,19,13,5,1,0
2021,Chichester 002B,E01031518,1612,1597,15,14,0,0,1
2021,Chichester 001D,E01031519,1373,1340,33,19,11,3,0
2021,Chichester 003B,E01031520,1310,1293,17,10,7,0,0
2021,Chichester 003C,E01031521,1118,1080,38,14,16,8,0
2021,Chichester 014A,E01031522,1969,1894,75,24,36,12,3
2021,Chichester 014B,E01031523,1640,1572,68,21,30,13,4
2021,Chichester 014C,E01031524,1709,1661,48,22,11,15,0
2021,Chichester 014D,E01031525,1312,1268,44,18,16,8,2
2021,Chichester 014E,E01031526,1236,1216,20,2,7,2,9
2021,Chichester 014F,E01031527,1422,1370,52,18,29,2,3
2021,Chichester 014G,E01031528,1443,1359,84,28,44,11,1
2021,Chichester 013D,E01031529,1280,1255,25,10,9,6,0
2021,Chichester 012D,E01031530,1253,1210,43,18,14,10,1
2021,Chichester 007C,E01031531,1257,1252,5,5,0,0,0
2021,Chichester 009C,E01031532,2154,2043,111,72,37,1,1
2021,Chichester 007D,E01031533,1351,1334,17,12,5,0,0
2021,Chichester 009D,E01031534,1772,1750,22,10,9,3,0
2021,Chichester 009E,E01031535,2007,1968,39,22,10,7,0
2021,Chichester 003D,E01031536,1214,1185,29,14,11,2,2
2021,Chichester 012E,E01031538,1546,1477,69,37,21,10,1
2021,Chichester 012F,E01031539,1630,1534,96,55,24,11,6
2021,Chichester 013E,E01031540,1346,1327,19,14,5,0,0
2021,Chichester 013F,E01031541,1372,1352,20,13,3,2,2
2021,Chichester 013G,E01031542,1976,1958,18,15,3,0,0
2021,Chichester 007E,E01031543,2314,2305,9,2,5,2,0
2021,Chichester 002C,E01031544,1230,1219,11,8,3,0,0
2021,Chichester 002D,E01031545,1249,1242,7,4,0,3,0
2021,Crawley 012A,E01031546,1434,1144,290,137,104,43,6
2021,Crawley 010A,E01031547,1260,1107,153,65,70,15,3
2021,Crawley 010B,E01031548,1617,1304,313,121,133,46,13
2021,Crawley 010C,E01031549,1699,1407,292,118,100,58,16
2021,Crawley 010D,E01031550,1334,1155,179,63,72,40,4
2021,Crawley 012B,E01031551,1555,1219,336,142,135,56,3
2021,Crawley 013A,E01031552,1766,1435,331,126,135,56,14
2021,Crawley 012C,E01031553,1459,1230,229,86,84,57,2
2021,Crawley 012D,E01031554,1760,1388,372,164,146,57,5
2021,Crawley 012E,E01031555,1529,1190,339,151,120,54,14
2021,Crawley 013B,E01031556,1549,1406,143,72,54,15,2
2021,Crawley 013C,E01031557,1743,1485,258,119,110,23,6
2021,Crawley 013D,E01031558,1555,1311,244,95,88,51,10
2021,Crawley 013E,E01031559,1575,1310,265,117,100,44,4
2021,Crawley 009A,E01031560,1524,1390,134,62,37,29,6
2021,Crawley 009B,E01031561,1498,1361,137,65,50,19,3
2021,Crawley 009C,E01031562,1309,1131,178,79,69,25,5
2021,Crawley 009D,E01031563,1491,1326,165,93,50,20,2
2021,Crawley 006A,E01031564,1466,1363,103,39,42,19,3
2021,Crawley 006B,E01031565,2217,1903,314,119,129,51,15
2021,Crawley 006C,E01031566,1627,1453,174,76,65,26,7
2021,Crawley 006D,E01031567,1326,1230,96,45,33,15,3
2021,Crawley 006E,E01031568,1435,1307,128,55,52,20,1
2021,Crawley 010E,E01031569,1598,1478,120,63,39,14,4
2021,Crawley 003A,E01031570,1358,1211,147,61,54,24,8
2021,Crawley 003B,E01031571,1737,1529,208,94,85,23,6
2021,Crawley 003C,E01031572,2119,1829,290,161,92,35,2
2021,Crawley 001A,E01031573,1767,1362,405,161,182,53,9
2021,Crawley 001B,E01031574,1946,1653,293,103,145,39,6
2021,Crawley 001C,E01031575,1735,1302,433,165,158,101,9
2021,Crawley 001D,E01031576,1787,1324,463,167,204,79,13
2021,Crawley 001E,E01031577,1390,939,451,173,184,83,11
2021,Crawley 008A,E01031578,1703,1583,120,64,40,13,3
2021,Crawley 009E,E01031579,1549,1372,177,80,62,30,5
2021,Crawley 008B,E01031580,2272,2101,171,101,40,23,7
2021,Crawley 008C,E01031581,1691,1594,97,64,23,8,2
2021,Crawley 009F,E01031582,1777,1613,164,81,59,19,5
2021,Crawley 004A,E01031583,2218,1607,611,285,246,69,11
2021,Crawley 004B,E01031584,1821,1388,433,168,190,59,16
2021,Crawley 004C,E01031585,2512,1664,848,402,330,96,20
2021,Crawley 002A,E01031586,1671,1539,132,76,46,9,1
2021,Crawley 002C,E01031588,1470,1371,99,52,32,12,3
2021,Crawley 005A,E01031589,1736,1483,253,122,83,39,9
2021,Crawley 002D,E01031590,1527,1429,98,65,20,13,0
2021,Crawley 005B,E01031591,1845,1546,299,155,117,26,1
2021,Crawley 008D,E01031592,1925,1842,83,52,22,9,0
2021,Crawley 002E,E01031593,1417,1306,111,47,43,18,3
2021,Crawley 005C,E01031594,1443,1291,152,74,49,25,4
2021,Crawley 011A,E01031595,1743,1423,320,144,117,49,10
2021,Crawley 007A,E01031596,1923,1571,352,147,167,37,1
2021,Crawley 007B,E01031597,1628,1382,246,107,99,34,6
2021,Crawley 007C,E01031598,1816,1527,289,131,116,32,10
2021,Crawley 007D,E01031599,2094,1636,458,225,168,56,9
2021,Crawley 005D,E01031600,1548,1308,240,120,83,31,6
2021,Crawley 004D,E01031601,1433,1176,257,101,110,42,4
2021,Crawley 005E,E01031603,1535,1242,293,138,102,46,7
2021,Crawley 011B,E01031604,1551,1401,150,64,60,22,4
2021,Crawley 011C,E01031605,1565,1380,185,90,67,22,6
2021,Crawley 011D,E01031606,1647,1448,199,85,80,31,3
2021,Crawley 011E,E01031607,1529,1327,202,106,62,32,2
2021,Crawley 007E,E01031608,2419,1800,619,299,236,77,7
2021,Crawley 003D,E01031609,1605,1415,190,97,69,20,4
2021,Crawley 003E,E01031610,1931,1498,433,207,165,55,6
2021,Horsham 010A,E01031611,2745,2688,57,42,13,1,1
2021,Horsham 010B,E01031612,2041,2017,24,17,5,2,0
2021,Horsham 010D,E01031614,2478,2411,67,43,15,9,0
2021,Horsham 010E,E01031615,1737,1693,44,25,11,6,2
2021,Horsham 016A,E01031616,1576,1548,28,13,9,3,3
2021,Horsham 016B,E01031617,2326,2305,21,14,3,4,0
2021,Horsham 014A,E01031618,1309,1292,17,12,3,2,0
2021,Horsham 003A,E01031620,2020,1963,57,40,14,3,0
2021,Horsham 012A,E01031621,1694,1676,18,13,4,1,0
2021,Horsham 015A,E01031622,1585,1571,14,10,3,1,0
2021,Horsham 012B,E01031623,1687,1668,19,12,6,1,0
2021,Horsham 015B,E01031624,1672,1658,14,10,3,0,1
2021,Horsham 015C,E01031625,1885,1847,38,28,10,0,0
2021,Horsham 013A,E01031626,1454,1445,9,7,2,0,0
2021,Horsham 012C,E01031627,1844,1835,9,9,0,0,0
2021,Horsham 015D,E01031628,1811,1772,39,26,9,4,0
2021,Horsham 015E,E01031629,1520,1511,9,7,1,1,0
2021,Horsham 013B,E01031630,1678,1647,31,18,9,4,0
2021,Horsham 013C,E01031631,1618,1596,22,13,7,2,0
2021,Horsham 011A,E01031632,1567,1538,29,25,3,1,0
2021,Horsham 011B,E01031633,1204,1194,10,7,2,1,0
2021,Horsham 011C,E01031634,1283,1266,17,12,1,4,0
2021,Horsham 011D,E01031635,1288,1268,20,13,4,3,0
2021,Horsham 007C,E01031638,1705,1660,45,33,12,0,0
2021,Horsham 008A,E01031639,1971,1852,119,66,35,15,3
2021,Horsham 008B,E01031640,1776,1731,45,33,8,3,1
2021,Horsham 014B,E01031641,1517,1490,27,18,6,2,1
2021,Horsham 014C,E01031642,2453,2410,43,29,12,1,1
2021,Horsham 014D,E01031643,1835,1786,49,25,21,3,0
2021,Horsham 002A,E01031644,1823,1707,116,59,36,20,1
2021,Horsham 002B,E01031645,1339,1298,41,24,14,3,0
2021,Horsham 002C,E01031646,1411,1365,46,28,13,5,0
2021,Horsham 002D,E01031647,1161,1103,58,31,22,5,0
2021,Horsham 003B,E01031648,1517,1427,90,57,25,6,2
2021,Horsham 002E,E01031649,1036,1018,18,13,3,2,0
2021,Horsham 002F,E01031650,1272,1250,22,15,7,0,0
2021,Horsham 003C,E01031651,1540,1462,78,44,27,6,1
2021,Horsham 006B,E01031652,1639,1520,119,62,37,17,3
2021,Horsham 006C,E01031653,1880,1745,135,78,44,13,0
2021,Horsham 004A,E01031654,1586,1520,66,51,10,4,1
2021,Horsham 004B,E01031655,1552,1450,102,60,32,10,0
2021,Horsham 006D,E01031656,1871,1693,178,108,58,9,3
2021,Horsham 005A,E01031657,1890,1845,45,25,16,4,0
2021,Horsham 003D,E01031658,2011,1961,50,24,24,1,1
2021,Horsham 005B,E01031659,1729,1705,24,14,6,3,1
2021,Horsham 008C,E01031660,1333,1308,25,16,3,5,1
2021,Horsham 008D,E01031661,1665,1623,42,24,16,2,0
2021,Horsham 013D,E01031662,1513,1499,14,7,5,2,0
2021,Horsham 013E,E01031663,2153,2112,41,25,10,6,0
2021,Horsham 012D,E01031664,1583,1566,17,15,2,0,0
2021,Horsham 013F,E01031665,1198,1184,14,10,2,2,0
2021,Horsham 002G,E01031666,1550,1487,63,41,21,1,0
2021,Horsham 004C,E01031667,1447,1412,35,17,17,1,0
2021,Horsham 002H,E01031668,1449,1400,49,31,17,0,1
2021,Horsham 004D,E01031669,1578,1491,87,63,21,3,0
2021,Horsham 001A,E01031670,1484,1390,94,35,39,19,1
2021,Horsham 001B,E01031671,1502,1434,68,33,24,10,1
2021,Horsham 004E,E01031672,1847,1735,112,58,43,11,0
2021,Horsham 001C,E01031673,1505,1434,71,31,35,4,1
2021,Horsham 005C,E01031674,1371,1234,137,23,29,65,20
2021,Horsham 005D,E01031675,1517,1494,23,11,6,5,1
2021,Horsham 009A,E01031677,1556,1528,28,15,12,1,0
2021,Horsham 009B,E01031678,1867,1847,20,16,3,1,0
2021,Horsham 008E,E01031679,2005,1924,81,49,28,4,0
2021,Horsham 009C,E01031680,1492,1481,11,10,1,0,0
2021,Horsham 009D,E01031681,1691,1646,45,34,9,2,0
2021,Horsham 009E,E01031682,1087,1066,21,14,6,1,0
2021,Horsham 009F,E01031683,1410,1361,49,28,16,5,0
2021,Horsham 016C,E01031684,1395,1385,10,5,3,2,0
2021,Horsham 016D,E01031685,1628,1609,19,14,4,1,0
2021,Horsham 016E,E01031686,1368,1350,18,14,4,0,0
2021,Horsham 014E,E01031687,1599,1562,37,26,9,2,0
2021,Horsham 006E,E01031688,1342,1306,36,19,7,10,0
2021,Horsham 003E,E01031689,1436,1365,71,43,20,8,0
2021,Horsham 007D,E01031690,1506,1464,42,27,11,3,1
2021,Horsham 006F,E01031691,1732,1628,104,60,29,8,7
2021,Mid Sussex 007B,E01031693,1842,1807,35,30,4,1,0
2021,Mid Sussex 006A,E01031694,1830,1765,65,50,10,4,1
2021,Mid Sussex 003A,E01031695,1409,1369,40,25,15,0,0
2021,Mid Sussex 003B,E01031696,1295,1271,24,19,3,1,1
2021,Mid Sussex 007C,E01031697,1141,1111,30,15,10,5,0
2021,Mid Sussex 016A,E01031698,1740,1702,38,26,9,2,1
2021,Mid Sussex 012A,E01031699,1563,1499,64,51,12,1,0
2021,Mid Sussex 012B,E01031700,1562,1510,52,36,12,4,0
2021,Mid Sussex 012C,E01031701,1864,1796,68,42,17,9,0
2021,Mid Sussex 015A,E01031702,1585,1559,26,17,7,2,0
2021,Mid Sussex 015B,E01031703,1728,1675,53,23,25,4,1
2021,Mid Sussex 013A,E01031704,1678,1622,56,36,14,4,2
2021,Mid Sussex 014A,E01031705,1498,1424,74,37,29,5,3
2021,Mid Sussex 013B,E01031706,1642,1579,63,39,14,9,1
2021,Mid Sussex 014B,E01031707,1445,1376,69,28,23,16,2
2021,Mid Sussex 014C,E01031708,1704,1412,292,148,103,35,6
2021,Mid Sussex 014D,E01031709,1728,1610,118,58,42,15,3
2021,Mid Sussex 015C,E01031710,1377,1347,30,26,4,0,0
2021,Mid Sussex 013D,E01031712,1394,1337,57,30,19,4,4
2021,Mid Sussex 013E,E01031713,1660,1623,37,24,11,2,0
2021,Mid Sussex 012D,E01031714,1830,1770,60,34,17,7,2
2021,Mid Sussex 015D,E01031715,1600,1552,48,28,12,5,3
2021,Mid Sussex 014E,E01031716,1135,1098,37,19,14,4,0
2021,Mid Sussex 014F,E01031717,1330,1250,80,36,28,15,1
2021,Mid Sussex 002A,E01031718,1776,1725,51,26,18,7,0
2021,Mid Sussex 002B,E01031719,1688,1655,33,24,8,1,0
2021,Mid Sussex 002C,E01031720,1423,1379,44,29,11,4,0
2021,Mid Sussex 005A,E01031721,1868,1827,41,19,15,7,0
2021,Mid Sussex 002D,E01031722,1300,1221,79,53,20,6,0
2021,Mid Sussex 005B,E01031723,1591,1557,34,25,8,0,1
2021,Mid Sussex 005C,E01031724,1255,1242,13,7,3,3,0
2021,Mid Sussex 005D,E01031725,1442,1425,17,10,3,3,1
2021,Mid Sussex 011A,E01031726,1582,1547,35,19,10,4,2
2021,Mid Sussex 007D,E01031727,1688,1646,42,28,11,2,1
2021,Mid Sussex 003C,E01031729,2156,2083,73,46,23,3,1
2021,Mid Sussex 003D,E01031730,1724,1643,81,38,33,10,0
2021,Mid Sussex 001A,E01031731,1926,1842,84,41,32,10,1
2021,Mid Sussex 001B,E01031732,1754,1668,86,52,18,16,0
2021,Mid Sussex 001C,E01031733,1673,1590,83,48,20,15,0
2021,Mid Sussex 001D,E01031734,1535,1511,24,21,2,1,0
2021,Mid Sussex 003E,E01031735,1534,1503,31,25,5,1,0
2021,Mid Sussex 004A,E01031736,1615,1580,35,23,9,3,0
2021,Mid Sussex 004B,E01031737,1535,1494,41,18,14,6,3
2021,Mid Sussex 004C,E01031738,1502,1478,24,18,3,2,1
2021,Mid Sussex 004D,E01031739,1835,1751,84,57,19,8,0
2021,Mid Sussex 004E,E01031740,1268,1227,41,26,10,3,2
2021,Mid Sussex 001E,E01031741,2101,1891,210,114,66,29,1
2021,Mid Sussex 001G,E01031743,1639,1432,207,76,88,40,3
2021,Mid Sussex 017A,E01031744,1698,1662,36,31,5,0,0
2021,Mid Sussex 017B,E01031745,2016,1983,33,26,5,2,0
2021,Mid Sussex 017C,E01031746,1634,1597,37,23,9,5,0
2021,Mid Sussex 017D,E01031747,1542,1518,24,21,2,1,0
2021,Mid Sussex 017E,E01031748,1369,1353,16,13,3,0,0
2021,Mid Sussex 011C,E01031749,1472,1413,59,28,22,8,1
2021,Mid Sussex 011D,E01031750,1435,1367,68,44,18,6,0
2021,Mid Sussex 009A,E01031751,2525,2342,183,95,57,27,4
2021,Mid Sussex 010A,E01031752,1798,1668,130,77,28,22,3
2021,Mid Sussex 010B,E01031753,1380,1314,66,37,21,6,2
2021,Mid Sussex 010C,E01031754,1559,1446,113,60,34,15,4
2021,Mid Sussex 010D,E01031755,1378,1275,103,58,35,10,0
2021,Mid Sussex 010E,E01031757,1359,1291,68,41,19,7,1
2021,Mid Sussex 008A,E01031758,1370,1329,41,26,9,5,1
2021,Mid Sussex 009B,E01031759,1671,1564,107,64,38,4,1
2021,Mid Sussex 008B,E01031760,1721,1658,63,39,20,4,0
2021,Mid Sussex 011F,E01031763,2005,1935,70,47,17,4,2
2021,Mid Sussex 006B,E01031764,1343,1331,12,4,8,0,0
2021,Mid Sussex 006C,E01031765,1534,1496,38,27,7,3,1
2021,Mid Sussex 006D,E01031766,2002,1970,32,23,7,2,0
2021,Mid Sussex 016B,E01031767,2197,2158,39,24,8,6,1
2021,Mid Sussex 017F,E01031768,1516,1505,11,9,2,0,0
2021,Mid Sussex 016C,E01031769,1690,1661,29,21,8,0,0
2021,Mid Sussex 016D,E01031770,1704,1679,25,18,5,1,1
2021,Mid Sussex 016E,E01031771,1506,1471,35,21,9,5,0
2021,Mid Sussex 008C,E01031772,2009,1952,57,34,16,5,2
2021,Mid Sussex 008D,E01031773,1855,1819,36,31,3,2,0
2021,Mid Sussex 008E,E01031774,2387,2346,41,31,7,1,2
2021,Mid Sussex 008F,E01031775,1755,1722,33,23,8,0,2
2021,Worthing 005A,E01031776,1505,1456,49,30,17,2,0
2021,Worthing 005B,E01031777,1752,1662,90,45,34,7,4
2021,Worthing 004A,E01031778,1478,1432,46,21,21,1,3
2021,Worthing 009A,E01031779,1250,1171,79,32,34,12,1
2021,Worthing 005C,E01031780,1459,1388,71,38,21,10,2
2021,Worthing 005D,E01031781,1583,1529,54,21,25,6,2
2021,Worthing 007A,E01031782,1764,1707,57,37,18,2,0
2021,Worthing 006A,E01031783,1556,1493,63,22,24,14,3
2021,Worthing 006B,E01031785,1426,1369,57,31,19,4,3
2021,Worthing 006C,E01031786,1549,1474,75,43,19,10,3
2021,Worthing 011A,E01031787,1957,1673,284,139,99,41,5
2021,Worthing 011B,E01031788,2046,1820,226,118,77,23,8
2021,Worthing 010A,E01031790,1845,1701,144,49,64,29,2
2021,Worthing 008A,E01031791,2015,1797,218,107,77,27,7
2021,Worthing 003A,E01031792,1330,1291,39,20,14,3,2
2021,Worthing 001A,E01031793,1309,1284,25,15,5,5,0
2021,Worthing 003B,E01031794,1427,1397,30,16,6,8,0
2021,Worthing 003C,E01031795,1597,1541,56,34,17,3,2
2021,Worthing 008B,E01031796,1531,1396,135,68,46,19,2
2021,Worthing 004B,E01031797,1259,1232,27,20,4,3,0
2021,Worthing 005E,E01031798,1504,1392,112,47,44,16,5
2021,Worthing 008C,E01031799,1604,1501,103,42,46,13,2
2021,Worthing 004C,E01031800,1552,1500,52,30,19,2,1
2021,Worthing 008D,E01031801,1652,1519,133,74,40,18,1
2021,Worthing 013A,E01031802,1638,1602,36,22,9,5,0
2021,Worthing 013B,E01031803,1543,1513,30,19,5,4,2
2021,Worthing 013C,E01031804,1705,1656,49,33,10,4,2
2021,Worthing 013D,E01031805,1626,1583,43,16,20,4,3
2021,Worthing 013E,E01031806,1735,1642,93,59,25,9,0
2021,Worthing 010B,E01031807,1781,1670,111,51,33,25,2
2021,Worthing 011D,E01031808,1687,1495,192,87,81,20,4
2021,Worthing 010C,E01031809,1779,1599,180,97,62,19,2
2021,Worthing 010D,E01031810,1737,1542,195,101,68,25,1
2021,Worthing 010E,E01031811,1523,1413,110,62,35,12,1
2021,Worthing 012A,E01031812,1552,1478,74,37,31,6,0
2021,Worthing 012B,E01031813,1695,1604,91,56,24,10,1
2021,Worthing 012C,E01031814,1672,1618,54,38,11,3,2
2021,Worthing 012D,E01031815,1534,1474,60,32,18,9,1
2021,Worthing 012E,E01031816,1589,1534,55,34,15,6,0
2021,Worthing 006D,E01031817,1718,1664,54,32,16,5,1
2021,Worthing 003D,E01031818,1906,1842,64,31,24,5,4
2021,Worthing 001B,E01031820,1725,1704,21,12,5,4,0
2021,Worthing 001C,E01031821,1680,1668,12,3,7,0,2
2021,Worthing 002A,E01031822,1531,1494,37,21,10,6,0
2021,Worthing 004D,E01031823,1609,1575,34,14,16,4,0
2021,Worthing 004E,E01031824,1288,1274,14,11,1,2,0
2021,Worthing 002B,E01031825,1594,1563,31,18,6,7,0
2021,Worthing 002C,E01031826,1422,1370,52,29,18,3,2
2021,Worthing 002D,E01031827,1450,1402,48,27,15,6,0
2021,Worthing 001D,E01031828,1281,1270,11,10,1,0,0
2021,Worthing 001E,E01031829,1569,1542,27,18,5,3,1
2021,Worthing 003E,E01031830,1573,1516,57,28,21,8,0
2021,Worthing 009B,E01031831,1610,1484,126,61,42,19,4
2021,Worthing 009C,E01031832,1556,1492,64,35,24,4,1
2021,Worthing 009D,E01031833,1583,1471,112,62,38,12,0
2021,Worthing 009E,E01031834,1577,1483,94,62,22,8,2
2021,Worthing 011E,E01031835,1862,1611,251,131,85,33,2
2021,Worthing 007C,E01031836,1553,1474,79,39,28,11,1
2021,Worthing 008E,E01031837,1813,1740,73,25,37,8,3
2021,Worthing 007D,E01031838,1482,1435,47,24,16,7,0
2021,Worthing 002E,E01031839,1685,1624,61,28,20,12,1
2021,Worthing 007E,E01031840,1663,1609,54,33,13,6,2
2021,Wiltshire 012A,E01031841,1825,1804,21,12,4,5,0
2021,Wiltshire 038A,E01031842,1860,1847,13,11,1,1,0
2021,Wiltshire 029A,E01031843,1748,1731,17,8,3,6,0
2021,Wiltshire 028A,E01031845,1642,1599,43,16,18,8,1
2021,Wiltshire 028B,E01031846,1519,1504,15,7,7,1,0
2021,Wiltshire 029B,E01031847,1892,1864,28,21,6,1,0
2021,Wiltshire 028C,E01031848,2113,2088,25,11,13,1,0
2021,Wiltshire 029C,E01031849,1593,1564,29,16,13,0,0
2021,Wiltshire 025A,E01031850,1887,1847,40,17,15,6,2
2021,Wiltshire 025B,E01031851,1476,1423,53,31,16,3,3
2021,Wiltshire 025C,E01031852,2002,1932,70,39,23,5,3
2021,Wiltshire 026A,E01031853,1448,1384,64,22,23,18,1
2021,Wiltshire 026B,E01031854,1721,1644,77,25,41,10,1
2021,Wiltshire 026C,E01031855,1474,1460,14,9,5,0,0
2021,Wiltshire 026D,E01031856,1587,1542,45,19,20,6,0
2021,Wiltshire 034B,E01031857,1484,1467,17,8,8,1,0
2021,Wiltshire 034C,E01031858,1832,1800,32,17,11,3,1
2021,Wiltshire 065B,E01031859,1531,1491,40,15,18,7,0
2021,Wiltshire 065A,E01031860,1462,1416,46,21,20,4,1
2021,Wiltshire 019A,E01031861,2722,2672,50,29,14,6,1
2021,Wiltshire 019B,E01031862,1449,1393,56,32,14,7,3
2021,Wiltshire 019C,E01031863,1083,1046,37,24,9,3,1
2021,Wiltshire 019D,E01031864,1194,1171,23,14,6,2,1
2021,Wiltshire 019E,E01031865,2531,2462,69,46,14,7,2
2021,Wiltshire 024A,E01031866,1558,1523,35,18,12,4,1
2021,Wiltshire 038B,E01031867,1754,1738,16,10,4,0,2
2021,Wiltshire 012B,E01031868,1710,1686,24,14,9,1,0
2021,Wiltshire 024B,E01031869,1901,1876,25,14,8,3,0
2021,Wiltshire 024C,E01031870,1811,1763,48,29,14,5,0
2021,Wiltshire 024D,E01031871,1669,1643,26,13,6,7,0
2021,Wiltshire 028D,E01031872,1512,1497,15,7,3,5,0
2021,Wiltshire 012C,E01031873,1801,1758,43,25,13,4,1
2021,Wiltshire 012D,E01031874,1502,1485,17,8,6,1,2
2021,Wiltshire 028E,E01031876,1476,1467,9,9,0,0,0
2021,Wiltshire 029D,E01031877,1934,1916,18,9,8,1,0
2021,Wiltshire 066A,E01031879,1738,1413,325,175,122,22,6
2021,Wiltshire 038C,E01031882,1936,1919,17,12,5,0,0
2021,Wiltshire 034D,E01031883,1901,1893,8,6,1,1,0
2021,Wiltshire 012E,E01031884,1539,1517,22,12,7,3,0
2021,Wiltshire 002A,E01031885,1683,1664,19,11,8,0,0
2021,Wiltshire 004A,E01031886,1408,1396,12,11,1,0,0
2021,Wiltshire 001A,E01031887,1753,1742,11,8,0,3,0
2021,Wiltshire 017A,E01031888,1389,1374,15,13,2,0,0
2021,Wiltshire 017B,E01031889,2336,2246,90,52,30,7,1
2021,Wiltshire 017C,E01031890,1715,1686,29,20,8,1,0
2021,Wiltshire 004B,E01031892,1424,1410,14,10,4,0,0
2021,Wiltshire 004C,E01031893,1611,1600,11,8,0,3,0
2021,Wiltshire 004D,E01031894,1547,1524,23,13,7,1,2
2021,Wiltshire 015A,E01031895,2473,2413,60,30,24,6,0
2021,Wiltshire 015B,E01031896,1403,1326,77,30,22,20,5
2021,Wiltshire 015C,E01031897,1926,1884,42,19,13,9,1
2021,Wiltshire 015D,E01031898,1749,1695,54,35,14,5,0
2021,Wiltshire 016B,E01031901,1344,1316,28,16,7,2,3
2021,Wiltshire 016C,E01031902,1739,1702,37,29,8,0,0
2021,Wiltshire 016D,E01031903,2207,2186,21,12,5,3,1
2021,Wiltshire 013B,E01031904,2518,2471,47,17,20,6,4
2021,Wiltshire 010A,E01031905,1321,1289,32,17,3,11,1
2021,Wiltshire 010B,E01031906,1327,1267,60,38,17,5,0
2021,Wiltshire 009A,E01031907,2338,2257,81,46,22,11,2
2021,Wiltshire 010C,E01031908,1676,1619,57,28,24,3,2
2021,Wiltshire 010D,E01031909,1239,1214,25,18,4,3,0
2021,Wiltshire 009B,E01031910,1487,1411,76,33,30,13,0
2021,Wiltshire 011A,E01031911,1325,1265,60,24,23,13,0
2021,Wiltshire 011B,E01031912,1510,1375,135,61,44,26,4
2021,Wiltshire 011C,E01031913,1492,1446,46,28,15,2,1
2021,Wiltshire 009C,E01031914,1286,1233,53,19,28,3,3
2021,Wiltshire 009D,E01031915,1502,1461,41,22,13,6,0
2021,Wiltshire 014A,E01031916,1282,1256,26,12,9,5,0
2021,Wiltshire 011D,E01031917,1369,1296,73,41,24,6,2
2021,Wiltshire 011E,E01031918,2445,2354,91,52,28,5,6
2021,Wiltshire 009E,E01031919,1629,1591,38,25,9,3,1
2021,Wiltshire 009F,E01031920,1179,1127,52,30,20,2,0
2021,Wiltshire 014B,E01031921,1281,1227,54,37,12,5,0
2021,Wiltshire 014C,E01031922,1186,1142,44,27,10,7,0
2021,Wiltshire 014D,E01031923,1208,1177,31,16,10,5,0
2021,Wiltshire 014E,E01031924,1532,1493,39,26,7,6,0
2021,Wiltshire 010E,E01031925,1312,1223,89,44,37,7,1
2021,Wiltshire 010F,E01031926,1470,1440,30,16,8,6,0
2021,Wiltshire 010G,E01031927,1211,1195,16,14,2,0,0
2021,Wiltshire 011F,E01031928,1194,1155,39,17,14,6,2
2021,Wiltshire 017D,E01031929,1259,1251,8,6,2,0,0
2021,Wiltshire 017E,E01031930,1336,1275,61,38,22,1,0
2021,Wiltshire 018A,E01031931,1857,1825,32,18,8,3,3
2021,Wiltshire 018B,E01031932,1524,1493,31,19,6,6,0
2021,Wiltshire 018C,E01031933,1733,1685,48,24,20,4,0
2021,Wiltshire 001B,E01031934,1858,1827,31,12,12,5,2
2021,Wiltshire 001C,E01031935,1677,1638,39,26,11,2,0
2021,Wiltshire 001D,E01031936,1380,1361,19,10,9,0,0
2021,Wiltshire 013C,E01031937,1094,1085,9,6,3,0,0
2021,Wiltshire 013D,E01031938,1504,1487,17,13,3,1,0
2021,Wiltshire 008A,E01031939,2339,2309,30,17,10,2,1
2021,Wiltshire 008B,E01031940,2153,2126,27,16,8,1,2
2021,Wiltshire 018D,E01031941,1715,1692,23,6,14,3,0
2021,Wiltshire 018E,E01031942,1305,1282,23,17,6,0,0
2021,Wiltshire 007B,E01031944,1033,1011,22,11,8,3,0
2021,Wiltshire 007D,E01031946,3411,3057,354,142,207,5,0
2021,Wiltshire 002B,E01031947,1606,1573,33,20,11,2,0
2021,Wiltshire 002C,E01031948,2565,2457,108,68,33,6,1
2021,Wiltshire 002D,E01031949,1804,1746,58,30,15,11,2
2021,Wiltshire 008C,E01031950,1327,1311,16,9,5,2,0
2021,Wiltshire 008D,E01031951,1288,1176,112,35,71,5,1
2021,Wiltshire 018F,E01031952,2274,2196,78,35,28,13,2
2021,Wiltshire 003B,E01031955,1569,1555,14,7,7,0,0
2021,Wiltshire 003C,E01031956,1333,1299,34,20,9,3,2
2021,Wiltshire 005A,E01031957,1451,1440,11,6,4,1,0
2021,Wiltshire 005B,E01031958,1361,1345,16,11,5,0,0
2021,Wiltshire 005C,E01031959,1856,1826,30,22,6,1,1
2021,Wiltshire 005D,E01031960,1445,1304,141,82,54,5,0
2021,Wiltshire 007E,E01031961,1356,1343,13,4,7,2,0
2021,Wiltshire 003D,E01031962,1370,1340,30,16,10,4,0
2021,Wiltshire 006A,E01031963,2092,1997,95,59,24,11,1
2021,Wiltshire 006B,E01031964,1895,1841,54,28,18,8,0
2021,Wiltshire 007F,E01031965,1357,1321,36,17,14,5,0
2021,Wiltshire 007G,E01031966,2721,2651,70,47,15,8,0
2021,Wiltshire 006C,E01031967,2143,2073,70,35,23,11,1
2021,Wiltshire 007H,E01031968,1682,1641,41,26,14,1,0
2021,Wiltshire 006D,E01031969,1330,1290,40,24,10,5,1
2021,Wiltshire 060A,E01031970,1611,1589,22,14,8,0,0
2021,Wiltshire 060B,E01031971,1164,1141,23,12,9,1,1
2021,Wiltshire 060C,E01031972,1531,1519,12,7,5,0,0
2021,Wiltshire 062A,E01031973,1836,1817,19,14,5,0,0
2021,Wiltshire 048A,E01031974,1293,1266,27,10,10,6,1
2021,Wiltshire 048B,E01031975,1210,1183,27,16,4,7,0
2021,Wiltshire 048C,E01031976,2284,2183,101,59,34,6,2
2021,Wiltshire 048E,E01031978,1570,1511,59,24,19,15,1
2021,Wiltshire 048F,E01031979,2033,1956,77,31,30,14,2
2021,Wiltshire 052A,E01031980,2527,2375,152,95,44,13,0
2021,Wiltshire 052B,E01031981,1509,1465,44,17,14,10,3
2021,Wiltshire 052C,E01031982,1379,1316,63,32,17,9,5
2021,Wiltshire 052D,E01031983,1854,1728,126,56,46,23,1
2021,Wiltshire 051A,E01031984,2722,2605,117,71,28,14,4
2021,Wiltshire 051B,E01031985,1270,1239,31,19,8,4,0
2021,Wiltshire 051C,E01031986,1196,1142,54,22,23,7,2
2021,Wiltshire 045B,E01031988,2559,2210,349,180,153,15,1
2021,Wiltshire 046A,E01031989,1989,1913,76,44,24,7,1
2021,Wiltshire 054A,E01031990,1919,1891,28,18,10,0,0
2021,Wiltshire 061A,E01031991,1965,1950,15,6,6,0,3
2021,Wiltshire 062B,E01031992,1435,1422,13,12,0,1,0
2021,Wiltshire 062C,E01031993,1398,1375,23,14,4,3,2
2021,Wiltshire 062D,E01031994,1281,1266,15,11,4,0,0
2021,Wiltshire 062E,E01031995,1817,1791,26,14,6,4,2
2021,Wiltshire 046B,E01031996,1404,1383,21,13,2,3,3
2021,Wiltshire 046C,E01031997,1310,1289,21,12,4,5,0
2021,Wiltshire 046D,E01031999,2289,2256,33,21,9,3,0
2021,Wiltshire 057A,E01032000,2124,2029,95,70,22,3,0
2021,Wiltshire 055A,E01032001,1438,1400,38,17,15,5,1
2021,Wiltshire 055B,E01032002,1280,1196,84,36,31,14,3
2021,Wiltshire 055C,E01032003,1723,1507,216,84,89,37,6
2021,Wiltshire 054B,E01032004,2244,2211,33,20,10,3,0
2021,Wiltshire 059A,E01032005,1254,1187,67,35,21,9,2
2021,Wiltshire 059B,E01032006,1174,1129,45,28,11,6,0
2021,Wiltshire 059C,E01032007,1638,1508,130,74,42,11,3
2021,Wiltshire 058A,E01032008,1466,1409,57,25,22,9,1
2021,Wiltshire 058B,E01032009,1769,1684,85,44,27,12,2
2021,Wiltshire 050A,E01032010,2099,2080,19,8,8,2,1
2021,Wiltshire 057C,E01032012,1763,1742,21,13,7,1,0
2021,Wiltshire 049A,E01032013,1975,1955,20,11,6,2,1
2021,Wiltshire 056A,E01032014,1853,1625,228,100,90,33,5
2021,Wiltshire 056B,E01032015,1269,1202,67,25,34,7,1
2021,Wiltshire 056C,E01032016,1295,1256,39,27,11,1,0
2021,Wiltshire 051D,E01032017,1476,1455,21,10,9,2,0
2021,Wiltshire 053A,E01032018,1555,1539,16,12,2,0,2
2021,Wiltshire 053B,E01032019,1388,1349,39,21,16,1,1
2021,Wiltshire 053C,E01032020,1443,1381,62,37,18,6,1
2021,Wiltshire 056D,E01032021,1598,1431,167,84,63,18,2
2021,Wiltshire 058C,E01032022,1707,1517,190,72,84,29,5
2021,Wiltshire 059D,E01032023,1769,1578,191,74,75,34,8
2021,Wiltshire 055D,E01032024,2267,1973,294,149,100,42,3
2021,Wiltshire 053D,E01032025,1374,1335,39,22,13,3,1
2021,Wiltshire 045D,E01032026,1583,1565,18,11,6,1,0
2021,Wiltshire 054C,E01032027,1293,1283,10,7,3,0,0
2021,Wiltshire 061B,E01032029,1327,1301,26,13,9,4,0
2021,Wiltshire 061C,E01032030,1634,1613,21,10,6,5,0
2021,Wiltshire 061D,E01032031,1119,1100,19,9,8,2,0
2021,Wiltshire 049B,E01032032,1509,1500,9,4,2,3,0
2021,Wiltshire 049C,E01032033,1354,1347,7,2,5,0,0
2021,Wiltshire 049D,E01032034,1419,1404,15,9,6,0,0
2021,Wiltshire 050B,E01032035,1641,1629,12,9,3,0,0
2021,Wiltshire 050C,E01032036,1412,1399,13,5,8,0,0
2021,Wiltshire 050D,E01032037,1473,1465,8,2,5,1,0
2021,Wiltshire 054D,E01032038,1292,1282,10,10,0,0,0
2021,Wiltshire 054E,E01032039,2023,1941,82,38,32,9,3
2021,Wiltshire 054F,E01032040,1373,1352,21,13,8,0,0
2021,Wiltshire 060D,E01032041,1915,1898,17,13,4,0,0
2021,Wiltshire 060E,E01032042,1678,1664,14,11,3,0,0
2021,Wiltshire 021A,E01032043,1266,1232,34,18,15,1,0
2021,Wiltshire 021B,E01032044,1516,1497,19,9,7,3,0
2021,Wiltshire 027A,E01032045,1693,1670,23,15,5,2,1
2021,Wiltshire 027B,E01032046,1521,1497,24,11,11,2,0
2021,Wiltshire 027C,E01032047,1463,1437,26,10,15,1,0
2021,Wiltshire 027D,E01032048,1651,1625,26,15,9,2,0
2021,Wiltshire 027E,E01032049,1536,1499,37,22,9,5,1
2021,Wiltshire 047A,E01032051,1368,1358,10,5,2,3,0
2021,Wiltshire 039A,E01032052,1252,1242,10,4,3,1,2
2021,Wiltshire 037A,E01032053,1430,1402,28,12,11,4,1
2021,Wiltshire 039B,E01032054,1221,1203,18,11,4,0,3
2021,Wiltshire 039C,E01032055,1139,1125,14,10,2,0,2
2021,Wiltshire 039D,E01032056,1305,1291,14,8,6,0,0
2021,Wiltshire 021C,E01032057,1193,1181,12,8,3,1,0
2021,Wiltshire 023A,E01032058,1323,1301,22,14,4,4,0
2021,Wiltshire 023B,E01032059,1816,1780,36,17,15,4,0
2021,Wiltshire 023C,E01032060,1568,1548,20,5,12,3,0
2021,Wiltshire 023D,E01032061,1111,1100,11,9,2,0,0
2021,Wiltshire 022A,E01032062,1850,1772,78,27,37,12,2
2021,Wiltshire 020A,E01032063,2137,2063,74,36,27,8,3
2021,Wiltshire 020B,E01032064,1291,1257,34,16,16,2,0
2021,Wiltshire 020C,E01032065,1507,1476,31,14,11,6,0
2021,Wiltshire 022B,E01032066,1600,1553,47,18,25,4,0
2021,Wiltshire 022C,E01032067,1387,1339,48,18,17,12,1
2021,Wiltshire 022D,E01032068,1348,1297,51,20,27,4,0
2021,Wiltshire 022E,E01032069,1202,1190,12,8,3,1,0
2021,Wiltshire 021D,E01032070,1778,1746,32,22,7,2,1
2021,Wiltshire 021F,E01032072,1860,1832,28,12,11,5,0
2021,Wiltshire 020D,E01032073,1352,1307,45,13,22,8,2
2021,Wiltshire 020E,E01032074,1267,1260,7,4,0,1,2
2021,Wiltshire 047B,E01032075,1276,1270,6,5,1,0,0
2021,Wiltshire 047C,E01032076,1191,1183,8,3,1,4,0
2021,Wiltshire 030A,E01032077,1725,1715,10,4,5,1,0
2021,Wiltshire 030B,E01032078,2770,2617,153,55,67,31,0
2021,Wiltshire 030C,E01032079,1492,1462,30,12,10,8,0
2021,Wiltshire 030D,E01032080,1858,1808,50,24,14,11,1
2021,Wiltshire 047D,E01032081,1297,1288,9,6,1,1,1
2021,Wiltshire 047E,E01032082,1175,1134,41,9,29,3,0
2021,Wiltshire 037B,E01032083,2397,2341,56,24,23,7,2
2021,Wiltshire 031A,E01032085,1548,1445,103,32,52,19,0
2021,Wiltshire 031C,E01032087,2108,1915,193,53,92,45,3
2021,Wiltshire 036A,E01032088,1436,1402,34,12,15,7,0
2021,Wiltshire 036B,E01032089,1401,1212,189,38,80,65,6
2021,Wiltshire 036C,E01032090,1420,1334,86,36,30,18,2
2021,Wiltshire 036D,E01032091,1141,1077,64,25,19,14,6
2021,Wiltshire 035A,E01032092,1405,1359,46,16,23,7,0
2021,Wiltshire 035B,E01032093,2381,2185,196,80,77,31,8
2021,Wiltshire 035C,E01032094,2327,1996,331,93,161,71,6
2021,Wiltshire 035D,E01032095,1737,1664,73,29,34,10,0
2021,Wiltshire 033A,E01032096,1886,1733,153,61,53,34,5
2021,Wiltshire 033B,E01032097,1824,1799,25,12,10,2,1
2021,Wiltshire 033C,E01032098,1576,1500,76,24,36,16,0
2021,Wiltshire 032B,E01032100,1760,1628,132,42,70,17,3
2021,Wiltshire 032C,E01032101,1614,1432,182,57,70,45,10
2021,Wiltshire 032D,E01032102,2375,2240,135,58,40,33,4
2021,Wiltshire 044A,E01032103,1651,1522,129,39,65,23,2
2021,Wiltshire 042A,E01032104,1491,1448,43,15,21,5,2
2021,Wiltshire 042B,E01032105,1423,1398,25,14,10,1,0
2021,Wiltshire 044B,E01032106,1478,1462,16,11,3,1,1
2021,Wiltshire 042C,E01032107,1210,1056,154,73,66,13,2
2021,Wiltshire 042D,E01032108,1263,1210,53,24,22,5,2
2021,Wiltshire 044C,E01032109,1392,1371,21,15,3,3,0
2021,Wiltshire 043A,E01032110,2304,2262,42,29,8,4,1
2021,Wiltshire 043B,E01032111,1271,1229,42,18,19,4,1
2021,Wiltshire 043C,E01032112,1398,1353,45,14,23,6,2
2021,Wiltshire 043D,E01032113,1309,1276,33,15,11,7,0
2021,Wiltshire 044D,E01032114,1457,1369,88,42,30,13,3
2021,Wiltshire 064A,E01032115,1646,1584,62,31,23,7,1
2021,Wiltshire 063D,E01032117,2620,2569,51,18,22,10,1
2021,Wiltshire 063C,E01032118,1573,1520,53,30,12,10,1
2021,Wiltshire 064B,E01032119,1831,1732,99,45,43,10,1
2021,Wiltshire 039E,E01032121,1898,1850,48,29,16,3,0
2021,Bromsgrove 009A,E01032122,2248,2222,26,16,7,3,0
2021,Bromsgrove 009B,E01032123,1538,1520,18,12,3,3,0
2021,Bromsgrove 009C,E01032124,1527,1515,12,9,3,0,0
2021,Bromsgrove 009D,E01032125,1436,1426,10,9,1,0,0
2021,Bromsgrove 003A,E01032126,2011,1990,21,15,2,4,0
2021,Bromsgrove 007A,E01032127,1693,1677,16,10,3,2,1
2021,Bromsgrove 007B,E01032128,1391,1370,21,10,5,5,1
2021,Bromsgrove 007C,E01032129,1354,1334,20,5,12,2,1
2021,Bromsgrove 013B,E01032131,1546,1499,47,20,12,15,0
2021,Bromsgrove 013C,E01032132,1955,1932,23,16,4,2,1
2021,Bromsgrove 004A,E01032133,1521,1510,11,8,1,2,0
2021,Bromsgrove 005A,E01032134,1599,1582,17,8,7,1,1
2021,Bromsgrove 004B,E01032135,1535,1498,37,24,8,4,1
2021,Bromsgrove 002A,E01032136,1293,1281,12,10,0,0,2
2021,Bromsgrove 002B,E01032137,1553,1547,6,5,0,1,0
2021,Bromsgrove 001A,E01032138,1595,1584,11,9,2,0,0
2021,Bromsgrove 001B,E01032139,2272,2235,37,27,3,5,2
2021,Bromsgrove 001C,E01032140,1756,1739,17,9,5,3,0
2021,Bromsgrove 001D,E01032141,1467,1441,26,9,6,10,1
2021,Bromsgrove 006A,E01032142,2318,2251,67,36,22,8,1
2021,Bromsgrove 006B,E01032143,1559,1531,28,18,6,2,2
2021,Bromsgrove 006C,E01032144,1986,1953,33,22,9,2,0
2021,Bromsgrove 004C,E01032145,1481,1465,16,11,3,0,2
2021,Bromsgrove 005B,E01032146,1603,1582,21,14,5,2,0
2021,Bromsgrove 004D,E01032147,1201,1181,20,11,5,2,2
2021,Bromsgrove 008A,E01032148,1171,1161,10,5,3,1,1
2021,Bromsgrove 006D,E01032149,1241,1216,25,12,6,7,0
2021,Bromsgrove 008B,E01032150,1421,1408,13,7,4,2,0
2021,Bromsgrove 008C,E01032151,1420,1400,20,17,3,0,0
2021,Bromsgrove 007D,E01032152,1325,1315,10,5,2,2,1
2021,Bromsgrove 008D,E01032153,2161,2113,48,37,8,3,0
2021,Bromsgrove 010A,E01032154,1689,1656,33,25,8,0,0
2021,Bromsgrove 008E,E01032155,1641,1624,17,17,0,0,0
2021,Bromsgrove 011A,E01032156,1986,1834,152,104,41,5,2
2021,Bromsgrove 011B,E01032157,1626,1600,26,13,10,3,0
2021,Bromsgrove 012A,E01032158,1471,1452,19,14,1,4,0
2021,Bromsgrove 010B,E01032159,1863,1806,57,34,16,6,1
2021,Bromsgrove 010C,E01032160,1656,1637,19,9,10,0,0
2021,Bromsgrove 010D,E01032161,1917,1903,14,6,5,3,0
2021,Bromsgrove 012B,E01032162,1856,1830,26,20,4,1,1
2021,Bromsgrove 002C,E01032168,1126,1112,14,9,5,0,0
2021,Bromsgrove 002D,E01032169,1131,1108,23,15,5,3,0
2021,Bromsgrove 003B,E01032170,1330,1325,5,3,2,0,0
2021,Bromsgrove 003C,E01032171,1414,1402,12,5,4,2,1
2021,Bromsgrove 003D,E01032172,1479,1462,17,5,10,2,0
2021,Bromsgrove 011C,E01032173,1616,1591,25,12,8,5,0
2021,Bromsgrove 013D,E01032174,1579,1555,24,14,7,3,0
2021,Bromsgrove 011D,E01032175,1548,1534,14,12,2,0,0
2021,Bromsgrove 002E,E01032176,2160,2150,10,6,4,0,0
2021,Bromsgrove 005C,E01032177,1776,1749,27,21,4,2,0
2021,Bromsgrove 005D,E01032178,1182,1168,14,10,3,0,1
2021,Malvern Hills 003A,E01032179,1568,1561,7,4,2,1,0
2021,Malvern Hills 003B,E01032180,2057,2025,32,22,5,0,5
2021,Malvern Hills 002A,E01032181,2166,2123,43,9,22,8,4
2021,Malvern Hills 003C,E01032182,2313,2280,33,21,8,4,0
2021,Malvern Hills 003D,E01032183,1519,1505,14,3,10,1,0
2021,Malvern Hills 009A,E01032184,1439,1431,8,7,1,0,0
2021,Malvern Hills 009B,E01032185,1456,1444,12,5,4,3,0
2021,Malvern Hills 009C,E01032186,1335,1273,62,36,21,4,1
2021,Malvern Hills 009D,E01032187,1633,1584,49,23,21,5,0
2021,Malvern Hills 006A,E01032188,1867,1832,35,22,10,2,1
2021,Malvern Hills 006B,E01032189,2720,2654,66,43,17,5,1
2021,Malvern Hills 002B,E01032190,2029,2002,27,12,5,10,0
2021,Malvern Hills 008A,E01032191,2803,2777,26,12,10,3,1
2021,Malvern Hills 008B,E01032192,2073,2051,22,12,9,1,0
2021,Malvern Hills 001A,E01032193,2259,2241,18,10,6,2,0
2021,Malvern Hills 004A,E01032194,1582,1533,49,15,19,11,4
2021,Malvern Hills 004B,E01032195,1482,1458,24,16,4,4,0
2021,Malvern Hills 004C,E01032196,1673,1601,72,34,32,4,2
2021,Malvern Hills 004D,E01032197,1443,1425,18,10,3,3,2
2021,Malvern Hills 011A,E01032198,2122,2104,18,15,1,2,0
2021,Malvern Hills 002C,E01032199,1955,1930,25,13,4,4,4
2021,Malvern Hills 011B,E01032200,2385,2365,20,10,4,4,2
2021,Malvern Hills 007A,E01032201,1632,1571,61,30,15,15,1
2021,Malvern Hills 007B,E01032202,1607,1565,42,11,19,10,2
2021,Malvern Hills 007C,E01032203,1414,1397,17,11,6,0,0
2021,Malvern Hills 007D,E01032204,1577,1508,69,16,34,18,1
2021,Malvern Hills 005A,E01032205,1033,1026,7,5,0,2,0
2021,Malvern Hills 005B,E01032206,1233,1208,25,13,7,3,2
2021,Malvern Hills 005C,E01032207,1818,1787,31,22,9,0,0
2021,Malvern Hills 010A,E01032208,1482,1439,43,22,10,11,0
2021,Malvern Hills 010B,E01032209,1592,1465,127,91,31,3,2
2021,Malvern Hills 010C,E01032210,1111,1090,21,17,3,1,0
2021,Malvern Hills 008C,E01032211,1849,1837,12,6,5,0,1
2021,Malvern Hills 001B,E01032212,2154,2132,22,10,9,3,0
2021,Malvern Hills 001C,E01032213,1710,1699,11,6,5,0,0
2021,Malvern Hills 001D,E01032214,2119,2048,71,35,24,10,2
2021,Malvern Hills 011C,E01032215,1044,1032,12,7,3,2,0
2021,Malvern Hills 011D,E01032216,1560,1534,26,11,14,1,0
2021,Malvern Hills 005D,E01032217,1668,1653,15,6,4,4,1
2021,Malvern Hills 010D,E01032218,1511,1455,56,21,25,8,2
2021,Malvern Hills 010E,E01032219,1592,1576,16,11,1,3,1
2021,Malvern Hills 006C,E01032220,1382,1366,16,5,10,1,0
2021,Malvern Hills 006D,E01032221,1205,1186,19,13,2,3,1
2021,Malvern Hills 006E,E01032222,1332,1290,42,20,14,7,1
2021,Malvern Hills 002D,E01032223,2222,2187,35,12,11,11,1
2021,Redditch 004A,E01032224,1852,1400,452,141,210,85,16
2021,Redditch 004B,E01032225,1094,918,176,65,81,25,5
2021,Redditch 001A,E01032226,2700,2487,213,85,96,27,5
2021,Redditch 001B,E01032227,1034,1023,11,5,3,3,0
2021,Redditch 013A,E01032228,1278,1271,7,5,0,2,0
2021,Redditch 013B,E01032229,1342,1301,41,24,9,3,5
2021,Redditch 013C,E01032230,1461,1447,14,6,3,5,0
2021,Redditch 013D,E01032231,1809,1777,32,14,10,6,2
2021,Redditch 003A,E01032232,1481,1367,114,50,43,18,3
2021,Redditch 003C,E01032234,1847,1663,184,73,74,29,8
2021,Redditch 003D,E01032235,1711,1554,157,64,67,23,3
2021,Redditch 006A,E01032236,1758,1435,323,83,166,67,7
2021,Redditch 006B,E01032237,1382,1289,93,36,46,9,2
2021,Redditch 006C,E01032238,1319,1121,198,63,89,41,5
2021,Redditch 004C,E01032239,1780,1211,569,166,247,140,16
2021,Redditch 002A,E01032240,1202,1073,129,54,63,9,3
2021,Redditch 002B,E01032241,1247,1111,136,47,69,18,2
2021,Redditch 002C,E01032242,1305,1222,83,29,41,13,0
2021,Redditch 001C,E01032243,1281,1268,13,8,5,0,0
2021,Redditch 001D,E01032244,1417,1351,66,32,26,8,0
2021,Redditch 002D,E01032245,1487,1270,217,69,106,33,9
2021,Redditch 012A,E01032246,1326,1308,18,9,6,3,0
2021,Redditch 012B,E01032247,1334,1295,39,18,16,5,0
2021,Redditch 012C,E01032248,1317,1303,14,9,4,1,0
2021,Redditch 012D,E01032249,1446,1406,40,13,19,7,1
2021,Redditch 010A,E01032250,1314,1159,155,55,73,25,2
2021,Redditch 010B,E01032251,1705,1543,162,54,79,26,3
2021,Redditch 010C,E01032252,1341,1150,191,60,90,39,2
2021,Redditch 009A,E01032253,1548,1466,82,41,31,9,1
2021,Redditch 010D,E01032254,2139,1971,168,63,86,19,0
2021,Redditch 007A,E01032255,1347,1262,85,58,17,10,0
2021,Redditch 011A,E01032256,1311,1271,40,18,21,1,0
2021,Redditch 011B,E01032257,1352,1317,35,23,8,4,0
2021,Redditch 011C,E01032258,1432,1387,45,22,18,5,0
2021,Redditch 008A,E01032259,1360,1337,23,8,6,5,4
2021,Redditch 011D,E01032260,1310,1215,95,42,37,15,1
2021,Redditch 012E,E01032261,1364,1349,15,4,8,2,1
2021,Redditch 004D,E01032262,1997,1622,375,110,192,63,10
2021,Redditch 007B,E01032263,1701,1578,123,55,48,15,5
2021,Redditch 006D,E01032264,1707,1527,180,61,84,28,7
2021,Redditch 009B,E01032265,1564,1394,170,65,71,30,4
2021,Redditch 007C,E01032266,1511,1443,68,29,30,9,0
2021,Redditch 009C,E01032267,1717,1527,190,64,98,25,3
2021,Redditch 009D,E01032268,1138,1095,43,17,17,8,1
2021,Redditch 008B,E01032269,1554,1518,36,17,14,5,0
2021,Redditch 008C,E01032270,1409,1390,19,12,7,0,0
2021,Redditch 008D,E01032271,2014,1973,41,21,12,6,2
2021,Redditch 008E,E01032272,1181,1161,20,6,9,5,0
2021,Redditch 005A,E01032273,1295,1271,24,8,12,4,0
2021,Redditch 007D,E01032274,1205,1163,42,22,14,6,0
2021,Redditch 005B,E01032275,1365,1268,97,34,43,18,2
2021,Redditch 009E,E01032276,1420,1364,56,35,16,4,1
2021,Redditch 005C,E01032277,1204,1048,156,50,79,23,4
2021,Redditch 005D,E01032278,1489,1304,185,67,101,17,0
2021,Worcester 004A,E01032279,1243,1169,74,40,20,12,2
2021,Worcester 007A,E01032280,1650,1561,89,40,30,17,2
2021,Worcester 007B,E01032281,1338,1198,140,66,46,25,3
2021,Worcester 007C,E01032282,1735,1357,378,140,161,64,13
2021,Worcester 013A,E01032283,1695,1576,119,44,45,27,3
2021,Worcester 013B,E01032284,1946,1885,61,22,29,8,2
2021,Worcester 011A,E01032285,1653,1560,93,38,42,11,2
2021,Worcester 012A,E01032286,2571,2449,122,62,44,15,1
2021,Worcester 012B,E01032287,1566,1503,63,30,25,8,0
2021,Worcester 012C,E01032288,1518,1448,70,40,16,12,2
2021,Worcester 012D,E01032289,1439,1423,16,9,6,1,0
2021,Worcester 012E,E01032290,1387,1354,33,14,10,6,3
2021,Worcester 011B,E01032292,1593,1211,382,118,166,79,19
2021,Worcester 011D,E01032294,1463,1265,198,58,95,40,5
2021,Worcester 001A,E01032296,1532,1474,58,31,19,8,0
2021,Worcester 001B,E01032297,1566,1544,22,14,8,0,0
2021,Worcester 001C,E01032298,1805,1777,28,15,5,4,4
2021,Worcester 001D,E01032299,1504,1451,53,28,17,7,1
2021,Worcester 001E,E01032300,1617,1594,23,12,9,2,0
2021,Worcester 005A,E01032301,1379,1249,130,67,46,15,2
2021,Worcester 005B,E01032302,1340,967,373,99,186,76,12
2021,Worcester 002A,E01032303,1253,1178,75,33,26,16,0
2021,Worcester 002B,E01032304,1459,1337,122,49,52,19,2
2021,Worcester 010A,E01032305,1653,1453,200,109,68,19,4
2021,Worcester 010B,E01032306,1483,1234,249,111,99,32,7
2021,Worcester 010C,E01032307,1878,1578,300,142,121,29,8
2021,Worcester 013D,E01032308,1936,1834,102,52,30,20,0
2021,Worcester 010D,E01032309,1663,1499,164,61,77,23,3
2021,Worcester 005C,E01032310,1503,1391,112,57,39,13,3
2021,Worcester 005D,E01032311,1482,1387,95,34,44,15,2
2021,Worcester 004B,E01032312,1386,1245,141,63,60,15,3
2021,Worcester 005E,E01032313,1276,1106,170,79,70,19,2
2021,Worcester 006A,E01032314,1155,1076,79,46,29,4,0
2021,Worcester 006B,E01032315,1909,1785,124,72,40,11,1
2021,Worcester 006C,E01032316,1126,1093,33,15,10,6,2
2021,Worcester 006D,E01032317,1462,1401,61,30,22,8,1
2021,Worcester 009A,E01032318,1666,1533,133,48,60,21,4
2021,Worcester 009B,E01032319,1817,1742,75,47,19,6,3
2021,Worcester 009C,E01032320,1631,1538,93,52,34,7,0
2021,Worcester 009D,E01032321,1851,1709,142,73,58,11,0
2021,Worcester 009E,E01032322,1751,1576,175,67,79,28,1
2021,Worcester 014A,E01032323,1477,1431,46,20,20,5,1
2021,Worcester 014B,E01032324,1265,1218,47,26,16,5,0
2021,Worcester 014C,E01032325,1437,1377,60,31,17,12,0
2021,Worcester 014D,E01032326,1316,1286,30,19,9,2,0
2021,Worcester 004C,E01032327,2056,1944,112,65,33,12,2
2021,Worcester 004D,E01032328,1431,1378,53,27,12,11,3
2021,Worcester 004E,E01032329,1943,1878,65,37,12,15,1
2021,Worcester 003A,E01032330,1140,1055,85,36,31,15,3
2021,Worcester 002C,E01032331,1326,1249,77,34,32,8,3
2021,Worcester 002D,E01032332,1232,1135,97,33,54,10,0
2021,Worcester 005F,E01032333,1906,1734,172,74,77,17,4
2021,Worcester 003B,E01032334,2222,2069,153,66,69,15,3
2021,Worcester 003C,E01032335,1492,1436,56,33,15,7,1
2021,Worcester 003D,E01032336,1442,1353,89,43,34,12,0
2021,Worcester 008A,E01032337,2458,2270,188,99,67,21,1
2021,Worcester 008B,E01032338,1899,1729,170,92,53,17,8
2021,Worcester 008C,E01032339,1693,1596,97,66,26,4,1
2021,Wychavon 013A,E01032340,1833,1764,69,30,29,8,2
2021,Wychavon 013B,E01032341,1371,1327,44,14,22,6,2
2021,Wychavon 016A,E01032342,2840,2363,477,158,226,76,17
2021,Wychavon 016B,E01032344,2223,2055,168,69,82,14,3
2021,Wychavon 007A,E01032345,1476,1462,14,10,2,2,0
2021,Wychavon 007B,E01032346,1421,1408,13,8,5,0,0
2021,Wychavon 019A,E01032347,1279,1260,19,9,6,4,0
2021,Wychavon 019B,E01032348,1324,1314,10,9,1,0,0
2021,Wychavon 013C,E01032349,1730,1606,124,34,41,44,5
2021,Wychavon 013D,E01032350,1168,1157,11,6,3,2,0
2021,Wychavon 018A,E01032351,1857,1817,40,14,20,4,2
2021,Wychavon 018B,E01032352,1455,1432,23,12,9,2,0
2021,Wychavon 018C,E01032353,1558,1529,29,15,9,4,1
2021,Wychavon 009A,E01032355,1517,1494,23,10,9,4,0
2021,Wychavon 009B,E01032356,1148,1143,5,3,1,0,1
2021,Wychavon 004A,E01032357,1094,1066,28,9,12,2,5
2021,Wychavon 004B,E01032358,1364,1323,41,20,18,3,0
2021,Wychavon 003A,E01032359,1780,1686,94,43,30,16,5
2021,Wychavon 003B,E01032360,1868,1835,33,17,13,3,0
2021,Wychavon 003C,E01032361,1634,1604,30,17,10,3,0
2021,Wychavon 005B,E01032363,1495,1475,20,12,4,4,0
2021,Wychavon 005C,E01032364,1635,1606,29,15,8,6,0
2021,Wychavon 004C,E01032365,1765,1715,50,33,15,2,0
2021,Wychavon 005D,E01032366,1541,1499,42,24,16,1,1
2021,Wychavon 004D,E01032367,1509,1481,28,10,10,7,1
2021,Wychavon 002A,E01032368,1255,1169,86,30,36,15,5
2021,Wychavon 002B,E01032369,1504,1396,108,46,48,13,1
2021,Wychavon 002C,E01032370,1212,1166,46,22,18,4,2
2021,Wychavon 002D,E01032371,1275,1220,55,22,25,7,1
2021,Wychavon 019C,E01032372,1453,1438,15,11,3,1,0
2021,Wychavon 019D,E01032373,1272,1263,9,4,5,0,0
2021,Wychavon 018D,E01032374,1329,1316,13,8,4,0,1
2021,Wychavon 010A,E01032375,1147,1145,2,2,0,0,0
2021,Wychavon 015A,E01032376,1488,1374,114,40,51,22,1
2021,Wychavon 014B,E01032377,1840,1388,452,160,206,71,15
2021,Wychavon 014C,E01032378,1735,1431,304,92,135,67,10
2021,Wychavon 016C,E01032379,1697,1568,129,40,63,24,2
2021,Wychavon 016D,E01032380,1463,1342,121,53,46,20,2
2021,Wychavon 017A,E01032381,1773,1481,292,108,115,59,10
2021,Wychavon 010B,E01032382,1276,1260,16,10,6,0,0
2021,Wychavon 010C,E01032383,1463,1423,40,18,15,6,1
2021,Wychavon 015B,E01032384,1546,1379,167,72,64,28,3
2021,Wychavon 015C,E01032385,2128,2017,111,36,53,19,3
2021,Wychavon 001B,E01032386,1392,1367,25,6,13,6,0
2021,Wychavon 001C,E01032387,1609,1587,22,10,8,3,1
2021,Wychavon 013E,E01032388,1344,1328,16,4,11,1,0
2021,Wychavon 013F,E01032389,1360,1329,31,16,10,3,2
2021,Wychavon 011A,E01032390,1645,1620,25,10,14,1,0
2021,Wychavon 011B,E01032391,1331,1298,33,16,16,1,0
2021,Wychavon 008A,E01032392,1624,1599,25,11,8,4,2
2021,Wychavon 008B,E01032393,1779,1766,13,5,7,1,0
2021,Wychavon 008C,E01032394,1195,1184,11,10,1,0,0
2021,Wychavon 007C,E01032395,1292,1277,15,7,8,0,0
2021,Wychavon 015D,E01032396,1740,1530,210,76,92,35,7
2021,Wychavon 017B,E01032397,2250,1991,259,85,135,32,7
2021,Wychavon 017C,E01032398,1583,1285,298,71,142,76,9
2021,Wychavon 006A,E01032399,2281,2218,63,39,16,7,1
2021,Wychavon 006B,E01032400,2449,2395,54,33,15,6,0
2021,Wychavon 001D,E01032401,2582,2541,41,27,11,3,0
2021,Wychavon 009C,E01032402,1543,1522,21,12,3,3,3
2021,Wychavon 009D,E01032403,2262,2199,63,18,34,9,2
2021,Wychavon 006C,E01032404,2421,2397,24,10,7,7,0
2021,Wychavon 012A,E01032405,1785,1747,38,22,12,3,1
2021,Wychavon 012B,E01032406,1306,1270,36,16,14,5,1
2021,Wychavon 012C,E01032407,1420,1399,21,7,8,5,1
2021,Wychavon 012D,E01032408,1336,1321,15,10,3,2,0
2021,Wychavon 012E,E01032409,2325,2259,66,30,21,14,1
2021,Wychavon 010D,E01032410,1379,1346,33,7,14,11,1
2021,Wychavon 010E,E01032411,1804,1746,58,22,9,15,12
2021,Wychavon 019E,E01032412,1217,1210,7,4,3,0,0
2021,Wychavon 019F,E01032413,1134,1127,7,4,2,1,0
2021,Wychavon 011C,E01032414,1523,1488,35,12,12,10,1
2021,Wychavon 011D,E01032415,1832,1775,57,12,38,5,2
2021,Wychavon 008D,E01032416,1162,1159,3,1,2,0,0
2021,Wychavon 007D,E01032417,1488,1482,6,5,1,0,0
2021,Wyre Forest 010A,E01032418,1253,1206,47,24,16,5,2
2021,Wyre Forest 010B,E01032419,1252,1246,6,5,1,0,0
2021,Wyre Forest 010C,E01032420,1202,1175,27,9,15,3,0
2021,Wyre Forest 010D,E01032421,1139,1130,9,1,3,5,0
2021,Wyre Forest 010E,E01032422,1373,1310,63,24,26,9,4
2021,Wyre Forest 014A,E01032423,1674,1659,15,11,3,0,1
2021,Wyre Forest 014B,E01032424,1345,1304,41,13,26,2,0
2021,Wyre Forest 014C,E01032425,1363,1352,11,10,0,1,0
2021,Wyre Forest 014D,E01032426,1370,1363,7,3,4,0,0
2021,Wyre Forest 011A,E01032427,1503,1494,9,5,4,0,0
2021,Wyre Forest 011B,E01032428,1523,1512,11,9,2,0,0
2021,Wyre Forest 011C,E01032429,1431,1430,1,1,0,0,0
2021,Wyre Forest 005A,E01032430,1780,1772,8,8,0,0,0
2021,Wyre Forest 001A,E01032431,1519,1496,23,12,9,2,0
2021,Wyre Forest 001B,E01032432,1534,1511,23,9,10,4,0
2021,Wyre Forest 001C,E01032433,1474,1457,17,6,6,4,1
2021,Wyre Forest 004A,E01032434,2190,1945,245,106,90,39,10
2021,Wyre Forest 004B,E01032435,1424,1270,154,51,64,34,5
2021,Wyre Forest 003A,E01032436,1468,1455,13,8,5,0,0
2021,Wyre Forest 004C,E01032437,1777,1689,88,36,40,10,2
2021,Wyre Forest 003B,E01032438,1474,1437,37,22,9,5,1
2021,Wyre Forest 001D,E01032439,1331,1323,8,4,4,0,0
2021,Wyre Forest 001E,E01032440,1154,1140,14,5,7,2,0
2021,Wyre Forest 002A,E01032441,1187,1182,5,4,1,0,0
2021,Wyre Forest 002B,E01032442,1574,1562,12,6,5,0,1
2021,Wyre Forest 002C,E01032443,1292,1287,5,5,0,0,0
2021,Wyre Forest 002D,E01032444,1215,1176,39,19,15,4,1
2021,Wyre Forest 002E,E01032445,1540,1526,14,5,6,3,0
2021,Wyre Forest 003C,E01032446,1378,1345,33,11,14,7,1
2021,Wyre Forest 003D,E01032447,1448,1397,51,24,15,11,1
2021,Wyre Forest 003E,E01032448,1120,1080,40,23,11,6,0
2021,Wyre Forest 007A,E01032449,1530,1400,130,40,66,20,4
2021,Wyre Forest 006A,E01032451,1475,1454,21,8,9,4,0
2021,Wyre Forest 006B,E01032452,1522,1511,11,8,3,0,0
2021,Wyre Forest 006C,E01032453,1763,1730,33,15,13,5,0
2021,Wyre Forest 006D,E01032454,1744,1689,55,18,25,10,2
2021,Wyre Forest 012A,E01032455,1401,1397,4,1,2,1,0
2021,Wyre Forest 012B,E01032456,1217,1192,25,7,14,4,0
2021,Wyre Forest 012C,E01032457,1457,1444,13,7,5,1,0
2021,Wyre Forest 012D,E01032458,1473,1459,14,11,3,0,0
2021,Wyre Forest 012E,E01032459,1434,1423,11,7,3,1,0
2021,Wyre Forest 013A,E01032460,1777,1753,24,13,8,3,0
2021,Wyre Forest 013B,E01032461,1915,1890,25,14,9,2,0
2021,Wyre Forest 013C,E01032462,2115,2098,17,8,9,0,0
2021,Wyre Forest 013D,E01032463,1584,1575,9,4,5,0,0
2021,Wyre Forest 007B,E01032464,1434,1405,29,10,9,9,1
2021,Wyre Forest 007C,E01032465,1473,1420,53,22,25,6,0
2021,Wyre Forest 007D,E01032466,1331,1305,26,11,10,4,1
2021,Wyre Forest 007E,E01032467,1149,1126,23,3,17,3,0
2021,Wyre Forest 007F,E01032468,1078,1071,7,6,1,0,0
2021,Wyre Forest 009A,E01032469,1644,1587,57,25,25,5,2
2021,Wyre Forest 009C,E01032471,1558,1512,46,15,21,9,1
2021,Wyre Forest 011D,E01032472,1232,1225,7,7,0,0,0
2021,Wyre Forest 011E,E01032473,1398,1387,11,8,1,2,0
2021,Wyre Forest 008A,E01032474,1728,1584,144,46,65,29,4
2021,Wyre Forest 008B,E01032475,1596,1539,57,19,30,8,0
2021,Wyre Forest 008C,E01032476,1356,1336,20,9,9,2,0
2021,Wyre Forest 008D,E01032477,1149,1135,14,7,3,4,0
2021,Wyre Forest 008E,E01032478,1477,1439,38,16,15,4,3
2021,Wyre Forest 001F,E01032479,2364,2348,16,12,0,3,1
2021,Wyre Forest 005B,E01032480,1702,1687,15,8,5,2,0
2021,Wyre Forest 005C,E01032481,1810,1801,9,5,4,0,0
2021,Wyre Forest 005D,E01032482,1349,1346,3,3,0,0,0
2021,Sunderland 032F,E01032483,1598,1586,12,8,2,2,0
2021,Sunderland 032G,E01032484,1235,1226,9,3,3,3,0
2021,Blackburn with Darwen 018E,E01032485,1851,1842,9,3,4,2,0
2021,Blackburn with Darwen 018F,E01032486,1303,1293,10,7,0,2,1
2021,Leeds 097F,E01032487,1014,995,19,13,6,0,0
2021,Leeds 097G,E01032488,1754,1728,26,15,5,4,2
2021,Leeds 102F,E01032489,2023,1890,133,74,49,10,0
2021,Leeds 102G,E01032490,1359,1304,55,29,19,7,0
2021,Leeds 102H,E01032491,1178,1142,36,25,4,7,0
2021,Leeds 102I,E01032492,2042,1931,111,53,45,11,2
2021,Leeds 033F,E01032493,1322,1256,66,33,21,8,4
2021,Leeds 033G,E01032494,1851,1673,178,78,59,33,8
2021,Leeds 105F,E01032496,2148,2092,56,21,15,15,5
2021,Leeds 099E,E01032497,1533,1325,208,88,81,38,1
2021,Leeds 099F,E01032498,1617,1547,70,29,23,15,3
2021,Leeds 067G,E01032499,1660,1536,124,64,43,14,3
2021,Leeds 067H,E01032500,1322,1031,291,109,106,63,13
2021,Leeds 017E,E01032501,1117,1076,41,19,14,8,0
2021,Leeds 017F,E01032502,1797,1613,184,82,71,27,4
2021,Leeds 007E,E01032503,1415,1407,8,6,1,1,0
2021,Leeds 007F,E01032504,1729,1664,65,32,22,11,0
2021,Liverpool 050F,E01032505,1239,1172,67,32,17,14,4
2021,Liverpool 050G,E01032506,1367,1283,84,39,26,18,1
2021,Liverpool 050H,E01032507,1323,1262,61,43,14,4,0
2021,Liverpool 027G,E01032508,1678,1480,198,91,45,61,1
2021,Liverpool 027H,E01032509,1245,1073,172,64,52,51,5
2021,Liverpool 008F,E01032510,2039,1895,144,53,52,23,16
2021,Liverpool 008G,E01032511,1290,1260,30,12,15,2,1
2021,Westminster 010F,E01032512,2317,1634,683,311,234,113,25
2021,Westminster 010G,E01032513,1197,878,319,146,119,47,7
2021,Bristol 053E,E01032514,1993,1836,157,60,72,21,4
2021,Bristol 053F,E01032515,1857,1720,137,46,73,16,2
2021,Bristol 001G,E01032516,1929,1772,157,86,61,9,1
2021,Bristol 001H,E01032517,1778,1523,255,107,116,31,1
2021,Bristol 018E,E01032518,2032,1749,283,118,109,41,15
2021,Bristol 018F,E01032519,1215,1125,90,50,26,9,5
2021,Nottingham 028E,E01032520,1891,1721,170,134,26,8,2
2021,Nottingham 028F,E01032522,2434,2019,415,199,132,66,18
2021,West Suffolk 003B,E01032523,2074,2017,57,31,23,3,0
2021,West Suffolk 003C,E01032524,1166,1132,34,13,17,3,1
2021,West Suffolk 003D,E01032526,1822,1799,23,15,8,0,0
2021,Coventry 035G,E01032527,1567,1415,152,74,44,29,5
2021,Coventry 035H,E01032528,1480,1217,263,118,102,37,6
2021,Coventry 038E,E01032529,1178,943,235,115,94,25,1
2021,Coventry 038F,E01032530,1833,1634,199,119,62,14,4
2021,Coventry 036F,E01032532,1462,1348,114,66,32,15,1
2021,Coventry 036G,E01032533,1877,1566,311,150,129,31,1
2021,Coventry 037F,E01032534,1746,1465,281,137,97,39,8
2021,Coventry 037G,E01032535,1193,1008,185,99,69,17,0
2021,Coventry 001F,E01032536,2076,1774,302,122,116,57,7
2021,Coventry 001G,E01032537,1872,1525,347,125,143,69,10
2021,Coventry 001H,E01032538,2161,1729,432,153,186,83,10
2021,Hartlepool 003G,E01032540,962,929,33,16,8,8,1
2021,Hartlepool 003H,E01032541,2117,2104,13,7,3,3,0
2021,Stockton-on-Tees 009F,E01032542,1755,1686,69,44,19,6,0
2021,Stockton-on-Tees 009G,E01032543,2073,2056,17,6,6,5,0
2021,Stockton-on-Tees 009H,E01032544,1971,1945,26,12,5,7,2
2021,Darlington 002E,E01032545,1670,1645,25,10,10,4,1
2021,Darlington 002F,E01032546,1710,1671,39,22,10,6,1
2021,Redcar and Cleveland 019E,E01032548,1610,1603,7,1,4,2,0
2021,Redcar and Cleveland 019F,E01032549,2452,2439,13,10,2,1,0
2021,Barnsley 010H,E01032551,2510,2422,88,38,35,14,1
2021,Middlesbrough 018G,E01032552,1599,1587,12,7,3,2,0
2021,Oxford 002F,E01032554,2138,1822,316,215,75,21,5
2021,Oxford 002G,E01032555,1907,1591,316,193,85,34,4
2021,Oldham 026E,E01032556,1437,1416,21,9,10,2,0
2021,Oldham 026F,E01032557,1736,1550,186,75,79,28,4
2021,Oldham 007E,E01032558,1609,1485,124,48,55,17,4
2021,Oldham 007F,E01032559,2658,2596,62,21,19,15,7
2021,Redcar and Cleveland 003E,E01032560,1102,1098,4,4,0,0,0
2021,Redcar and Cleveland 003F,E01032561,1408,1393,15,11,3,1,0
2021,Bromley 040D,E01032562,1549,1396,153,66,58,28,1
2021,Bromley 040E,E01032563,1413,1291,122,72,33,13,4
2021,Lewisham 037E,E01032564,1271,1078,193,95,63,31,4
2021,Lewisham 038E,E01032565,1414,1178,236,118,77,35,6
2021,Bexley 029D,E01032566,1796,1488,308,145,108,48,7
2021,Greenwich 033D,E01032567,1547,1292,255,130,81,39,5
2021,Bromley 041E,E01032568,1475,1369,106,48,34,19,5
2021,Croydon 045E,E01032569,1707,1498,209,76,94,32,7
2021,Bromley 042D,E01032570,1685,1651,34,26,7,1,0
2021,Tandridge 012D,E01032571,1927,1888,39,20,15,3,1
2021,Ealing 040D,E01032572,1555,1273,282,175,66,40,1
2021,Hounslow 029E,E01032573,1752,1380,372,246,86,34,6
2021,Enfield 037E,E01032574,1987,1328,659,213,262,161,23
2021,Haringey 037D,E01032575,2074,1516,558,155,216,159,28
2021,Harrow 032E,E01032576,1630,1092,538,257,207,67,7
2021,Hillingdon 033E,E01032577,1729,1515,214,111,73,26,4
2021,Lewisham 039E,E01032579,2072,1636,436,229,106,90,11
2021,Barking and Dagenham 023F,E01032580,1480,1067,413,174,165,67,7
2021,Redbridge 034G,E01032581,1833,1295,538,183,242,105,8
2021,Lambeth 036E,E01032582,2239,1701,538,333,135,54,16
2021,Southwark 034D,E01032583,1993,1590,403,227,127,39,10
2021,Southwark 034E,E01032584,1315,1072,243,133,82,27,1
2021,Sheffield 072E,E01032585,1297,1282,15,5,7,3,0
2021,North East Derbyshire 014D,E01032586,1583,1553,30,9,17,4,0
2021,Coventry 043E,E01032587,1754,1459,295,126,116,48,5
2021,Nuneaton and Bedworth 018E,E01032588,1372,1302,70,27,31,10,2
2021,Birmingham 132E,E01032589,1480,1249,231,110,76,40,5
2021,Solihull 030D,E01032590,2221,2005,216,118,52,41,5
2021,Birmingham 133F,E01032591,1540,1116,424,169,137,92,26
2021,Sandwell 039F,E01032592,1726,1586,140,49,55,31,5
2021,Middlesbrough 020F,E01032593,2490,2448,42,30,10,2,0
2021,Redcar and Cleveland 021E,E01032594,1418,1410,8,6,2,0,0
2021,Kingston upon Hull 033E,E01032595,1784,1710,74,20,27,23,4
2021,East Riding of Yorkshire 043F,E01032596,1371,1346,25,13,6,6,0
2021,Leicester 037F,E01032597,1502,1286,216,65,80,66,5
2021,Leicester 038E,E01032599,1575,1259,316,134,101,71,10
2021,Oadby and Wigston 008D,E01032600,1944,1724,220,106,80,29,5
2021,Oadby and Wigston 008E,E01032601,1407,1288,119,54,36,26,3
2021,Leicester 039E,E01032602,1729,1466,263,107,98,52,6
2021,Blaby 013F,E01032603,1436,1350,86,34,40,11,1
2021,Portsmouth 026D,E01032604,1489,1467,22,11,9,2,0
2021,Havant 018F,E01032605,1618,1586,32,20,8,4,0
2021,Leeds 067I,E01032606,2006,1871,135,69,52,13,1
2021,Leeds 067J,E01032607,1235,1055,180,84,65,23,8
2021,Leeds 067K,E01032608,1082,903,179,59,75,40,5
2021,Buckinghamshire 039F,E01032609,1283,1245,38,17,16,4,1
2021,Buckinghamshire 036F,E01032610,1548,1499,49,28,13,8,0
2021,East Cambridgeshire 011D,E01032611,1627,1578,49,34,10,5,0
2021,West Suffolk 015F,E01032612,1967,1723,244,103,105,31,5
2021,Amber Valley 017E,E01032613,1228,1218,10,7,2,1,0
2021,Erewash 016E,E01032614,1188,1178,10,6,4,0,0
2021,East Hampshire 016D,E01032615,1032,1023,9,3,6,0,0
2021,East Hampshire 016E,E01032616,1485,1473,12,12,0,0,0
2021,Havant 020D,E01032617,1550,1528,22,15,3,4,0
2021,Havant 019D,E01032618,1672,1635,37,26,7,4,0
2021,Sevenoaks 016D,E01032619,1506,1491,15,10,5,0,0
2021,Tonbridge and Malling 014E,E01032620,2264,2199,65,35,25,5,0
2021,Nottingham 038E,E01032621,1467,1398,69,23,19,24,3
2021,Gedling 016D,E01032622,1315,1276,39,26,5,7,1
2021,Sutton 025E,E01032623,1762,1620,142,81,42,15,4
2021,Epsom and Ewell 010F,E01032624,1934,1781,153,89,44,15,5
2021,East Hampshire 017E,E01032625,1368,1337,31,18,8,5,0
2021,Waverley 018F,E01032626,1619,1540,79,46,27,3,3
2021,Mendip 011F,E01032627,2139,2098,41,30,9,2,0
2021,East Devon 004G,E01032628,2516,2486,30,19,9,1,1
2021,Sedgemoor 011E,E01032631,1345,1186,159,56,73,26,4
2021,Sedgemoor 011F,E01032632,1445,1381,64,27,32,4,1
2021,Sedgemoor 002G,E01032633,2210,2187,23,7,9,5,2
2021,Sedgemoor 011G,E01032634,1219,1200,19,8,6,3,2
2021,Somerset West and Taunton 003E,E01032635,2260,2242,18,10,6,2,0
2021,Somerset West and Taunton 001D,E01032636,1944,1865,79,44,28,6,1
2021,Southwark 035E,E01032637,1035,798,237,203,28,4,2
2021,Southwark 035D,E01032638,1073,935,138,122,16,0,0
2021,Southwark 014F,E01032639,1873,1401,472,254,155,56,7
2021,Southwark 035B,E01032640,1016,871,145,127,14,4,0
2021,Dorset 031A,E01032643,1490,1421,69,40,23,6,0
2021,Dorset 031B,E01032644,1193,1104,89,37,28,18,6
2021,Dorset 031C,E01032645,1517,1447,70,37,22,10,1
2021,Southwark 036B,E01032646,1479,1243,236,178,48,7,3
2021,North Tyneside 011E,E01032647,2742,2652,90,59,24,5,2
2021,North Tyneside 011F,E01032648,1493,1432,61,31,20,7,3
2021,North Tyneside 019F,E01032649,1059,954,105,68,25,12,0
2021,North Tyneside 019G,E01032650,1007,941,66,38,18,10,0
2021,Somerset West and Taunton 012D,E01032651,1800,1712,88,34,44,9,1
2021,Somerset West and Taunton 012E,E01032652,2095,1966,129,75,42,12,0
2021,Swale 004F,E01032653,1470,1451,19,12,7,0,0
2021,Swale 007G,E01032655,1869,1820,49,17,22,9,1
2021,Swale 007H,E01032656,2478,2437,41,22,11,5,3
2021,Plymouth 027F,E01032657,1284,1131,153,87,45,20,1
2021,Plymouth 027G,E01032658,1512,1237,275,126,111,33,5
2021,"Bournemouth, Christchurch and Poole 044C",E01032659,1219,1087,132,51,56,21,4
2021,"Bournemouth, Christchurch and Poole 044D",E01032660,1582,1423,159,94,43,19,3
2021,"Bournemouth, Christchurch and Poole 044E",E01032661,1314,1198,116,61,34,20,1
2021,"Bournemouth, Christchurch and Poole 044F",E01032662,1144,989,155,61,65,21,8
2021,East Hampshire 012F,E01032664,1086,1028,58,34,16,8,0
2021,East Hampshire 012G,E01032665,1299,1206,93,33,37,23,0
2021,North Somerset 026B,E01032666,1264,1243,21,10,9,1,1
2021,North Somerset 026C,E01032667,1120,1091,29,17,9,2,1
2021,North Somerset 026D,E01032668,1440,1398,42,26,14,2,0
2021,North Somerset 027B,E01032669,1387,1245,142,76,59,7,0
2021,North Somerset 027C,E01032670,1662,1553,109,42,48,18,1
2021,North Somerset 027D,E01032671,1269,1158,111,50,56,4,1
2021,North Somerset 026E,E01032672,2626,2490,136,69,46,21,0
2021,North Somerset 026F,E01032673,1303,1234,69,25,29,12,3
2021,North Somerset 001E,E01032675,1568,1485,83,50,27,5,1
2021,North Somerset 001F,E01032676,1946,1810,136,73,48,13,2
2021,North Somerset 003D,E01032677,1861,1774,87,47,26,14,0
2021,North Somerset 003E,E01032678,1529,1475,54,34,17,3,0
2021,North Somerset 027E,E01032679,1129,1008,121,49,59,12,1
2021,North Somerset 006G,E01032680,1871,1855,16,12,3,0,1
2021,North Somerset 001G,E01032681,1286,1255,31,19,8,3,1
2021,North Somerset 003F,E01032682,1014,989,25,10,8,7,0
2021,West Lindsey 001G,E01032683,2168,2147,21,6,14,1,0
2021,Salford 034D,E01032684,1347,1018,329,146,118,62,3
2021,Wiltshire 025E,E01032688,1241,1217,24,9,12,3,0
2021,Wiltshire 025F,E01032689,1251,1222,29,17,10,2,0
2021,Wiltshire 015F,E01032690,1826,1794,32,19,11,2,0
2021,Wiltshire 015G,E01032691,1396,1369,27,19,7,1,0
2021,Wiltshire 025G,E01032692,1112,1068,44,18,21,5,0
2021,Wiltshire 025H,E01032693,1753,1694,59,31,19,9,0
2021,Wiltshire 064D,E01032694,1801,1759,42,20,17,5,0
2021,Wiltshire 064C,E01032695,1471,1432,39,17,19,3,0
2021,Wiltshire 045F,E01032696,2229,2154,75,38,32,3,2
2021,Wiltshire 066C,E01032697,1470,1276,194,98,67,24,5
2021,Wiltshire 007I,E01032699,2073,1963,110,66,38,4,2
2021,Swindon 026B,E01032700,1712,1588,124,84,32,5,3
2021,Swindon 027A,E01032701,1218,1064,154,79,48,26,1
2021,Swindon 027B,E01032702,1397,1271,126,73,41,10,2
2021,Swindon 026C,E01032703,1541,1394,147,81,49,13,4
2021,Swindon 027C,E01032704,1790,1632,158,87,50,19,2
2021,Swindon 026D,E01032705,1463,1345,118,71,29,17,1
2021,Swindon 021E,E01032706,1482,1207,275,145,87,31,12
2021,Swindon 021F,E01032707,2040,1927,113,63,28,19,3
2021,Swindon 012F,E01032708,1630,1233,397,189,137,60,11
2021,Swindon 026E,E01032709,1326,1222,104,53,39,8,4
2021,Swindon 028E,E01032710,1345,1232,113,53,44,14,2
2021,Swindon 027D,E01032711,1526,1279,247,126,83,33,5
2021,Swindon 027E,E01032712,2309,2043,266,146,94,21,5
2021,Swindon 026F,E01032713,1987,1821,166,100,52,13,1
2021,Swindon 019E,E01032714,1765,1218,547,285,186,65,11
2021,Swindon 019F,E01032715,1195,950,245,105,98,39,3
2021,Swindon 012G,E01032716,1516,1274,242,82,108,52,0
2021,Southwark 014G,E01032719,1402,983,419,222,131,53,13
2021,Bracknell Forest 006F,E01032724,1627,1247,380,204,127,38,11
2021,Bracknell Forest 009H,E01032726,1695,1535,160,71,67,20,2
2021,Bracknell Forest 006G,E01032728,1796,1520,276,132,109,31,4
2021,Slough 009F,E01032729,1693,1069,624,258,242,107,17
2021,Slough 009G,E01032730,1832,1156,676,327,242,100,7
2021,Slough 013E,E01032731,1493,1120,373,217,108,43,5
2021,Slough 013F,E01032732,1702,1275,427,201,152,63,11
2021,Windsor and Maidenhead 005G,E01032733,1273,1020,253,164,63,25,1
2021,Windsor and Maidenhead 005H,E01032734,1714,1304,410,202,146,52,10
2021,Swale 013F,E01032735,1597,1562,35,21,11,3,0
2021,Swale 013G,E01032737,1489,1446,43,18,13,12,0
2021,Southampton 022F,E01032738,1903,1373,530,286,193,48,3
2021,City of London 001F,E01032739,1606,1193,413,323,66,19,5
2021,City of London 001G,E01032740,1376,969,407,303,88,15,1
2021,Havering 013E,E01032741,1386,1029,357,176,127,49,5
2021,Havering 013F,E01032742,1684,1434,250,122,97,29,2
2021,Ealing 010F,E01032743,2160,1411,749,286,304,135,24
2021,Ealing 010G,E01032744,1562,930,632,250,234,112,36
2021,Southampton 033C,E01032745,2895,2205,690,380,244,63,3
2021,Southampton 034C,E01032746,1252,900,352,233,92,26,1
2021,Southampton 034D,E01032748,1859,1449,410,246,120,41,3
2021,Southampton 022G,E01032750,1516,952,564,178,260,113,13
2021,Southampton 033D,E01032751,1749,1213,536,270,182,71,13
2021,Southampton 009F,E01032753,2161,1897,264,156,77,30,1
2021,Southampton 033A,E01032755,1063,678,385,133,182,62,8
2021,Wokingham 012H,E01032759,1915,1768,147,105,27,12,3
2021,Tower Hamlets 004E,E01032764,2300,1783,517,321,120,73,3
2021,Tower Hamlets 004F,E01032765,1692,1380,312,149,89,62,12
2021,Tower Hamlets 021F,E01032767,1541,1092,449,322,98,26,3
2021,Tower Hamlets 025E,E01032768,1272,951,321,254,43,19,5
2021,Tower Hamlets 025F,E01032769,1282,987,295,172,77,36,10
2021,Tower Hamlets 032B,E01032770,2050,1367,683,431,190,53,9
2021,Tower Hamlets 033B,E01032771,1488,988,500,323,116,51,10
2021,Tower Hamlets 032C,E01032772,2328,1540,788,442,237,89,20
2021,Tower Hamlets 032E,E01032774,1723,1232,491,280,152,51,8
2021,Tower Hamlets 031F,E01032775,1110,750,360,257,79,23,1
2021,Tower Hamlets 034D,E01032776,1987,1387,600,400,137,58,5
2021,Tower Hamlets 035A,E01032777,1225,912,313,188,80,36,9
2021,Tower Hamlets 035C,E01032779,1342,967,375,291,61,22,1
2021,Tower Hamlets 035D,E01032780,1993,1410,583,372,164,42,5
2021,Tower Hamlets 033C,E01032781,1631,1114,517,286,149,74,8
2021,Tower Hamlets 033D,E01032782,2181,1468,713,450,161,83,19
2021,Tower Hamlets 031G,E01032783,1258,869,389,204,118,55,12
2021,Tower Hamlets 004G,E01032784,1655,1280,375,215,119,36,5
2021,Tower Hamlets 010E,E01032785,2341,1951,390,241,101,40,8
2021,Tower Hamlets 010F,E01032786,1554,1168,386,141,148,93,4
2021,Tower Hamlets 011F,E01032787,2362,1631,731,246,249,199,37
2021,Hammersmith and Fulham 023D,E01032788,1519,1252,267,168,78,19,2
2021,Hammersmith and Fulham 023E,E01032789,1150,896,254,147,79,24,4
2021,Hammersmith and Fulham 023F,E01032790,1081,843,238,145,70,22,1
2021,Cambridge 003F,E01032792,1201,983,218,152,47,17,2
2021,Cambridge 014D,E01032794,1247,1090,157,107,36,11,3
2021,Gravesham 002F,E01032799,1371,879,492,160,210,104,18
2021,Gravesham 002G,E01032800,1161,923,238,71,111,49,7
2021,Cambridge 003G,E01032802,1309,1042,267,182,59,23,3
2021,Southwark 036C,E01032803,1464,1143,321,242,56,21,2
2021,Canterbury 020F,E01032807,1426,1245,181,131,44,4,2
2021,Canterbury 020G,E01032808,1612,1326,286,173,85,25,3
2021,Ashford 001F,E01032810,1517,1420,97,40,37,16,4
2021,Ashford 003D,E01032811,1541,1437,104,53,33,15,3
2021,Ashford 001G,E01032812,1746,1679,67,41,18,8,0
2021,Ashford 012E,E01032813,1820,1723,97,64,26,6,1
2021,Ashford 012F,E01032814,2023,1980,43,24,12,7,0
2021,Ashford 009F,E01032815,995,899,96,46,40,8,2
2021,Ashford 008E,E01032816,1939,1859,80,44,25,7,4
2021,Ashford 009G,E01032817,1129,1021,108,48,42,16,2
2021,Ashford 009H,E01032818,1474,1386,88,44,30,14,0
2021,Ashford 009I,E01032819,1690,1589,101,69,23,6,3
2021,Ashford 016B,E01032820,2398,2140,258,144,74,30,10
2021,Ashford 016A,E01032821,2880,2623,257,132,88,26,11
2021,Ashford 003E,E01032822,1406,1354,52,38,9,4,1
2021,Ashford 008F,E01032823,1565,1445,120,44,45,21,10
2021,Ashford 009J,E01032824,1385,1313,72,43,19,10,0
2021,Tonbridge and Malling 007E,E01032825,2859,2753,106,75,26,5,0
2021,Tonbridge and Malling 007F,E01032826,1690,1627,63,33,20,8,2
2021,Tonbridge and Malling 007G,E01032827,2074,2006,68,57,7,2,2
2021,Tonbridge and Malling 007H,E01032828,1139,1104,35,21,13,0,1
2021,Tonbridge and Malling 014F,E01032829,1686,1674,12,7,5,0,0
2021,Tonbridge and Malling 002G,E01032830,2385,2342,43,27,12,0,4
2021,Eastbourne 014B,E01032831,1570,1509,61,37,21,2,1
2021,Eastbourne 014C,E01032832,1455,1399,56,31,13,8,4
2021,Eastbourne 014D,E01032833,1276,1184,92,45,34,9,4
2021,Southwark 035C,E01032834,1011,850,161,138,18,4,1
2021,Crawley 004F,E01032835,1853,1225,628,348,199,75,6
2021,Crawley 004G,E01032836,2207,1686,521,227,220,60,14
2021,Mid Sussex 009E,E01032837,2373,2255,118,84,26,6,2
2021,Mid Sussex 009F,E01032838,1415,1344,71,56,10,5,0
2021,Mid Sussex 009G,E01032839,1247,1137,110,68,33,8,1
2021,Basingstoke and Deane 010G,E01032841,2513,2224,289,189,71,20,9
2021,Basingstoke and Deane 011E,E01032842,1315,885,430,247,133,34,16
2021,Basingstoke and Deane 007H,E01032843,1875,1690,185,96,68,20,1
2021,Basingstoke and Deane 007I,E01032844,2776,2331,445,222,168,47,8
2021,Basingstoke and Deane 012E,E01032845,1711,1388,323,141,111,56,15
2021,Basingstoke and Deane 012F,E01032846,1602,1130,472,268,144,51,9
2021,Basingstoke and Deane 011F,E01032847,2008,1633,375,191,124,53,7
2021,Basingstoke and Deane 021E,E01032848,1630,1549,81,59,12,8,2
2021,Basingstoke and Deane 021F,E01032849,1468,1420,48,23,18,5,2
2021,Basingstoke and Deane 021G,E01032850,1360,1310,50,35,10,4,1
2021,Hart 005E,E01032852,1659,1585,74,45,20,8,1
2021,Hart 005F,E01032853,1804,1679,125,90,19,14,2
2021,Hart 005G,E01032854,1614,1494,120,88,25,5,2
2021,Hart 011D,E01032855,1168,1144,24,13,10,1,0
2021,Hart 011E,E01032856,1560,1517,43,27,14,2,0
2021,Hart 005H,E01032857,1027,959,68,43,18,5,2
2021,Rushmoor 009F,E01032858,2384,2097,287,122,112,43,10
2021,Winchester 013F,E01032859,1692,1641,51,29,14,8,0
2021,Winchester 013G,E01032860,1499,1369,130,79,39,9,3
2021,Leicester 042B,E01032862,2151,1540,611,268,199,123,21
2021,Leicester 042C,E01032863,2281,1695,586,255,223,78,30
2021,Leicester 042A,E01032865,2041,1520,521,278,146,88,9
2021,Leicester 041B,E01032868,2769,2141,628,335,248,42,3
2021,Test Valley 005F,E01032870,1838,1767,71,37,22,9,3
2021,Test Valley 005G,E01032871,1448,1433,15,11,4,0,0
2021,Leicester 041C,E01032872,1155,847,308,186,88,30,4
2021,Leicester 041D,E01032873,1972,1462,510,259,186,60,5
2021,Leeds 109G,E01032876,1807,1716,91,55,22,13,1
2021,Fareham 013F,E01032877,2724,2699,25,17,3,3,2
2021,Gosport 008F,E01032878,992,938,54,21,22,11,0
2021,Gosport 008G,E01032879,1165,1116,49,29,16,4,0
2021,Gosport 006F,E01032880,1367,1351,16,6,6,3,1
2021,Gosport 006G,E01032881,1653,1624,29,9,19,1,0
2021,Gosport 006H,E01032883,1315,1300,15,9,5,1,0
2021,Gosport 007F,E01032884,1944,1905,39,28,9,1,1
2021,Solihull 029F,E01032885,1499,1430,69,49,18,2,0
2021,Solihull 029G,E01032886,2659,2519,140,98,35,7,0
2021,Walsall 018F,E01032888,2633,2421,212,99,63,49,1
2021,Rugby 014C,E01032891,1897,1575,322,148,143,26,5
2021,Rugby 007F,E01032893,1960,1837,123,83,29,9,2
2021,Rugby 007G,E01032894,2131,1989,142,98,36,7,1
2021,Rugby 007H,E01032895,1444,1355,89,43,27,15,4
2021,East Staffordshire 011F,E01032896,1368,932,436,152,204,69,11
2021,East Staffordshire 011G,E01032897,1514,1371,143,58,75,8,2
2021,East Staffordshire 011H,E01032898,1217,757,460,138,228,84,10
2021,Lichfield 004F,E01032899,1766,1708,58,25,25,7,1
2021,Lichfield 004G,E01032900,1971,1919,52,20,22,10,0
2021,Tamworth 010F,E01032901,1757,1687,70,36,27,4,3
2021,Tamworth 010G,E01032902,1290,1254,36,14,20,2,0
2021,St. Helens 025C,E01032904,1809,1756,53,30,18,4,1
2021,St. Helens 025D,E01032905,2694,2626,68,37,23,7,1
2021,Salford 034E,E01032906,2007,1573,434,238,138,51,7
2021,Salford 033F,E01032909,1694,1371,323,187,116,20,0
2021,Salford 035B,E01032912,2151,1731,420,208,134,73,5
2021,Salford 035A,E01032914,2028,1484,544,261,217,57,9
2021,Salford 036C,E01032915,2085,1733,352,144,115,85,8
2021,Oldham 011E,E01032920,2455,2301,154,61,59,28,6
2021,Oldham 020E,E01032922,2370,2354,16,7,5,3,1
2021,Calderdale 008F,E01032923,2056,1974,82,26,34,21,1
2021,Barnsley 026F,E01032924,1534,1428,106,31,51,21,3
2021,Barnsley 026G,E01032925,1372,1285,87,26,42,18,1
2021,Rotherham 012E,E01032926,1701,1686,15,4,7,3,1
2021,Rotherham 012F,E01032927,1395,1373,22,9,8,5,0
2021,Cheshire West and Chester 033E,E01032930,2122,1830,292,147,103,36,6
2021,Cheshire West and Chester 033F,E01032931,1097,974,123,76,26,19,2
2021,Gloucester 004E,E01032932,1735,1530,205,95,72,31,7
2021,Gloucester 015E,E01032933,1609,1517,92,53,30,7,2
2021,Gloucester 015G,E01032935,1497,1367,130,57,53,17,3
2021,Gloucester 004F,E01032937,1448,1213,235,98,84,44,9
2021,Tewkesbury 001F,E01032938,2272,2169,103,49,35,19,0
2021,Tewkesbury 001G,E01032939,1435,1390,45,23,14,7,1
2021,Tewkesbury 001H,E01032940,1470,1434,36,22,12,2,0
2021,Cherwell 004G,E01032941,1432,1200,232,77,99,47,9
2021,Cherwell 004H,E01032942,1436,1042,394,160,182,44,8
2021,Cherwell 002E,E01032943,2077,1885,192,117,59,16,0
2021,Cherwell 002F,E01032944,1291,1154,137,56,62,18,1
2021,Leeds 110G,E01032946,3127,2899,228,154,47,24,3
2021,West Oxfordshire 008G,E01032947,1780,1667,113,61,30,19,3
2021,West Oxfordshire 008H,E01032948,1900,1822,78,38,23,15,2
2021,West Oxfordshire 013E,E01032949,1310,1207,103,47,45,9,2
2021,West Oxfordshire 013F,E01032950,1650,1561,89,48,31,10,0
2021,West Oxfordshire 013G,E01032951,1925,1865,60,29,26,3,2
2021,West Oxfordshire 008I,E01032952,1315,1253,62,38,20,4,0
2021,West Oxfordshire 013H,E01032953,2286,2208,78,39,27,8,4
2021,Buckinghamshire 015D,E01032955,1328,1175,153,83,57,10,3
2021,Buckinghamshire 016D,E01032956,1551,1482,69,39,21,8,1
2021,Buckinghamshire 016E,E01032957,1219,1108,111,64,27,18,2
2021,Buckinghamshire 009E,E01032958,1491,1480,11,5,5,1,0
2021,Buckinghamshire 015E,E01032961,1382,1117,265,118,108,36,3
2021,Buckinghamshire 016F,E01032962,1403,1291,112,58,34,19,1
2021,North Northamptonshire 008B,E01032963,1466,1217,249,91,122,34,2
2021,North Northamptonshire 008C,E01032964,1809,1395,414,179,185,42,8
2021,North Northamptonshire 008D,E01032965,1814,1397,417,173,167,72,5
2021,North Northamptonshire 008E,E01032966,2620,1984,636,249,271,103,13
2021,North Northamptonshire 008F,E01032967,2525,1969,556,216,224,89,27
2021,North Northamptonshire 013F,E01032969,1567,1518,49,28,13,8,0
2021,North Northamptonshire 013G,E01032970,1998,1937,61,32,18,9,2
2021,North Northamptonshire 013H,E01032971,1095,1047,48,17,20,10,1
2021,North Northamptonshire 020B,E01032972,1526,1501,25,13,11,0,1
2021,North Northamptonshire 020C,E01032973,1663,1626,37,19,11,5,2
2021,North Northamptonshire 020D,E01032974,1413,1394,19,11,6,2,0
2021,West Northamptonshire 035A,E01032976,1600,1466,134,67,47,17,3
2021,West Northamptonshire 032D,E01032978,1730,1156,574,207,244,110,13
2021,West Northamptonshire 032E,E01032979,1428,939,489,181,206,82,20
2021,West Northamptonshire 037D,E01032980,1695,978,717,280,334,94,9
2021,West Northamptonshire 037E,E01032981,2649,1986,663,269,284,100,10
2021,West Northamptonshire 046E,E01032982,1383,1241,142,49,67,23,3
2021,West Northamptonshire 046F,E01032983,1560,1408,152,69,61,18,4
2021,West Northamptonshire 046G,E01032984,1629,1488,141,81,35,24,1
2021,West Northamptonshire 046H,E01032985,2229,2187,42,27,13,2,0
2021,East Lindsey 004D,E01032986,1100,1081,19,10,8,1,0
2021,East Lindsey 004E,E01032987,1409,1370,39,22,11,4,2
2021,North Kesteven 013B,E01032988,1812,1741,71,31,29,10,1
2021,North Kesteven 013C,E01032989,1999,1939,60,33,21,6,0
2021,North Kesteven 014E,E01032991,2147,2088,59,34,21,4,0
2021,North Kesteven 014F,E01032992,1444,1406,38,25,10,1,2
2021,North Kesteven 013D,E01032993,2418,2349,69,34,27,8,0
2021,North Kesteven 003H,E01032994,1475,1457,18,11,5,2,0
2021,South Holland 006F,E01032995,1414,833,581,129,265,173,14
2021,South Holland 006G,E01032996,1352,1206,146,47,74,19,6
2021,South Kesteven 011E,E01032997,1267,1214,53,23,23,7,0
2021,South Kesteven 011F,E01032998,1781,1668,113,66,35,12,0
2021,South Kesteven 011G,E01032999,1219,1162,57,23,24,10,0
2021,Hounslow 025F,E01033000,1693,1272,421,173,169,71,8
2021,Leeds 055F,E01033002,2102,1402,700,338,246,99,17
2021,Leeds 055G,E01033003,2112,1282,830,294,382,147,7
2021,Leeds 111A,E01033008,2142,1739,403,200,154,43,6
2021,Leeds 111B,E01033010,3482,2196,1286,456,675,153,2
2021,Leeds 111C,E01033011,1328,1131,197,135,56,6,0
2021,Leeds 082E,E01033013,1399,1060,339,135,147,46,11
2021,Leeds 111D,E01033015,1497,1221,276,176,90,10,0
2021,Leeds 111E,E01033016,1035,856,179,117,52,10,0
2021,Leeds 075E,E01033021,1999,1653,346,173,131,34,8
2021,Dacorum 018G,E01033022,1331,1208,123,81,32,10,0
2021,Dacorum 018H,E01033023,2016,1777,239,116,76,41,6
2021,North Hertfordshire 017E,E01033024,1515,1451,64,46,12,6,0
2021,North Hertfordshire 017D,E01033025,1272,1199,73,52,18,3,0
2021,North Hertfordshire 017A,E01033026,1550,1477,73,44,25,3,1
2021,North Hertfordshire 017C,E01033027,1421,1356,65,45,17,3,0
2021,St Albans 018F,E01033028,1480,1351,129,68,45,15,1
2021,St Albans 018G,E01033029,1634,1548,86,50,21,13,2
2021,Hounslow 025G,E01033030,1732,1021,711,437,206,57,11
2021,Leeds 064E,E01033031,1518,1022,496,218,175,85,18
2021,Leeds 075F,E01033033,1589,1306,283,204,64,14,1
2021,Leeds 075G,E01033034,1462,1293,169,138,26,5,0
2021,Leeds 064F,E01033035,1622,930,692,189,323,167,13
2021,King's Lynn and West Norfolk 017E,E01033036,1582,1520,62,29,19,14,0
2021,King's Lynn and West Norfolk 017F,E01033037,1570,1489,81,24,41,13,3
2021,King's Lynn and West Norfolk 017G,E01033038,2057,1870,187,73,76,33,5
2021,King's Lynn and West Norfolk 017H,E01033039,1032,985,47,18,19,10,0
2021,Breckland 010F,E01033040,2511,2260,251,98,98,53,2
2021,Breckland 010G,E01033041,1278,1187,91,40,35,15,1
2021,Breckland 001F,E01033042,2221,2175,46,30,13,3,0
2021,West Suffolk 011D,E01033043,1119,1043,76,33,28,14,1
2021,West Suffolk 012D,E01033044,1346,1268,78,41,28,9,0
2021,West Suffolk 012E,E01033045,1275,1206,69,40,23,5,1
2021,West Suffolk 011E,E01033046,1044,958,86,46,26,14,0
2021,West Suffolk 011F,E01033047,1076,1005,71,30,33,7,1
2021,West Suffolk 013E,E01033048,1357,1300,57,27,22,6,2
2021,West Suffolk 013F,E01033049,1118,1040,78,39,26,12,1
2021,West Suffolk 012F,E01033050,1160,1109,51,30,18,3,0
2021,Tendring 002F,E01033051,2435,2401,34,14,11,8,1
2021,Uttlesford 008F,E01033052,1889,1814,75,50,22,3,0
2021,Uttlesford 008G,E01033053,2105,2068,37,20,14,3,0
2021,Uttlesford 007D,E01033054,1174,1131,43,31,11,1,0
2021,Uttlesford 007E,E01033055,2187,2144,43,26,13,4,0
2021,Uttlesford 007F,E01033056,1534,1507,27,17,7,2,1
2021,Coventry 042F,E01033058,2389,1881,508,261,195,47,5
2021,Bromsgrove 012D,E01033059,1496,1479,17,12,2,3,0
2021,Bromsgrove 014E,E01033060,1112,1095,17,12,4,1,0
2021,Bromsgrove 012E,E01033061,1810,1775,35,24,9,2,0
2021,Bromsgrove 014F,E01033062,2211,2180,31,19,5,5,2
2021,Brentwood 007F,E01033063,1372,1293,79,58,18,2,1
2021,Brentwood 007G,E01033064,1328,1226,102,49,39,13,1
2021,York 013F,E01033067,1556,1336,220,114,86,20,0
2021,York 013G,E01033068,1085,962,123,73,41,9,0
2021,York 013H,E01033069,1012,925,87,49,23,15,0
2021,York 013I,E01033070,2653,2073,580,235,282,63,0
2021,Lancaster 014E,E01033071,1656,1288,368,196,145,25,2
2021,Lancaster 016I,E01033072,2441,2418,23,8,12,3,0
2021,Lancaster 014F,E01033073,1839,1634,205,112,65,24,4
2021,Sunderland 012F,E01033076,2347,2293,54,26,20,5,3
2021,Sunderland 027F,E01033077,2205,2184,21,14,3,4,0
2021,Bath and North East Somerset 010G,E01033078,1849,1807,42,28,12,2,0
2021,Bath and North East Somerset 010H,E01033079,1140,1133,7,6,1,0,0
2021,Bath and North East Somerset 009E,E01033080,2191,1905,286,165,91,25,5
2021,Hounslow 031D,E01033081,1540,1186,354,201,107,41,5
2021,Hounslow 031C,E01033082,1210,963,247,101,101,35,10
2021,Hounslow 018F,E01033083,2081,1146,935,547,295,85,8
2021,Hounslow 018G,E01033084,1833,1179,654,272,259,97,26
2021,Haringey 020F,E01033086,1145,846,299,99,104,82,14
2021,Maidstone 006F,E01033087,1663,1300,363,165,146,39,13
2021,Maidstone 008F,E01033088,2236,1978,258,151,81,21,5
2021,Maidstone 008G,E01033089,1765,1537,228,102,86,30,10
2021,Maidstone 006G,E01033091,1630,1368,262,106,115,38,3
2021,Maidstone 004G,E01033092,1424,1033,391,133,187,59,12
2021,Sefton 004F,E01033094,1155,873,282,73,114,86,9
2021,Sefton 033F,E01033095,2367,2329,38,13,14,11,0
2021,Sefton 004G,E01033097,1131,849,282,65,100,111,6
2021,Wandsworth 038C,E01033098,1648,1147,501,394,83,19,5
2021,Wandsworth 004E,E01033099,1805,1400,405,245,128,30,2
2021,Wandsworth 039B,E01033100,1827,1359,468,279,126,59,4
2021,North West Leicestershire 011E,E01033102,1522,1422,100,47,43,9,1
2021,North West Leicestershire 011F,E01033103,2170,2078,92,58,29,4,1
2021,Kingston upon Hull 029E,E01033104,1411,1189,222,118,85,17,2
2021,Kingston upon Hull 035D,E01033105,1505,1444,61,29,19,8,5
2021,Kingston upon Hull 035E,E01033107,1281,1234,47,20,21,6,0
2021,Kingston upon Hull 029F,E01033109,1441,1161,280,133,97,44,6
2021,Fenland 003H,E01033111,1620,1226,394,85,192,105,12
2021,Fenland 003I,E01033112,1412,789,623,115,245,232,31
2021,South Cambridgeshire 020A,E01033113,1210,1061,149,91,45,12,1
2021,South Cambridgeshire 020B,E01033114,1371,1169,202,126,53,19,4
2021,South Cambridgeshire 020C,E01033115,1382,1246,136,90,34,12,0
2021,South Cambridgeshire 021D,E01033116,2715,2499,216,141,57,13,5
2021,South Cambridgeshire 020D,E01033117,1273,1124,149,77,59,9,4
2021,South Cambridgeshire 021E,E01033118,1474,1380,94,58,27,7,2
2021,South Cambridgeshire 006G,E01033120,1393,1189,204,124,65,13,2
2021,South Cambridgeshire 006H,E01033121,2065,1583,482,309,125,42,6
2021,Ipswich 012F,E01033122,2178,1630,548,201,218,113,16
2021,Ipswich 011E,E01033123,1692,1396,296,101,128,52,15
2021,Ipswich 007F,E01033124,1038,793,245,125,87,31,2
2021,Ipswich 007G,E01033125,1342,938,404,164,155,70,15
2021,Ipswich 011F,E01033126,1844,1351,493,244,167,68,14
2021,Ipswich 014E,E01033127,1619,1499,120,48,49,19,4
2021,Ipswich 014F,E01033128,1129,1022,107,52,37,15,3
2021,Ipswich 007H,E01033129,1609,1143,466,157,180,110,19
2021,Ipswich 012G,E01033130,1095,698,397,107,163,106,21
2021,Ipswich 014G,E01033131,1709,1512,197,74,81,37,5
2021,Wandsworth 038D,E01033132,1957,1420,537,380,118,36,3
2021,Wandsworth 004G,E01033133,1160,954,206,150,42,14,0
2021,Wandsworth 010G,E01033135,1141,1021,120,99,13,7,1
2021,Chelmsford 014F,E01033137,1541,1453,88,42,37,6,3
2021,Chelmsford 009F,E01033138,1436,1322,114,51,46,17,0
2021,Chelmsford 009G,E01033139,1577,1302,275,153,83,36,3
2021,Chelmsford 022D,E01033140,1965,1691,274,120,103,46,5
2021,Chelmsford 005E,E01033142,2087,2032,55,28,21,6,0
2021,Chelmsford 005F,E01033144,1733,1664,69,54,10,5,0
2021,Chelmsford 014G,E01033145,1483,1419,64,41,11,10,2
2021,Enfield 025F,E01033146,1470,1049,421,145,143,114,19
2021,Enfield 003F,E01033148,2130,1482,648,175,216,216,41
2021,Enfield 003G,E01033150,1574,1235,339,114,113,94,18
2021,Enfield 025G,E01033151,1408,1017,391,119,148,110,14
2021,Dorset 002D,E01033156,1658,1568,90,35,40,14,1
2021,Dorset 002E,E01033158,1340,1325,15,4,8,3,0
2021,Barrow-in-Furness 009F,E01033160,2189,2182,7,3,4,0,0
2021,County Durham 021D,E01033161,1458,1425,33,12,13,5,3
2021,County Durham 016F,E01033163,1951,1933,18,10,6,2,0
2021,Derby 018F,E01033166,1227,932,295,120,121,43,11
2021,Derby 018G,E01033167,1200,871,329,86,118,100,25
2021,Derby 030E,E01033168,1277,1235,42,27,8,6,1
2021,Derby 030F,E01033169,1736,1542,194,126,46,19,3
2021,Derby 030G,E01033170,1230,1124,106,62,34,8,2
2021,Derby 024E,E01033171,1568,1398,170,91,53,23,3
2021,Derby 024F,E01033172,1520,1354,166,85,55,22,4
2021,Peterborough 016F,E01033173,2189,1808,381,202,123,41,15
2021,Peterborough 022C,E01033174,2417,1919,498,223,207,55,13
2021,Peterborough 023B,E01033175,1477,1263,214,84,80,41,9
2021,Peterborough 023D,E01033177,1707,1473,234,128,74,28,4
2021,Peterborough 022D,E01033179,2822,2388,434,195,184,50,5
2021,Peterborough 023F,E01033180,1744,1454,290,155,87,39,9
2021,Peterborough 022E,E01033181,1605,1374,231,98,93,35,5
2021,Peterborough 016G,E01033182,1532,1162,370,131,145,81,13
2021,Richmondshire 004H,E01033184,1940,1724,216,132,82,1,1
2021,Richmondshire 006F,E01033185,1347,1340,7,2,5,0,0
2021,Richmondshire 006G,E01033186,1395,1391,4,1,2,1,0
2021,Central Bedfordshire 014E,E01033188,1451,1424,27,18,7,2,0
2021,Central Bedfordshire 014F,E01033189,2755,2682,73,54,13,5,1
2021,Central Bedfordshire 014G,E01033190,1475,1420,55,38,10,7,0
2021,Central Bedfordshire 024E,E01033191,1721,1665,56,39,13,3,1
2021,Central Bedfordshire 024F,E01033192,1623,1489,134,71,45,18,0
2021,County Durham 030E,E01033195,1545,1376,169,83,80,6,0
2021,County Durham 030F,E01033197,2077,1884,193,120,64,8,1
2021,County Durham 021E,E01033198,1229,1202,27,3,8,14,2
2021,Dorset 047C,E01033200,2728,2670,58,30,15,11,2
2021,County Durham 021F,E01033205,1358,1337,21,11,3,7,0
2021,County Durham 021G,E01033206,1417,1402,15,6,8,0,1
2021,Lambeth 004G,E01033208,1668,1291,377,265,86,25,1
2021,Dover 012E,E01033209,1107,982,125,57,33,28,7
2021,Dover 010G,E01033210,2394,2368,26,16,5,2,3
2021,Dover 012F,E01033211,1321,1132,189,79,60,46,4
2021,Folkestone and Hythe 014C,E01033212,1442,1218,224,96,74,44,10
2021,Folkestone and Hythe 002E,E01033213,1907,1831,76,44,29,1,2
2021,Folkestone and Hythe 002F,E01033214,2000,1945,55,31,21,3,0
2021,Folkestone and Hythe 014D,E01033215,1223,1098,125,70,41,9,5
2021,Bolton 016E,E01033217,1127,824,303,91,132,70,10
2021,Bolton 028F,E01033218,1523,1491,32,19,9,4,0
2021,Bolton 028G,E01033219,1385,1351,34,14,13,5,2
2021,Bolton 016F,E01033220,1259,979,280,81,109,73,17
2021,Preston 017F,E01033223,1557,1196,361,198,131,27,5
2021,Preston 017G,E01033224,1084,828,256,84,111,54,7
2021,Preston 017H,E01033226,1148,826,322,88,150,75,9
2021,Knowsley 008F,E01033228,2552,2288,264,121,99,38,6
2021,Isle of Wight 003D,E01033229,1822,1803,19,12,5,2,0
2021,Exeter 011F,E01033232,1413,1273,140,79,44,16,1
2021,Exeter 011G,E01033234,1990,1882,108,58,36,10,4
2021,Exeter 015E,E01033235,1172,1152,20,12,5,2,1
2021,Exeter 015F,E01033236,985,968,17,8,6,2,1
2021,Isle of Wight 003E,E01033237,1699,1687,12,6,5,1,0
2021,Isle of Wight 012H,E01033239,2297,2277,20,12,8,0,0
2021,"Bournemouth, Christchurch and Poole 037D",E01033241,1071,840,231,105,81,39,6
2021,"Bournemouth, Christchurch and Poole 038C",E01033242,997,692,305,160,104,37,4
2021,Bromsgrove 014G,E01033243,2151,2062,89,33,20,35,1
2021,North Northamptonshire 035D,E01033244,2619,2547,72,44,19,6,3
2021,North Northamptonshire 035E,E01033245,1041,1019,22,10,10,2,0
2021,Worcester 007E,E01033246,1240,1143,97,55,32,9,1
2021,Worcester 007F,E01033247,1219,944,275,117,122,30,6
2021,Worcester 011E,E01033248,1179,939,240,115,87,35,3
2021,Worcester 011F,E01033249,1315,1097,218,97,84,30,7
2021,Stratford-on-Avon 010D,E01033250,1283,1174,109,55,38,15,1
2021,Stratford-on-Avon 010E,E01033251,1644,1505,139,58,53,22,6
2021,Stratford-on-Avon 010F,E01033252,1371,1334,37,23,14,0,0
2021,Warwick 007H,E01033253,1450,1184,266,211,39,15,1
2021,Warwick 011G,E01033254,1370,1274,96,58,31,6,1
2021,Warwick 011H,E01033255,2676,2534,142,96,31,15,0
2021,Warwick 007I,E01033256,1255,1047,208,162,37,7,2
2021,Newcastle-under-Lyme 015H,E01033257,2388,2282,106,72,27,5,2
2021,Doncaster 014E,E01033259,1575,1409,166,46,78,34,8
2021,Doncaster 014F,E01033260,1584,1434,150,46,63,39,2
2021,Sheffield 073A,E01033261,2375,1195,1180,393,602,182,3
2021,Sheffield 073B,E01033262,2220,1736,484,269,177,35,3
2021,Sheffield 073C,E01033263,2000,1462,538,205,243,86,4
2021,Sheffield 073D,E01033264,1972,1301,671,313,296,58,4
2021,Sheffield 074C,E01033265,1454,934,520,208,212,84,16
2021,Sheffield 075G,E01033268,2635,2176,459,195,140,115,9
2021,Sheffield 022G,E01033269,1751,1173,578,145,238,170,25
2021,Sheffield 022H,E01033270,1569,1117,452,193,176,75,8
2021,Sheffield 040E,E01033271,1950,1375,575,180,265,112,18
2021,Sheffield 040F,E01033272,1541,1215,326,152,121,48,5
2021,Sheffield 042F,E01033273,2191,1859,332,167,103,56,6
2021,Sheffield 042G,E01033274,2465,2066,399,216,151,27,5
2021,Sheffield 008F,E01033275,1551,1511,40,22,11,7,0
2021,Sheffield 073E,E01033276,1833,1060,773,320,380,68,5
2021,Sheffield 011E,E01033277,2841,2545,296,142,97,50,7
2021,Sheffield 076F,E01033279,2219,2179,40,13,17,4,6
2021,Sheffield 008G,E01033280,1532,1504,28,16,8,3,1
2021,Rossendale 004G,E01033281,2590,2463,127,31,47,45,4
2021,"Bournemouth, Christchurch and Poole 037E",E01033283,1165,985,180,82,73,22,3
2021,"Bournemouth, Christchurch and Poole 038D",E01033285,1301,787,514,248,205,58,3
2021,"Bournemouth, Christchurch and Poole 040C",E01033286,1104,928,176,98,66,12,0
2021,"Bournemouth, Christchurch and Poole 040D",E01033288,1154,1015,139,92,37,9,1
2021,Cornwall 007E,E01033289,2003,1983,20,10,5,4,1
2021,Cornwall 004D,E01033291,1773,1759,14,8,4,2,0
2021,Cornwall 004E,E01033292,1482,1467,15,6,6,3,0
2021,Cornwall 034E,E01033294,2118,2101,17,5,10,2,0
2021,North Lincolnshire 018F,E01033296,1352,1311,41,11,23,6,1
2021,North Lincolnshire 018G,E01033297,1654,1554,100,46,35,17,2
2021,Warrington 017F,E01033299,2290,1829,461,203,182,71,5
2021,Warrington 018F,E01033300,1558,1112,446,188,198,55,5
2021,Warrington 018G,E01033302,1536,1185,351,149,135,60,7
2021,Warrington 017G,E01033303,1066,798,268,71,132,60,5
2021,Vale of White Horse 006G,E01033305,1268,1083,185,113,58,12,2
2021,Vale of White Horse 006H,E01033306,1793,1552,241,139,70,31,1
2021,Welwyn Hatfield 010E,E01033308,2881,2275,606,347,191,63,5
2021,Welwyn Hatfield 002E,E01033310,1723,1422,301,122,111,64,4
2021,Welwyn Hatfield 010F,E01033311,1474,1214,260,141,86,30,3
2021,Welwyn Hatfield 002F,E01033313,1487,1385,102,62,25,15,0
2021,Welwyn Hatfield 010G,E01033314,2196,1747,449,207,179,58,5
2021,Mid Suffolk 010F,E01033316,1949,1883,66,40,21,5,0
2021,Mid Suffolk 010G,E01033317,1727,1655,72,39,22,9,2
2021,Mid Suffolk 010H,E01033319,2631,2554,77,45,25,7,0
2021,Lewisham 017E,E01033320,1494,1213,281,150,93,32,6
2021,Lewisham 017F,E01033322,1184,933,251,152,65,30,4
2021,Lewisham 008E,E01033324,1497,1349,148,74,46,27,1
2021,Lewisham 008F,E01033325,1315,918,397,267,91,38,1
2021,Lewisham 041B,E01033327,2074,1533,541,268,180,69,24
2021,Brighton and Hove 027F,E01033328,1267,1179,88,66,14,6,2
2021,Brighton and Hove 027G,E01033329,1837,1349,488,260,178,46,4
2021,Salford 033E,E01033330,1490,1125,365,117,163,75,10
2021,South Gloucestershire 021F,E01033334,1504,1398,106,58,36,10,2
2021,South Gloucestershire 021G,E01033336,1653,1577,76,42,18,15,1
2021,South Gloucestershire 019F,E01033338,1623,1527,96,50,39,7,0
2021,South Gloucestershire 019G,E01033339,1438,1363,75,37,28,9,1
2021,Lewisham 041C,E01033341,1278,1006,272,118,91,54,9
2021,Bristol 025E,E01033342,1942,1370,572,276,250,45,1
2021,Bristol 060D,E01033344,1810,1363,447,201,201,39,6
2021,Bristol 059D,E01033347,2156,1760,396,259,107,26,4
2021,Bristol 059C,E01033348,1155,897,258,131,88,38,1
2021,Bristol 061D,E01033350,1175,1078,97,73,20,4,0
2021,Bristol 054A,E01033352,1698,1354,344,192,131,18,3
2021,Bristol 054B,E01033353,1964,1513,451,243,161,41,6
2021,Bristol 056C,E01033356,1633,1203,430,141,207,67,15
2021,Bristol 054D,E01033358,2455,1901,554,208,246,87,13
2021,Bristol 039E,E01033359,1643,1288,355,215,110,27,3
2021,Bristol 039F,E01033361,1469,1275,194,114,50,29,1
2021,Bristol 039G,E01033362,1263,1096,167,106,48,10,3
2021,Bristol 039H,E01033364,1707,1567,140,87,37,15,1
2021,Bristol 059B,E01033366,1498,1197,301,116,125,49,11
2021,Bristol 025F,E01033367,1338,1105,233,122,59,48,4
2021,Bristol 056D,E01033369,1397,1044,353,138,132,63,20
2021,Bristol 054E,E01033370,1294,964,330,172,109,45,4
2021,Cheshire East 050E,E01033372,1121,1088,33,20,11,2,0
2021,Cheshire East 050F,E01033373,1422,1367,55,22,25,8,0
2021,Cheshire East 053B,E01033375,1987,1934,53,39,11,3,0
2021,Cheshire East 053A,E01033376,1121,1084,37,22,12,3,0
2021,Cheshire East 053E,E01033378,1482,1463,19,10,8,1,0
2021,Portsmouth 024E,E01033380,1121,933,188,114,61,13,0
2021,Portsmouth 027D,E01033381,1435,1129,306,160,109,33,4
2021,Portsmouth 027B,E01033383,1245,1087,158,58,71,26,3
2021,Portsmouth 024F,E01033384,1317,1237,80,48,22,8,2
2021,Charnwood 001E,E01033386,1970,1688,282,102,118,57,5
2021,Chesterfield 010F,E01033387,1160,1094,66,36,24,5,1
2021,Chesterfield 010G,E01033388,1669,1598,71,39,23,8,1
2021,Mansfield 013G,E01033389,1372,1255,117,50,37,26,4
2021,Mansfield 013H,E01033390,1633,1510,123,59,43,18,3
2021,Mansfield 013I,E01033391,1169,1142,27,10,13,3,1
2021,Mansfield 006G,E01033392,2543,2343,200,79,74,38,9
2021,Newark and Sherwood 012G,E01033394,1422,1398,24,13,10,1,0
2021,Nottingham 026G,E01033395,3219,2677,542,273,243,26,0
2021,Nottingham 026H,E01033396,1063,841,222,100,86,32,4
2021,Nottingham 006F,E01033397,1874,1583,291,131,107,48,5
2021,Nottingham 006G,E01033398,1119,876,243,117,84,42,0
2021,Nottingham 023E,E01033399,2564,2205,359,159,154,46,0
2021,Nottingham 039B,E01033400,2693,2093,600,313,221,62,4
2021,Nottingham 039C,E01033402,1344,856,488,236,192,60,0
2021,Nottingham 039F,E01033407,1185,937,248,156,76,15,1
2021,Nottingham 023H,E01033409,1534,1389,145,60,58,26,1
2021,Nottingham 031I,E01033410,2649,2325,324,158,134,27,5
2021,Nottingham 023I,E01033411,1107,842,265,65,130,64,6
2021,Broxtowe 016F,E01033412,2229,2197,32,14,11,4,3
2021,Broxtowe 016G,E01033413,2101,2048,53,21,23,9,0
2021,North East Lincolnshire 009E,E01033414,2717,2611,106,45,50,11,0
2021,Reading 019B,E01033415,2101,1255,846,491,230,89,36
2021,Reading 010F,E01033417,1174,848,326,168,101,37,20
2021,Reading 019A,E01033418,1370,940,430,297,105,26,2
2021,Reading 020B,E01033420,1244,778,466,276,119,57,14
2021,Reading 010G,E01033421,2337,1733,604,366,157,65,16
2021,Reading 019D,E01033422,1322,812,510,225,172,92,21
2021,Reading 020A,E01033423,1749,1070,679,391,202,74,12
2021,East Cambridgeshire 004F,E01033425,1954,1833,121,73,40,7,1
2021,East Cambridgeshire 003F,E01033426,1574,1484,90,61,23,6,0
2021,East Cambridgeshire 006G,E01033427,1243,1148,95,48,28,14,5
2021,East Cambridgeshire 006H,E01033429,1942,1755,187,76,74,31,6
2021,East Cambridgeshire 003G,E01033430,1376,1256,120,55,44,18,3
2021,Bedford 004F,E01033431,1698,1556,142,69,50,23,0
2021,Norwich 011G,E01033434,1126,972,154,105,35,9,5
2021,Norwich 005G,E01033435,1978,1672,306,146,113,38,9
2021,Norwich 005H,E01033436,1994,1769,225,98,77,40,10
2021,Norwich 011H,E01033437,1452,1236,216,101,77,35,3
2021,Norwich 014A,E01033438,1908,1675,233,113,79,28,13
2021,Norwich 014C,E01033440,1511,1173,338,175,124,33,6
2021,Norwich 014D,E01033441,1376,1149,227,142,71,14,0
2021,East Suffolk 025F,E01033442,1542,1478,64,44,20,0,0
2021,East Suffolk 023B,E01033443,1508,1443,65,47,15,3,0
2021,East Suffolk 025G,E01033444,1489,1418,71,52,15,3,1
2021,East Suffolk 023C,E01033445,1687,1654,33,14,15,4,0
2021,East Suffolk 023D,E01033446,2837,2788,49,34,13,2,0
2021,East Suffolk 025H,E01033447,1423,1390,33,25,4,4,0
2021,East Suffolk 023E,E01033448,1266,1251,15,10,4,1,0
2021,East Suffolk 023F,E01033449,1836,1792,44,26,14,4,0
2021,East Suffolk 028E,E01033450,2273,2250,23,14,4,5,0
2021,West Suffolk 007C,E01033452,1592,1489,103,45,42,15,1
2021,West Suffolk 007D,E01033454,1697,1599,98,63,25,8,2
2021,Brent 031G,E01033455,1095,639,456,132,218,96,10
2021,Brent 027F,E01033456,2547,1915,632,220,262,128,22
2021,Brent 035A,E01033457,1905,1149,756,267,286,178,25
2021,Braintree 009E,E01033458,1543,1295,248,107,98,38,5
2021,Braintree 009F,E01033459,1693,1481,212,88,92,26,6
2021,Braintree 017F,E01033460,1951,1871,80,42,27,11,0
2021,Braintree 017G,E01033461,1430,1368,62,43,10,9,0
2021,Braintree 017H,E01033462,994,939,55,18,29,7,1
2021,Brent 003G,E01033463,3070,1816,1254,473,512,221,48
2021,Hartlepool 001F,E01033465,1903,1882,21,10,9,1,1
2021,Hartlepool 003I,E01033466,2191,2117,74,17,31,21,5
2021,Hartlepool 001G,E01033467,2162,2138,24,14,7,3,0
2021,Middlesbrough 006E,E01033469,2116,1905,211,77,88,42,4
2021,Redcar and Cleveland 022G,E01033470,1793,1593,200,39,76,72,13
2021,Redcar and Cleveland 009F,E01033471,2036,2000,36,11,12,11,2
2021,Redcar and Cleveland 019G,E01033472,2333,2315,18,9,4,4,1
2021,Redcar and Cleveland 013E,E01033473,2134,2124,10,3,4,3,0
2021,Stockton-on-Tees 027C,E01033474,2610,2529,81,51,21,8,1
2021,Stockton-on-Tees 028A,E01033475,1840,1766,74,37,25,9,3
2021,Stockton-on-Tees 005F,E01033476,1889,1818,71,46,21,1,3
2021,Stockton-on-Tees 027A,E01033479,1717,1664,53,30,19,4,0
2021,Stockton-on-Tees 005G,E01033480,2813,2774,39,24,9,3,3
2021,Darlington 001E,E01033481,1682,1637,45,25,13,7,0
2021,Darlington 001F,E01033482,1609,1584,25,8,10,6,1
2021,Brent 031H,E01033485,1593,1101,492,181,186,109,16
2021,Islington 011E,E01033486,1004,808,196,105,49,41,1
2021,Islington 011F,E01033487,1154,877,277,211,48,17,1
2021,Islington 011G,E01033488,1614,1132,482,224,209,42,7
2021,Islington 022G,E01033489,1419,1003,416,316,81,19,0
2021,Islington 022H,E01033490,1367,1007,360,207,118,30,5
2021,Islington 011H,E01033491,1865,1468,397,212,124,58,3
2021,Islington 006F,E01033493,1260,1030,230,194,32,3,1
2021,Islington 006G,E01033494,1486,1267,219,154,36,26,3
2021,East Riding of Yorkshire 032G,E01033495,1460,1411,49,38,6,3,2
2021,East Riding of Yorkshire 032H,E01033496,1536,1503,33,18,12,2,1
2021,Milton Keynes 023E,E01033497,1483,1266,217,102,82,28,5
2021,Milton Keynes 023F,E01033498,1858,1552,306,135,115,53,3
2021,Milton Keynes 014E,E01033499,1975,1349,626,302,246,75,3
2021,Milton Keynes 014F,E01033500,1405,999,406,261,122,21,2
2021,Milton Keynes 016E,E01033501,2092,1784,308,192,98,17,1
2021,Milton Keynes 033A,E01033503,2534,2216,318,188,105,19,6
2021,Milton Keynes 016F,E01033506,2018,1805,213,123,58,27,5
2021,Milton Keynes 034C,E01033508,2702,2269,433,215,168,46,4
2021,Milton Keynes 033B,E01033511,1685,1329,356,174,135,36,11
2021,Milton Keynes 025E,E01033514,1704,1495,209,139,37,27,6
2021,Milton Keynes 025F,E01033515,2047,1783,264,180,59,22,3
2021,Milton Keynes 025G,E01033517,1563,1410,153,101,37,15,0
2021,Milton Keynes 028E,E01033519,2834,2449,385,257,90,30,8
2021,Milton Keynes 028F,E01033520,1808,1630,178,108,60,6,4
2021,Milton Keynes 036E,E01033522,1837,1605,232,127,84,19,2
2021,Milton Keynes 036D,E01033523,1442,1232,210,132,58,19,1
2021,Shropshire 038H,E01033526,1033,996,37,15,16,6,0
2021,Shropshire 038I,E01033527,1246,1220,26,18,6,1,1
2021,Shropshire 006H,E01033528,2295,2224,71,36,24,9,2
2021,Shropshire 030E,E01033530,1854,1833,21,11,10,0,0
2021,South Derbyshire 002F,E01033532,1497,1450,47,21,12,11,3
2021,South Derbyshire 002G,E01033533,1555,1528,27,16,8,1,2
2021,South Derbyshire 002H,E01033534,988,939,49,30,15,4,0
2021,South Derbyshire 013D,E01033535,1451,1418,33,17,11,5,0
2021,South Derbyshire 012D,E01033536,1758,1700,58,18,33,7,0
2021,South Derbyshire 012E,E01033537,1562,1531,31,20,8,3,0
2021,South Norfolk 015G,E01033539,2056,1833,223,86,87,41,9
2021,South Norfolk 016E,E01033540,1478,1433,45,22,17,4,2
2021,South Norfolk 015H,E01033541,1404,1276,128,44,47,29,8
2021,Newcastle upon Tyne 036C,E01033543,1812,1268,544,270,209,64,1
2021,Newcastle upon Tyne 036D,E01033545,2037,1408,629,351,210,63,5
2021,Newcastle upon Tyne 025E,E01033547,2562,2248,314,130,116,60,8
2021,Newcastle upon Tyne 037C,E01033548,1440,1194,246,148,68,24,6
2021,Newcastle upon Tyne 002F,E01033550,2005,1925,80,56,14,5,5
2021,Newcastle upon Tyne 002G,E01033551,1782,1702,80,46,23,10,1
2021,Newcastle upon Tyne 037B,E01033553,2975,2442,533,344,152,36,1
2021,Newcastle upon Tyne 022H,E01033556,2558,1973,585,249,186,127,23
2021,Birmingham 134B,E01033557,2089,1437,652,411,187,47,7
2021,Birmingham 049E,E01033559,1452,1228,224,118,82,24,0
2021,Birmingham 050E,E01033561,2540,2103,437,208,162,60,7
2021,Birmingham 087F,E01033562,2492,1985,507,227,195,72,13
2021,Birmingham 136C,E01033564,1138,791,347,241,85,18,3
2021,Birmingham 137B,E01033565,1385,1109,276,162,95,17,2
2021,Birmingham 135B,E01033567,1091,672,419,190,170,54,5
2021,Kingston upon Thames 004G,E01033569,1760,1305,455,264,122,60,9
2021,Richmond upon Thames 004G,E01033570,1816,1372,444,300,102,39,3
2021,Richmond upon Thames 004H,E01033571,1449,1314,135,81,38,16,0
2021,Newham 040C,E01033579,1836,1323,513,308,149,49,7
2021,Newham 042A,E01033580,1353,888,465,272,140,46,7
2021,Newham 041A,E01033581,1825,1355,470,209,170,82,9
2021,Newham 041B,E01033582,1363,769,594,282,222,82,8
2021,Newham 034I,E01033584,1654,1246,408,156,154,88,10
2021,Newham 040D,E01033586,2040,1504,536,255,195,77,9
2021,Barking and Dagenham 021E,E01033587,2253,1637,616,295,236,74,11
2021,Redbridge 039B,E01033589,1820,903,917,494,263,145,15
2021,Redbridge 037C,E01033590,1158,838,320,149,129,38,4
2021,Redbridge 039A,E01033591,2805,1683,1122,401,454,230,37
2021,Redbridge 037D,E01033592,1905,1428,477,213,182,74,8
2021,Westminster 015F,E01033593,1676,1147,529,313,165,44,7
2021,Westminster 015G,E01033594,1472,897,575,403,113,56,3
2021,Westminster 023F,E01033597,980,705,275,151,90,30,4
2021,Westminster 009F,E01033598,1340,875,465,189,149,100,27
2021,Westminster 023G,E01033599,1277,989,288,138,99,35,16
2021,Westminster 009G,E01033601,1838,1284,554,253,175,104,22
2021,Westminster 009H,E01033602,1480,1014,466,185,153,104,24
2021,Westminster 009I,E01033603,1216,792,424,210,151,53,10
2021,Westminster 009J,E01033604,1147,664,483,196,179,102,6
2021,Westminster 009K,E01033605,1589,1058,531,241,175,98,17
2021,East Hertfordshire 010E,E01033609,2534,2494,40,25,14,1,0
2021,Thurrock 019B,E01033610,1632,1379,253,118,105,24,6
2021,Thurrock 019C,E01033611,1650,1348,302,126,131,37,8
2021,Thurrock 020D,E01033612,1548,1310,238,124,76,34,4
2021,Thurrock 019D,E01033613,1514,1263,251,114,97,35,5
2021,Thurrock 020E,E01033614,1782,1601,181,73,77,28,3
2021,Birmingham 135C,E01033615,1073,693,380,177,135,62,6
2021,Birmingham 135D,E01033616,1221,895,326,142,124,55,5
2021,Birmingham 050F,E01033617,5647,4702,945,497,321,119,8
2021,Birmingham 137C,E01033618,1203,911,292,214,60,18,0
2021,Birmingham 138A,E01033620,1064,673,391,198,118,61,14
2021,Birmingham 138B,E01033622,1832,1418,414,250,125,38,1
2021,Birmingham 138C,E01033623,1445,1181,264,114,122,26,2
2021,Birmingham 134C,E01033624,1538,1100,438,260,126,45,7
2021,Birmingham 138D,E01033625,1673,1096,577,344,168,55,10
2021,Birmingham 134D,E01033626,1139,849,290,131,118,36,5
2021,Birmingham 137E,E01033627,1084,750,334,151,121,54,8
2021,Birmingham 106F,E01033629,2479,2257,222,86,94,36,6
2021,Birmingham 031H,E01033630,1173,922,251,102,100,44,5
2021,Birmingham 049F,E01033638,1854,1329,525,145,221,137,22
2021,Birmingham 134E,E01033640,1922,1428,494,206,186,96,6
2021,Birmingham 063F,E01033642,3235,2223,1012,260,362,321,69
2021,Birmingham 082F,E01033643,3119,2086,1033,221,395,337,80
2021,Birmingham 031I,E01033646,1745,1381,364,103,177,76,8
2021,Birmingham 084F,E01033648,2605,2012,593,140,200,208,45
2021,Birmingham 058F,E01033649,2001,1329,672,220,211,187,54
2021,Birmingham 077F,E01033650,2708,1876,832,136,307,306,83
2021,Manchester 054B,E01033651,1662,1345,317,177,106,31,3
2021,Manchester 055B,E01033653,1840,1232,608,289,148,103,68
2021,Manchester 055C,E01033654,1784,1173,611,238,331,36,6
2021,Manchester 056B,E01033655,1251,1010,241,157,72,12,0
2021,Manchester 057B,E01033656,2708,2126,582,301,250,30,1
2021,Manchester 054C,E01033658,1383,1044,339,208,101,26,4
2021,Manchester 059B,E01033660,1431,1297,134,93,31,7,3
2021,Manchester 055E,E01033661,1976,1820,156,110,26,19,1
2021,Manchester 057C,E01033662,2006,1210,796,388,326,81,1
2021,Manchester 054D,E01033664,1807,1397,410,226,146,32,6
2021,Manchester 056C,E01033665,1496,1190,306,194,85,22,5
2021,Manchester 054E,E01033667,1480,1222,258,166,56,35,1
2021,Manchester 015F,E01033668,1113,913,200,104,61,31,4
2021,Manchester 015G,E01033669,1378,1161,217,67,79,52,19
2021,Manchester 039E,E01033670,1406,1268,138,90,36,10,2
2021,Manchester 039F,E01033671,1714,1600,114,71,27,12,4
2021,Manchester 059C,E01033672,1650,1363,287,174,88,20,5
2021,Manchester 059D,E01033673,1434,1288,146,107,29,7,3
2021,Manchester 058C,E01033674,2041,1621,420,160,139,106,15
2021,Manchester 058D,E01033675,2100,1395,705,252,271,153,29
2021,Manchester 056D,E01033676,1906,1416,490,165,186,108,31
2021,Manchester 060A,E01033677,999,733,266,188,61,15,2
2021,Manchester 009F,E01033678,1700,1307,393,145,173,64,11
2021,Manchester 009G,E01033679,1340,1063,277,111,94,67,5
2021,Manchester 028E,E01033680,1206,931,275,127,93,37,18
2021,Manchester 060B,E01033681,1314,1136,178,126,42,7,3
2021,Manchester 060C,E01033682,1206,1072,134,89,29,15,1
2021,Manchester 062D,E01033684,1800,1565,235,155,59,21,0
2021,Manchester 003F,E01033685,1521,1330,191,73,72,40,6
2021,Manchester 028F,E01033686,1272,1054,218,105,70,37,6
2021,Manchester 003G,E01033687,1305,1140,165,66,50,39,10
2021,Manchester 062B,E01033688,1645,1392,253,101,80,58,14
2021,Bradford 020E,E01033689,1219,1099,120,67,37,13,3
2021,Bradford 065C,E01033690,1770,1033,737,363,222,126,26
2021,Bradford 065B,E01033691,2186,1391,795,300,291,165,39
2021,Bradford 064D,E01033692,1078,754,324,162,105,47,10
2021,Bradford 064A,E01033693,2719,1852,867,233,332,240,62
2021,Bradford 020F,E01033694,1025,967,58,24,30,4,0
2021,Bradford 049H,E01033695,2071,1931,140,62,42,29,7
2021,Bradford 049I,E01033696,1559,1495,64,23,25,13,3
2021,Bradford 049J,E01033697,2690,1878,812,154,316,297,45
2021,Hackney 030A,E01033699,1366,1031,335,191,92,47,5
2021,Hackney 030B,E01033700,2428,1921,507,322,105,68,12
2021,Hackney 028C,E01033702,1362,1087,275,113,84,66,12
2021,Hackney 010F,E01033703,1367,1081,286,131,90,57,8
2021,Hackney 023F,E01033704,2291,1893,398,254,87,54,3
2021,Hackney 028D,E01033705,1387,1066,321,163,77,72,9
2021,Hackney 033B,E01033706,1421,1037,384,280,77,24,3
2021,Hackney 033C,E01033708,1849,1308,541,368,127,41,5
2021,Hackney 032B,E01033709,1726,1280,446,276,106,56,8
2021,Hackney 028E,E01033710,1102,836,266,142,81,30,13
2021,Hackney 032C,E01033711,1888,1261,627,451,139,32,5
2021,Hackney 023G,E01033712,1497,1228,269,150,68,42,9
2021,Hackney 010G,E01033713,1278,1053,225,121,67,33,4
2021,Northumberland 033F,E01033714,2865,2793,72,42,20,9,1
2021,Northumberland 005D,E01033715,1036,1003,33,16,7,9,1
2021,Northumberland 013F,E01033716,2225,2216,9,6,3,0,0
2021,Northumberland 005E,E01033717,1509,1494,15,8,5,2,0
2021,Northumberland 016F,E01033718,1926,1905,21,13,4,2,2
2021,Colchester 008G,E01033719,2009,1438,571,330,209,29,3
2021,Colchester 002F,E01033720,1976,1793,183,119,57,6,1
2021,Colchester 002G,E01033721,1695,1606,89,61,20,8,0
2021,Colchester 008H,E01033722,1598,1314,284,159,91,32,2
2021,Greenwich 035B,E01033727,2630,2056,574,320,180,60,14
2021,Greenwich 035C,E01033728,1693,1313,380,262,87,28,3
2021,Greenwich 030E,E01033729,2413,2112,301,145,121,29,6
2021,Greenwich 041E,E01033732,1034,808,226,159,56,10,1
2021,Greenwich 039B,E01033734,1404,1189,215,134,55,23,3
2021,Greenwich 042D,E01033735,1187,737,450,208,131,84,27
2021,Greenwich 039A,E01033736,2150,1608,542,411,97,30,4
2021,Greenwich 042B,E01033737,1856,1363,493,230,170,79,14
2021,Greenwich 037D,E01033738,1781,1354,427,249,125,46,7
2021,Greenwich 002E,E01033739,1628,1291,337,171,113,49,4
2021,Greenwich 002F,E01033740,1548,1201,347,155,122,62,8
2021,Greenwich 002G,E01033741,2618,2179,439,200,138,80,21
2021,Greenwich 007F,E01033742,1279,975,304,166,83,55,0
2021,Greenwich 002H,E01033743,1856,1529,327,154,102,58,13
2021,Greenwich 007G,E01033744,1726,1388,338,130,152,48,8
2021,Greenwich 002I,E01033745,1688,1420,268,123,92,45,8
2021,Greenwich 038E,E01033746,1404,1263,141,92,32,14,3
2021,Liverpool 018F,E01033747,1829,1536,293,110,126,52,5
2021,Liverpool 050I,E01033748,1174,1054,120,68,32,14,6
2021,Liverpool 061A,E01033750,2150,1876,274,167,64,40,3
2021,Liverpool 062A,E01033751,2468,2246,222,146,57,18,1
2021,Liverpool 061C,E01033756,1002,692,310,157,119,27,7
2021,Liverpool 037E,E01033757,1293,973,320,105,176,38,1
2021,Liverpool 060B,E01033758,1950,1376,574,212,293,69,0
2021,Liverpool 060C,E01033760,2475,2158,317,161,138,18,0
2021,Liverpool 060D,E01033761,2137,1643,494,271,163,54,6
2021,Liverpool 060E,E01033762,3664,3063,601,377,182,42,0
2021,Liverpool 031G,E01033763,2401,1863,538,196,195,125,22
2021,Liverpool 061D,E01033765,1466,1318,148,76,42,23,7
2021,Liverpool 050J,E01033767,954,887,67,27,21,17,2
2021,Liverpool 037F,E01033768,1115,983,132,54,40,36,2
2021,Bassetlaw 014F,E01033769,1938,1923,15,7,4,4,0
2021,Newark and Sherwood 001G,E01033770,1252,1214,38,22,11,5,0
2021,Newark and Sherwood 001H,E01033771,1242,1234,8,3,2,2,1
2021,Newark and Sherwood 002F,E01033772,1290,1249,41,26,14,1,0
2021,Newark and Sherwood 002G,E01033773,1505,1472,33,20,8,5,0
2021,Newark and Sherwood 002H,E01033774,1383,1353,30,7,14,9,0
2021,Mansfield 007G,E01033775,1638,1595,43,22,12,9,0
2021,Mansfield 007H,E01033776,1485,1457,28,12,7,8,1
2021,Newark and Sherwood 012H,E01033777,1416,1325,91,48,27,13,3
2021,Ashfield 013F,E01033778,1296,1254,42,25,11,6,0
2021,Ashfield 013G,E01033779,1225,1170,55,26,21,5,3
2021,Newark and Sherwood 012I,E01033780,1580,1517,63,26,24,12,1
2021,Ashfield 013H,E01033781,1182,1124,58,21,22,13,2
2021,Ashfield 013I,E01033782,1336,1315,21,11,8,1,1
2021,Ashfield 013J,E01033783,1361,1299,62,36,19,7,0
2021,Havering 007F,E01033784,1479,1328,151,75,52,23,1
2021,Havering 007G,E01033785,1266,1104,162,87,51,21,3
2021,Havering 017G,E01033786,1224,793,431,235,149,40,7
2021,Havering 017H,E01033787,1385,998,387,219,133,28,7
2021,Havering 017I,E01033788,1488,1218,270,116,109,35,10
2021,Bexley 008H,E01033789,1667,1426,241,150,68,20,3
2021,Bexley 008I,E01033790,1283,1125,158,69,58,27,4
2021,Bexley 019G,E01033791,1310,1130,180,83,65,31,1
2021,Bexley 019H,E01033792,1329,1252,77,46,16,15,0
2021,St. Helens 013D,E01033793,1193,1148,45,20,18,6,1
2021,St. Helens 013E,E01033794,1645,1604,41,23,9,6,3
2021,St. Helens 022G,E01033795,1451,1438,13,8,3,2,0
2021,St. Helens 022H,E01033796,1585,1504,81,37,37,6,1
2021,Sefton 004H,E01033797,1111,945,166,44,59,54,9
2021,Sefton 004I,E01033798,1017,730,287,87,119,70,11
2021,Sefton 018G,E01033799,1369,1359,10,7,3,0,0
2021,Sefton 018H,E01033800,1648,1639,9,5,0,2,2
2021,Luton 022C,E01033801,1723,1020,703,285,295,109,14
2021,Luton 022D,E01033802,1515,828,687,274,299,104,10
2021,Luton 023A,E01033803,1490,846,644,273,262,99,10
2021,Luton 023B,E01033804,1114,573,541,154,255,111,21
2021,Luton 023C,E01033805,1220,726,494,238,179,71,6
2021,Luton 021G,E01033806,1424,916,508,166,236,89,17
2021,Luton 021H,E01033807,1664,1010,654,247,291,100,16
2021,Central Bedfordshire 006E,E01033808,1255,1202,53,39,11,2,1
2021,Central Bedfordshire 006F,E01033809,1354,1291,63,39,17,6,1
2021,Central Bedfordshire 006G,E01033810,1379,1343,36,31,4,1,0
2021,Central Bedfordshire 006H,E01033811,1469,1420,49,27,18,2,2
2021,Central Bedfordshire 006I,E01033812,1283,1233,50,31,13,3,3
2021,Central Bedfordshire 006J,E01033813,1104,1074,30,16,13,1,0
2021,Central Bedfordshire 007H,E01033814,1828,1156,672,372,252,35,13
2021,Central Bedfordshire 007I,E01033815,1268,1191,77,60,11,6,0
2021,Central Bedfordshire 007J,E01033816,1250,1194,56,36,18,2,0
2021,Central Bedfordshire 008F,E01033817,1454,1425,29,19,8,2,0
2021,Central Bedfordshire 008G,E01033818,1418,1330,88,47,34,5,2
2021,Central Bedfordshire 009F,E01033819,1580,1517,63,46,11,5,1
2021,Central Bedfordshire 009G,E01033820,1614,1583,31,19,10,2,0
2021,Central Bedfordshire 009H,E01033821,1208,1152,56,33,16,5,2
2021,Central Bedfordshire 009I,E01033822,1291,1223,68,45,18,2,3
2021,Central Bedfordshire 009J,E01033823,999,958,41,28,8,5,0
2021,Central Bedfordshire 017F,E01033824,1656,1619,37,19,13,5,0
2021,Central Bedfordshire 017G,E01033825,1612,1582,30,22,6,1,1
2021,Central Bedfordshire 019F,E01033826,1073,997,76,56,17,3,0
2021,Central Bedfordshire 019G,E01033827,1925,1884,41,25,11,4,1
2021,Central Bedfordshire 024H,E01033828,1254,1190,64,43,16,5,0
2021,Central Bedfordshire 024I,E01033829,1158,1096,62,31,24,5,2
2021,Central Bedfordshire 024J,E01033830,1022,966,56,30,20,6,0
2021,Central Bedfordshire 024K,E01033831,979,952,27,16,10,0,1
2021,Central Bedfordshire 024L,E01033832,1156,1064,92,64,19,5,4
2021,Central Bedfordshire 024M,E01033833,1461,1422,39,14,22,2,1
2021,Central Bedfordshire 028G,E01033834,1524,1278,246,97,121,27,1
2021,Central Bedfordshire 028H,E01033835,1414,1216,198,92,81,22,3
2021,Central Bedfordshire 029F,E01033836,1608,1264,344,172,138,28,6
2021,Central Bedfordshire 029G,E01033837,1478,1202,276,113,126,33,4
2021,Reading 020C,E01033838,1298,839,459,243,173,42,1
2021,Reading 020D,E01033839,1644,1196,448,276,134,34,4
2021,Swindon 008E,E01033840,1486,1354,132,82,39,10,1
2021,Swindon 008F,E01033841,1405,1305,100,67,22,11,0
2021,Swindon 008G,E01033842,1497,1368,129,80,37,11,1
2021,Swindon 008H,E01033843,1299,1281,18,10,4,4,0
2021,Swindon 008I,E01033844,1527,1435,92,59,26,6,1
2021,Swindon 015E,E01033845,1642,1147,495,270,148,64,13
2021,Swindon 015F,E01033846,1509,1120,389,158,144,77,10
2021,Swindon 024E,E01033847,1600,1554,46,34,8,4,0
2021,Swindon 024F,E01033848,1877,1665,212,125,64,21,2
2021,Swindon 025G,E01033849,2074,1802,272,164,79,21,8
2021,Swindon 025H,E01033850,2114,2057,57,33,15,9,0
2021,West Berkshire 007F,E01033851,3185,3072,113,70,36,7,0
2021,West Berkshire 019E,E01033852,1533,1470,63,39,16,6,2
2021,West Berkshire 019F,E01033853,1692,1622,70,53,8,6,3
2021,West Berkshire 019G,E01033854,1545,1403,142,94,41,6,1
2021,West Berkshire 019H,E01033855,1144,928,216,118,80,13,5
2021,West Berkshire 019I,E01033856,1059,813,246,152,76,15,3
2021,Reading 017G,E01033857,2053,1606,447,178,187,61,21
2021,Reading 017H,E01033858,1607,1161,446,258,123,55,10
2021,Reading 017I,E01033859,1323,930,393,223,119,44,7
2021,Swindon 028F,E01033860,1751,1592,159,81,53,25,0
2021,Swindon 028G,E01033861,1768,1616,152,98,32,17,5
2021,Lambeth 003F,E01033862,1371,995,376,219,123,34,0
2021,Lambeth 003G,E01033863,1286,1015,271,112,98,56,5
2021,Lambeth 004H,E01033864,1012,800,212,102,60,44,6
2021,Lambeth 004I,E01033865,1497,1055,442,251,152,28,11
2021,Lambeth 004J,E01033866,1104,695,409,248,138,22,1
2021,Southwark 002F,E01033867,1521,1190,331,214,84,30,3
2021,Southwark 002G,E01033868,1381,965,416,270,123,21,2
2021,Southwark 004F,E01033869,1416,1180,236,130,64,31,11
2021,Southwark 004G,E01033870,1708,1355,353,231,81,35,6
2021,Southwark 004H,E01033871,1467,1188,279,173,73,28,5
2021,Southwark 004I,E01033872,1266,1043,223,139,57,26,1
2021,Southwark 009G,E01033873,1699,1203,496,209,184,74,29
2021,Southwark 009H,E01033874,1132,790,342,212,105,23,2
2021,Southwark 012G,E01033875,1282,1022,260,151,64,39,6
2021,Southwark 012H,E01033876,1218,887,331,206,92,30,3
2021,Southwark 012I,E01033877,1493,1174,319,163,95,57,4
2021,Southwark 015F,E01033878,1071,815,256,77,99,58,22
2021,Southwark 015G,E01033879,2452,1935,517,206,193,102,16
2021,Southwark 015H,E01033880,2054,1056,998,194,320,371,113
2021,Southwark 016F,E01033881,1834,1436,398,148,142,92,16
2021,Southwark 022G,E01033882,1356,1125,231,66,87,65,13
2021,Southwark 022H,E01033883,1552,1339,213,116,58,33,6
2021,Southwark 035A,E01033884,1079,835,244,151,73,19,1
2021,Southwark 036A,E01033885,1293,1072,221,140,58,20,3
2021,Sandwell 014F,E01033886,1561,1415,146,68,52,24,2
2021,Sandwell 014G,E01033887,1483,1354,129,49,46,27,7
2021,Sandwell 018F,E01033888,1470,960,510,175,184,126,25
2021,Sandwell 018G,E01033889,1865,1309,556,177,242,115,22
2021,Sandwell 040B,E01033890,1394,964,430,115,170,114,31
2021,Sandwell 040C,E01033891,1563,948,615,181,255,144,35
2021,Sandwell 041A,E01033892,1946,1342,604,202,224,149,29
2021,Sandwell 041C,E01033893,1567,1122,445,166,163,94,22
2021,Walsall 013F,E01033894,1708,1522,186,78,78,26,4
2021,Walsall 013G,E01033895,1572,1340,232,93,107,28,4
2021,Walsall 030F,E01033896,1487,999,488,104,179,167,38
2021,Walsall 030G,E01033897,1345,949,396,109,151,118,18
2021,Bradford 030E,E01033898,1450,1151,299,92,117,76,14
2021,Bradford 030F,E01033899,1526,1176,350,105,126,106,13
2021,Bradford 044G,E01033900,1506,946,560,128,197,178,57
2021,Bradford 044H,E01033901,1559,1026,533,104,200,172,57
2021,Bristol 054F,E01033902,1270,1026,244,179,49,13,3
2021,Bristol 054G,E01033903,1126,858,268,167,80,21,0
2021,Bristol 060B,E01033904,2367,1993,374,204,157,11,2
2021,Bristol 060C,E01033905,1375,1109,266,165,85,12,4
2021,Bristol 060E,E01033906,1095,793,302,215,69,18,0
2021,Bristol 061A,E01033907,1803,1231,572,232,247,80,13
2021,Bristol 061B,E01033908,1473,1219,254,185,55,12,2
2021,Bristol 061C,E01033909,2134,1838,296,205,70,21,0
2021,Bristol 061E,E01033910,1343,1143,200,98,64,30,8
2021,Barnet 017E,E01033911,1814,1521,293,177,78,27,11
2021,Barnet 017F,E01033912,1605,1292,313,188,80,40,5
2021,Barnet 024G,E01033913,1468,954,514,169,228,102,15
2021,Barnet 024H,E01033914,1705,1077,628,232,292,86,18
2021,Barnet 042A,E01033915,1404,930,474,202,152,93,27
2021,Barnet 042B,E01033916,1708,819,889,297,341,199,52
2021,Barnet 042C,E01033917,1454,911,543,242,224,68,9
2021,Barnet 042D,E01033918,1502,1008,494,286,149,55,4
2021,Barnet 042E,E01033919,1264,768,496,267,164,59,6
2021,Barnet 042F,E01033920,1416,845,571,283,177,106,5
2021,Barnet 043A,E01033921,1578,995,583,291,208,73,11
2021,Barnet 043B,E01033922,1616,942,674,331,247,86,10
2021,Barnet 043C,E01033923,1501,1022,479,193,194,82,10
2021,Barnet 043D,E01033924,1487,954,533,192,216,110,15
2021,Barnet 043E,E01033925,1655,1064,591,274,206,99,12
2021,Enfield 014E,E01033926,2500,1843,657,194,246,176,41
2021,Enfield 020F,E01033927,1580,934,646,258,242,127,19
2021,Enfield 020G,E01033928,1251,759,492,195,190,91,16
2021,Brent 002F,E01033929,1261,897,364,198,119,38,9
2021,Brent 002G,E01033930,1774,1241,533,222,200,97,14
2021,Brent 009F,E01033931,1302,897,405,145,167,80,13
2021,Brent 009G,E01033932,1622,1139,483,186,199,79,19
2021,Brent 010G,E01033933,1417,847,570,152,226,158,34
2021,Brent 010H,E01033934,1593,933,660,257,199,175,29
2021,Brent 020F,E01033935,1942,1165,777,282,263,182,50
2021,Brent 020G,E01033936,1579,1003,576,253,222,92,9
2021,Brent 027G,E01033937,1133,867,266,69,113,73,11
2021,Brent 027H,E01033938,1181,933,248,99,80,59,10
2021,Brent 027I,E01033939,1795,1161,634,359,175,85,15
2021,Brent 035B,E01033940,2282,1598,684,432,210,35,7
2021,Brent 035C,E01033941,1497,983,514,307,144,55,8
2021,Brent 035D,E01033942,1542,1076,466,274,148,37,7
2021,Haringey 015E,E01033943,2410,1437,973,387,384,167,35
2021,Haringey 015F,E01033944,2435,1773,662,286,249,114,13
2021,Haringey 020G,E01033945,1328,1004,324,174,95,50,5
2021,Haringey 020H,E01033946,1303,1001,302,187,70,38,7
2021,Stockport 014E,E01033947,1486,1334,152,75,50,23,4
2021,Stockport 014F,E01033948,1276,1115,161,71,61,25,4
2021,Tameside 013F,E01033949,1147,872,275,98,102,60,15
2021,Tameside 013G,E01033950,1331,1032,299,94,125,69,11
2021,Buckinghamshire 001C,E01033951,1568,1519,49,28,20,1,0
2021,Buckinghamshire 001D,E01033952,1380,1345,35,23,8,4,0
2021,Buckinghamshire 001E,E01033953,1586,1486,100,77,17,6,0
2021,Buckinghamshire 001F,E01033954,1678,1591,87,57,21,7,2
2021,Buckinghamshire 007E,E01033955,1373,1289,84,64,16,3,1
2021,Buckinghamshire 007F,E01033956,1553,1435,118,82,24,11,1
2021,Buckinghamshire 007G,E01033957,999,870,129,93,29,5,2
2021,Buckinghamshire 009F,E01033958,1522,1365,157,84,50,19,4
2021,Buckinghamshire 009G,E01033959,1450,1294,156,78,61,13,4
2021,Buckinghamshire 011D,E01033960,1581,1320,261,176,71,12,2
2021,Buckinghamshire 011E,E01033961,1600,1328,272,173,78,18,3
2021,Buckinghamshire 011F,E01033962,1558,1400,158,99,44,14,1
2021,Buckinghamshire 011G,E01033963,1483,1296,187,126,44,15,2
2021,Buckinghamshire 011H,E01033964,1409,1256,153,73,65,11,4
2021,Buckinghamshire 021F,E01033965,1464,1450,14,6,5,3,0
2021,Buckinghamshire 021G,E01033966,1566,1511,55,40,10,5,0
2021,Buckinghamshire 011I,E01033967,1395,1269,126,78,36,8,4
2021,Buckinghamshire 024E,E01033968,1877,1794,83,31,43,9,0
2021,Buckinghamshire 024F,E01033969,1418,1369,49,32,12,4,1
2021,Buckinghamshire 040D,E01033970,1509,1465,44,23,11,9,1
2021,Buckinghamshire 040E,E01033971,1653,1613,40,25,9,3,3
2021,Buckinghamshire 051C,E01033972,1683,1462,221,116,74,29,2
2021,Buckinghamshire 051D,E01033973,1186,1065,121,53,54,12,2
2021,Buckinghamshire 051E,E01033974,1330,1209,121,83,28,9,1
2021,Buckinghamshire 051F,E01033975,1326,1215,111,49,46,14,2
2021,Salford 003D,E01033976,1856,1760,96,49,39,8,0
2021,Salford 003E,E01033977,1092,1039,53,24,20,8,1
2021,Salford 008E,E01033978,986,890,96,51,25,17,3
2021,Salford 008F,E01033979,1967,1810,157,66,56,30,5
2021,Salford 017G,E01033980,987,758,229,82,76,62,9
2021,Salford 017H,E01033981,2697,2367,330,137,133,53,7
2021,Salford 021H,E01033982,1833,1605,228,96,82,45,5
2021,Salford 021I,E01033983,1230,964,266,119,105,40,2
2021,Salford 024E,E01033984,2309,1790,519,214,226,73,6
2021,Salford 032A,E01033985,1610,1178,432,168,161,85,18
2021,Salford 032B,E01033986,1474,1090,384,193,118,63,10
2021,Salford 033A,E01033987,1120,859,261,146,89,22,4
2021,Salford 033B,E01033988,1275,1029,246,126,102,16,2
2021,Salford 033C,E01033989,1120,850,270,156,85,26,3
2021,Salford 033D,E01033990,1177,841,336,174,134,25,3
2021,Salford 034A,E01033991,1497,1229,268,132,91,38,7
2021,Salford 034B,E01033992,1363,1160,203,130,53,19,1
2021,Salford 036A,E01033993,1782,1530,252,137,78,35,2
2021,Salford 036B,E01033994,1165,1029,136,87,37,12,0
2021,Salford 037A,E01033995,1185,870,315,179,101,24,11
2021,Salford 037B,E01033996,1194,935,259,148,75,34,2
2021,Salford 037C,E01033997,999,823,176,117,44,12,3
2021,Salford 037D,E01033998,1302,1065,237,159,58,15,5
2021,Salford 037E,E01033999,1181,885,296,197,71,25,3
2021,Trafford 001G,E01034000,1209,958,251,164,69,18,0
2021,Trafford 001H,E01034001,1579,1194,385,149,160,67,9
2021,Charnwood 009G,E01034002,1645,1523,122,58,43,18,3
2021,Charnwood 009H,E01034003,1499,1408,91,50,29,11,1
2021,Charnwood 010G,E01034004,1639,1493,146,100,28,15,3
2021,Charnwood 010H,E01034005,1435,1334,101,56,28,17,0
2021,Charnwood 019E,E01034006,2359,2115,244,127,83,28,6
2021,Charnwood 019F,E01034007,1716,1551,165,95,45,20,5
2021,Leicester 006F,E01034008,1795,699,1096,316,377,294,109
2021,Leicester 006G,E01034009,1595,566,1029,234,325,331,139
2021,Leicester 008F,E01034010,1712,1133,579,211,211,132,25
2021,Leicester 008G,E01034011,1379,772,607,260,218,88,41
2021,Leicester 008H,E01034012,1213,817,396,161,155,72,8
2021,Leicester 023H,E01034013,1909,1453,456,205,180,64,7
2021,Leicester 023I,E01034014,1446,1019,427,188,162,71,6
2021,Leicester 029E,E01034015,1379,960,419,209,171,26,13
2021,Leicester 029F,E01034016,1798,1013,785,284,320,143,38
2021,Leicester 037G,E01034017,1601,1290,311,178,88,42,3
2021,Leicester 037H,E01034018,1437,1198,239,104,92,37,6
2021,Leicester 040E,E01034019,1738,1191,547,206,207,116,18
2021,Leicester 040F,E01034020,3467,2626,841,406,305,111,19
2021,Leicester 040G,E01034021,1278,1037,241,99,105,31,6
2021,Leicester 041E,E01034022,2801,2063,738,269,320,133,16
2021,Leicester 041F,E01034023,1203,753,450,203,148,89,10
2021,Leicester 043A,E01034024,1825,1381,444,188,141,84,31
2021,Leicester 043B,E01034025,1965,1549,416,176,149,69,22
2021,Ealing 015F,E01034026,2468,1620,848,518,266,58,6
2021,Ealing 015G,E01034027,2457,1635,822,411,292,112,7
2021,Ealing 019F,E01034028,1197,860,337,142,137,54,4
2021,Ealing 019G,E01034029,1450,989,461,232,163,58,8
2021,Ealing 042A,E01034030,1791,1164,627,305,198,102,22
2021,Ealing 042B,E01034031,1222,568,654,260,222,141,31
2021,Hounslow 006G,E01034032,1733,1398,335,171,114,44,6
2021,Hounslow 006H,E01034033,1668,1280,388,239,111,36,2
2021,Hounslow 014F,E01034034,1572,1174,398,225,128,43,2
2021,Hounslow 014G,E01034035,1527,1357,170,104,50,14,2
2021,Hounslow 015F,E01034036,1730,1042,688,297,263,111,17
2021,Hounslow 015G,E01034037,1754,1101,653,332,219,81,21
2021,Hounslow 017F,E01034038,1716,1153,563,315,165,68,15
2021,Hounslow 017G,E01034039,1611,1045,566,278,209,67,12
2021,Hounslow 018H,E01034040,1599,1016,583,237,209,119,18
2021,Hounslow 018I,E01034041,1425,882,543,190,225,103,25
2021,Hounslow 030A,E01034042,1159,866,293,154,102,37,0
2021,Hounslow 030B,E01034043,1385,987,398,200,133,57,8
2021,Hounslow 030C,E01034044,1173,918,255,149,77,24,5
2021,Hounslow 031A,E01034045,1705,1221,484,304,141,33,6
2021,Hounslow 031B,E01034046,1882,1481,401,174,140,79,8
2021,Stafford 010F,E01034047,1091,969,122,63,37,20,2
2021,Stafford 010G,E01034048,989,918,71,39,19,12,1
2021,Stafford 011F,E01034049,1453,1402,51,29,18,2,2
2021,Stafford 011G,E01034050,1686,1552,134,67,65,2,0
2021,Stafford 014I,E01034051,2574,2538,36,24,10,2,0
2021,Stoke-on-Trent 009F,E01034052,1098,910,188,70,85,26,7
2021,Stoke-on-Trent 009G,E01034053,1357,1117,240,67,120,49,4
2021,Stoke-on-Trent 016H,E01034054,1022,805,217,113,66,34,4
2021,Stoke-on-Trent 016I,E01034055,1201,902,299,119,128,47,5
2021,Stoke-on-Trent 016J,E01034056,1457,1294,163,53,79,28,3
2021,Stoke-on-Trent 016K,E01034057,1381,1072,309,111,137,51,10
2021,Stoke-on-Trent 032E,E01034058,1677,1566,111,59,42,8,2
2021,Stoke-on-Trent 032F,E01034059,1948,1779,169,116,36,15,2
2021,Gosport 004H,E01034060,2038,1922,116,57,44,15,0
2021,Gosport 004I,E01034061,1085,1056,29,9,14,5,1
2021,Gosport 005F,E01034062,1360,1318,42,21,16,4,1
2021,Gosport 005G,E01034063,1137,1110,27,14,10,3,0
2021,Gosport 008H,E01034064,1331,1297,34,17,14,3,0
2021,Gosport 008I,E01034065,1010,984,26,12,11,3,0
2021,Havant 014G,E01034066,972,932,40,20,14,6,0
2021,Havant 014H,E01034067,1359,1280,79,31,31,13,4
2021,Allerdale 012F,E01034068,2072,1965,107,52,50,5,0
2021,Barrow-in-Furness 007G,E01034069,1936,1898,38,20,14,2,2
2021,Carlisle 013F,E01034070,1082,1045,37,21,14,2,0
2021,Carlisle 013G,E01034071,1512,1484,28,13,12,3,0
2021,Carlisle 013H,E01034072,1173,1143,30,25,5,0,0
2021,Carlisle 013I,E01034073,1363,1348,15,12,3,0,0
2021,Carlisle 013J,E01034074,1722,1693,29,17,7,5,0
2021,Copeland 001E,E01034075,2302,2283,19,7,11,1,0
2021,Copeland 004J,E01034076,1977,1960,17,6,6,4,1
2021,South Lakeland 002F,E01034077,2052,1874,178,94,62,21,1
2021,South Lakeland 006H,E01034078,1188,1149,39,14,18,7,0
2021,South Lakeland 006I,E01034079,1727,1677,50,26,18,5,1
2021,South Lakeland 011F,E01034080,2474,2466,8,4,4,0,0
2021,Chelmsford 001E,E01034081,1580,1478,102,64,28,8,2
2021,Chelmsford 001F,E01034082,1573,1432,141,102,29,7,3
2021,Chelmsford 004G,E01034083,1399,1249,150,102,36,11,1
2021,Chelmsford 004H,E01034084,1738,1671,67,53,7,5,2
2021,Chelmsford 018F,E01034085,1475,1384,91,61,27,1,2
2021,Chelmsford 018G,E01034086,1651,1633,18,14,4,0,0
2021,Chelmsford 021D,E01034087,1374,1348,26,14,11,1,0
2021,Chelmsford 021E,E01034088,1535,1486,49,30,12,2,5
2021,Chelmsford 022A,E01034089,2202,1859,343,225,90,25,3
2021,Chelmsford 022C,E01034090,1255,1063,192,101,73,18,0
2021,Chelmsford 023A,E01034091,1231,961,270,147,95,21,7
2021,Chelmsford 023B,E01034092,1186,990,196,122,58,14,2
2021,Maldon 008H,E01034093,1644,1630,14,9,2,3,0
2021,Maldon 008I,E01034094,1539,1517,22,14,3,3,2
2021,Southend-on-Sea 010G,E01034095,1460,1217,243,125,94,21,3
2021,Southend-on-Sea 010H,E01034096,1614,1380,234,76,110,45,3
2021,Cannock Chase 005E,E01034097,1111,1095,16,7,6,3,0
2021,Cannock Chase 005F,E01034098,2218,2163,55,23,27,5,0
2021,Lichfield 001E,E01034099,1659,1633,26,15,10,1,0
2021,Lichfield 001F,E01034100,1508,1500,8,4,3,1,0
2021,Lichfield 002E,E01034101,1871,1832,39,22,15,2,0
2021,Lichfield 002F,E01034102,1601,1548,53,31,17,3,2
2021,Lichfield 006F,E01034103,1217,1191,26,8,14,3,1
2021,Lichfield 006G,E01034104,1773,1748,25,15,8,2,0
2021,Lichfield 008E,E01034105,1468,1417,51,34,11,5,1
2021,Lichfield 008F,E01034106,1730,1688,42,21,16,4,1
2021,Manchester 002F,E01034107,1351,1128,223,109,70,39,5
2021,Manchester 002G,E01034108,1962,1615,347,139,133,57,18
2021,Manchester 008G,E01034109,1435,853,582,207,226,129,20
2021,Manchester 008H,E01034110,1412,901,511,192,211,93,15
2021,Manchester 017G,E01034111,1504,1255,249,115,90,38,6
2021,Manchester 017H,E01034112,1767,1422,345,123,128,77,17
2021,Manchester 017I,E01034113,1406,1154,252,95,103,42,12
2021,Manchester 017J,E01034114,1819,1495,324,100,112,77,35
2021,Manchester 018F,E01034115,1852,1144,708,324,297,76,11
2021,Manchester 018G,E01034116,1071,679,392,180,152,49,11
2021,Manchester 019E,E01034117,2169,1418,751,420,265,64,2
2021,Manchester 019F,E01034118,981,770,211,64,109,34,4
2021,Manchester 022H,E01034119,2603,1946,657,305,223,121,8
2021,Manchester 023F,E01034120,1710,1401,309,112,121,68,8
2021,Manchester 023G,E01034121,1357,1068,289,140,97,46,6
2021,Manchester 024E,E01034122,1795,1249,546,221,190,111,24
2021,Manchester 024F,E01034123,1680,1257,423,156,164,81,22
2021,Manchester 025F,E01034124,1479,1006,473,168,181,104,20
2021,Manchester 025G,E01034125,1463,912,551,173,219,133,26
2021,Manchester 025H,E01034126,1578,1090,488,229,177,64,18
2021,Manchester 025I,E01034127,1303,964,339,139,125,71,4
2021,Manchester 032F,E01034128,3661,3149,512,195,187,109,21
2021,Manchester 055F,E01034129,1078,975,103,68,32,3,0
2021,Manchester 055G,E01034130,1380,1162,218,162,45,11,0
2021,Manchester 060E,E01034131,1014,768,246,177,59,10,0
2021,Manchester 060F,E01034132,1816,1302,514,274,205,32,3
2021,Manchester 061C,E01034133,1828,1538,290,101,77,101,11
2021,Manchester 061D,E01034134,1183,1061,122,99,18,3,2
2021,Manchester 062A,E01034135,1080,923,157,109,38,7,3
2021,Manchester 062C,E01034136,996,816,180,121,42,17,0
2021,Manchester 063C,E01034137,1640,916,724,189,290,209,36
2021,Manchester 064B,E01034138,1309,644,665,173,271,187,34
2021,Croydon 015F,E01034139,1742,1245,497,233,178,79,7
2021,Croydon 015G,E01034140,1183,792,391,175,145,64,7
2021,Croydon 020F,E01034141,1328,961,367,209,115,34,9
2021,Croydon 020G,E01034142,1403,1055,348,181,118,42,7
2021,Croydon 020H,E01034143,1241,863,378,203,133,36,6
2021,Croydon 024F,E01034144,1260,967,293,144,95,46,8
2021,Croydon 024G,E01034145,1251,926,325,118,131,69,7
2021,Croydon 024H,E01034146,1344,986,358,227,99,28,4
2021,Croydon 046A,E01034147,1076,751,325,216,78,28,3
2021,Croydon 046B,E01034148,1552,1116,436,287,110,34,5
2021,Croydon 046C,E01034149,2030,1517,513,298,144,60,11
2021,Croydon 046D,E01034150,1271,997,274,136,93,42,3
2021,Croydon 046E,E01034151,1120,908,212,122,61,26,3
2021,Croydon 047B,E01034152,1514,1137,377,151,153,62,11
2021,Sutton 004F,E01034153,1346,1129,217,108,81,23,5
2021,Sutton 004G,E01034154,1421,1115,306,176,101,26,3
2021,Sutton 012F,E01034155,1949,1417,532,264,192,67,9
2021,Sutton 012G,E01034156,1320,932,388,193,139,51,5
2021,Plymouth 031G,E01034157,1761,1702,59,38,15,6,0
2021,Plymouth 031H,E01034158,1098,1082,16,5,7,3,1
2021,Plymouth 034B,E01034159,1140,1019,121,58,37,26,0
2021,Plymouth 034C,E01034160,1434,1295,139,74,44,19,2
2021,Plymouth 034D,E01034161,1197,1110,87,36,34,15,2
2021,Plymouth 034E,E01034162,1020,971,49,21,20,6,2
2021,Teignbridge 005E,E01034165,1493,1476,17,9,4,2,2
2021,Teignbridge 005F,E01034166,1806,1779,27,11,12,1,3
2021,Teignbridge 013E,E01034167,1854,1783,71,23,44,3,1
2021,Teignbridge 013F,E01034168,1648,1603,45,30,14,1,0
2021,Torbay 003G,E01034169,1488,1424,64,34,20,10,0
2021,Torbay 003H,E01034170,1330,1276,54,23,24,3,4
2021,Torbay 013H,E01034171,1125,1114,11,5,5,1,0
2021,Torbay 013I,E01034172,1904,1852,52,27,14,11,0
2021,Greenwich 005F,E01034173,1786,1431,355,131,102,102,20
2021,Greenwich 034F,E01034174,1199,928,271,154,81,31,5
2021,Greenwich 034G,E01034175,1235,913,322,214,88,20,0
2021,Greenwich 034H,E01034176,1982,1717,265,114,100,42,9
2021,Greenwich 034I,E01034177,1525,1197,328,191,94,34,9
2021,Greenwich 035E,E01034178,1611,1261,350,245,86,16,3
2021,Greenwich 035F,E01034179,1382,1115,267,165,66,30,6
2021,Greenwich 035G,E01034180,1249,1012,237,100,88,43,6
2021,Greenwich 035H,E01034181,1748,1371,377,273,81,23,0
2021,Greenwich 035I,E01034182,1350,1061,289,189,59,31,10
2021,Greenwich 037E,E01034183,1444,1229,215,149,51,10,5
2021,Greenwich 037F,E01034184,1218,975,243,163,64,15,1
2021,Greenwich 037G,E01034185,1142,978,164,109,35,17,3
2021,Greenwich 039C,E01034186,1313,981,332,242,79,10,1
2021,Greenwich 039D,E01034187,1214,898,316,159,87,54,16
2021,Greenwich 040A,E01034188,1315,1010,305,203,77,23,2
2021,Greenwich 040B,E01034189,1160,834,326,273,41,11,1
2021,Greenwich 040C,E01034190,1618,1298,320,170,100,42,8
2021,Greenwich 040D,E01034191,1556,1231,325,243,50,30,2
2021,Greenwich 040E,E01034192,2158,1856,302,212,63,25,2
2021,Greenwich 041A,E01034193,1420,1080,340,214,95,26,5
2021,Greenwich 041B,E01034194,1246,914,332,247,65,18,2
2021,Greenwich 041C,E01034195,1236,961,275,177,73,22,3
2021,Greenwich 041D,E01034196,1226,918,308,223,66,16,3
2021,Greenwich 042C,E01034198,2212,1574,638,307,212,100,19
2021,Newham 012E,E01034199,1741,1183,558,216,213,120,9
2021,Newham 012F,E01034200,1528,967,561,314,163,67,17
2021,Newham 022E,E01034201,1391,857,534,211,186,118,19
2021,Newham 022F,E01034202,1582,1005,577,187,249,124,17
2021,Newham 025E,E01034203,1287,848,439,142,237,56,4
2021,Newham 025F,E01034204,1894,1110,784,241,325,195,23
2021,Newham 033E,E01034205,1483,897,586,252,218,104,12
2021,Newham 033F,E01034206,1670,1250,420,213,131,61,15
2021,Newham 033G,E01034207,1435,1018,417,263,125,21,8
2021,Newham 034J,E01034208,1868,1454,414,133,181,76,24
2021,Newham 034K,E01034209,1442,892,550,398,126,24,2
2021,Newham 034L,E01034210,1478,1033,445,266,133,43,3
2021,Newham 034M,E01034211,1397,874,523,367,119,35,2
2021,Newham 034N,E01034212,1842,1292,550,368,136,39,7
2021,Newham 038A,E01034213,1693,1340,353,212,104,35,2
2021,Newham 038B,E01034214,1522,1161,361,239,88,28,6
2021,Newham 038C,E01034215,1488,1130,358,224,100,30,4
2021,Newham 038D,E01034216,1671,1298,373,246,101,23,3
2021,Newham 038E,E01034217,1987,1468,519,286,190,39,4
2021,Newham 039B,E01034218,1741,1223,518,228,191,88,11
2021,Newham 039C,E01034219,1819,1430,389,252,110,26,1
2021,Newham 039D,E01034220,1208,845,363,267,78,15,3
2021,Newham 039E,E01034221,1743,1133,610,269,255,76,10
2021,Newham 040A,E01034222,1454,1005,449,270,119,48,12
2021,Newham 040B,E01034223,1318,984,334,228,82,21,3
2021,Newham 041D,E01034224,1684,1229,455,216,149,71,19
2021,Newham 042B,E01034225,1433,1135,298,150,94,50,4
2021,Newham 042C,E01034226,1346,952,394,226,127,40,1
2021,Newham 042D,E01034227,1460,1106,354,200,110,36,8
2021,Newham 042E,E01034228,1276,948,328,235,79,13,1
2021,Newham 042F,E01034229,1352,1008,344,197,121,23,3
2021,Newham 042G,E01034230,1190,878,312,238,66,7,1
2021,Newham 042H,E01034231,1259,957,302,236,55,10,1
2021,Oldham 036A,E01034232,1600,1206,394,104,153,112,25
2021,Oldham 036B,E01034233,1508,1024,484,122,191,141,30
2021,Rochdale 008H,E01034234,1681,1163,518,96,193,186,43
2021,Rochdale 008I,E01034235,1582,1102,480,94,154,184,48
2021,Doncaster 019G,E01034236,1071,604,467,107,206,140,14
2021,Doncaster 019H,E01034237,1027,620,407,83,176,134,14
2021,Doncaster 022G,E01034238,1156,759,397,137,178,67,15
2021,Doncaster 022H,E01034239,1417,783,634,133,287,187,27
2021,Doncaster 027E,E01034240,1413,1190,223,101,86,31,5
2021,Doncaster 027F,E01034241,1325,1218,107,39,38,27,3
2021,Doncaster 028E,E01034242,1666,1515,151,74,52,21,4
2021,Doncaster 028F,E01034243,1849,1760,89,39,35,12,3
2021,Doncaster 038D,E01034244,1067,1013,54,27,17,8,2
2021,Doncaster 038E,E01034245,1793,1758,35,14,15,3,3
2021,Rotherham 001F,E01034246,1700,1668,32,16,10,6,0
2021,Rotherham 001G,E01034247,2065,1986,79,37,29,12,1
2021,Rotherham 027F,E01034248,1441,1350,91,61,25,5,0
2021,Rotherham 027G,E01034249,1424,1367,57,32,22,2,1
2021,Rotherham 027H,E01034250,1025,1011,14,10,4,0,0
2021,Rotherham 028E,E01034251,1044,1032,12,2,7,2,1
2021,Rotherham 028F,E01034252,2033,2007,26,15,8,3,0
2021,Rotherham 034G,E01034253,2290,2243,47,23,14,6,4
2021,Amber Valley 016E,E01034254,2726,2708,18,11,4,2,1
2021,Amber Valley 016F,E01034255,1194,1142,52,27,20,5,0
2021,Derby 013G,E01034256,1553,1231,322,193,91,35,3
2021,Derby 013H,E01034257,1541,1150,391,164,137,78,12
2021,Barnsley 010I,E01034258,1424,1387,37,9,18,10,0
2021,Barnsley 010J,E01034259,1413,1344,69,22,25,20,2
2021,Wakefield 002F,E01034260,1346,1271,75,27,40,7,1
2021,Wakefield 002G,E01034261,1204,1085,119,30,43,40,6
2021,Wakefield 005E,E01034262,1298,1209,89,28,37,22,2
2021,Wakefield 005F,E01034263,1447,1355,92,37,34,16,5
2021,Wakefield 017E,E01034264,1308,815,493,126,216,127,24
2021,Wakefield 017F,E01034265,1170,868,302,76,137,81,8
2021,Wakefield 024G,E01034266,1566,1494,72,37,25,7,3
2021,Wakefield 024H,E01034267,1319,1279,40,18,18,3,1
2021,Wakefield 024I,E01034268,1271,1234,37,17,13,7,0
2021,Wakefield 034G,E01034269,1480,1460,20,12,5,1,2
2021,Wakefield 034H,E01034270,1608,1585,23,12,10,1,0
2021,"Bournemouth, Christchurch and Poole 038E",E01034271,2771,2449,322,153,122,44,3
2021,"Bournemouth, Christchurch and Poole 038F",E01034272,1236,945,291,151,89,38,13
2021,"Bournemouth, Christchurch and Poole 038G",E01034273,1200,739,461,244,173,40,4
2021,"Bournemouth, Christchurch and Poole 038H",E01034274,1542,885,657,310,237,99,11
2021,"Bournemouth, Christchurch and Poole 037F",E01034275,1061,738,323,109,144,54,16
2021,"Bournemouth, Christchurch and Poole 037G",E01034276,1045,670,375,145,162,66,2
2021,"Bournemouth, Christchurch and Poole 041E",E01034277,2401,1848,553,307,185,60,1
2021,"Bournemouth, Christchurch and Poole 041F",E01034278,1972,1496,476,286,137,48,5
2021,"Bournemouth, Christchurch and Poole 031E",E01034279,1473,1425,48,28,15,5,0
2021,"Bournemouth, Christchurch and Poole 031F",E01034280,1051,1029,22,19,3,0,0
2021,"Bournemouth, Christchurch and Poole 044G",E01034281,1134,1013,121,71,42,6,2
2021,"Bournemouth, Christchurch and Poole 044H",E01034282,1227,1005,222,127,75,17,3
2021,"Bournemouth, Christchurch and Poole 046D",E01034283,1472,1378,94,46,32,11,5
2021,"Bournemouth, Christchurch and Poole 046E",E01034284,1085,1010,75,33,36,6,0
2021,Elmbridge 007E,E01034285,956,841,115,72,35,8,0
2021,Elmbridge 007F,E01034286,1523,1404,119,61,37,18,3
2021,Epsom and Ewell 005E,E01034287,1633,1403,230,127,74,25,4
2021,Epsom and Ewell 005F,E01034288,1436,1208,228,96,77,45,10
2021,Epsom and Ewell 008E,E01034289,1402,1134,268,128,109,27,4
2021,Epsom and Ewell 008F,E01034290,1353,1144,209,110,71,24,4
2021,Spelthorne 004F,E01034291,1433,1060,373,213,134,25,1
2021,Spelthorne 004G,E01034292,1159,812,347,191,117,37,2
2021,Woking 004G,E01034293,2769,2038,731,242,283,173,33
2021,Woking 008F,E01034294,1532,1124,408,294,90,22,2
2021,Woking 008G,E01034295,1588,1219,369,193,126,43,7
2021,Woking 011F,E01034296,1187,1097,90,65,23,2,0
2021,Woking 011G,E01034297,1742,1534,208,122,68,15,3
2021,Eastbourne 012F,E01034298,2210,2095,115,73,18,20,4
2021,Wealden 018G,E01034299,1429,1411,18,11,6,1,0
2021,Wealden 018H,E01034300,1516,1489,27,15,7,4,1
2021,Wealden 018I,E01034301,1100,1074,26,20,4,2,0
2021,Wealden 018J,E01034302,1766,1745,21,10,9,1,1
2021,Wealden 018K,E01034303,1258,1195,63,33,29,1,0
2021,Wealden 019F,E01034304,1313,1304,9,6,3,0,0
2021,Wealden 019G,E01034305,1830,1768,62,46,12,4,0
2021,Dudley 006H,E01034306,1622,1508,114,50,50,14,0
2021,Dudley 006I,E01034307,1646,1504,142,49,71,17,5
2021,Dudley 011E,E01034308,1352,1114,238,83,97,47,11
2021,Dudley 011F,E01034309,1226,940,286,104,139,41,2
2021,Wolverhampton 006E,E01034310,988,917,71,33,22,14,2
2021,Wolverhampton 006F,E01034311,2153,1827,326,145,114,60,7
2021,Wolverhampton 020G,E01034312,1852,1471,381,155,165,53,8
2021,Wolverhampton 020H,E01034313,1239,882,357,170,147,27,13
2021,Wolverhampton 035I,E01034314,1611,1200,411,144,161,93,13
2021,Wolverhampton 035J,E01034315,1240,827,413,139,166,89,19
2021,Bromsgrove 013E,E01034316,1280,1256,24,18,2,3,1
2021,Bromsgrove 013F,E01034317,1356,1352,4,1,3,0,0
2021,Bromsgrove 014H,E01034318,1386,1380,6,3,3,0,0
2021,Bromsgrove 014I,E01034319,1213,1211,2,2,0,0,0
2021,Redditch 003E,E01034320,1415,1366,49,27,14,6,2
2021,Redditch 003F,E01034321,1107,1067,40,24,16,0,0
2021,Redditch 003G,E01034322,1370,1332,38,23,11,4,0
2021,Worcester 013E,E01034323,1650,1536,114,60,37,12,5
2021,Worcester 013F,E01034324,1478,1363,115,62,38,12,3
2021,Wychavon 001E,E01034325,1559,1540,19,11,5,3,0
2021,Wychavon 001F,E01034326,1334,1297,37,23,11,3,0
2021,Wychavon 005E,E01034327,1657,1645,12,7,4,1,0
2021,Wychavon 005F,E01034328,1706,1670,36,17,14,5,0
2021,Wychavon 014D,E01034329,1249,852,397,115,188,82,12
2021,Wychavon 014E,E01034330,1268,863,405,105,204,84,12
2021,Wyre Forest 004E,E01034331,1049,932,117,32,65,20,0
2021,Wyre Forest 004F,E01034332,1582,1476,106,34,55,15,2
2021,Wyre Forest 009D,E01034333,1291,1249,42,18,20,4,0
2021,Wyre Forest 009E,E01034334,1392,1377,15,9,4,2,0
2021,Hyndburn 006I,E01034335,1623,1261,362,86,125,122,29
2021,Hyndburn 006J,E01034336,1919,1463,456,125,186,119,26
2021,Chorley 004E,E01034337,1791,1752,39,21,12,4,2
2021,Chorley 004F,E01034338,1234,1197,37,14,19,4,0
2021,Chorley 006G,E01034339,2237,2180,57,35,19,2,1
2021,Chorley 008E,E01034340,1586,1549,37,22,10,4,1
2021,Chorley 008F,E01034341,1556,1485,71,48,13,9,1
2021,Chorley 008G,E01034342,1615,1563,52,38,9,4,1
2021,Chorley 008H,E01034343,1330,1280,50,22,19,9,0
2021,Chorley 012E,E01034344,1672,1634,38,15,16,5,2
2021,Chorley 012F,E01034345,1219,1188,31,15,8,7,1
2021,Preston 002E,E01034346,1095,1087,8,2,3,2,1
2021,Preston 002F,E01034347,2393,2336,57,36,16,5,0
2021,South Ribble 005E,E01034348,1881,1840,41,18,10,9,4
2021,South Ribble 012E,E01034349,1661,1658,3,2,1,0,0
2021,South Ribble 012F,E01034350,2097,2052,45,30,11,4,0
2021,South Ribble 016F,E01034351,2872,2842,30,18,10,2,0
2021,South Ribble 016G,E01034352,1417,1402,15,8,6,1,0
2021,South Ribble 016H,E01034353,1389,1350,39,20,15,2,2
2021,Basildon 014F,E01034354,1748,1661,87,61,14,10,2
2021,Basildon 014G,E01034355,1587,1514,73,35,29,8,1
2021,Basildon 020F,E01034356,1379,913,466,264,144,54,4
2021,Basildon 020G,E01034357,1567,1406,161,76,67,13,5
2021,Brentwood 007H,E01034358,1135,1009,126,69,47,8,2
2021,Brentwood 007I,E01034359,1363,1241,122,66,44,12,0
2021,Brentwood 007J,E01034360,1388,1287,101,56,36,9,0
2021,Brentwood 007K,E01034361,1103,987,116,71,33,9,3
2021,Harlow 001E,E01034362,1394,1297,97,53,35,6,3
2021,Harlow 001F,E01034363,1224,1131,93,51,30,11,1
2021,Harlow 001G,E01034364,1573,1472,101,60,32,6,3
2021,Harlow 001H,E01034365,1372,1252,120,60,48,8,4
2021,Harlow 007F,E01034366,1048,704,344,161,125,57,1
2021,Harlow 007G,E01034367,1629,1261,368,146,161,53,8
2021,Thurrock 006G,E01034368,1628,1311,317,180,95,33,9
2021,Thurrock 006H,E01034369,1742,1555,187,90,69,25,3
2021,Thurrock 022C,E01034370,1735,1409,326,176,106,41,3
2021,Thurrock 022D,E01034371,2013,1603,410,172,162,68,8
2021,Dorset 024E,E01034372,1404,1388,16,9,7,0,0
2021,Dorset 024F,E01034373,1585,1574,11,8,3,0,0
2021,Dorset 003D,E01034374,2053,1968,85,39,36,10,0
2021,Dorset 003E,E01034375,1496,1456,40,9,23,7,1
2021,Dorset 005E,E01034376,1289,1221,68,16,42,10,0
2021,Dorset 005F,E01034377,1302,1137,165,47,69,39,10
2021,Dorset 009D,E01034378,2557,2262,295,151,134,9,1
2021,Dorset 004F,E01034379,1686,1638,48,36,11,1,0
2021,Dorset 004G,E01034380,1570,1543,27,15,11,1,0
2021,Dorset 031D,E01034381,1402,1367,35,20,13,2,0
2021,Dorset 032D,E01034382,1504,1448,56,40,14,2,0
2021,Bromley 005F,E01034383,1258,1003,255,133,79,38,5
2021,Bromley 005G,E01034384,1228,1054,174,102,56,15,1
2021,Bromley 018F,E01034385,1409,1204,205,129,58,17,1
2021,Bromley 018G,E01034386,1192,868,324,194,102,22,6
2021,Lewisham 001F,E01034387,1533,1021,512,377,103,30,2
2021,Lewisham 001G,E01034388,1230,857,373,242,94,30,7
2021,Lewisham 001H,E01034389,1616,1201,415,222,121,62,10
2021,Lewisham 020F,E01034390,1405,1175,230,132,68,25,5
2021,Lewisham 020G,E01034391,1529,1324,205,113,60,30,2
2021,Lewisham 040A,E01034392,1670,1184,486,221,168,88,9
2021,Lewisham 040B,E01034393,1054,733,321,237,63,20,1
2021,Lewisham 040C,E01034394,1203,780,423,288,101,28,6
2021,Lewisham 040D,E01034395,1630,1265,365,224,96,39,6
2021,Liverpool 010G,E01034396,1758,1528,230,87,66,71,6
2021,Liverpool 010H,E01034397,1708,1413,295,120,98,70,7
2021,Liverpool 022F,E01034398,1099,952,147,65,48,28,6
2021,Liverpool 022G,E01034399,1042,872,170,82,54,27,7
2021,Liverpool 022H,E01034400,1035,916,119,50,47,19,3
2021,Liverpool 035G,E01034401,3619,2522,1097,318,443,291,45
2021,Liverpool 037G,E01034402,1090,907,183,95,39,28,21
2021,Liverpool 037H,E01034403,1205,988,217,74,71,50,22
2021,Liverpool 042H,E01034404,2155,2101,54,36,13,4,1
2021,Liverpool 060F,E01034405,2382,1836,546,248,228,68,2
2021,Liverpool 060G,E01034406,1447,1183,264,110,128,25,1
2021,Liverpool 061E,E01034407,1241,992,249,141,80,26,2
2021,Liverpool 061F,E01034408,1263,1104,159,89,47,20,3
2021,Liverpool 062E,E01034409,2006,1582,424,263,142,18,1
2021,Liverpool 062F,E01034410,1023,801,222,114,68,35,5
2021,Liverpool 062G,E01034411,1106,800,306,179,102,25,0
2021,Bedford 004H,E01034412,2039,1941,98,35,37,21,5
2021,Bedford 004I,E01034413,1109,1026,83,37,34,12,0
2021,Bedford 008F,E01034414,1462,1351,111,81,18,12,0
2021,Bedford 008G,E01034415,1428,1285,143,68,47,26,2
2021,Bedford 008H,E01034416,1415,1274,141,77,48,15,1
2021,Bedford 008I,E01034417,1232,1111,121,77,37,6,1
2021,Bedford 012G,E01034418,1094,915,179,89,66,22,2
2021,Bedford 012H,E01034419,1229,956,273,106,105,57,5
2021,Bedford 015G,E01034420,1813,1139,674,239,288,136,11
2021,Bedford 015H,E01034421,1465,943,522,241,192,79,10
2021,Bedford 018F,E01034422,1458,1352,106,39,37,25,5
2021,Bedford 018G,E01034423,1037,925,112,41,46,21,4
2021,Bedford 018H,E01034424,1427,1289,138,67,54,14,3
2021,Bedford 020E,E01034425,1808,1755,53,27,18,8,0
2021,Bedford 020F,E01034426,2161,2038,123,69,40,13,1
2021,Bedford 021A,E01034427,1385,1212,173,96,60,15,2
2021,Bedford 021C,E01034428,1308,1175,133,80,40,11,2
2021,Bedford 021D,E01034429,1129,1087,42,15,17,9,1
2021,Bedford 021E,E01034430,998,965,33,15,11,6,1
2021,Bedford 022A,E01034431,1855,1632,223,109,68,38,8
2021,Bedford 022B,E01034432,1216,1120,96,43,32,17,4
2021,Bedford 022C,E01034433,2265,2120,145,81,47,16,1
2021,Bedford 022D,E01034434,1883,1754,129,70,42,11,6
2021,Huntingdonshire 010H,E01034435,1570,1504,66,43,22,1,0
2021,Huntingdonshire 010I,E01034436,1735,1663,72,49,18,5,0
2021,Huntingdonshire 012F,E01034437,1072,816,256,100,116,36,4
2021,Huntingdonshire 012G,E01034438,1271,1074,197,96,70,29,2
2021,Huntingdonshire 014E,E01034439,1253,1197,56,24,19,12,1
2021,Huntingdonshire 014F,E01034440,1449,1316,133,83,35,15,0
2021,Huntingdonshire 018E,E01034441,1665,1624,41,34,4,3,0
2021,Huntingdonshire 018F,E01034442,1671,1531,140,81,36,18,5
2021,Huntingdonshire 018G,E01034443,1621,1511,110,80,21,7,2
2021,Huntingdonshire 021G,E01034444,1576,1499,77,32,28,17,0
2021,Huntingdonshire 021H,E01034445,1599,1500,99,53,42,3,1
2021,Milton Keynes 002G,E01034446,1471,1347,124,74,44,6,0
2021,Milton Keynes 002H,E01034447,1244,1227,17,12,3,2,0
2021,Milton Keynes 002I,E01034448,1518,1399,119,80,30,9,0
2021,Milton Keynes 010E,E01034449,1973,1796,177,94,61,21,1
2021,Milton Keynes 010F,E01034450,1593,1430,163,92,57,11,3
2021,Milton Keynes 024E,E01034451,1810,1610,200,124,60,16,0
2021,Milton Keynes 024F,E01034452,2155,2055,100,58,25,15,2
2021,Milton Keynes 032E,E01034453,1785,1557,228,137,73,17,1
2021,Milton Keynes 032F,E01034454,1843,1604,239,92,104,39,4
2021,Milton Keynes 032G,E01034455,1627,1447,180,108,59,9,4
2021,Milton Keynes 033C,E01034456,1740,1554,186,116,54,14,2
2021,Milton Keynes 033D,E01034457,1946,1479,467,275,155,33,4
2021,Milton Keynes 034A,E01034458,1712,1429,283,187,73,19,4
2021,Milton Keynes 034B,E01034459,1791,1505,286,171,93,16,6
2021,Milton Keynes 034D,E01034460,1633,1263,370,227,100,37,6
2021,Milton Keynes 034E,E01034461,1698,1247,451,220,173,50,8
2021,Milton Keynes 036A,E01034462,1380,1346,34,23,7,4,0
2021,Milton Keynes 036B,E01034463,1472,1308,164,112,41,9,2
2021,Milton Keynes 036C,E01034464,1303,1144,159,117,32,10,0
2021,Milton Keynes 036F,E01034465,1775,1414,361,234,109,16,2
2021,Milton Keynes 037A,E01034466,2422,1851,571,417,123,28,3
2021,Milton Keynes 037B,E01034467,2015,1773,242,148,76,16,2
2021,Milton Keynes 037E,E01034468,1290,1204,86,46,27,13,0
2021,Barking and Dagenham 004F,E01034469,1608,1161,447,271,131,39,6
2021,Barking and Dagenham 004G,E01034470,1432,1019,413,161,172,72,8
2021,Barking and Dagenham 008G,E01034471,2571,1781,790,338,307,131,14
2021,Barking and Dagenham 008H,E01034472,1749,1183,566,250,231,79,6
2021,Barking and Dagenham 015E,E01034473,1208,609,599,198,264,116,21
2021,Barking and Dagenham 015F,E01034474,2084,1295,789,433,240,101,15
2021,Barking and Dagenham 019F,E01034475,1769,1292,477,136,210,118,13
2021,Barking and Dagenham 019G,E01034476,1737,1378,359,128,143,74,14
2021,Barking and Dagenham 019H,E01034477,1439,1098,341,152,133,48,8
2021,Barking and Dagenham 019I,E01034478,1081,818,263,155,80,22,6
2021,Barking and Dagenham 021G,E01034479,2071,1510,561,228,218,101,14
2021,Redbridge 023E,E01034480,1280,827,453,192,168,79,14
2021,Redbridge 023F,E01034481,1592,1058,534,228,188,94,24
2021,Redbridge 032F,E01034482,999,618,381,236,101,43,1
2021,Redbridge 032G,E01034483,1302,984,318,166,108,42,2
2021,Redbridge 032H,E01034484,1634,981,653,241,241,154,17
2021,Waltham Forest 014F,E01034485,1944,1380,564,217,237,91,19
2021,Waltham Forest 014G,E01034486,1604,1307,297,225,56,14,2
2021,Waltham Forest 020H,E01034487,1206,878,328,138,124,61,5
2021,Waltham Forest 020I,E01034488,1841,1374,467,139,203,111,14
2021,County Durham 014F,E01034489,1192,1156,36,19,14,3,0
2021,County Durham 014G,E01034490,1480,1455,25,14,7,4,0
2021,County Durham 014H,E01034491,1218,1154,64,25,26,13,0
2021,County Durham 016H,E01034492,2084,2074,10,1,7,2,0
2021,County Durham 030H,E01034493,6459,5698,761,370,345,45,1
2021,County Durham 031D,E01034494,1463,1399,64,42,16,6,0
2021,County Durham 031E,E01034495,1424,1399,25,12,7,4,2
2021,County Durham 033F,E01034496,1584,1410,174,113,54,5,2
2021,County Durham 033G,E01034497,1513,1447,66,41,21,0,4
2021,County Durham 033H,E01034498,1930,1785,145,90,42,12,1
2021,County Durham 033I,E01034499,1708,1607,101,51,30,10,10
2021,County Durham 039F,E01034500,2134,2127,7,3,4,0,0
2021,County Durham 049E,E01034501,1823,1800,23,16,6,1,0
2021,County Durham 049F,E01034502,1290,1254,36,20,10,6,0
2021,County Durham 052F,E01034503,1570,1544,26,13,5,7,1
2021,County Durham 052G,E01034504,1319,1314,5,3,2,0,0
2021,County Durham 053F,E01034505,1435,1426,9,6,3,0,0
2021,County Durham 053G,E01034506,1116,1083,33,19,7,7,0
2021,County Durham 053H,E01034507,1196,1181,15,1,9,5,0
2021,County Durham 053I,E01034508,1501,1483,18,11,4,3,0
2021,County Durham 057F,E01034509,1631,1581,50,21,16,12,1
2021,County Durham 057G,E01034510,1140,1078,62,19,27,14,2
2021,County Durham 067A,E01034511,2151,2142,9,7,1,1,0
2021,South Tyneside 013F,E01034512,1419,1395,24,9,7,5,3
2021,South Tyneside 013G,E01034513,1466,1435,31,22,7,0,2
2021,Sunderland 005H,E01034514,3112,3053,59,20,25,11,3
2021,Sunderland 017F,E01034515,1457,1432,25,15,8,2,0
2021,Sunderland 017G,E01034516,1524,1493,31,19,8,4,0
2021,Sunderland 021G,E01034517,2164,2125,39,16,17,4,2
2021,Sunderland 030F,E01034518,1697,1681,16,4,6,4,2
2021,Sunderland 030G,E01034519,1479,1467,12,7,3,2,0
2021,Wiltshire 003E,E01034520,1571,1526,45,28,12,5,0
2021,Wiltshire 003F,E01034521,2114,1938,176,113,46,16,1
2021,Wiltshire 013E,E01034522,1412,1399,13,11,2,0,0
2021,Wiltshire 013F,E01034523,1443,1396,47,31,12,4,0
2021,Wiltshire 016E,E01034524,1191,1180,11,6,3,1,1
2021,Wiltshire 016F,E01034525,1214,1207,7,5,0,2,0
2021,Wiltshire 018H,E01034526,1255,1232,23,10,8,5,0
2021,Wiltshire 018I,E01034527,1457,1414,43,27,7,9,0
2021,Wiltshire 021G,E01034528,1411,1380,31,17,11,3,0
2021,Wiltshire 021H,E01034529,1388,1355,33,21,10,2,0
2021,Wiltshire 021I,E01034530,1652,1611,41,27,9,5,0
2021,Wiltshire 027G,E01034531,1115,1081,34,20,9,5,0
2021,Wiltshire 027H,E01034532,1156,1141,15,12,2,1,0
2021,Wiltshire 031D,E01034533,1993,1651,342,130,132,69,11
2021,Wiltshire 031E,E01034534,1006,801,205,76,83,42,4
2021,Wiltshire 032E,E01034535,1285,1235,50,29,15,5,1
2021,Wiltshire 032F,E01034536,1350,1224,126,54,61,10,1
2021,Wiltshire 032G,E01034537,1409,1318,91,49,31,8,3
2021,Wiltshire 034E,E01034538,1260,1248,12,7,5,0,0
2021,Wiltshire 034F,E01034539,1549,1527,22,14,7,1,0
2021,Wiltshire 037D,E01034540,1475,1462,13,4,7,2,0
2021,Wiltshire 037E,E01034541,1529,1462,67,24,28,11,4
2021,Wiltshire 045G,E01034542,1795,1647,148,69,67,10,2
2021,Wiltshire 045H,E01034543,1226,1155,71,53,11,5,2
2021,Wiltshire 048G,E01034544,1530,1475,55,19,18,16,2
2021,Wiltshire 048H,E01034545,1270,1215,55,26,20,8,1
2021,Wiltshire 048I,E01034546,1431,1356,75,43,22,7,3
2021,Wiltshire 057D,E01034547,1279,1218,61,38,18,3,2
2021,Wiltshire 057E,E01034548,1488,1419,69,41,26,2,0
2021,Wiltshire 057F,E01034549,1408,1320,88,52,28,8,0
2021,Wiltshire 057G,E01034550,1110,1063,47,30,14,3,0
2021,Wiltshire 063A,E01034551,1673,1633,40,21,12,6,1
2021,Wiltshire 063B,E01034552,1688,1647,41,22,16,2,1
2021,Wiltshire 065C,E01034553,1438,1374,64,39,17,6,2
2021,Wiltshire 065D,E01034554,1691,1566,125,54,49,16,6
2021,Wiltshire 065E,E01034555,2096,1977,119,69,46,4,0
2021,Wiltshire 066B,E01034556,1537,1437,100,53,30,14,3
2021,Wiltshire 066D,E01034557,2090,1997,93,62,28,2,1
2021,Wiltshire 066E,E01034558,1458,1372,86,55,21,8,2
2021,Babergh 004G,E01034559,1664,1619,45,25,15,3,2
2021,Babergh 004H,E01034560,1405,1388,17,7,9,0,1
2021,West Suffolk 001C,E01034561,1565,1517,48,18,22,7,1
2021,West Suffolk 001D,E01034562,2380,2301,79,42,24,12,1
2021,West Suffolk 001E,E01034563,1227,1161,66,42,20,4,0
2021,West Suffolk 003E,E01034564,1121,1076,45,24,17,4,0
2021,West Suffolk 003F,E01034565,1274,1225,49,17,21,9,2
2021,West Suffolk 007E,E01034566,1823,1702,121,64,37,16,4
2021,West Suffolk 007F,E01034567,1044,943,101,62,28,10,1
2021,West Suffolk 008E,E01034568,1172,1038,134,53,51,25,5
2021,West Suffolk 008F,E01034569,1211,1080,131,58,58,13,2
2021,Mid Suffolk 003D,E01034570,1722,1714,8,5,2,0,1
2021,Mid Suffolk 003E,E01034571,981,978,3,2,1,0,0
2021,West Suffolk 016C,E01034572,1615,1602,13,7,4,1,1
2021,West Suffolk 016D,E01034573,1476,1416,60,35,18,7,0
2021,West Suffolk 018C,E01034574,2328,2160,168,69,68,28,3
2021,West Suffolk 018D,E01034575,1089,1072,17,7,8,1,1
2021,Kingston upon Thames 004H,E01034576,1217,866,351,200,99,46,6
2021,Kingston upon Thames 004I,E01034577,1312,902,410,199,135,68,8
2021,Merton 001F,E01034578,1012,814,198,88,77,26,7
2021,Merton 001G,E01034579,1780,1417,363,221,107,28,7
2021,Merton 005F,E01034580,1441,980,461,208,128,105,20
2021,Merton 005G,E01034581,1451,1181,270,171,66,27,6
2021,Calderdale 008G,E01034582,1257,970,287,158,82,39,8
2021,Calderdale 008H,E01034583,1012,822,190,103,57,23,7
2021,Kirklees 017F,E01034584,1602,1403,199,63,66,56,14
2021,Kirklees 017G,E01034585,1307,1064,243,69,86,69,19
2021,Kirklees 030E,E01034586,1433,1413,20,8,6,5,1
2021,Kirklees 030F,E01034587,1455,1392,63,34,21,5,3
2021,Kirklees 053G,E01034588,2277,2251,26,14,10,2,0
2021,Harrow 002F,E01034589,1938,1485,453,202,181,63,7
2021,Harrow 002G,E01034590,1274,988,286,180,86,16,4
2021,Harrow 013F,E01034591,1700,951,749,256,317,147,29
2021,Harrow 013G,E01034592,1171,763,408,169,162,61,16
2021,Harrow 015E,E01034593,1430,1048,382,203,128,42,9
2021,Harrow 015F,E01034594,1478,1048,430,278,110,36,6
2021,Harrow 023E,E01034595,1317,721,596,277,224,81,14
2021,Harrow 023F,E01034596,1204,775,429,282,102,37,8
2021,Harrow 023G,E01034597,1357,860,497,232,163,84,18
2021,Harrow 023H,E01034598,1198,767,431,272,124,30,5
2021,Harrow 027E,E01034599,1616,1002,614,249,247,106,12
2021,Harrow 027F,E01034600,1838,1093,745,314,300,110,21
2021,Hillingdon 015G,E01034601,1382,1126,256,136,89,27,4
2021,Hillingdon 015H,E01034602,1335,1002,333,186,116,28,3
2021,Hillingdon 015I,E01034603,1286,994,292,200,71,18,3
2021,Hillingdon 015J,E01034604,1371,1037,334,159,128,42,5
2021,Hillingdon 015K,E01034605,1573,1186,387,199,127,50,11
2021,Hillingdon 016G,E01034606,2573,2054,519,317,149,48,5
2021,Hillingdon 016H,E01034607,2221,1655,566,293,189,77,7
2021,Hillingdon 022G,E01034608,2257,1652,605,287,213,91,14
2021,Hillingdon 022H,E01034609,1830,1218,612,288,220,88,16
2021,Hillingdon 027G,E01034610,1697,1278,419,187,162,66,4
2021,Hillingdon 027H,E01034611,1195,808,387,156,155,64,12
2021,Hillingdon 027I,E01034612,1996,1367,629,242,245,118,24
2021,Hillingdon 027J,E01034613,952,651,301,166,77,48,10
2021,Hillingdon 028F,E01034614,1878,1307,571,331,173,59,8
2021,Hillingdon 028G,E01034615,2072,1579,493,317,129,41,6
2021,Hillingdon 030F,E01034616,1431,917,514,270,162,71,11
2021,Hillingdon 030G,E01034617,2241,1448,793,350,279,135,29
2021,East Devon 005F,E01034618,1698,1662,36,23,10,2,1
2021,East Devon 005G,E01034619,1684,1659,25,13,8,0,4
2021,East Devon 021C,E01034620,1728,1713,15,5,8,0,2
2021,East Devon 021D,E01034621,1647,1579,68,42,14,10,2
2021,East Devon 021E,E01034622,1640,1547,93,60,23,8,2
2021,East Devon 021F,E01034623,1662,1648,14,6,3,3,2
2021,East Devon 022A,E01034624,1622,1524,98,63,25,7,3
2021,East Devon 022B,E01034625,1549,1474,75,43,23,5,4
2021,East Devon 022C,E01034626,1351,1263,88,45,34,9,0
2021,East Devon 022D,E01034627,1174,1119,55,32,19,4,0
2021,Exeter 001G,E01034628,3551,3303,248,162,75,11,0
2021,Exeter 001H,E01034629,3408,3031,377,183,161,33,0
2021,Exeter 008F,E01034630,1420,1173,247,126,99,19,3
2021,Exeter 008G,E01034631,1321,1111,210,113,67,24,6
2021,Exeter 011H,E01034632,1140,1115,25,13,9,3,0
2021,Exeter 011I,E01034633,2034,1909,125,84,28,11,2
2021,Exeter 015G,E01034634,1754,1692,62,37,22,1,2
2021,Exeter 015H,E01034635,1264,1213,51,29,14,3,5
2021,Mid Devon 002E,E01034636,1535,1508,27,15,8,3,1
2021,Mid Devon 002F,E01034637,1462,1353,109,40,47,22,0
2021,North Devon 012F,E01034638,1537,1501,36,22,11,3,0
2021,North Devon 012G,E01034639,1337,1311,26,15,10,1,0
2021,Torridge 002D,E01034640,1114,1102,12,7,4,0,1
2021,Torridge 002E,E01034641,1268,1256,12,9,1,1,1
2021,West Devon 001E,E01034642,1528,1518,10,9,1,0,0
2021,West Devon 001F,E01034643,1713,1645,68,38,26,4,0
2021,Bolsover 001F,E01034644,1255,1237,18,4,9,3,2
2021,Bolsover 001G,E01034645,1432,1430,2,0,1,1,0
2021,Bolsover 006E,E01034646,1547,1449,98,19,48,27,4
2021,Bolsover 006F,E01034647,1469,1275,194,46,93,46,9
2021,North East Derbyshire 012E,E01034648,1379,1363,16,9,5,2,0
2021,North East Derbyshire 012F,E01034649,1051,1017,34,6,16,11,1
2021,South Derbyshire 003F,E01034650,2271,1932,339,235,64,34,6
2021,South Derbyshire 003G,E01034651,1288,1273,15,10,2,3,0
2021,South Derbyshire 004E,E01034652,1435,1342,93,49,30,9,5
2021,South Derbyshire 004F,E01034653,1438,1373,65,38,23,3,1
2021,South Derbyshire 012F,E01034654,1719,1674,45,24,17,4,0
2021,South Derbyshire 012G,E01034655,1586,1531,55,33,16,6,0
2021,South Derbyshire 013E,E01034656,1564,1535,29,14,11,3,1
2021,South Derbyshire 013F,E01034657,1620,1579,41,17,18,4,2
2021,Cheshire East 003F,E01034658,2414,2394,20,13,4,2,1
2021,Cheshire East 016F,E01034659,1238,1184,54,31,18,5,0
2021,Cheshire East 016G,E01034660,1056,1010,46,33,8,5,0
2021,Cheshire East 020E,E01034661,1011,1000,11,9,1,1,0
2021,Cheshire East 020F,E01034662,1866,1847,19,11,6,1,1
2021,Cheshire East 022D,E01034663,2110,2080,30,23,5,2,0
2021,Cheshire East 022E,E01034664,1372,1366,6,4,2,0,0
2021,Cheshire East 031E,E01034665,1255,1228,27,21,5,1,0
2021,Cheshire East 031F,E01034666,1513,1490,23,19,3,1,0
2021,Cheshire East 033H,E01034667,1291,1280,11,5,3,1,2
2021,Cheshire East 033I,E01034668,1639,1614,25,15,4,6,0
2021,Cheshire East 036F,E01034669,1258,924,334,86,142,89,17
2021,Cheshire East 036G,E01034670,1451,1080,371,135,167,63,6
2021,Cheshire East 041F,E01034671,1211,1201,10,5,4,0,1
2021,Cheshire East 041G,E01034672,997,986,11,6,4,0,1
2021,Cheshire East 041H,E01034673,1255,1208,47,29,14,4,0
2021,Cheshire East 052A,E01034674,1458,1383,75,46,24,5,0
2021,Cheshire East 052B,E01034675,2027,1998,29,15,12,2,0
2021,Cheshire East 052C,E01034676,1041,1022,19,11,7,0,1
2021,Cheshire East 052D,E01034677,1326,1304,22,8,9,2,3
2021,Cheshire East 052E,E01034678,1284,1244,40,27,11,1,1
2021,Boston 002F,E01034679,1339,758,581,131,242,178,30
2021,Boston 002G,E01034680,1588,860,728,211,268,205,44
2021,Boston 003E,E01034681,1301,642,659,123,268,214,54
2021,Boston 003F,E01034682,1523,703,820,185,333,250,52
2021,Boston 009E,E01034683,1504,1246,258,111,107,35,5
2021,Boston 009F,E01034684,1393,1089,304,100,133,63,8
2021,East Lindsey 012E,E01034685,1220,1204,16,8,5,2,1
2021,East Lindsey 012F,E01034686,1572,1471,101,37,39,22,3
2021,Lincoln 005E,E01034687,1236,1153,83,45,28,7,3
2021,Lincoln 005F,E01034688,1803,1691,112,51,49,10,2
2021,Lincoln 007E,E01034689,1135,1040,95,39,44,8,4
2021,Lincoln 007F,E01034690,1514,1406,108,57,34,16,1
2021,Lincoln 008E,E01034691,2876,2555,321,135,135,48,3
2021,Lincoln 008F,E01034692,1404,1144,260,92,114,45,9
2021,North Kesteven 003I,E01034693,1694,1657,37,26,11,0,0
2021,North Kesteven 003J,E01034694,1802,1739,63,36,22,5,0
2021,North Kesteven 011F,E01034695,1908,1860,48,18,20,10,0
2021,North Kesteven 011G,E01034696,1483,1466,17,5,8,4,0
2021,South Holland 006H,E01034697,1482,1165,317,101,134,75,7
2021,South Holland 006I,E01034698,1706,1190,516,184,224,85,23
2021,South Holland 009F,E01034699,1375,863,512,153,240,109,10
2021,South Holland 009G,E01034700,1385,1093,292,106,119,59,8
2021,South Kesteven 004F,E01034701,1446,1357,89,47,29,6,7
2021,South Kesteven 004G,E01034702,1641,1568,73,40,24,9,0
2021,South Kesteven 010E,E01034703,1298,1272,26,14,9,2,1
2021,South Kesteven 010F,E01034704,1364,1268,96,45,39,9,3
2021,South Kesteven 010G,E01034705,1303,1219,84,35,34,13,2
2021,West Lindsey 009E,E01034706,1591,1579,12,7,4,1,0
2021,West Lindsey 009F,E01034707,1199,1146,53,38,14,1,0
2021,Basingstoke and Deane 005F,E01034708,1238,1195,43,29,10,4,0
2021,Basingstoke and Deane 005G,E01034709,1197,1149,48,26,17,5,0
2021,Basingstoke and Deane 005H,E01034710,1274,1134,140,99,27,12,2
2021,Basingstoke and Deane 006E,E01034711,1581,1499,82,58,18,6,0
2021,Basingstoke and Deane 006F,E01034712,1857,1786,71,50,14,7,0
2021,Basingstoke and Deane 007K,E01034713,1429,1278,151,74,55,22,0
2021,Basingstoke and Deane 007L,E01034714,1782,1612,170,92,61,15,2
2021,Basingstoke and Deane 009E,E01034715,1609,1338,271,114,112,35,10
2021,Basingstoke and Deane 009F,E01034716,1209,975,234,157,57,17,3
2021,Basingstoke and Deane 010H,E01034717,1002,831,171,107,56,6,2
2021,Basingstoke and Deane 010I,E01034718,2091,1813,278,173,75,28,2
2021,East Hampshire 003G,E01034719,1686,1636,50,30,13,7,0
2021,East Hampshire 003H,E01034720,1643,1610,33,16,14,2,1
2021,East Hampshire 008F,E01034721,1125,1086,39,20,14,5,0
2021,East Hampshire 008G,E01034722,1716,1652,64,25,30,8,1
2021,Hart 008F,E01034723,1336,1313,23,14,5,4,0
2021,Hart 008G,E01034724,1609,1519,90,61,24,5,0
2021,Hart 010F,E01034725,2011,1882,129,94,25,8,2
2021,Hart 010G,E01034726,2163,2052,111,67,35,8,1
2021,Rushmoor 008E,E01034727,2052,1519,533,248,201,57,27
2021,Rushmoor 008F,E01034728,1584,1242,342,185,115,26,16
2021,Rushmoor 008G,E01034729,1348,1127,221,101,75,30,15
2021,Rushmoor 008H,E01034730,1403,744,659,106,210,197,146
2021,Winchester 013H,E01034731,1421,1389,32,21,7,3,1
2021,Winchester 013I,E01034732,1316,1295,21,5,12,2,2
2021,Winchester 014F,E01034733,1776,1761,15,10,5,0,0
2021,Winchester 014G,E01034734,1486,1384,102,71,28,3,0
2021,Coventry 015G,E01034735,1540,946,594,296,208,78,12
2021,Coventry 015H,E01034736,1622,995,627,228,233,143,23
2021,Coventry 020F,E01034737,1783,1198,585,204,189,151,41
2021,Coventry 020G,E01034738,1375,887,488,165,192,109,22
2021,Coventry 025E,E01034739,1513,1373,140,84,32,18,6
2021,Coventry 025F,E01034740,1760,1683,77,29,22,24,2
2021,Coventry 028E,E01034741,1906,1405,501,231,211,50,9
2021,Coventry 028F,E01034742,1128,826,302,173,100,25,4
2021,Coventry 031E,E01034743,2038,1393,645,309,266,64,6
2021,Coventry 031F,E01034744,2855,1792,1063,584,411,62,6
2021,Coventry 035I,E01034745,1323,1108,215,110,68,36,1
2021,Coventry 035J,E01034746,1579,1172,407,175,167,56,9
2021,Coventry 036H,E01034747,1938,1709,229,115,84,27,3
2021,Coventry 036I,E01034748,1308,1117,191,87,65,32,7
2021,Coventry 038G,E01034749,1849,1281,568,230,230,90,18
2021,Coventry 038H,E01034750,2645,1773,872,499,250,112,11
2021,West Oxfordshire 004I,E01034751,1497,1471,26,17,7,2,0
2021,East Riding of Yorkshire 001G,E01034752,1434,1414,20,10,6,4,0
2021,East Riding of Yorkshire 001H,E01034753,1133,1113,20,9,7,4,0
2021,East Riding of Yorkshire 011H,E01034754,1193,1178,15,5,7,3,0
2021,East Riding of Yorkshire 011I,E01034755,1548,1515,33,16,8,8,1
2021,East Riding of Yorkshire 024F,E01034756,2444,2425,19,14,5,0,0
2021,East Riding of Yorkshire 032I,E01034757,1189,1158,31,11,12,6,2
2021,East Riding of Yorkshire 032J,E01034758,1576,1525,51,32,12,5,2
2021,East Riding of Yorkshire 044E,E01034759,1491,1478,13,6,6,1,0
2021,East Riding of Yorkshire 044F,E01034760,1395,1374,21,8,8,4,1
2021,York 023D,E01034761,1645,1549,96,57,34,4,1
2021,York 023E,E01034762,1356,1276,80,42,28,9,1
2021,Lancaster 015E,E01034763,2259,2025,234,127,68,35,4
2021,Ribble Valley 008H,E01034764,2025,1976,49,30,17,2,0
2021,Broadland 013F,E01034765,1596,1522,74,46,21,7,0
2021,Broadland 013G,E01034766,1440,1408,32,14,9,8,1
2021,Great Yarmouth 013E,E01034767,2125,2105,20,14,4,1,1
2021,King's Lynn and West Norfolk 011G,E01034768,1096,922,174,46,79,36,13
2021,King's Lynn and West Norfolk 011H,E01034769,1005,720,285,85,105,86,9
2021,King's Lynn and West Norfolk 017I,E01034770,1153,1138,15,6,8,1,0
2021,King's Lynn and West Norfolk 017J,E01034771,1310,1210,100,33,48,16,3
2021,King's Lynn and West Norfolk 017K,E01034772,1102,1094,8,5,2,1,0
2021,King's Lynn and West Norfolk 017L,E01034773,1212,1187,25,9,11,5,0
2021,North Norfolk 005D,E01034774,1177,1166,11,8,2,1,0
2021,North Norfolk 005E,E01034775,1356,1342,14,11,2,1,0
2021,North Norfolk 006E,E01034776,2221,2206,15,8,7,0,0
2021,Cheltenham 007G,E01034777,1276,1040,236,94,94,43,5
2021,Cheltenham 007H,E01034778,1019,885,134,68,47,19,0
2021,Cheltenham 012H,E01034779,1564,1405,159,109,36,9,5
2021,Cheltenham 012I,E01034780,1419,1364,55,34,16,3,2
2021,Cotswold 002F,E01034781,1678,1637,41,24,12,5,0
2021,Cotswold 002G,E01034782,1274,1244,30,17,9,3,1
2021,Cotswold 003E,E01034783,1303,1241,62,32,27,3,0
2021,Cotswold 003F,E01034784,1386,1313,73,32,34,7,0
2021,Cotswold 003G,E01034785,1413,1378,35,19,13,3,0
2021,Cotswold 003H,E01034786,1529,1461,68,38,26,3,1
2021,Cotswold 010D,E01034787,1659,1633,26,16,9,0,1
2021,Cotswold 010E,E01034788,1211,1189,22,14,5,2,1
2021,Cotswold 011G,E01034789,1244,1211,33,23,8,2,0
2021,Cotswold 011H,E01034790,1498,1426,72,35,27,10,0
2021,Gloucester 004G,E01034791,1436,1326,110,38,48,15,9
2021,Gloucester 004H,E01034792,1490,1295,195,87,80,25,3
2021,Gloucester 004I,E01034793,1436,1041,395,121,155,98,21
2021,Gloucester 004J,E01034794,1863,1740,123,50,46,24,3
2021,Gloucester 015I,E01034795,2065,1902,163,86,61,14,2
2021,Gloucester 015J,E01034796,1996,1802,194,100,76,17,1
2021,Gloucester 015K,E01034797,1420,1363,57,24,23,8,2
2021,Gloucester 015L,E01034798,1773,1602,171,107,48,13,3
2021,Stroud 001E,E01034799,1659,1555,104,76,18,10,0
2021,Stroud 001F,E01034800,1759,1735,24,18,6,0,0
2021,Stroud 001G,E01034801,1946,1914,32,11,16,4,1
2021,Stroud 001H,E01034802,1845,1743,102,67,25,8,2
2021,Stroud 006F,E01034803,1169,1100,69,39,24,4,2
2021,Stroud 006G,E01034804,1239,1152,87,46,30,10,1
2021,Tewkesbury 008D,E01034805,1782,1753,29,21,7,1,0
2021,Tewkesbury 008E,E01034806,1081,1065,16,11,3,2,0
2021,Tewkesbury 009F,E01034807,1491,1440,51,32,15,3,1
2021,Tewkesbury 009G,E01034808,1639,1521,118,58,49,8,3
2021,Tewkesbury 009H,E01034809,1277,1214,63,35,17,9,2
2021,Tewkesbury 009I,E01034810,1974,1927,47,25,16,4,2
2021,Tewkesbury 010A,E01034811,1535,1493,42,30,7,4,1
2021,Tewkesbury 010B,E01034812,1115,1058,57,42,15,0,0
2021,Tewkesbury 011A,E01034813,1145,1108,37,19,12,4,2
2021,Tewkesbury 011B,E01034814,1208,1191,17,6,6,5,0
2021,Tewkesbury 011D,E01034815,1422,1394,28,21,4,2,1
2021,Arun 004F,E01034816,2002,1857,145,69,56,20,0
2021,Arun 004G,E01034817,1952,1877,75,41,28,5,1
2021,Arun 004H,E01034818,1526,1470,56,35,15,6,0
2021,Arun 004I,E01034819,1630,1544,86,43,28,15,0
2021,Arun 005F,E01034820,2110,2058,52,33,13,5,1
2021,Arun 005G,E01034821,1601,1554,47,29,7,8,3
2021,Arun 012F,E01034822,1885,1702,183,88,68,21,6
2021,Arun 012G,E01034823,1719,1591,128,52,52,22,2
2021,Arun 015F,E01034824,1823,1705,118,51,45,22,0
2021,Arun 015G,E01034825,1718,1674,44,15,18,8,3
2021,Worthing 006F,E01034826,1744,1664,80,47,23,9,1
2021,Worthing 006G,E01034827,1729,1613,116,69,37,6,4
2021,Worthing 007F,E01034828,1550,1476,74,37,30,7,0
2021,Worthing 007G,E01034829,1282,1133,149,85,46,18,0
2021,Worthing 011F,E01034830,1177,1080,97,52,35,10,0
2021,Worthing 011G,E01034831,1163,946,217,104,87,23,3
2021,Knowsley 006E,E01034832,970,907,63,26,23,11,3
2021,Knowsley 006F,E01034833,2081,1938,143,67,48,22,6
2021,Knowsley 007F,E01034834,1179,1154,25,10,6,6,3
2021,Knowsley 007G,E01034835,1080,1015,65,29,20,13,3
2021,Wirral 010G,E01034836,1193,1115,78,20,26,29,3
2021,Wirral 010H,E01034837,1578,1489,89,37,34,16,2
2021,Wirral 016F,E01034838,987,893,94,30,33,17,14
2021,Wirral 016G,E01034839,1006,946,60,39,16,3,2
2021,Wirral 036F,E01034840,1346,1316,30,13,9,7,1
2021,Wirral 036G,E01034841,1268,1228,40,25,9,2,4
2021,Sheffield 022I,E01034842,3177,1821,1356,423,542,325,66
2021,Sheffield 036F,E01034843,3027,2760,267,160,80,24,3
2021,Sheffield 074F,E01034844,2117,1522,595,248,269,69,9
2021,Sheffield 076G,E01034845,1277,1255,22,12,4,6,0
2021,Sheffield 076H,E01034846,1319,1301,18,10,4,1,3
2021,Cornwall 005F,E01034847,1748,1665,83,40,26,15,2
2021,Cornwall 005G,E01034848,2055,1915,140,69,57,10,4
2021,Cornwall 016E,E01034849,1391,1354,37,11,14,5,7
2021,Cornwall 016F,E01034850,1350,1319,31,14,12,2,3
2021,Cornwall 016G,E01034851,1169,1168,1,0,1,0,0
2021,Cornwall 016H,E01034852,1538,1530,8,6,1,0,1
2021,Cornwall 018E,E01034853,1282,1251,31,20,9,2,0
2021,Cornwall 018F,E01034854,1422,1380,42,20,10,5,7
2021,Cornwall 018G,E01034855,1447,1372,75,36,35,3,1
2021,Cornwall 036F,E01034856,1560,1544,16,8,7,1,0
2021,Cornwall 036G,E01034857,1194,1171,23,16,5,2,0
2021,Cornwall 037E,E01034858,2252,2217,35,11,16,7,1
2021,Cornwall 040E,E01034859,1493,1485,8,5,3,0,0
2021,Cornwall 040F,E01034860,1477,1471,6,6,0,0,0
2021,Cornwall 043G,E01034862,1382,1271,111,78,29,4,0
2021,Cornwall 043H,E01034863,2170,2065,105,65,31,4,5
2021,Cornwall 044E,E01034864,1003,961,42,26,9,7,0
2021,Cornwall 044F,E01034865,1078,995,83,37,28,17,1
2021,Cornwall 052E,E01034866,1604,1551,53,23,16,12,2
2021,Cornwall 052F,E01034867,1323,1249,74,30,25,18,1
2021,Cornwall 057F,E01034868,1372,1355,17,8,6,3,0
2021,Cornwall 057G,E01034869,1621,1590,31,15,8,6,2
2021,Birmingham 014F,E01034913,1112,1006,106,31,42,21,12
2021,Birmingham 014G,E01034914,1835,1649,186,63,71,46,6
2021,Birmingham 023G,E01034915,1710,1334,376,143,157,68,8
2021,Birmingham 023H,E01034916,1452,1306,146,75,53,15,3
2021,Birmingham 035H,E01034917,1583,1174,409,112,151,128,18
2021,Birmingham 035I,E01034918,1660,1266,394,82,162,119,31
2021,Birmingham 037G,E01034919,1592,1050,542,104,165,207,66
2021,Birmingham 037H,E01034920,1803,1267,536,109,166,219,42
2021,Birmingham 039I,E01034921,1354,716,638,154,240,202,42
2021,Birmingham 039J,E01034922,1532,965,567,123,226,192,26
2021,Birmingham 041H,E01034923,1697,1263,434,84,151,156,43
2021,Birmingham 041I,E01034924,1511,1090,421,100,127,136,58
2021,Birmingham 041J,E01034925,1593,1162,431,108,163,136,24
2021,Birmingham 041K,E01034926,1488,1122,366,88,120,126,32
2021,Birmingham 043D,E01034927,1678,1243,435,140,170,100,25
2021,Birmingham 043E,E01034928,1414,963,451,136,173,119,23
2021,Birmingham 050G,E01034929,1459,940,519,159,228,117,15
2021,Birmingham 050H,E01034930,2184,1736,448,237,153,54,4
2021,Birmingham 051F,E01034931,1829,1277,552,154,205,157,36
2021,Birmingham 051G,E01034932,1428,1086,342,83,119,107,33
2021,Birmingham 052G,E01034933,1444,975,469,118,159,148,44
2021,Birmingham 052H,E01034934,1545,1107,438,98,146,160,34
2021,Birmingham 058G,E01034935,3225,2346,879,231,333,252,63
2021,Birmingham 079G,E01034936,2679,2418,261,137,62,22,40
2021,Birmingham 079H,E01034937,2402,1840,562,251,239,67,5
2021,Birmingham 088F,E01034938,1852,1445,407,104,149,116,38
2021,Birmingham 088G,E01034939,1617,1233,384,82,97,173,32
2021,Birmingham 096H,E01034940,2167,1718,449,129,245,74,1
2021,Birmingham 096I,E01034941,2087,1991,96,55,33,6,2
2021,Birmingham 125H,E01034942,1764,1619,145,91,42,12,0
2021,Birmingham 125I,E01034943,1641,1585,56,19,13,22,2
2021,Birmingham 129E,E01034944,1251,1200,51,19,21,10,1
2021,Birmingham 129F,E01034945,1428,1363,65,24,29,10,2
2021,Birmingham 135E,E01034946,1015,759,256,99,79,46,32
2021,Birmingham 135F,E01034947,1515,1114,401,169,119,98,15
2021,Birmingham 136E,E01034948,1721,1225,496,221,204,62,9
2021,Birmingham 136F,E01034949,1266,824,442,235,153,51,3
2021,Birmingham 137F,E01034950,1099,906,193,140,39,12,2
2021,Birmingham 137G,E01034951,1075,884,191,99,62,24,6
2021,Birmingham 142B,E01034952,1197,860,337,111,134,66,26
2021,Birmingham 142C,E01034953,1520,1035,485,114,185,147,39
2021,Birmingham 143A,E01034954,1656,1239,417,130,166,98,23
2021,Birmingham 143B,E01034955,2040,1534,506,156,194,122,34
2021,Craven 006E,E01034956,1377,1222,155,52,65,34,4
2021,Craven 006F,E01034957,1261,1192,69,29,32,8,0
2021,Hambleton 007F,E01034958,2602,2567,35,17,15,0,3
2021,Hambleton 009E,E01034959,1831,1782,49,12,20,16,1
2021,Hambleton 009F,E01034960,1473,1465,8,3,3,0,2
2021,Hambleton 012A,E01034961,1480,1466,14,10,3,1,0
2021,Hambleton 012B,E01034962,1102,1088,14,10,1,0,3
2021,Harrogate 008E,E01034963,1281,1273,8,7,0,1,0
2021,Harrogate 008F,E01034964,2615,2556,59,36,21,2,0
2021,Richmondshire 004I,E01034965,2581,2450,131,83,36,11,1
2021,Richmondshire 004J,E01034966,1748,1601,147,50,56,33,8
2021,Richmondshire 004K,E01034967,1637,1560,77,34,31,10,2
2021,Ryedale 009B,E01034968,1535,1477,58,24,22,10,2
2021,Ryedale 009C,E01034969,1533,1451,82,42,29,11,0
2021,Ryedale 009D,E01034970,1217,1114,103,18,40,40,5
2021,Ryedale 009E,E01034971,1400,1346,54,18,20,16,0
2021,Scarborough 001F,E01034972,2096,2021,75,16,23,30,6
2021,Scarborough 004G,E01034973,1914,1893,21,10,8,3,0
2021,Scarborough 006F,E01034974,2682,2544,138,54,51,25,8
2021,Selby 004F,E01034975,1459,1442,17,14,3,0,0
2021,Selby 004G,E01034976,1721,1699,22,8,11,3,0
2021,Selby 004H,E01034977,1381,1366,15,5,7,2,1
2021,Selby 004I,E01034978,1327,1316,11,6,3,2,0
2021,Selby 005G,E01034979,1339,1253,86,44,28,13,1
2021,Selby 005H,E01034980,1066,918,148,42,75,30,1
2021,Selby 005I,E01034981,1447,1310,137,46,58,29,4
2021,Selby 005J,E01034982,1177,1112,65,19,30,11,5
2021,Selby 005K,E01034983,1461,1353,108,54,43,11,0
2021,Selby 006F,E01034984,2356,2283,73,36,26,11,0
2021,Ashford 005F,E01034985,1326,1096,230,100,81,37,12
2021,Ashford 005G,E01034986,1250,967,283,145,91,42,5
2021,Ashford 010E,E01034987,1471,1390,81,47,30,4,0
2021,Ashford 010F,E01034988,1602,1570,32,23,7,2,0
2021,Ashford 010G,E01034989,1629,1573,56,37,19,0,0
2021,Maidstone 001F,E01034990,2242,2197,45,30,10,5,0
2021,Maidstone 004H,E01034991,1086,781,305,146,111,41,7
2021,Maidstone 004I,E01034992,1037,848,189,66,79,32,12
2021,Maidstone 011E,E01034993,1534,1515,19,9,7,2,1
2021,Maidstone 011F,E01034994,1777,1744,33,23,5,5,0
2021,Maidstone 013H,E01034995,1433,1285,148,71,59,16,2
2021,Maidstone 013I,E01034996,1373,1248,125,48,46,26,5
2021,Maidstone 015F,E01034997,1434,1337,97,53,32,10,2
2021,Maidstone 015G,E01034998,1371,1272,99,58,35,5,1
2021,Maidstone 015H,E01034999,1468,1345,123,75,37,10,1
2021,Sevenoaks 008F,E01035000,1502,1420,82,55,23,4,0
2021,Sevenoaks 008G,E01035001,1287,1194,93,65,22,6,0
2021,Tonbridge and Malling 001G,E01035002,1359,1328,31,16,10,2,3
2021,Tonbridge and Malling 001H,E01035003,1244,1203,41,26,11,3,1
2021,Tonbridge and Malling 001I,E01035004,1211,1186,25,9,10,6,0
2021,Tonbridge and Malling 002H,E01035005,1200,1165,35,21,11,3,0
2021,Tonbridge and Malling 002I,E01035006,1251,1197,54,25,22,7,0
2021,Tonbridge and Malling 002J,E01035007,1373,1313,60,42,17,1,0
2021,Tonbridge and Malling 012G,E01035008,1444,1261,183,96,61,22,4
2021,Tonbridge and Malling 012H,E01035009,1636,1520,116,63,37,14,2
2021,Tonbridge and Malling 014G,E01035010,1338,1304,34,27,6,1,0
2021,Tonbridge and Malling 014H,E01035011,1421,1404,17,12,4,0,1
2021,Tunbridge Wells 008E,E01035012,1158,946,212,119,74,17,2
2021,Tunbridge Wells 008F,E01035013,1606,1364,242,136,78,23,5
2021,Nuneaton and Bedworth 001F,E01035014,2019,1914,105,64,29,9,3
2021,Nuneaton and Bedworth 001G,E01035015,1639,1606,33,21,11,0,1
2021,Nuneaton and Bedworth 002G,E01035016,1685,1571,114,58,47,8,1
2021,Nuneaton and Bedworth 002H,E01035017,1814,1526,288,146,116,23,3
2021,Nuneaton and Bedworth 003F,E01035018,1670,1567,103,60,24,13,6
2021,Nuneaton and Bedworth 003G,E01035019,1548,1483,65,32,20,10,3
2021,Rugby 002G,E01035020,1576,1135,441,225,165,46,5
2021,Rugby 002H,E01035021,1822,1404,418,162,196,51,9
2021,Rugby 007I,E01035022,1586,1452,134,61,56,15,2
2021,Rugby 007J,E01035023,1623,1516,107,68,29,9,1
2021,Rugby 012F,E01035024,1885,1706,179,102,53,21,3
2021,Rugby 012G,E01035025,1433,1409,24,18,3,3,0
2021,Rugby 013D,E01035026,1427,1333,94,47,37,9,1
2021,Rugby 014A,E01035027,1384,1189,195,109,69,16,1
2021,Rugby 014B,E01035028,1497,1367,130,65,57,8,0
2021,Rugby 014E,E01035029,1650,1430,220,144,58,14,4
2021,Stratford-on-Avon 008H,E01035030,1436,1405,31,12,14,4,1
2021,Stratford-on-Avon 008I,E01035031,1623,1502,121,50,61,10,0
2021,Stratford-on-Avon 009G,E01035032,1619,1489,130,55,54,21,0
2021,Stratford-on-Avon 009H,E01035033,1709,1500,209,91,92,23,3
2021,Stratford-on-Avon 014E,E01035034,1420,1391,29,17,9,3,0
2021,Stratford-on-Avon 014F,E01035035,1681,1566,115,68,37,9,1
2021,Stratford-on-Avon 014G,E01035036,1393,1345,48,20,26,2,0
2021,Warwick 012G,E01035037,1346,1233,113,76,27,7,3
2021,Warwick 012H,E01035038,1639,1405,234,155,47,26,6
2021,Warwick 012I,E01035039,1226,1082,144,95,33,14,2
2021,Leeds 044G,E01035040,1727,1628,99,56,27,14,2
2021,Leeds 044H,E01035041,1284,1197,87,52,21,14,0
2021,Leeds 055I,E01035042,2269,1572,697,312,290,88,7
2021,Leeds 055J,E01035043,1403,1118,285,127,121,34,3
2021,Leeds 063F,E01035044,2627,2091,536,239,250,41,6
2021,Leeds 063G,E01035045,1289,809,480,286,163,31,0
2021,Leeds 082G,E01035046,1134,911,223,157,54,9,3
2021,Leeds 082H,E01035047,1298,1037,261,117,106,34,4
2021,Leeds 099G,E01035048,1809,1601,208,114,63,28,3
2021,Leeds 099H,E01035049,1439,1332,107,49,42,16,0
2021,Leeds 105G,E01035050,1542,1412,130,68,45,15,2
2021,Leeds 105H,E01035051,1539,1430,109,54,41,8,6
2021,Leeds 105I,E01035052,1383,1340,43,20,16,6,1
2021,Leeds 105J,E01035053,1659,1629,30,10,17,3,0
2021,Leeds 112F,E01035054,2543,2180,363,273,75,14,1
2021,Herefordshire 011E,E01035055,1540,1499,41,23,13,5,0
2021,Herefordshire 011F,E01035056,1472,1422,50,30,16,4,0
2021,Shropshire 009E,E01035057,1421,1377,44,21,19,2,2
2021,Shropshire 009F,E01035058,1711,1669,42,15,10,12,5
2021,Shropshire 016E,E01035059,1969,1838,131,61,40,27,3
2021,Shropshire 016F,E01035060,1599,1538,61,26,21,13,1
2021,Shropshire 019E,E01035061,1039,917,122,54,42,26,0
2021,Shropshire 019F,E01035062,1327,1264,63,28,28,7,0
2021,Shropshire 019G,E01035063,1174,1049,125,68,34,17,6
2021,Shropshire 019H,E01035064,995,960,35,19,13,3,0
2021,Shropshire 020F,E01035065,1419,1348,71,38,22,8,3
2021,Shropshire 020G,E01035066,1751,1660,91,67,17,7,0
2021,Shropshire 024E,E01035067,1613,1603,10,7,3,0,0
2021,Shropshire 024F,E01035068,1487,1468,19,9,8,2,0
2021,Shropshire 025F,E01035069,1467,1457,10,5,4,1,0
2021,Shropshire 025G,E01035070,1679,1646,33,18,10,5,0
2021,Shropshire 030F,E01035071,2205,2183,22,10,11,1,0
2021,Shropshire 036F,E01035072,2317,2301,16,8,6,1,1
2021,Telford and Wrekin 009F,E01035073,1442,1120,322,106,149,60,7
2021,Telford and Wrekin 009G,E01035074,1862,1526,336,123,153,56,4
2021,Telford and Wrekin 009H,E01035075,1068,944,124,72,39,9,4
2021,Telford and Wrekin 024A,E01035076,1811,1637,174,79,64,27,4
2021,Telford and Wrekin 024B,E01035077,1277,1187,90,28,43,16,3
2021,Telford and Wrekin 024D,E01035078,1658,1522,136,69,51,13,3
2021,Telford and Wrekin 025A,E01035079,1355,1276,79,42,25,12,0
2021,Telford and Wrekin 025B,E01035080,1350,1288,62,35,13,13,1
2021,Telford and Wrekin 025C,E01035081,1441,1416,25,14,9,2,0
2021,Telford and Wrekin 025D,E01035082,1822,1778,44,29,9,4,2
2021,Telford and Wrekin 025E,E01035083,2193,2121,72,45,21,3,3
2021,Harborough 003G,E01035084,1689,1623,66,39,22,4,1
2021,Harborough 003H,E01035085,1553,1520,33,25,5,1,2
2021,Harborough 005G,E01035086,1623,1612,11,8,1,2,0
2021,Harborough 005H,E01035087,1398,1386,12,10,1,1,0
2021,Harborough 007G,E01035088,1592,1558,34,19,11,4,0
2021,Harborough 007H,E01035089,1337,1301,36,21,14,1,0
2021,Harborough 010E,E01035090,1573,1534,39,26,8,3,2
2021,Harborough 010F,E01035091,1494,1426,68,31,28,6,3
2021,Harborough 011E,E01035092,1640,1529,111,56,26,23,6
2021,Harborough 011F,E01035093,1486,1383,103,48,31,18,6
2021,Hinckley and Bosworth 001F,E01035094,1289,1263,26,9,12,5,0
2021,Hinckley and Bosworth 001G,E01035095,1606,1576,30,17,5,4,4
2021,Hinckley and Bosworth 011F,E01035096,1480,1436,44,23,14,5,2
2021,Hinckley and Bosworth 011G,E01035097,1431,1341,90,51,31,4,4
2021,North West Leicestershire 001F,E01035098,1106,1081,25,14,9,2,0
2021,North West Leicestershire 001G,E01035099,1357,1271,86,49,29,8,0
2021,North West Leicestershire 003E,E01035100,1732,1692,40,30,9,1,0
2021,North West Leicestershire 003F,E01035101,1841,1791,50,24,19,4,3
2021,Rutland 002E,E01035102,1501,1460,41,28,9,4,0
2021,Rutland 002F,E01035103,1158,1114,44,32,6,6,0
2021,Rutland 002G,E01035104,1336,1302,34,14,10,7,3
2021,Rutland 003E,E01035105,1337,1322,15,8,6,0,1
2021,Rutland 003F,E01035106,1240,1211,29,15,10,4,0
2021,Mendip 002F,E01035107,2036,2021,15,15,0,0,0
2021,Mendip 005E,E01035108,1615,1575,40,23,14,3,0
2021,Mendip 005F,E01035109,1335,1302,33,15,14,4,0
2021,Mendip 007G,E01035110,1291,1207,84,48,26,7,3
2021,Mendip 007H,E01035111,1784,1716,68,29,34,4,1
2021,Sedgemoor 002H,E01035112,1734,1711,23,12,8,0,3
2021,Sedgemoor 002I,E01035113,1488,1449,39,20,10,7,2
2021,Sedgemoor 010E,E01035114,1180,1063,117,54,46,17,0
2021,Sedgemoor 010F,E01035115,1343,1168,175,96,54,20,5
2021,Sedgemoor 010G,E01035116,1084,1044,40,16,18,6,0
2021,Sedgemoor 014H,E01035117,1658,1504,154,78,63,13,0
2021,Sedgemoor 014I,E01035118,1342,1174,168,61,75,26,6
2021,Sedgemoor 014J,E01035119,1608,1340,268,107,129,27,5
2021,Sedgemoor 014K,E01035120,1502,1469,33,14,14,4,1
2021,South Somerset 011E,E01035121,1465,1375,90,44,37,7,2
2021,South Somerset 011F,E01035122,1912,1731,181,79,81,19,2
2021,South Somerset 012E,E01035123,1603,1511,92,54,25,12,1
2021,South Somerset 012F,E01035124,1362,1292,70,43,24,3,0
2021,South Somerset 015E,E01035125,1081,768,313,109,138,65,1
2021,South Somerset 015F,E01035126,1082,906,176,65,65,43,3
2021,Somerset West and Taunton 008E,E01035127,1863,1823,40,25,10,3,2
2021,Somerset West and Taunton 008F,E01035128,2009,1899,110,62,35,12,1
2021,Somerset West and Taunton 018E,E01035129,1894,1812,82,47,26,9,0
2021,Somerset West and Taunton 018F,E01035130,1300,1235,65,29,22,11,3
2021,Somerset West and Taunton 017E,E01035131,1346,1323,23,11,9,3,0
2021,Somerset West and Taunton 017F,E01035132,1431,1392,39,17,12,10,0
2021,Breckland 007F,E01035133,1196,1130,66,21,22,23,0
2021,Breckland 007G,E01035134,1467,1380,87,33,36,16,2
2021,Breckland 011F,E01035135,1121,1057,64,37,20,6,1
2021,Breckland 011G,E01035136,1950,1898,52,28,14,10,0
2021,Norwich 014E,E01035137,998,871,127,52,39,36,0
2021,Norwich 014F,E01035138,1187,1035,152,69,54,27,2
2021,Norwich 017B,E01035139,2748,2454,294,158,107,27,2
2021,Norwich 017C,E01035140,1116,939,177,91,64,21,1
2021,South Norfolk 002F,E01035141,1795,1592,203,135,57,10,1
2021,South Norfolk 002G,E01035142,1418,1357,61,47,11,2,1
2021,South Norfolk 006H,E01035143,1346,1322,24,13,7,4,0
2021,South Norfolk 006I,E01035144,1603,1554,49,28,14,5,2
2021,South Norfolk 007F,E01035145,1366,1323,43,27,12,3,1
2021,South Norfolk 007G,E01035146,1424,1381,43,25,14,3,1
2021,South Norfolk 007H,E01035147,1010,994,16,6,8,2,0
2021,South Norfolk 007I,E01035148,1420,1398,22,16,3,1,2
2021,South Norfolk 007J,E01035149,3167,3123,44,24,14,5,1
2021,South Norfolk 016A,E01035150,1097,1020,77,48,24,4,1
2021,South Norfolk 016B,E01035151,1346,1239,107,65,30,9,3
2021,South Norfolk 016C,E01035152,1425,1297,128,71,48,8,1
2021,South Norfolk 016F,E01035153,1388,1242,146,92,43,7,4
2021,East Suffolk 014C,E01035154,2149,2132,17,11,5,1,0
2021,Braintree 011F,E01035155,1349,1251,98,54,31,11,2
2021,Braintree 011G,E01035156,1429,1381,48,22,20,4,2
2021,Colchester 007F,E01035157,1147,997,150,85,49,16,0
2021,Colchester 007G,E01035158,1083,848,235,118,88,27,2
2021,Colchester 010F,E01035159,2484,2318,166,86,56,19,5
2021,Colchester 010G,E01035160,1689,1666,23,17,3,3,0
2021,Colchester 011G,E01035161,1490,1225,265,133,91,37,4
2021,Colchester 011H,E01035162,1240,1008,232,95,88,45,4
2021,Colchester 011I,E01035163,1417,1246,171,70,77,18,6
2021,Colchester 011J,E01035164,1659,1412,247,136,86,23,2
2021,Colchester 015H,E01035165,2212,2034,178,99,68,9,2
2021,Colchester 015I,E01035166,1130,1025,105,59,30,16,0
2021,Colchester 023A,E01035167,1059,930,129,76,43,9,1
2021,Colchester 023B,E01035168,1587,1456,131,100,26,4,1
2021,Colchester 023C,E01035169,1280,1184,96,77,13,6,0
2021,Colchester 023D,E01035170,1398,1259,139,78,41,18,2
2021,Colchester 023E,E01035171,1070,1005,65,43,12,8,2
2021,Colchester 023F,E01035172,1811,1726,85,69,10,3,3
2021,Colchester 024B,E01035173,1242,1064,178,126,45,6,1
2021,Colchester 024C,E01035174,1429,1254,175,107,54,13,1
2021,Colchester 024D,E01035175,1659,1360,299,196,86,16,1
2021,Colchester 024E,E01035176,1655,1528,127,83,30,12,2
2021,Colchester 024F,E01035177,1271,1148,123,68,41,12,2
2021,Uttlesford 006E,E01035178,1829,1758,71,46,18,6,1
2021,Uttlesford 006F,E01035179,1319,1265,54,39,6,7,2
2021,Uttlesford 006G,E01035180,1154,1082,72,39,25,8,0
2021,Uttlesford 006H,E01035181,1271,1220,51,37,9,4,1
2021,Uttlesford 006I,E01035182,1247,1225,22,12,7,2,1
2021,Darlington 009E,E01035183,1417,1355,62,35,27,0,0
2021,Darlington 009F,E01035184,1297,1262,35,13,17,5,0
2021,Darlington 010D,E01035185,1504,1441,63,35,19,9,0
2021,Darlington 010E,E01035186,1090,1050,40,31,6,2,1
2021,Darlington 016H,E01035187,2058,1833,225,82,87,43,13
2021,Hartlepool 015C,E01035188,1873,1704,169,42,63,51,13
2021,Middlesbrough 001H,E01035189,1296,1113,183,67,79,30,7
2021,Middlesbrough 001I,E01035190,1665,1163,502,156,180,128,38
2021,Middlesbrough 001J,E01035191,1698,1379,319,123,126,62,8
2021,Middlesbrough 001K,E01035192,1232,919,313,84,125,91,13
2021,Middlesbrough 018I,E01035193,1636,1614,22,12,8,1,1
2021,Middlesbrough 018J,E01035194,1200,1190,10,3,2,3,2
2021,Middlesbrough 020G,E01035195,1547,1451,96,66,16,12,2
2021,Middlesbrough 020H,E01035196,1223,1195,28,13,7,7,1
2021,Stockton-on-Tees 025A,E01035197,1560,1454,106,35,23,35,13
2021,Stockton-on-Tees 025B,E01035198,1499,1415,84,33,30,21,0
2021,Stockton-on-Tees 025D,E01035199,1141,873,268,75,115,74,4
2021,Stockton-on-Tees 026A,E01035200,1946,1537,409,97,188,108,16
2021,Stockton-on-Tees 026C,E01035201,1626,1588,38,22,10,4,2
2021,Stockton-on-Tees 026D,E01035202,1853,1741,112,62,30,17,3
2021,Stockton-on-Tees 027B,E01035203,1573,1524,49,31,13,5,0
2021,Stockton-on-Tees 028B,E01035204,2393,2308,85,61,14,9,1
2021,Bath and North East Somerset 002D,E01035205,1610,1576,34,27,5,1,1
2021,Bath and North East Somerset 002E,E01035206,1366,1329,37,20,13,4,0
2021,Bath and North East Somerset 013E,E01035207,1427,1144,283,195,72,14,2
2021,Bath and North East Somerset 013F,E01035208,2236,2135,101,67,26,7,1
2021,Bath and North East Somerset 022F,E01035209,988,974,14,14,0,0,0
2021,Bath and North East Somerset 022G,E01035210,2298,2253,45,30,15,0,0
2021,North Somerset 006H,E01035211,1277,1238,39,25,10,4,0
2021,North Somerset 006I,E01035212,1754,1725,29,15,11,3,0
2021,North Somerset 023G,E01035213,1817,1716,101,63,28,7,3
2021,North Somerset 023H,E01035214,1640,1605,35,12,15,6,2
2021,North Somerset 027F,E01035215,1408,1275,133,61,54,14,4
2021,North Somerset 027G,E01035216,2302,2000,302,154,120,24,4
2021,South Gloucestershire 019H,E01035217,1470,1350,120,77,27,14,2
2021,South Gloucestershire 019I,E01035218,1547,1463,84,51,26,6,1
2021,South Gloucestershire 019J,E01035219,1026,1009,17,12,5,0,0
2021,South Gloucestershire 021H,E01035220,1965,1853,112,58,37,15,2
2021,South Gloucestershire 021I,E01035221,1505,1372,133,90,29,12,2
2021,South Gloucestershire 033E,E01035222,1615,1432,183,94,60,25,4
2021,South Gloucestershire 034A,E01035223,1452,1269,183,108,50,23,2
2021,South Gloucestershire 034C,E01035224,1372,1107,265,145,90,27,3
2021,South Gloucestershire 034D,E01035225,1567,1310,257,133,92,26,6
2021,South Gloucestershire 034E,E01035226,1717,1426,291,184,84,22,1
2021,South Gloucestershire 035A,E01035227,1270,1125,145,81,42,21,1
2021,South Gloucestershire 035B,E01035228,2429,2067,362,226,120,15,1
2021,South Gloucestershire 035C,E01035229,2743,2462,281,156,106,18,1
2021,South Gloucestershire 035D,E01035230,1170,1049,121,77,25,13,6
2021,South Gloucestershire 035E,E01035231,1260,1126,134,76,43,15,0
2021,South Gloucestershire 036B,E01035232,1660,1520,140,83,34,18,5
2021,South Gloucestershire 036C,E01035233,1764,1620,144,84,42,17,1
2021,Bracknell Forest 001F,E01035234,1039,998,41,27,11,3,0
2021,Bracknell Forest 001G,E01035235,1777,1730,47,31,12,4,0
2021,Bracknell Forest 002F,E01035236,1758,1701,57,39,12,4,2
2021,Bracknell Forest 002G,E01035237,1278,1198,80,54,18,7,1
2021,Bracknell Forest 002H,E01035238,1239,1164,75,49,19,6,1
2021,Bracknell Forest 002I,E01035239,1064,1018,46,31,10,5,0
2021,Bracknell Forest 002J,E01035240,1410,1291,119,82,26,7,4
2021,Bracknell Forest 007F,E01035241,1238,954,284,163,104,17,0
2021,Bracknell Forest 007G,E01035242,1497,1243,254,124,100,24,6
2021,Bracknell Forest 007H,E01035243,1709,1512,197,130,46,15,6
2021,Bracknell Forest 007I,E01035244,1289,1202,87,40,31,14,2
2021,Bracknell Forest 009I,E01035245,1538,1412,126,78,33,13,2
2021,Bracknell Forest 009J,E01035246,1738,1604,134,94,38,2,0
2021,Slough 011F,E01035247,1365,828,537,273,197,59,8
2021,Slough 011G,E01035248,1527,996,531,197,217,108,9
2021,Slough 011H,E01035249,1287,939,348,185,108,46,9
2021,Slough 011I,E01035250,1775,1317,458,309,115,26,8
2021,Slough 015B,E01035251,2200,1442,758,291,312,136,19
2021,Slough 015C,E01035252,1244,745,499,196,224,72,7
2021,Slough 015D,E01035253,1410,914,496,291,156,44,5
2021,Slough 016B,E01035254,1609,996,613,246,238,109,20
2021,West Oxfordshire 012D,E01035255,1105,1078,27,19,6,1,1
2021,Wokingham 001E,E01035256,2445,2366,79,58,15,5,1
2021,Wokingham 008H,E01035257,2749,2356,393,212,143,33,5
2021,Wokingham 008I,E01035258,1409,1250,159,109,38,10,2
2021,Wokingham 012I,E01035259,1619,1450,169,110,40,16,3
2021,Wokingham 012J,E01035260,1583,1337,246,185,49,12,0
2021,Wokingham 014F,E01035261,1834,1643,191,127,49,14,1
2021,Wokingham 014G,E01035262,1994,1907,87,54,25,7,1
2021,Wokingham 017E,E01035263,1510,1344,166,121,42,3,0
2021,Wokingham 017F,E01035264,1794,1701,93,61,26,5,1
2021,Wokingham 017G,E01035265,1875,1670,205,140,46,15,4
2021,Wokingham 017H,E01035266,1601,1546,55,37,16,2,0
2021,Wokingham 018E,E01035267,1536,1453,83,42,30,8,3
2021,Wokingham 018F,E01035268,1366,1267,99,60,30,9,0
2021,Wokingham 018G,E01035269,3190,3016,174,111,45,16,2
2021,Dartford 001E,E01035270,1487,1256,231,139,68,22,2
2021,Dartford 001F,E01035271,1568,1308,260,160,73,23,4
2021,Dartford 001G,E01035272,1510,1335,175,86,56,27,6
2021,Dartford 001H,E01035273,1185,1048,137,67,54,15,1
2021,Dartford 001I,E01035274,1196,1069,127,62,52,12,1
2021,Dartford 001J,E01035275,1375,1083,292,184,92,14,2
2021,Dartford 001K,E01035276,1501,1118,383,270,93,15,5
2021,Dartford 002E,E01035277,1664,1503,161,81,59,21,0
2021,Dartford 002F,E01035278,1665,1552,113,54,41,16,2
2021,Dartford 002G,E01035279,1893,1651,242,129,73,35,5
2021,Dartford 002H,E01035280,1814,1586,228,163,45,17,3
2021,Dartford 002I,E01035281,1733,1537,196,126,44,22,4
2021,Dartford 004E,E01035282,1497,1332,165,99,47,16,3
2021,Dartford 004F,E01035283,1478,1388,90,46,31,9,4
2021,Gravesham 006F,E01035284,1348,1151,197,130,49,17,1
2021,Gravesham 006G,E01035285,1500,1345,155,56,72,16,11
2021,Medway 003F,E01035286,1652,1603,49,33,11,5,0
2021,Medway 003G,E01035287,1786,1750,36,17,7,12,0
2021,Medway 004D,E01035288,1348,1297,51,27,16,8,0
2021,Medway 004E,E01035289,1470,1427,43,23,15,5,0
2021,Medway 007F,E01035290,1788,1644,144,89,41,14,0
2021,Medway 007G,E01035291,1784,1686,98,59,30,9,0
2021,Medway 007H,E01035292,2033,1741,292,146,117,26,3
2021,Medway 007I,E01035293,1565,1437,128,74,25,25,4
2021,Medway 009E,E01035294,1684,1513,171,111,49,11,0
2021,Medway 009F,E01035295,1569,1375,194,95,71,22,6
2021,Medway 015F,E01035296,1523,1312,211,97,79,34,1
2021,Medway 015G,E01035297,1400,1108,292,112,122,53,5
2021,Swale 004H,E01035298,1408,1372,36,18,12,4,2
2021,Swale 004I,E01035299,1661,1614,47,26,19,2,0
2021,Swale 006E,E01035300,2405,2332,73,21,29,15,8
2021,Swale 006F,E01035301,2095,1974,121,27,41,35,18
2021,Swale 007I,E01035302,1524,1400,124,58,52,14,0
2021,Swale 007J,E01035303,1440,1304,136,63,45,27,1
2021,Swale 009F,E01035304,1811,1762,49,21,22,5,1
2021,Swale 009G,E01035305,1676,1606,70,32,26,12,0
2021,Swale 009H,E01035306,1631,1563,68,30,23,13,2
2021,Swale 009I,E01035307,1342,1290,52,25,15,12,0
2021,Canterbury 012G,E01035308,1147,1112,35,22,8,5,0
2021,Canterbury 012H,E01035309,5415,4925,490,337,143,6,4
2021,Canterbury 019D,E01035310,1516,1423,93,55,24,11,3
2021,Canterbury 019E,E01035311,1322,1141,181,113,54,11,3
2021,Dover 005F,E01035312,1683,1658,25,17,4,4,0
2021,Dover 005G,E01035313,1358,1341,17,8,7,1,1
2021,Dover 006E,E01035314,1954,1809,145,84,52,8,1
2021,Dover 006F,E01035315,1692,1629,63,26,28,8,1
2021,Thanet 001F,E01035316,1063,934,129,48,52,25,4
2021,Thanet 001G,E01035317,1111,932,179,51,76,51,1
2021,Thanet 014E,E01035318,1475,1433,42,26,12,4,0
2021,Thanet 014F,E01035319,1477,1448,29,12,13,2,2
2021,Chichester 004G,E01035320,1863,1796,67,29,22,16,0
2021,Chichester 004H,E01035321,1006,985,21,11,7,2,1
2021,Chichester 006E,E01035322,1386,1367,19,6,8,2,3
2021,Chichester 006F,E01035323,1450,1403,47,23,16,7,1
2021,Chichester 008G,E01035324,1536,1444,92,58,27,7,0
2021,Chichester 008H,E01035325,1753,1632,121,75,40,6,0
2021,Chichester 012G,E01035326,1641,1417,224,80,84,44,16
2021,Chichester 012H,E01035327,1754,1615,139,28,67,35,9
2021,Crawley 002F,E01035328,1969,1799,170,98,56,16,0
2021,Crawley 002G,E01035329,2180,1916,264,162,83,17,2
2021,Horsham 001E,E01035330,1326,1230,96,67,26,2,1
2021,Horsham 001F,E01035331,1260,1233,27,21,5,1,0
2021,Horsham 001G,E01035332,1389,1238,151,91,50,9,1
2021,Horsham 001H,E01035333,1519,1386,133,89,37,6,1
2021,Horsham 006G,E01035334,1132,1032,100,60,34,6,0
2021,Horsham 006H,E01035335,1348,1123,225,111,74,36,4
2021,Horsham 007E,E01035336,1104,1044,60,27,16,15,2
2021,Horsham 007F,E01035337,1223,1154,69,42,24,3,0
2021,Horsham 007G,E01035338,1692,1564,128,78,42,4,4
2021,Horsham 007H,E01035339,1681,1596,85,52,24,6,3
2021,Horsham 007I,E01035340,1595,1519,76,42,27,7,0
2021,Horsham 010F,E01035341,1569,1538,31,21,6,4,0
2021,Horsham 010G,E01035342,1360,1331,29,16,8,4,1
2021,Mid Sussex 001H,E01035343,1128,919,209,121,63,24,1
2021,Mid Sussex 001I,E01035344,1145,1105,40,23,15,2,0
2021,Mid Sussex 007E,E01035345,1621,1547,74,51,17,6,0
2021,Mid Sussex 007F,E01035346,1338,1288,50,25,20,3,2
2021,Mid Sussex 009H,E01035347,1168,985,183,93,69,21,0
2021,Mid Sussex 009I,E01035348,1003,873,130,68,39,20,3
2021,Mid Sussex 011G,E01035349,1403,1379,24,20,3,1,0
2021,Mid Sussex 011H,E01035350,1253,1146,107,68,22,15,2
2021,Mid Sussex 011I,E01035351,1587,1544,43,36,5,1,1
2021,Mid Sussex 011J,E01035352,1654,1562,92,48,36,7,1
2021,Mid Sussex 013F,E01035353,1510,1485,25,9,13,2,1
2021,Mid Sussex 013G,E01035354,1587,1508,79,46,28,5,0
2021,Reigate and Banstead 011F,E01035355,1517,1373,144,98,36,10,0
2021,Reigate and Banstead 011G,E01035356,1483,1320,163,80,65,16,2
2021,Reigate and Banstead 011H,E01035357,1524,1289,235,165,54,16,0
2021,Reigate and Banstead 011I,E01035358,1263,957,306,172,96,30,8
2021,Reigate and Banstead 016F,E01035359,1791,1641,150,108,24,16,2
2021,Reigate and Banstead 016G,E01035360,1835,1794,41,38,3,0,0
2021,Reigate and Banstead 018F,E01035361,1356,1189,167,100,54,10,3
2021,Reigate and Banstead 018G,E01035362,1212,977,235,110,95,28,2
2021,Tandridge 002E,E01035363,1222,1148,74,45,20,9,0
2021,Tandridge 002F,E01035364,1159,1102,57,35,16,6,0
2021,Cheshire West and Chester 007F,E01035365,1204,1098,106,39,49,14,4
2021,Cheshire West and Chester 007G,E01035366,1905,1822,83,47,27,8,1
2021,Cheshire West and Chester 007H,E01035367,1279,1197,82,33,31,16,2
2021,Cheshire West and Chester 007I,E01035368,1182,1105,77,21,37,17,2
2021,Cheshire West and Chester 018D,E01035369,1105,1072,33,17,8,6,2
2021,Cheshire West and Chester 018E,E01035370,1531,1491,40,26,10,2,2
2021,Cheshire West and Chester 018F,E01035371,1134,1112,22,8,10,4,0
2021,Cheshire West and Chester 018G,E01035372,1468,1443,25,18,5,2,0
2021,Cheshire West and Chester 033G,E01035373,1192,1077,115,50,52,12,1
2021,Cheshire West and Chester 033H,E01035374,1103,960,143,65,50,26,2
2021,Cheshire West and Chester 034F,E01035375,1318,1188,130,71,44,11,4
2021,Cheshire West and Chester 034G,E01035376,1514,1354,160,99,42,14,5
2021,Cheshire West and Chester 034H,E01035377,1643,1483,160,95,45,18,2
2021,Cheshire West and Chester 034I,E01035378,1187,1091,96,68,23,5,0
2021,Cheshire West and Chester 041E,E01035379,1326,1293,33,24,6,3,0
2021,Cheshire West and Chester 041F,E01035380,1515,1428,87,65,13,6,3
2021,Cheshire West and Chester 041G,E01035381,1395,1366,29,19,8,2,0
2021,Halton 012G,E01035382,1217,1166,51,27,15,6,3
2021,Halton 012H,E01035383,1246,1209,37,16,17,4,0
2021,Warrington 009E,E01035384,1228,1149,79,44,23,12,0
2021,Warrington 009F,E01035385,1522,1453,69,43,15,9,2
2021,Warrington 009G,E01035386,1475,1401,74,49,19,5,1
2021,Warrington 009H,E01035387,1439,1342,97,52,31,12,2
2021,Warrington 009I,E01035388,1535,1452,83,53,21,9,0
2021,Warrington 010G,E01035389,1489,1402,87,56,22,8,1
2021,Warrington 010H,E01035390,1451,1373,78,45,24,9,0
2021,Warrington 020F,E01035391,1616,1542,74,36,26,11,1
2021,Warrington 020G,E01035392,1338,1236,102,49,35,14,4
2021,North Northamptonshire 006C,E01035393,1596,1382,214,108,81,22,3
2021,North Northamptonshire 006D,E01035394,1561,1206,355,143,160,46,6
2021,North Northamptonshire 006E,E01035395,1413,1363,50,23,17,8,2
2021,North Northamptonshire 006F,E01035396,1184,1078,106,55,37,10,4
2021,North Northamptonshire 006G,E01035397,1830,1556,274,142,101,24,7
2021,North Northamptonshire 006H,E01035398,1852,1755,97,52,36,7,2
2021,West Northamptonshire 004D,E01035399,1260,1242,18,9,9,0,0
2021,West Northamptonshire 004E,E01035400,2265,2165,100,35,33,25,7
2021,West Northamptonshire 003E,E01035401,1589,1546,43,25,14,4,0
2021,West Northamptonshire 003F,E01035402,1284,1205,79,46,24,7,2
2021,West Northamptonshire 010D,E01035403,1495,1335,160,58,82,20,0
2021,West Northamptonshire 010E,E01035404,1542,1449,93,42,40,9,2
2021,West Northamptonshire 010F,E01035405,1663,1427,236,117,86,31,2
2021,West Northamptonshire 010G,E01035406,1647,1501,146,61,57,23,5
2021,North Northamptonshire 011E,E01035407,1490,1413,77,37,21,15,4
2021,North Northamptonshire 011F,E01035408,1439,1402,37,18,14,5,0
2021,North Northamptonshire 039E,E01035409,1458,1392,66,30,27,5,4
2021,North Northamptonshire 039F,E01035410,1644,1582,62,30,27,5,0
2021,North Northamptonshire 014D,E01035411,1428,1372,56,27,18,11,0
2021,North Northamptonshire 014E,E01035412,1200,1153,47,22,18,7,0
2021,North Northamptonshire 018F,E01035413,970,808,162,51,78,31,2
2021,North Northamptonshire 018G,E01035414,1073,869,204,78,92,31,3
2021,North Northamptonshire 023D,E01035415,2509,2412,97,52,25,20,0
2021,North Northamptonshire 023E,E01035416,1968,1861,107,36,45,20,6
2021,West Northamptonshire 034D,E01035417,1351,892,459,216,176,58,9
2021,West Northamptonshire 034E,E01035418,2006,1510,496,237,181,75,3
2021,West Northamptonshire 044D,E01035419,1867,1774,93,57,25,9,2
2021,West Northamptonshire 044E,E01035420,1125,1089,36,18,11,5,2
2021,West Northamptonshire 035B,E01035421,1823,1662,161,74,64,15,8
2021,West Northamptonshire 035C,E01035422,1480,1310,170,95,61,10,4
2021,West Northamptonshire 035D,E01035423,2417,2006,411,187,172,44,8
2021,West Northamptonshire 039D,E01035424,2232,1982,250,121,95,31,3
2021,West Northamptonshire 050D,E01035425,1364,1321,43,28,13,2,0
2021,West Northamptonshire 050E,E01035426,1601,1576,25,15,5,5,0
2021,West Northamptonshire 051E,E01035427,2157,2085,72,45,22,5,0
2021,West Northamptonshire 051F,E01035428,2156,2125,31,21,9,0,1
2021,North Northamptonshire 030D,E01035429,1419,1072,347,142,149,46,10
2021,North Northamptonshire 030E,E01035430,2107,1501,606,235,274,91,6
2021,North Northamptonshire 032D,E01035431,1326,886,440,131,222,80,7
2021,North Northamptonshire 032E,E01035432,1085,905,180,50,95,34,1
2021,Eastleigh 006F,E01035433,1345,1178,167,97,47,21,2
2021,Eastleigh 006G,E01035434,1865,1713,152,77,56,12,7
2021,Eastleigh 006H,E01035435,1139,1078,61,31,20,8,2
2021,Eastleigh 006I,E01035436,1168,1082,86,59,15,9,3
2021,Eastleigh 006J,E01035437,1613,1516,97,58,28,11,0
2021,Eastleigh 010F,E01035438,1978,1924,54,38,14,0,2
2021,Eastleigh 010G,E01035439,1908,1832,76,46,17,13,0
2021,Eastleigh 010H,E01035440,1417,1333,84,56,20,6,2
2021,Eastleigh 010I,E01035441,1431,1414,17,6,5,5,1
2021,Southampton 005G,E01035442,1726,1321,405,198,151,44,12
2021,Southampton 005H,E01035443,1305,796,509,174,236,88,11
2021,Southampton 023E,E01035444,1516,986,530,199,237,82,12
2021,Southampton 023F,E01035445,1751,1366,385,170,183,29,3
2021,Southampton 031F,E01035446,1183,983,200,119,68,12,1
2021,Southampton 031G,E01035447,1525,1360,165,64,75,26,0
2021,Southampton 034A,E01035448,1000,758,242,121,78,38,5
2021,Southampton 034B,E01035449,1057,856,201,131,54,14,2
2021,Test Valley 013E,E01035450,1510,1473,37,28,9,0,0
2021,Test Valley 013F,E01035451,1511,1466,45,32,10,3,0
2021,Test Valley 013G,E01035452,1485,1451,34,23,6,2,3
2021,Test Valley 016A,E01035453,1311,1211,100,51,35,11,3
2021,Test Valley 016B,E01035454,1378,1351,27,12,10,2,3
2021,Test Valley 016C,E01035455,1608,1442,166,79,62,21,4
2021,Test Valley 016D,E01035456,1583,1440,143,72,57,11,3
2021,Test Valley 016E,E01035457,1369,1236,133,76,46,10,1
2021,Test Valley 017A,E01035458,1511,1451,60,42,14,4,0
2021,Test Valley 017B,E01035459,1532,1473,59,25,30,3,1
2021,Test Valley 017C,E01035460,1305,1207,98,38,46,12,2
2021,Test Valley 017D,E01035461,1191,1121,70,47,16,6,1
2021,Test Valley 017E,E01035462,1464,1356,108,48,45,10,5
2021,Kingston upon Hull 011F,E01035463,2383,2343,40,22,8,8,2
2021,Kingston upon Hull 017G,E01035464,2171,1982,189,80,77,29,3
2021,Kingston upon Hull 029G,E01035465,1129,854,275,90,114,61,10
2021,Kingston upon Hull 029H,E01035466,1312,930,382,117,132,113,20
2021,Kingston upon Hull 031H,E01035467,1550,1057,493,167,224,80,22
2021,Kingston upon Hull 031I,E01035468,1181,1013,168,58,60,41,9
2021,Kingston upon Hull 034C,E01035469,1970,1880,90,50,29,9,2
2021,Kingston upon Hull 035A,E01035470,2346,2241,105,55,40,7,3
2021,Kingston upon Hull 035B,E01035471,1278,1234,44,14,22,5,3
2021,Kingston upon Hull 035C,E01035472,1711,1656,55,24,22,6,3
2021,North East Lincolnshire 002E,E01035473,2012,1756,256,82,96,72,6
2021,North East Lincolnshire 007E,E01035474,1451,1433,18,9,4,5,0
2021,North East Lincolnshire 007F,E01035475,1655,1617,38,21,15,1,1
2021,North East Lincolnshire 020F,E01035476,2428,2400,28,13,8,7,0
2021,North East Lincolnshire 021F,E01035477,1807,1725,82,39,35,8,0
2021,North East Lincolnshire 021G,E01035478,1939,1846,93,48,31,12,2
2021,North East Lincolnshire 022F,E01035479,1287,1273,14,7,2,5,0
2021,North East Lincolnshire 022G,E01035480,1571,1512,59,42,16,1,0
2021,North Lincolnshire 015E,E01035481,1333,1259,74,19,25,27,3
2021,North Lincolnshire 015F,E01035482,1157,1058,99,32,45,20,2
2021,North Lincolnshire 015G,E01035483,1345,1255,90,38,33,16,3
2021,Hammersmith and Fulham 001F,E01035484,1656,1107,549,296,203,40,10
2021,Hammersmith and Fulham 001G,E01035485,1076,708,368,182,132,51,3
2021,Hammersmith and Fulham 023G,E01035486,1705,1310,395,248,109,35,3
2021,Hammersmith and Fulham 023H,E01035487,1502,1216,286,181,71,30,4
2021,Wandsworth 004H,E01035488,1415,1115,300,200,75,24,1
2021,Wandsworth 004I,E01035489,1274,1034,240,171,53,14,2
2021,Wandsworth 010H,E01035490,1651,1348,303,204,67,32,0
2021,Wandsworth 010I,E01035491,1181,954,227,146,60,20,1
2021,Wandsworth 010J,E01035492,1600,1342,258,195,50,12,1
2021,Wandsworth 010K,E01035493,1612,1314,298,189,80,28,1
2021,Wandsworth 018E,E01035494,1753,1408,345,228,90,25,2
2021,Wandsworth 018F,E01035495,1296,1029,267,114,95,52,6
2021,Wandsworth 038A,E01035496,1212,909,303,229,50,23,1
2021,Wandsworth 038B,E01035497,1437,1080,357,214,105,34,4
2021,Wandsworth 038E,E01035498,1133,841,292,228,50,14,0
2021,Wandsworth 039C,E01035499,1560,1178,382,143,154,75,10
2021,Nottingham 023J,E01035500,2058,1538,520,281,178,52,9
2021,Nottingham 028H,E01035501,2314,1958,356,165,119,67,5
2021,Nottingham 028I,E01035502,2895,2777,118,46,34,30,8
2021,Nottingham 031J,E01035503,2057,1978,79,49,18,8,4
2021,Nottingham 031K,E01035504,1666,1492,174,89,57,28,0
2021,Nottingham 031L,E01035505,2981,2674,307,159,99,40,9
2021,Nottingham 039G,E01035506,2203,1718,485,328,136,20,1
2021,Nottingham 041E,E01035507,4688,4123,565,260,211,81,13
2021,Nottingham 041F,E01035508,4856,4249,607,283,257,62,5
2021,Rushcliffe 008F,E01035509,1339,1276,63,44,11,7,1
2021,Rushcliffe 008G,E01035510,1618,1472,146,99,35,12,0
2021,Cambridge 005E,E01035511,1169,953,216,146,56,12,2
2021,Cambridge 005F,E01035512,986,576,410,279,101,27,3
2021,Cambridge 005G,E01035513,998,699,299,217,72,10,0
2021,Cambridge 005H,E01035514,8189,6682,1507,1215,256,34,2
2021,Cambridge 007H,E01035515,2603,2251,352,311,37,4,0
2021,Cambridge 007I,E01035516,5685,4817,868,696,154,17,1
2021,Cambridge 007J,E01035517,3245,2787,458,365,82,8,3
2021,Cambridge 010F,E01035518,1628,1154,474,319,127,25,3
2021,Cambridge 010G,E01035519,2305,1178,1127,554,372,165,36
2021,Cambridge 013F,E01035520,1946,1727,219,148,44,26,1
2021,Cambridge 013G,E01035521,1773,1315,458,296,136,18,8
2021,Cambridge 014B,E01035522,1955,1455,500,360,120,19,1
2021,Cambridge 014C,E01035523,1123,909,214,169,36,9,0
2021,Cambridge 015A,E01035524,1436,1108,328,193,101,30,4
2021,Cambridge 015B,E01035525,1503,1214,289,212,57,19,1
2021,Cambridge 015C,E01035526,1894,1469,425,271,112,37,5
2021,Cambridge 015D,E01035527,1382,1022,360,227,76,52,5
2021,Cambridge 015E,E01035528,1454,1110,344,220,90,21,13
2021,Cambridge 015F,E01035529,1500,1191,309,188,65,47,9
2021,Cambridge 015G,E01035530,1357,1146,211,146,52,12,1
2021,East Cambridgeshire 001F,E01035531,1245,1180,65,25,31,9,0
2021,East Cambridgeshire 001G,E01035532,1699,1562,137,76,44,15,2
2021,East Cambridgeshire 003H,E01035533,1480,1321,159,92,50,16,1
2021,East Cambridgeshire 003I,E01035534,1195,1088,107,53,35,18,1
2021,East Cambridgeshire 004H,E01035535,2334,2206,128,66,34,21,7
2021,Fenland 011F,E01035536,1671,1502,169,63,72,26,8
2021,Fenland 011G,E01035537,1270,1199,71,23,32,13,3
2021,Peterborough 007G,E01035538,1607,1349,258,105,117,32,4
2021,Peterborough 007H,E01035539,1701,1266,435,159,191,77,8
2021,Peterborough 013G,E01035540,1441,929,512,157,225,106,24
2021,Peterborough 013H,E01035541,1459,958,501,185,212,91,13
2021,Peterborough 014F,E01035542,1507,848,659,199,276,149,35
2021,Peterborough 014G,E01035543,1121,568,553,173,239,117,24
2021,Peterborough 017F,E01035544,1511,1137,374,172,156,37,9
2021,Peterborough 017G,E01035545,1573,1226,347,136,149,50,12
2021,Peterborough 019G,E01035546,1350,1181,169,70,69,27,3
2021,Peterborough 019H,E01035547,1494,1144,350,172,138,36,4
2021,Peterborough 019I,E01035548,1461,1147,314,147,123,38,6
2021,Peterborough 019J,E01035549,1645,1335,310,147,121,35,7
2021,Peterborough 023G,E01035551,1626,1440,186,88,76,19,3
2021,Peterborough 023H,E01035552,1578,1308,270,154,93,19,4
2021,Peterborough 023I,E01035553,1374,1074,300,133,118,46,3
2021,Peterborough 023J,E01035554,1501,1266,235,118,94,17,6
2021,South Cambridgeshire 003E,E01035555,1547,1277,270,176,75,17,2
2021,South Cambridgeshire 003F,E01035556,1409,1311,98,64,28,5,1
2021,South Cambridgeshire 003G,E01035557,1250,1114,136,77,43,14,2
2021,South Cambridgeshire 003H,E01035558,1214,1130,84,67,10,6,1
2021,South Cambridgeshire 020F,E01035559,1946,1579,367,227,100,28,12
2021,South Cambridgeshire 020G,E01035560,2305,1883,422,285,97,34,6
2021,South Cambridgeshire 022D,E01035561,2117,1993,124,82,25,13,4
2021,Dacorum 015F,E01035562,1450,1208,242,117,82,42,1
2021,Dacorum 015G,E01035563,1299,1058,241,101,95,39,6
2021,Dacorum 015H,E01035564,1144,945,199,124,53,19,3
2021,West Oxfordshire 012E,E01035565,2353,2327,26,19,5,2,0
2021,St Albans 012E,E01035566,1252,1078,174,110,44,19,1
2021,St Albans 012F,E01035567,1211,1004,207,122,58,22,5
2021,Stevenage 001E,E01035568,1416,1295,121,83,28,9,1
2021,Stevenage 001F,E01035569,1728,1556,172,84,58,26,4
2021,Stevenage 008E,E01035570,1218,974,244,143,68,29,4
2021,Stevenage 008F,E01035571,1310,1136,174,92,61,20,1
2021,Watford 007E,E01035572,1357,1080,277,194,62,19,2
2021,Watford 007F,E01035573,1530,1183,347,193,103,44,7
2021,Watford 009E,E01035574,1236,917,319,187,100,24,8
2021,Watford 009F,E01035575,1246,856,390,184,157,45,4
2021,Watford 009G,E01035576,1013,645,368,206,127,31,4
2021,Watford 009H,E01035577,1587,1069,518,276,174,58,10
2021,Watford 009I,E01035578,1266,768,498,224,188,71,15
2021,Watford 011F,E01035579,1743,1301,442,240,156,41,5
2021,Watford 011G,E01035580,1193,903,290,157,95,32,6
2021,St Albans 021C,E01035581,1519,1468,51,27,22,2,0
2021,Stevenage 013A,E01035582,1623,1549,74,40,27,5,2
2021,Broxbourne 005F,E01035583,1274,1166,108,51,38,18,1
2021,Broxbourne 005G,E01035584,1477,1369,108,49,42,16,1
2021,Broxbourne 013E,E01035585,1420,1123,297,102,126,64,5
2021,Broxbourne 013F,E01035586,1269,1071,198,74,84,40,0
2021,East Hertfordshire 001E,E01035587,1636,1599,37,23,7,7,0
2021,East Hertfordshire 001F,E01035588,1233,1220,13,4,6,1,2
2021,East Hertfordshire 001G,E01035589,1083,1070,13,8,2,1,2
2021,East Hertfordshire 004D,E01035590,1534,1386,148,84,50,11,3
2021,East Hertfordshire 004E,E01035591,1089,738,351,196,128,25,2
2021,East Hertfordshire 006D,E01035592,1014,992,22,17,5,0,0
2021,East Hertfordshire 006E,E01035593,1838,1816,22,12,6,3,1
2021,East Hertfordshire 007G,E01035594,1401,1198,203,106,72,21,4
2021,East Hertfordshire 007H,E01035595,1057,656,401,249,123,27,2
2021,East Hertfordshire 017F,E01035596,1298,1206,92,52,29,10,1
2021,East Hertfordshire 017G,E01035597,1273,1176,97,49,29,18,1
2021,Hertsmere 011F,E01035598,1625,1338,287,103,141,32,11
2021,Hertsmere 011G,E01035599,1569,1196,373,185,141,38,9
2021,Three Rivers 001F,E01035600,1431,1389,42,26,16,0,0
2021,Three Rivers 001G,E01035601,1177,1096,81,60,15,6,0
2021,Three Rivers 002F,E01035602,1214,1163,51,32,12,5,2
2021,Three Rivers 002G,E01035603,2316,2122,194,124,60,8,2
2021,Welwyn Hatfield 007F,E01035604,1216,1130,86,47,27,10,2
2021,Welwyn Hatfield 007G,E01035605,1613,1418,195,112,58,22,3
2021,Welwyn Hatfield 009E,E01035606,1778,1652,126,75,42,7,2
2021,Welwyn Hatfield 009F,E01035607,1148,1029,119,74,38,6,1
2021,Welwyn Hatfield 017C,E01035608,1587,1524,63,44,15,2,2
2021,East Hertfordshire 019C,E01035609,1399,1387,12,10,1,1,0
2021,Gateshead 008F,E01035610,2560,2277,283,110,108,52,13
2021,Gateshead 027E,E01035611,1086,961,125,72,39,14,0
2021,Gateshead 027F,E01035612,1186,1066,120,35,43,28,14
2021,Newcastle upon Tyne 032C,E01035613,1360,1279,81,55,22,2,2
2021,Newcastle upon Tyne 032D,E01035614,1639,1515,124,84,28,9,3
2021,Newcastle upon Tyne 032E,E01035615,1444,1359,85,54,19,10,2
2021,Newcastle upon Tyne 032F,E01035616,1400,1320,80,53,16,10,1
2021,Newcastle upon Tyne 036A,E01035617,3543,3097,446,228,149,60,9
2021,Newcastle upon Tyne 038B,E01035618,1457,636,821,219,315,245,42
2021,Newcastle upon Tyne 038C,E01035619,1495,938,557,152,201,175,29
2021,Newcastle upon Tyne 039B,E01035620,1734,1220,514,189,238,85,2
2021,Newcastle upon Tyne 039C,E01035621,1981,1545,436,130,193,100,13
2021,Newcastle upon Tyne 040A,E01035622,1167,977,190,54,80,48,8
2021,Newcastle upon Tyne 040B,E01035623,1147,1007,140,60,47,26,7
2021,Gateshead 029D,E01035624,1526,1511,15,6,6,2,1
2021,North Tyneside 007E,E01035625,1748,1726,22,17,3,2,0
2021,North Tyneside 007F,E01035626,1774,1747,27,18,6,1,2
2021,North Tyneside 018F,E01035627,1603,1543,60,25,22,13,0
2021,North Tyneside 018G,E01035628,1572,1501,71,39,21,6,5
2021,Northumberland 015E,E01035629,1687,1661,26,14,5,6,1
2021,Northumberland 015F,E01035630,1573,1557,16,13,1,2,0
2021,Northumberland 023F,E01035631,1516,1504,12,2,4,4,2
2021,Northumberland 023G,E01035632,1682,1664,18,6,9,2,1
2021,Northumberland 025E,E01035633,1339,1326,13,5,3,5,0
2021,Northumberland 025F,E01035634,1021,1005,16,11,3,2,0
2021,Northumberland 025G,E01035635,1498,1481,17,9,6,2,0
2021,Northumberland 038G,E01035636,2028,2012,16,8,5,2,1
2021,Northumberland 043F,E01035637,1068,1061,7,4,3,0,0
2021,Hackney 002G,E01035638,1810,1282,528,293,156,68,11
2021,Hackney 002H,E01035639,1643,1269,374,197,102,59,16
2021,Hackney 020F,E01035640,1348,1139,209,106,60,33,10
2021,Hackney 020G,E01035641,1381,1135,246,164,52,23,7
2021,Hackney 025G,E01035642,1787,1394,393,250,90,45,8
2021,Hackney 025H,E01035643,1653,1315,338,182,96,52,8
2021,Hackney 025I,E01035644,1140,882,258,197,39,20,2
2021,Hackney 025J,E01035645,1273,1024,249,127,69,49,4
2021,Hackney 026E,E01035646,1504,1157,347,199,93,51,4
2021,Hackney 026F,E01035647,1079,866,213,183,21,9,0
2021,Hackney 026G,E01035648,1501,1165,336,142,93,92,9
2021,Hackney 026H,E01035649,1410,1091,319,203,84,28,4
2021,Hackney 031C,E01035650,1960,1548,412,161,116,113,22
2021,Islington 007E,E01035651,1521,1176,345,168,114,53,10
2021,Islington 007F,E01035652,1249,955,294,172,79,40,3
2021,Islington 011J,E01035653,1359,1068,291,199,82,10,0
2021,Islington 011K,E01035654,1098,946,152,96,42,11,3
2021,Islington 020F,E01035655,1663,1304,359,240,67,47,5
2021,Islington 020G,E01035656,1422,1114,308,232,62,10,4
2021,Tower Hamlets 001E,E01035657,1013,889,124,92,22,8,2
2021,Tower Hamlets 001F,E01035658,1217,1027,190,120,42,25,3
2021,Tower Hamlets 001G,E01035659,1521,1254,267,99,93,63,12
2021,Tower Hamlets 002E,E01035660,1403,1072,331,138,97,72,24
2021,Tower Hamlets 002F,E01035661,1606,1203,403,130,91,166,16
2021,Tower Hamlets 004H,E01035662,1086,918,168,140,22,6,0
2021,Tower Hamlets 004I,E01035663,1263,1055,208,112,69,22,5
2021,Tower Hamlets 006E,E01035664,2427,1974,453,252,102,84,15
2021,Tower Hamlets 008F,E01035665,1367,1066,301,201,68,25,7
2021,Tower Hamlets 008G,E01035666,1846,1253,593,262,204,105,22
2021,Tower Hamlets 008H,E01035667,1896,1386,510,193,160,128,29
2021,Tower Hamlets 009E,E01035668,2022,1578,444,216,126,86,16
2021,Tower Hamlets 009F,E01035669,1358,1034,324,209,61,47,7
2021,Tower Hamlets 010G,E01035670,4185,2935,1250,561,369,276,44
2021,Tower Hamlets 012F,E01035671,2078,1571,507,271,120,100,16
2021,Tower Hamlets 012G,E01035672,2831,2058,773,258,273,202,40
2021,Tower Hamlets 012H,E01035673,1098,812,286,142,76,57,11
2021,Tower Hamlets 014F,E01035674,1330,1047,283,123,95,51,14
2021,Tower Hamlets 014G,E01035675,1748,1183,565,295,155,103,12
2021,Tower Hamlets 014H,E01035676,1463,1103,360,101,131,111,17
2021,Tower Hamlets 014I,E01035677,1467,1096,371,176,103,74,18
2021,Tower Hamlets 018E,E01035678,1860,1398,462,239,131,71,21
2021,Tower Hamlets 018F,E01035679,1538,1094,444,226,138,69,11
2021,Tower Hamlets 019E,E01035680,1783,1368,415,225,128,50,12
2021,Tower Hamlets 019F,E01035681,1917,1409,508,130,181,143,54
2021,Tower Hamlets 019G,E01035682,1431,1056,375,155,120,76,24
2021,Tower Hamlets 019H,E01035683,1752,1266,486,134,168,143,41
2021,Tower Hamlets 020E,E01035684,1504,1097,407,174,119,85,29
2021,Tower Hamlets 020F,E01035685,1402,1000,402,135,160,80,27
2021,Tower Hamlets 021G,E01035686,1459,916,543,253,162,102,26
2021,Tower Hamlets 021H,E01035687,1694,1109,585,383,144,52,6
2021,Tower Hamlets 021I,E01035688,1616,967,649,363,231,50,5
2021,Tower Hamlets 021J,E01035689,1558,1087,471,259,136,66,10
2021,Tower Hamlets 023E,E01035690,1975,1381,594,318,144,101,31
2021,Tower Hamlets 023F,E01035691,1855,1380,475,313,122,33,7
2021,Tower Hamlets 024E,E01035692,1409,1027,382,237,85,50,10
2021,Tower Hamlets 024F,E01035693,1481,1065,416,242,110,55,9
2021,Tower Hamlets 024G,E01035694,2088,1522,566,252,192,100,22
2021,Tower Hamlets 024H,E01035695,1581,1089,492,181,176,121,14
2021,Tower Hamlets 026E,E01035696,1154,857,297,214,56,26,1
2021,Tower Hamlets 026F,E01035697,1632,1137,495,266,154,59,16
2021,Tower Hamlets 032F,E01035698,911,592,319,221,79,17,2
2021,Tower Hamlets 032G,E01035699,1675,1129,546,341,118,76,11
2021,Tower Hamlets 034A,E01035700,1134,801,333,262,60,8,3
2021,Tower Hamlets 034B,E01035701,1154,841,313,238,65,9,1
2021,Tower Hamlets 034C,E01035702,1458,1087,371,201,122,37,11
2021,Tower Hamlets 036B,E01035703,1092,718,374,287,67,15,5
2021,Tower Hamlets 036C,E01035704,1716,1243,473,248,147,71,7
2021,Tower Hamlets 036D,E01035705,1389,1020,369,168,128,62,11
2021,Tower Hamlets 036E,E01035706,1229,830,399,247,111,37,4
2021,Camden 015F,E01035707,2395,2006,389,283,75,28,3
2021,Camden 022F,E01035708,1897,1308,589,348,194,41,6
2021,Camden 022G,E01035709,1497,1138,359,138,152,59,10
2021,Camden 023F,E01035710,2515,1779,736,324,269,124,19
2021,Camden 026E,E01035711,2394,1779,615,391,138,76,10
2021,Camden 029E,E01035712,2412,1705,707,421,175,86,25
2021,Kensington and Chelsea 016F,E01035713,1941,1424,517,403,89,24,1
2021,Kensington and Chelsea 020F,E01035714,2003,1584,419,325,72,20,2
2021,Westminster 007H,E01035715,2714,2141,573,383,160,26,4
2021,Westminster 013G,E01035716,2148,1590,558,397,95,57,9
2021,Westminster 014H,E01035717,1844,1424,420,274,105,35,6
2021,Westminster 019G,E01035718,2524,1875,649,416,198,32,3
2021,Westminster 021F,E01035719,1241,911,330,226,82,22,0
2021,Westminster 021G,E01035720,1197,930,267,180,61,25,1
2021,Westminster 023H,E01035721,2260,1793,467,267,133,56,11
2021,Westminster 024G,E01035722,1977,1417,560,328,173,42,17
2021,Cherwell 001E,E01035723,1189,1166,23,14,7,2,0
2021,Cherwell 001F,E01035724,1608,1457,151,73,57,19,2
2021,Cherwell 004I,E01035725,1114,998,116,62,45,7,2
2021,Cherwell 004J,E01035726,1598,1118,480,154,239,74,13
2021,Cherwell 008E,E01035727,1742,1577,165,108,41,12,4
2021,Cherwell 008F,E01035728,1315,1236,79,53,18,6,2
2021,Cherwell 008G,E01035729,1456,1412,44,24,12,6,2
2021,Cherwell 010F,E01035730,1662,1570,92,61,24,6,1
2021,Cherwell 010G,E01035731,1428,1370,58,36,20,1,1
2021,Cherwell 011G,E01035733,1597,1469,128,76,38,10,4
2021,Cherwell 011H,E01035734,1229,1076,153,78,64,9,2
2021,Cherwell 015E,E01035735,1700,1420,280,116,117,40,7
2021,Cherwell 015F,E01035736,1154,978,176,94,64,17,1
2021,Cherwell 016G,E01035737,1781,1541,240,131,79,24,6
2021,Cherwell 016H,E01035738,1559,1401,158,99,44,11,4
2021,Cherwell 016I,E01035739,1826,1788,38,19,13,3,3
2021,Oxford 003E,E01035740,2490,1958,532,393,116,22,1
2021,Oxford 008F,E01035741,2160,1711,449,315,104,29,1
2021,Oxford 008G,E01035742,2214,1901,313,249,53,11,0
2021,Oxford 019C,E01035743,1590,1161,429,170,163,80,16
2021,Oxford 019D,E01035744,1435,1100,335,135,145,49,6
2021,South Oxfordshire 010E,E01035745,1717,1587,130,66,47,17,0
2021,South Oxfordshire 010F,E01035746,1742,1524,218,125,73,17,3
2021,South Oxfordshire 011E,E01035747,1005,978,27,15,9,3,0
2021,South Oxfordshire 011F,E01035748,2034,1720,314,136,120,58,0
2021,South Oxfordshire 015F,E01035749,2441,2164,277,184,78,14,1
2021,South Oxfordshire 015G,E01035750,1148,1125,23,16,6,0,1
2021,South Oxfordshire 015H,E01035751,1527,1476,51,35,8,8,0
2021,South Oxfordshire 015I,E01035752,1515,1459,56,37,14,5,0
2021,Vale of White Horse 007D,E01035753,1939,1855,84,59,22,3,0
2021,Vale of White Horse 007E,E01035754,1803,1739,64,42,17,3,2
2021,Vale of White Horse 010F,E01035755,1508,1453,55,41,10,3,1
2021,Vale of White Horse 010G,E01035756,1479,1436,43,27,10,5,1
2021,Vale of White Horse 014G,E01035757,1105,1027,78,48,20,10,0
2021,Vale of White Horse 014H,E01035758,1141,1075,66,46,17,3,0
2021,Vale of White Horse 015G,E01035759,1445,1397,48,26,18,3,1
2021,Vale of White Horse 015H,E01035760,1494,1291,203,128,62,10,3
2021,Vale of White Horse 015I,E01035761,1495,1390,105,82,14,8,1
2021,West Oxfordshire 004H,E01035762,1417,1389,28,19,7,2,0
2021,Isle of Anglesey 001A,W01000003,2370,2347,23,10,8,5,0
2021,Isle of Anglesey 001B,W01000004,1229,1218,11,6,3,2,0
2021,Isle of Anglesey 005A,W01000005,1587,1561,26,10,8,5,3
2021,Isle of Anglesey 006A,W01000006,1494,1488,6,3,0,3,0
2021,Isle of Anglesey 009A,W01000007,1738,1726,12,7,1,3,1
2021,Isle of Anglesey 008A,W01000008,1417,1394,23,12,6,5,0
2021,Isle of Anglesey 007C,W01000009,1818,1798,20,13,6,0,1
2021,Isle of Anglesey 002A,W01000010,1775,1763,12,4,4,2,2
2021,Isle of Anglesey 008B,W01000011,999,954,45,28,13,4,0
2021,Isle of Anglesey 006B,W01000012,1658,1625,33,9,12,11,1
2021,Isle of Anglesey 005B,W01000013,2130,2114,16,15,1,0,0
2021,Isle of Anglesey 006C,W01000014,2129,2085,44,12,19,10,3
2021,Isle of Anglesey 008C,W01000015,1434,1410,24,6,9,8,1
2021,Isle of Anglesey 003A,W01000016,1157,1132,25,6,12,7,0
2021,Isle of Anglesey 003B,W01000017,1636,1628,8,5,2,1,0
2021,Isle of Anglesey 001C,W01000018,1148,1143,5,3,1,1,0
2021,Isle of Anglesey 005C,W01000019,1326,1319,7,3,2,1,1
2021,Isle of Anglesey 002C,W01000021,2265,2257,8,6,0,2,0
2021,Isle of Anglesey 004A,W01000022,1576,1571,5,3,1,0,1
2021,Isle of Anglesey 007D,W01000023,1525,1521,4,2,2,0,0
2021,Isle of Anglesey 007E,W01000024,1293,1274,19,12,6,1,0
2021,Isle of Anglesey 009B,W01000025,2097,2080,17,12,5,0,0
2021,Isle of Anglesey 005D,W01000026,1229,1224,5,3,1,1,0
2021,Isle of Anglesey 009C,W01000027,1813,1800,13,8,4,1,0
2021,Isle of Anglesey 001D,W01000028,1919,1911,8,2,5,0,1
2021,Isle of Anglesey 003C,W01000029,1541,1536,5,2,2,1,0
2021,Isle of Anglesey 003D,W01000030,2236,2221,15,5,8,2,0
2021,Isle of Anglesey 001E,W01000031,1513,1506,7,0,4,3,0
2021,Isle of Anglesey 003E,W01000033,1506,1495,11,5,2,4,0
2021,Isle of Anglesey 004B,W01000034,1398,1387,11,3,6,2,0
2021,Isle of Anglesey 005E,W01000035,1744,1730,14,6,3,2,3
2021,Isle of Anglesey 003F,W01000036,1069,1059,10,6,1,3,0
2021,Isle of Anglesey 003G,W01000037,1125,1117,8,4,1,1,2
2021,Isle of Anglesey 009D,W01000038,2177,2166,11,6,4,0,1
2021,Isle of Anglesey 004D,W01000040,1041,1036,5,4,0,1,0
2021,Isle of Anglesey 006D,W01000041,1530,1520,10,7,0,3,0
2021,Isle of Anglesey 008D,W01000042,1982,1900,82,44,25,12,1
2021,Isle of Anglesey 004F,W01000044,1070,1066,4,0,2,1,1
2021,Gwynedd 011A,W01000047,1233,1224,9,6,3,0,0
2021,Gwynedd 003A,W01000050,1399,1351,48,23,10,13,2
2021,Gwynedd 015A,W01000051,1945,1849,96,28,33,28,7
2021,Gwynedd 004A,W01000052,1061,1061,0,0,0,0,0
2021,Gwynedd 004B,W01000053,1144,1132,12,9,1,2,0
2021,Gwynedd 007A,W01000054,989,986,3,1,1,1,0
2021,Gwynedd 009A,W01000056,1719,1700,19,8,7,4,0
2021,Gwynedd 016C,W01000057,1358,1352,6,5,1,0,0
2021,Gwynedd 006A,W01000059,2028,1986,42,23,8,11,0
2021,Gwynedd 015B,W01000060,1227,1219,8,5,3,0,0
2021,Gwynedd 011B,W01000061,1700,1653,47,23,16,8,0
2021,Gwynedd 001A,W01000062,1967,1623,344,171,125,41,7
2021,Gwynedd 005A,W01000063,1847,1837,10,7,3,0,0
2021,Gwynedd 002A,W01000064,1943,1766,177,81,59,34,3
2021,Gwynedd 009B,W01000065,996,977,19,8,6,3,2
2021,Gwynedd 010A,W01000066,1142,1133,9,3,5,0,1
2021,Gwynedd 016D,W01000067,1166,1150,16,11,3,2,0
2021,Gwynedd 016E,W01000068,1375,1353,22,14,4,4,0
2021,Gwynedd 012A,W01000070,1263,1258,5,1,3,1,0
2021,Gwynedd 003B,W01000071,2175,2156,19,15,4,0,0
2021,Gwynedd 002B,W01000072,1633,1536,97,50,28,19,0
2021,Gwynedd 008A,W01000073,1620,1613,7,3,2,2,0
2021,Gwynedd 013B,W01000074,1770,1764,6,3,2,0,1
2021,Gwynedd 002C,W01000075,1367,1228,139,61,48,22,8
2021,Gwynedd 001B,W01000076,1273,1131,142,96,39,7,0
2021,Gwynedd 001C,W01000077,1147,1042,105,52,40,13,0
2021,Gwynedd 011C,W01000078,1517,1496,21,9,9,3,0
2021,Gwynedd 014C,W01000080,1424,1375,49,18,27,4,0
2021,Gwynedd 005B,W01000081,1959,1944,15,8,4,1,2
2021,Gwynedd 015C,W01000082,1070,1056,14,12,1,1,0
2021,Gwynedd 015D,W01000083,1318,1313,5,2,1,1,1
2021,Gwynedd 014D,W01000084,1047,1041,6,4,1,1,0
2021,Gwynedd 017C,W01000085,1888,1875,13,8,5,0,0
2021,Gwynedd 008B,W01000086,2113,2094,19,8,5,6,0
2021,Gwynedd 004C,W01000087,1778,1769,9,7,0,1,1
2021,Gwynedd 007B,W01000088,2009,2002,7,3,4,0,0
2021,Gwynedd 011D,W01000089,1869,1859,10,6,1,3,0
2021,Gwynedd 002D,W01000090,1315,1286,29,16,10,3,0
2021,Gwynedd 001D,W01000091,1048,1015,33,20,7,6,0
2021,Gwynedd 001E,W01000092,3035,2696,339,165,143,28,3
2021,Gwynedd 006B,W01000093,2183,2142,41,22,15,3,1
2021,Gwynedd 012B,W01000094,1187,1182,5,4,1,0,0
2021,Gwynedd 012C,W01000095,1262,1251,11,5,3,3,0
2021,Gwynedd 003C,W01000096,1220,1207,13,9,4,0,0
2021,Gwynedd 003D,W01000097,1102,1073,29,9,15,4,1
2021,Gwynedd 006C,W01000098,2423,2375,48,18,16,11,3
2021,Gwynedd 005C,W01000099,1617,1610,7,5,0,2,0
2021,Gwynedd 010B,W01000100,1032,1020,12,8,2,0,2
2021,Gwynedd 013D,W01000101,1329,1316,13,7,3,3,0
2021,Gwynedd 002E,W01000102,1832,1720,112,76,16,18,2
2021,Gwynedd 005D,W01000103,1140,1105,35,29,6,0,0
2021,Gwynedd 008C,W01000104,1745,1717,28,12,9,2,5
2021,Gwynedd 010C,W01000105,1689,1641,48,21,21,4,2
2021,Gwynedd 010D,W01000106,1475,1464,11,5,2,3,1
2021,Gwynedd 010E,W01000107,1167,1148,19,7,6,4,2
2021,Gwynedd 012D,W01000108,2034,1941,93,27,28,31,7
2021,Gwynedd 012E,W01000109,1815,1738,77,38,23,16,0
2021,Gwynedd 006D,W01000110,1544,1529,15,6,8,1,0
2021,Gwynedd 007C,W01000111,1529,1481,48,14,18,14,2
2021,Gwynedd 008D,W01000112,1877,1869,8,3,2,1,2
2021,Gwynedd 009C,W01000113,1793,1776,17,7,8,2,0
2021,Gwynedd 009D,W01000114,1377,1361,16,5,2,6,3
2021,Gwynedd 003E,W01000115,2067,2043,24,21,1,1,1
2021,Gwynedd 017D,W01000116,1649,1639,10,5,5,0,0
2021,Gwynedd 017E,W01000117,1437,1424,13,7,2,2,2
2021,Gwynedd 007D,W01000118,1653,1641,12,8,4,0,0
2021,Gwynedd 004D,W01000119,2256,2201,55,33,18,3,1
2021,Conwy 015A,W01000121,1124,1113,11,7,3,1,0
2021,Conwy 014A,W01000122,1916,1913,3,3,0,0,0
2021,Conwy 013A,W01000123,1700,1672,28,17,5,5,1
2021,Conwy 012A,W01000124,1905,1898,7,5,1,1,0
2021,Conwy 013B,W01000125,1495,1486,9,5,4,0,0
2021,Conwy 009A,W01000126,1640,1621,19,13,3,3,0
2021,Conwy 009B,W01000127,1334,1313,21,11,5,3,2
2021,Conwy 009C,W01000128,1452,1426,26,11,14,1,0
2021,Conwy 012B,W01000129,1152,1135,17,6,9,1,1
2021,Conwy 012C,W01000130,1389,1361,28,14,11,3,0
2021,Conwy 012D,W01000131,1623,1611,12,9,1,2,0
2021,Conwy 001A,W01000132,1499,1431,68,35,21,12,0
2021,Conwy 002A,W01000133,1753,1730,23,12,7,3,1
2021,Conwy 015B,W01000134,1992,1957,35,19,10,6,0
2021,Conwy 006A,W01000135,1964,1937,27,21,6,0,0
2021,Conwy 006B,W01000136,1723,1703,20,16,4,0,0
2021,Conwy 015C,W01000137,1509,1501,8,7,0,1,0
2021,Conwy 008A,W01000138,1891,1863,28,10,13,3,2
2021,Conwy 007A,W01000139,1575,1555,20,8,9,2,1
2021,Conwy 010B,W01000140,1720,1702,18,13,3,2,0
2021,Conwy 010C,W01000141,1499,1486,13,8,4,1,0
2021,Conwy 010D,W01000142,1493,1472,21,12,3,5,1
2021,Conwy 007B,W01000143,1524,1471,53,18,23,10,2
2021,Conwy 007C,W01000144,1594,1545,49,21,17,8,3
2021,Conwy 008B,W01000145,1259,1245,14,4,4,6,0
2021,Conwy 001B,W01000146,2003,1814,189,83,65,34,7
2021,Conwy 001C,W01000147,1475,1422,53,26,24,3,0
2021,Conwy 015D,W01000148,1046,1024,22,15,7,0,0
2021,Conwy 005A,W01000149,1456,1442,14,4,4,6,0
2021,Conwy 005B,W01000150,1451,1436,15,5,10,0,0
2021,Conwy 005C,W01000151,1474,1449,25,13,5,6,1
2021,Conwy 005D,W01000152,1383,1365,18,6,4,6,2
2021,Conwy 009D,W01000153,1574,1563,11,5,2,4,0
2021,Conwy 003A,W01000154,1373,1355,18,14,4,0,0
2021,Conwy 004A,W01000155,1382,1344,38,23,6,9,0
2021,Conwy 004B,W01000156,1470,1451,19,14,4,1,0
2021,Conwy 004C,W01000157,1378,1352,26,14,6,4,2
2021,Conwy 004D,W01000158,1530,1507,23,12,7,3,1
2021,Conwy 014B,W01000159,1388,1377,11,8,1,1,1
2021,Conwy 014C,W01000162,1772,1761,11,7,2,0,2
2021,Conwy 009E,W01000163,1325,1314,11,6,1,3,1
2021,Conwy 009F,W01000164,1315,1301,14,6,4,2,2
2021,Conwy 006C,W01000165,1829,1821,8,7,0,1,0
2021,Conwy 006D,W01000166,2664,2604,60,29,25,6,0
2021,Conwy 011C,W01000167,1933,1888,45,15,17,10,3
2021,Conwy 002B,W01000168,1776,1704,72,31,24,14,3
2021,Conwy 001D,W01000169,1737,1661,76,27,35,13,1
2021,Conwy 013C,W01000170,1754,1736,18,8,9,1,0
2021,Conwy 013D,W01000171,1452,1438,14,12,1,0,1
2021,Conwy 013E,W01000172,1220,1217,3,3,0,0,0
2021,Conwy 003B,W01000173,1419,1398,21,9,5,7,0
2021,Conwy 003C,W01000174,1556,1522,34,18,12,3,1
2021,Conwy 003D,W01000175,1502,1481,21,10,5,5,1
2021,Conwy 011D,W01000176,1556,1509,47,26,11,9,1
2021,Conwy 011E,W01000177,1392,1367,25,7,13,5,0
2021,Conwy 010E,W01000178,1947,1906,41,24,10,3,4
2021,Conwy 010F,W01000179,1950,1926,24,15,8,1,0
2021,Conwy 008C,W01000180,1477,1449,28,20,8,0,0
2021,Conwy 008D,W01000181,1425,1393,32,17,11,2,2
2021,Conwy 007D,W01000182,2036,1967,69,22,25,18,4
2021,Conwy 008E,W01000183,1446,1403,43,21,13,7,2
2021,Conwy 005E,W01000184,2223,2199,24,10,9,4,1
2021,Conwy 015E,W01000185,1203,1196,7,1,0,6,0
2021,Conwy 001E,W01000186,1552,1480,72,40,19,13,0
2021,Conwy 002C,W01000187,1464,1415,49,23,22,4,0
2021,Conwy 002D,W01000188,1549,1504,45,21,22,0,2
2021,Conwy 015F,W01000189,1428,1408,20,10,6,4,0
2021,Conwy 014D,W01000190,1358,1346,12,7,3,0,2
2021,Denbighshire 009A,W01000191,2027,1930,97,68,17,11,1
2021,Denbighshire 016A,W01000192,975,969,6,2,4,0,0
2021,Denbighshire 015A,W01000193,1222,1190,32,7,14,8,3
2021,Denbighshire 011A,W01000194,1849,1790,59,17,37,5,0
2021,Denbighshire 012A,W01000195,1412,1404,8,4,4,0,0
2021,Denbighshire 012B,W01000196,1361,1341,20,11,6,2,1
2021,Denbighshire 012C,W01000197,1647,1626,21,11,7,2,1
2021,Denbighshire 011B,W01000198,1324,1306,18,11,3,1,3
2021,Denbighshire 011C,W01000199,1661,1644,17,5,10,2,0
2021,Denbighshire 008A,W01000200,1256,1249,7,5,2,0,0
2021,Denbighshire 008B,W01000201,1665,1649,16,8,2,5,1
2021,Denbighshire 015B,W01000202,1599,1586,13,9,2,0,2
2021,Denbighshire 013A,W01000203,2389,2371,18,10,4,1,3
2021,Denbighshire 013B,W01000204,1424,1416,8,5,0,2,1
2021,Denbighshire 016B,W01000205,1172,1169,3,1,2,0,0
2021,Denbighshire 013C,W01000206,2170,2150,20,10,0,0,10
2021,Denbighshire 015C,W01000207,2243,2220,23,11,11,1,0
2021,Denbighshire 016C,W01000208,1257,1215,42,19,9,14,0
2021,Denbighshire 016D,W01000209,1373,1360,13,6,6,1,0
2021,Denbighshire 016E,W01000210,1306,1290,16,5,8,3,0
2021,Denbighshire 012D,W01000211,1761,1759,2,1,1,0,0
2021,Denbighshire 003A,W01000212,2132,2098,34,19,11,4,0
2021,Denbighshire 002A,W01000213,1277,1258,19,5,6,5,3
2021,Denbighshire 002B,W01000214,1124,1108,16,5,8,2,1
2021,Denbighshire 002C,W01000215,1437,1426,11,7,4,0,0
2021,Denbighshire 002D,W01000216,1258,1248,10,6,2,2,0
2021,Denbighshire 008C,W01000217,1949,1931,18,10,6,2,0
2021,Denbighshire 001A,W01000218,1548,1535,13,7,3,3,0
2021,Denbighshire 001B,W01000219,2546,2502,44,24,12,8,0
2021,Denbighshire 001C,W01000220,1611,1602,9,4,1,3,1
2021,Denbighshire 003B,W01000221,1305,1297,8,3,4,1,0
2021,Denbighshire 003C,W01000222,1749,1740,9,4,5,0,0
2021,Denbighshire 009B,W01000223,1272,1260,12,4,5,2,1
2021,Denbighshire 009C,W01000224,1523,1506,17,11,5,1,0
2021,Denbighshire 009D,W01000225,1404,1390,14,7,4,3,0
2021,Denbighshire 004A,W01000226,1487,1477,10,6,4,0,0
2021,Denbighshire 004B,W01000227,1454,1440,14,5,7,2,0
2021,Denbighshire 004C,W01000228,1596,1541,55,23,19,11,2
2021,Denbighshire 017E,W01000229,1496,1475,21,10,9,1,1
2021,Denbighshire 017F,W01000230,1864,1828,36,21,9,5,1
2021,Denbighshire 017A,W01000231,1297,1269,28,15,11,2,0
2021,Denbighshire 017B,W01000232,1583,1567,16,9,6,1,0
2021,Denbighshire 017C,W01000233,1261,1251,10,6,4,0,0
2021,Denbighshire 017G,W01000234,2182,2128,54,24,20,8,2
2021,Denbighshire 017D,W01000235,1290,1283,7,3,3,1,0
2021,Denbighshire 006A,W01000236,1902,1811,91,50,22,14,5
2021,Denbighshire 006B,W01000237,1704,1666,38,13,14,9,2
2021,Denbighshire 006C,W01000238,1734,1676,58,24,19,13,2
2021,Denbighshire 004D,W01000239,1652,1561,91,44,30,14,3
2021,Denbighshire 004E,W01000240,1590,1494,96,20,41,29,6
2021,Denbighshire 004F,W01000241,1448,1415,33,14,9,9,1
2021,Denbighshire 014A,W01000242,1909,1875,34,16,11,7,0
2021,Denbighshire 014B,W01000243,2047,1910,137,51,77,9,0
2021,Denbighshire 014C,W01000244,1567,1551,16,7,5,3,1
2021,Denbighshire 010A,W01000245,1795,1773,22,11,2,9,0
2021,Denbighshire 010B,W01000246,1600,1565,35,15,17,1,2
2021,Denbighshire 010C,W01000247,1781,1769,12,8,3,1,0
2021,Denbighshire 008D,W01000248,1600,1590,10,6,4,0,0
2021,Flintshire 014A,W01000249,1168,1157,11,1,3,6,1
2021,Flintshire 014B,W01000250,1397,1383,14,7,5,0,2
2021,Flintshire 013A,W01000251,1504,1464,40,13,19,8,0
2021,Flintshire 010A,W01000252,1601,1572,29,14,15,0,0
2021,Flintshire 003A,W01000253,1788,1726,62,21,30,8,3
2021,Flintshire 003B,W01000254,2054,1940,114,34,54,20,6
2021,Flintshire 015A,W01000255,2207,2164,43,21,19,3,0
2021,Flintshire 015B,W01000256,1500,1458,42,18,19,5,0
2021,Flintshire 015C,W01000257,2613,2532,81,43,26,11,1
2021,Flintshire 006A,W01000258,2062,2050,12,9,3,0,0
2021,Flintshire 017A,W01000259,1627,1582,45,16,10,17,2
2021,Flintshire 017B,W01000260,1675,1657,18,7,9,2,0
2021,Flintshire 014C,W01000261,1378,1352,26,13,8,2,3
2021,Flintshire 017C,W01000262,1377,1339,38,14,17,5,2
2021,Flintshire 017D,W01000263,1298,1279,19,7,9,3,0
2021,Flintshire 012A,W01000264,1665,1650,15,10,2,1,2
2021,Flintshire 012B,W01000265,1447,1431,16,10,5,1,0
2021,Flintshire 017E,W01000266,1597,1556,41,20,13,6,2
2021,Flintshire 017F,W01000267,1978,1963,15,10,3,2,0
2021,Flintshire 013B,W01000268,1615,1609,6,5,1,0,0
2021,Flintshire 020A,W01000269,1522,1505,17,8,6,3,0
2021,Flintshire 006B,W01000270,1217,1211,6,4,1,0,1
2021,Flintshire 006C,W01000271,1218,1205,13,12,1,0,0
2021,Flintshire 006D,W01000272,1757,1750,7,4,3,0,0
2021,Flintshire 007A,W01000273,1499,1376,123,35,51,36,1
2021,Flintshire 007B,W01000274,1835,1528,307,79,126,92,10
2021,Flintshire 007C,W01000275,1159,1065,94,23,40,30,1
2021,Flintshire 008A,W01000276,1165,1068,97,41,47,7,2
2021,Flintshire 008B,W01000277,1327,1261,66,31,27,8,0
2021,Flintshire 007D,W01000278,1418,1303,115,34,56,24,1
2021,Flintshire 008C,W01000279,1151,1120,31,10,11,8,2
2021,Flintshire 010B,W01000280,1686,1661,25,18,3,4,0
2021,Flintshire 008D,W01000281,1142,1088,54,28,17,8,1
2021,Flintshire 010C,W01000282,1590,1564,26,15,9,2,0
2021,Flintshire 008E,W01000283,2254,2032,222,67,93,51,11
2021,Flintshire 013C,W01000284,1684,1645,39,17,13,8,1
2021,Flintshire 013D,W01000285,1567,1548,19,8,7,4,0
2021,Flintshire 013E,W01000286,2131,2062,69,33,13,20,3
2021,Flintshire 001A,W01000287,1820,1792,28,17,6,5,0
2021,Flintshire 004A,W01000288,2114,1898,216,56,75,68,17
2021,Flintshire 005A,W01000289,1301,1259,42,13,14,11,4
2021,Flintshire 004B,W01000290,1240,1128,112,28,36,31,17
2021,Flintshire 005B,W01000291,1265,1187,78,24,27,22,5
2021,Flintshire 004C,W01000292,1418,1317,101,35,44,17,5
2021,Flintshire 004D,W01000293,2558,2414,144,61,52,24,7
2021,Flintshire 005C,W01000294,1844,1795,49,17,26,6,0
2021,Flintshire 005D,W01000295,1537,1479,58,19,26,9,4
2021,Flintshire 003C,W01000296,1490,1459,31,14,8,7,2
2021,Flintshire 003D,W01000297,1197,1165,32,10,13,6,3
2021,Flintshire 001B,W01000298,1439,1434,5,5,0,0,0
2021,Flintshire 019A,W01000299,1859,1852,7,2,3,2,0
2021,Flintshire 019B,W01000300,1592,1589,3,3,0,0,0
2021,Flintshire 006E,W01000301,1688,1678,10,5,3,2,0
2021,Flintshire 013F,W01000302,1896,1871,25,14,9,2,0
2021,Flintshire 018A,W01000303,1682,1660,22,8,10,4,0
2021,Flintshire 003E,W01000304,2008,1908,100,25,52,21,2
2021,Flintshire 003F,W01000305,1852,1792,60,23,17,17,3
2021,Flintshire 002A,W01000306,2360,2299,61,33,14,13,1
2021,Flintshire 020B,W01000307,1391,1376,15,12,3,0,0
2021,Flintshire 020C,W01000308,1159,1151,8,4,0,3,1
2021,Flintshire 019C,W01000309,2058,2029,29,12,14,1,2
2021,Flintshire 020D,W01000310,1850,1838,12,11,1,0,0
2021,Flintshire 011A,W01000311,1633,1549,84,35,27,19,3
2021,Flintshire 011B,W01000312,1568,1458,110,44,34,23,9
2021,Flintshire 016A,W01000313,1552,1515,37,23,7,7,0
2021,Flintshire 016B,W01000314,1102,1085,17,7,6,4,0
2021,Flintshire 016C,W01000315,1904,1881,23,9,12,0,2
2021,Flintshire 016D,W01000316,1197,1183,14,8,6,0,0
2021,Flintshire 016E,W01000317,1562,1553,9,7,0,2,0
2021,Flintshire 016F,W01000318,1162,1131,31,9,13,7,2
2021,Flintshire 016G,W01000319,1396,1346,50,26,12,11,1
2021,Flintshire 002B,W01000320,1831,1812,19,5,9,4,1
2021,Flintshire 014D,W01000321,1597,1587,10,5,3,1,1
2021,Flintshire 014E,W01000322,1344,1329,15,5,8,2,0
2021,Flintshire 012C,W01000323,1536,1518,18,11,1,5,1
2021,Flintshire 012D,W01000324,1471,1466,5,3,2,0,0
2021,Flintshire 010D,W01000325,1760,1743,17,10,6,1,0
2021,Flintshire 018B,W01000326,2151,2142,9,7,1,1,0
2021,Flintshire 018C,W01000327,2384,2364,20,18,0,2,0
2021,Flintshire 011C,W01000328,1866,1551,315,63,162,69,21
2021,Flintshire 015D,W01000329,1555,1453,102,35,49,14,4
2021,Flintshire 015E,W01000330,2017,1852,165,72,59,28,6
2021,Flintshire 015F,W01000331,1421,1359,62,29,16,15,2
2021,Flintshire 009A,W01000332,1765,1661,104,41,45,13,5
2021,Flintshire 009B,W01000333,1424,1271,153,53,65,26,9
2021,Flintshire 009C,W01000334,1699,1428,271,50,108,106,7
2021,Flintshire 009D,W01000335,1143,1040,103,32,41,28,2
2021,Flintshire 009E,W01000336,1386,1248,138,44,56,34,4
2021,Flintshire 009F,W01000337,2095,1768,327,82,139,94,12
2021,Flintshire 001C,W01000338,1724,1708,16,6,5,3,2
2021,Flintshire 019D,W01000339,1637,1625,12,5,4,2,1
2021,Flintshire 002C,W01000340,2191,2181,10,7,1,2,0
2021,Wrexham 023C,W01000341,1508,1409,99,36,39,20,4
2021,Wrexham 023E,W01000342,1488,1335,153,53,71,23,6
2021,Wrexham 023B,W01000343,1010,979,31,14,6,10,1
2021,Wrexham 023A,W01000344,1223,1207,16,14,1,1,0
2021,Wrexham 018A,W01000345,1559,1550,9,2,7,0,0
2021,Wrexham 018B,W01000346,1460,1453,7,2,4,1,0
2021,Wrexham 006A,W01000347,2701,2612,89,44,36,7,2
2021,Wrexham 006B,W01000348,1375,1323,52,23,16,6,7
2021,Wrexham 011A,W01000349,2201,1969,232,105,82,41,4
2021,Wrexham 011B,W01000350,1757,1329,428,160,155,86,27
2021,Wrexham 005A,W01000351,1997,1959,38,18,12,6,2
2021,Wrexham 017A,W01000354,1604,1590,14,7,5,2,0
2021,Wrexham 017B,W01000355,1691,1662,29,16,11,2,0
2021,Wrexham 017C,W01000356,1574,1560,14,9,4,1,0
2021,Wrexham 019C,W01000359,1157,1152,5,5,0,0,0
2021,Wrexham 019D,W01000360,1193,1171,22,7,5,10,0
2021,Wrexham 019E,W01000361,1926,1892,34,15,12,7,0
2021,Wrexham 006C,W01000362,1442,1404,38,19,12,6,1
2021,Wrexham 006D,W01000363,1430,1415,15,5,8,2,0
2021,Wrexham 006E,W01000364,1429,1397,32,10,12,9,1
2021,Wrexham 011C,W01000365,1987,1765,222,58,94,62,8
2021,Wrexham 014A,W01000366,1418,1365,53,17,28,8,0
2021,Wrexham 014B,W01000367,1248,1196,52,15,22,12,3
2021,Wrexham 008A,W01000368,1936,1914,22,12,10,0,0
2021,Wrexham 021B,W01000369,1238,1220,18,9,8,1,0
2021,Wrexham 021D,W01000370,1507,1484,23,9,10,3,1
2021,Wrexham 008B,W01000371,1030,894,136,55,45,32,4
2021,Wrexham 008C,W01000372,1484,1269,215,78,75,49,13
2021,Wrexham 005B,W01000373,1698,1636,62,32,16,11,3
2021,Wrexham 003A,W01000374,1327,1286,41,12,17,8,4
2021,Wrexham 003B,W01000375,2034,1996,38,21,15,2,0
2021,Wrexham 003C,W01000376,1304,1279,25,15,8,2,0
2021,Wrexham 004A,W01000377,1497,1470,27,12,11,3,1
2021,Wrexham 004B,W01000378,1249,1195,54,16,24,14,0
2021,Wrexham 004C,W01000379,1559,1517,42,19,17,6,0
2021,Wrexham 004D,W01000380,1419,1384,35,16,8,10,1
2021,Wrexham 012A,W01000381,1084,913,171,41,69,49,12
2021,Wrexham 012B,W01000382,1341,1141,200,61,84,48,7
2021,Wrexham 022C,W01000384,1067,1060,7,6,1,0,0
2021,Wrexham 014C,W01000385,1692,1673,19,11,7,0,1
2021,Wrexham 015A,W01000386,1388,1326,62,28,16,15,3
2021,Wrexham 008D,W01000387,1105,1089,16,5,6,5,0
2021,Wrexham 008E,W01000388,1073,1058,15,7,4,4,0
2021,Wrexham 017D,W01000389,1942,1927,15,7,6,2,0
2021,Wrexham 021A,W01000390,1695,1665,30,20,4,6,0
2021,Wrexham 003D,W01000391,1403,1396,7,6,0,1,0
2021,Wrexham 003E,W01000392,1561,1516,45,17,21,7,0
2021,Wrexham 023G,W01000393,1889,1761,128,43,58,25,2
2021,Wrexham 016A,W01000394,1136,1129,7,5,2,0,0
2021,Wrexham 016B,W01000395,1015,1005,10,2,6,0,2
2021,Wrexham 013A,W01000398,1189,1169,20,4,11,4,1
2021,Wrexham 013B,W01000399,1062,1060,2,0,1,1,0
2021,Wrexham 005C,W01000400,1773,1701,72,29,23,16,4
2021,Wrexham 005D,W01000401,1944,1861,83,30,32,20,1
2021,Wrexham 011D,W01000402,2466,1852,614,181,252,162,19
2021,Wrexham 018C,W01000403,1284,1277,7,3,1,3,0
2021,Wrexham 018D,W01000404,1955,1937,18,11,6,1,0
2021,Wrexham 015B,W01000405,2204,2149,55,21,23,10,1
2021,Wrexham 013C,W01000406,2095,2046,49,6,28,13,2
2021,Wrexham 016C,W01000407,1360,1341,19,6,11,2,0
2021,Wrexham 013D,W01000408,1193,1188,5,1,0,3,1
2021,Wrexham 017E,W01000409,1782,1722,60,15,21,19,5
2021,Wrexham 014D,W01000410,1647,1609,38,17,13,6,2
2021,Wrexham 015C,W01000411,1469,1398,71,28,33,6,4
2021,Wrexham 015D,W01000412,1446,1399,47,19,13,13,2
2021,Wrexham 010C,W01000413,1251,1116,135,49,55,26,5
2021,Wrexham 010D,W01000414,1155,1057,98,33,38,22,5
2021,Wrexham 023F,W01000415,1394,1333,61,17,27,11,6
2021,Wrexham 023D,W01000416,1141,1116,25,10,10,4,1
2021,Wrexham 022B,W01000417,1499,1471,28,11,8,7,2
2021,Wrexham 022A,W01000418,1704,1688,16,12,2,2,0
2021,Wrexham 016D,W01000419,1390,1351,39,7,22,9,1
2021,Wrexham 016E,W01000420,1483,1410,73,19,17,28,9
2021,Wrexham 008F,W01000422,2093,1949,144,50,55,35,4
2021,Wrexham 012D,W01000423,2104,1768,336,105,158,66,7
2021,Wrexham 012E,W01000424,1239,1054,185,59,67,51,8
2021,Wrexham 010E,W01000425,1971,1726,245,76,95,68,6
2021,Powys 021A,W01000426,1385,1374,11,7,1,3,0
2021,Powys 011A,W01000427,1310,1308,2,0,1,1,0
2021,Powys 005A,W01000428,1298,1291,7,2,4,1,0
2021,Powys 010A,W01000429,2272,2252,20,16,2,2,0
2021,Powys 015A,W01000430,1290,1281,9,5,3,0,1
2021,Powys 014A,W01000431,1226,1207,19,6,7,5,1
2021,Powys 014B,W01000432,1178,1165,13,9,2,2,0
2021,Powys 006A,W01000433,2219,2209,10,1,6,2,1
2021,Powys 007A,W01000434,1705,1678,27,13,9,4,1
2021,Powys 012A,W01000438,1203,1197,6,5,1,0,0
2021,Powys 007B,W01000439,1983,1979,4,3,1,0,0
2021,Powys 020A,W01000440,1286,1282,4,4,0,0,0
2021,Powys 005B,W01000441,1494,1484,10,5,2,1,2
2021,Powys 004A,W01000442,1999,1987,12,11,1,0,0
2021,Powys 015B,W01000443,2236,2228,8,6,2,0,0
2021,Powys 002A,W01000444,2199,2180,19,12,5,2,0
2021,Powys 015C,W01000445,1458,1448,10,4,4,2,0
2021,Powys 015D,W01000446,1643,1621,22,11,10,0,1
2021,Powys 007C,W01000447,1954,1934,20,16,4,0,0
2021,Powys 011B,W01000448,1349,1337,12,1,8,3,0
2021,Powys 011C,W01000449,1494,1476,18,11,6,1,0
2021,Powys 014C,W01000450,1364,1360,4,1,0,3,0
2021,Powys 012B,W01000451,1160,1149,11,2,4,4,1
2021,Powys 004B,W01000452,1964,1960,4,2,1,1,0
2021,Powys 010B,W01000453,1354,1347,7,6,1,0,0
2021,Powys 013A,W01000454,1244,1185,59,18,22,13,6
2021,Powys 013B,W01000455,2125,2080,45,19,20,3,3
2021,Powys 013C,W01000456,2119,2069,50,25,13,11,1
2021,Powys 002B,W01000457,2098,2081,17,8,5,3,1
2021,Powys 002C,W01000458,1815,1800,15,3,10,2,0
2021,Powys 014D,W01000459,1184,1176,8,1,5,2,0
2021,Powys 006B,W01000460,1668,1664,4,2,0,1,1
2021,Powys 001A,W01000461,1548,1538,10,5,1,3,1
2021,Powys 011D,W01000464,1155,1148,7,4,2,1,0
2021,Powys 018E,W01000465,1018,1018,0,0,0,0,0
2021,Powys 010C,W01000466,1287,1272,15,10,3,2,0
2021,Powys 010D,W01000467,1422,1367,55,18,15,21,1
2021,Powys 001D,W01000470,1948,1929,19,13,3,3,0
2021,Powys 014E,W01000471,1723,1708,15,10,1,3,1
2021,Powys 012C,W01000472,1160,1154,6,4,0,2,0
2021,Powys 004C,W01000473,2089,2062,27,13,6,6,2
2021,Powys 020B,W01000474,1708,1693,15,9,3,2,1
2021,Powys 001E,W01000475,2349,2344,5,4,1,0,0
2021,Powys 005C,W01000476,1250,1242,8,5,3,0,0
2021,Powys 012D,W01000477,1487,1483,4,3,1,0,0
2021,Powys 009A,W01000478,1796,1704,92,28,49,15,0
2021,Powys 009B,W01000479,1401,1354,47,12,25,10,0
2021,Powys 008A,W01000480,2038,1899,139,33,69,29,8
2021,Powys 008B,W01000481,2137,2096,41,17,21,3,0
2021,Powys 008C,W01000482,1855,1790,65,38,17,7,3
2021,Powys 009C,W01000483,1772,1684,88,30,30,27,1
2021,Powys 011E,W01000484,1648,1636,12,6,2,3,1
2021,Powys 011F,W01000485,1553,1522,31,14,10,7,0
2021,Powys 011G,W01000486,1039,1016,23,7,12,4,0
2021,Powys 012E,W01000487,2029,2009,20,9,7,4,0
2021,Powys 006C,W01000488,2125,2115,10,10,0,0,0
2021,Powys 017A,W01000489,1741,1647,94,37,33,20,4
2021,Powys 017D,W01000492,1494,1385,109,36,48,16,9
2021,Powys 017E,W01000493,1696,1482,214,108,93,10,3
2021,Powys 015E,W01000494,1660,1648,12,5,5,0,2
2021,Powys 021B,W01000496,2037,2019,18,3,5,8,2
2021,Powys 005D,W01000497,1339,1333,6,4,2,0,0
2021,Powys 003A,W01000498,1438,1322,116,27,42,39,8
2021,Powys 003B,W01000499,1207,1077,130,32,74,22,2
2021,Powys 003C,W01000500,1645,1568,77,27,26,17,7
2021,Powys 003D,W01000501,2155,2007,148,47,56,38,7
2021,Powys 021C,W01000502,2023,1989,34,12,12,9,1
2021,Powys 020C,W01000503,1034,1031,3,3,0,0,0
2021,Powys 021D,W01000504,1097,1057,40,22,12,6,0
2021,Powys 021E,W01000505,1400,1383,17,4,11,1,1
2021,Ceredigion 005A,W01000506,1249,1224,25,11,10,4,0
2021,Ceredigion 009A,W01000507,1111,1107,4,3,1,0,0
2021,Ceredigion 009B,W01000508,1013,1004,9,3,5,1,0
2021,Ceredigion 009C,W01000509,1820,1786,34,20,6,6,2
2021,Ceredigion 009D,W01000510,1149,1111,38,14,11,11,2
2021,Ceredigion 009E,W01000511,1134,1104,30,6,16,8,0
2021,Ceredigion 002A,W01000512,1340,1202,138,104,29,4,1
2021,Ceredigion 002B,W01000513,2085,1803,282,210,59,12,1
2021,Ceredigion 003A,W01000515,1276,1240,36,24,8,3,1
2021,Ceredigion 003B,W01000516,1580,1517,63,33,26,4,0
2021,Ceredigion 002D,W01000517,1156,1040,116,78,31,7,0
2021,Ceredigion 003C,W01000518,991,912,79,48,27,4,0
2021,Ceredigion 010A,W01000519,1721,1703,18,8,8,2,0
2021,Ceredigion 010B,W01000522,1181,1171,10,8,2,0,0
2021,Ceredigion 001C,W01000523,1836,1822,14,11,3,0,0
2021,Ceredigion 005B,W01000524,1877,1860,17,5,7,4,1
2021,Ceredigion 011A,W01000525,1209,1153,56,36,18,2,0
2021,Ceredigion 008A,W01000527,1130,969,161,29,76,53,3
2021,Ceredigion 008B,W01000528,1312,1194,118,34,56,26,2
2021,Ceredigion 010C,W01000531,1720,1709,11,5,5,0,1
2021,Ceredigion 010D,W01000533,1313,1304,9,5,2,0,2
2021,Ceredigion 011B,W01000534,1484,1460,24,15,9,0,0
2021,Ceredigion 008C,W01000535,1996,1980,16,10,4,2,0
2021,Ceredigion 011E,W01000536,1335,1325,10,8,2,0,0
2021,Ceredigion 008D,W01000537,1366,1352,14,5,3,4,2
2021,Ceredigion 005C,W01000538,1508,1494,14,12,2,0,0
2021,Ceredigion 005D,W01000539,1152,1140,12,6,3,2,1
2021,Ceredigion 005E,W01000540,1117,1108,9,6,2,0,1
2021,Ceredigion 008E,W01000541,1699,1676,23,7,9,6,1
2021,Ceredigion 011F,W01000542,2151,2130,21,16,2,1,2
2021,Ceredigion 011C,W01000543,1957,1939,18,13,4,1,0
2021,Ceredigion 007D,W01000545,1944,1928,16,7,4,4,1
2021,Ceredigion 009F,W01000546,1115,1111,4,2,1,1,0
2021,Ceredigion 009G,W01000547,1120,1117,3,2,0,1,0
2021,Ceredigion 001D,W01000548,1727,1687,40,22,9,7,2
2021,Ceredigion 001E,W01000549,1717,1690,27,19,3,4,1
2021,Ceredigion 011G,W01000550,1129,1126,3,2,1,0,0
2021,Ceredigion 010E,W01000551,1346,1342,4,1,1,2,0
2021,Ceredigion 011D,W01000552,1954,1945,9,7,1,1,0
2021,Pembrokeshire 011A,W01000553,1209,1205,4,2,2,0,0
2021,Pembrokeshire 009A,W01000554,1812,1802,10,5,4,0,1
2021,Pembrokeshire 008A,W01000555,1490,1474,16,11,1,2,2
2021,Pembrokeshire 008B,W01000556,1153,1144,9,7,1,1,0
2021,Pembrokeshire 014A,W01000557,1488,1480,8,3,2,2,1
2021,Pembrokeshire 001A,W01000558,2066,2059,7,4,1,0,2
2021,Pembrokeshire 001B,W01000559,1425,1419,6,5,1,0,0
2021,Pembrokeshire 001C,W01000560,1268,1253,15,9,3,3,0
2021,Pembrokeshire 001D,W01000561,1269,1264,5,5,0,0,0
2021,Pembrokeshire 002A,W01000562,1576,1552,24,10,8,6,0
2021,Pembrokeshire 011B,W01000563,1100,1093,7,6,1,0,0
2021,Pembrokeshire 011C,W01000564,1266,1253,13,8,5,0,0
2021,Pembrokeshire 002B,W01000565,1796,1789,7,1,3,3,0
2021,Pembrokeshire 002C,W01000566,1554,1518,36,13,11,8,4
2021,Pembrokeshire 002D,W01000567,1968,1939,29,11,10,7,1
2021,Pembrokeshire 005B,W01000569,1065,1039,26,15,8,3,0
2021,Pembrokeshire 005C,W01000570,1367,1327,40,18,10,9,3
2021,Pembrokeshire 006A,W01000571,2354,2272,82,29,35,14,4
2021,Pembrokeshire 005D,W01000572,1783,1711,72,34,23,9,6
2021,Pembrokeshire 006B,W01000573,2494,2452,42,29,11,2,0
2021,Pembrokeshire 015A,W01000574,1684,1672,12,7,5,0,0
2021,Pembrokeshire 008C,W01000575,2716,2683,33,15,15,3,0
2021,Pembrokeshire 011D,W01000576,2243,2211,32,16,4,8,4
2021,Pembrokeshire 007A,W01000577,1522,1507,15,8,3,3,1
2021,Pembrokeshire 014B,W01000578,1680,1667,13,7,2,1,3
2021,Pembrokeshire 003A,W01000579,2308,2300,8,7,1,0,0
2021,Pembrokeshire 009B,W01000580,2265,2256,9,5,2,1,1
2021,Pembrokeshire 003B,W01000581,1376,1365,11,10,1,0,0
2021,Pembrokeshire 004A,W01000582,1636,1624,12,5,6,0,1
2021,Pembrokeshire 004B,W01000583,1391,1383,8,1,4,3,0
2021,Pembrokeshire 014C,W01000584,2024,2011,13,9,1,1,2
2021,Pembrokeshire 007B,W01000585,1332,1323,9,8,0,1,0
2021,Pembrokeshire 006C,W01000586,2143,2126,17,10,3,4,0
2021,Pembrokeshire 010A,W01000587,1934,1880,54,21,23,10,0
2021,Pembrokeshire 010B,W01000588,2258,2193,65,28,23,13,1
2021,Pembrokeshire 012A,W01000589,1106,1086,20,8,5,4,3
2021,Pembrokeshire 012B,W01000590,1110,1103,7,5,2,0,0
2021,Pembrokeshire 012C,W01000591,1587,1553,34,21,9,4,0
2021,Pembrokeshire 012D,W01000592,1279,1261,18,5,7,6,0
2021,Pembrokeshire 012E,W01000594,2103,2062,41,11,12,13,5
2021,Pembrokeshire 007C,W01000595,2299,2268,31,15,9,6,1
2021,Pembrokeshire 007D,W01000596,1675,1648,27,9,10,7,1
2021,Pembrokeshire 002E,W01000597,1038,1030,8,5,2,1,0
2021,Pembrokeshire 009C,W01000598,2109,2088,21,10,7,4,0
2021,Pembrokeshire 009D,W01000599,1951,1931,20,11,6,3,0
2021,Pembrokeshire 013A,W01000600,1559,1519,40,14,18,7,1
2021,Pembrokeshire 013B,W01000601,1463,1431,32,7,12,11,2
2021,Pembrokeshire 013C,W01000602,1184,1159,25,10,7,6,2
2021,Pembrokeshire 013D,W01000603,1754,1732,22,15,4,2,1
2021,Pembrokeshire 013E,W01000604,1654,1643,11,7,4,0,0
2021,Pembrokeshire 013F,W01000605,1742,1721,21,11,4,5,1
2021,Pembrokeshire 015B,W01000606,1603,1590,13,6,5,2,0
2021,Pembrokeshire 015C,W01000607,2375,2351,24,12,3,7,2
2021,Pembrokeshire 015D,W01000608,1395,1361,34,12,12,10,0
2021,Pembrokeshire 014D,W01000609,2375,2347,28,10,15,1,2
2021,Pembrokeshire 016A,W01000610,1675,1663,12,8,3,1,0
2021,Pembrokeshire 004C,W01000611,2042,2004,38,24,9,4,1
2021,Pembrokeshire 003C,W01000612,1733,1724,9,6,0,3,0
2021,Pembrokeshire 001E,W01000613,2012,1990,22,12,9,1,0
2021,Pembrokeshire 008D,W01000614,1352,1346,6,4,2,0,0
2021,Pembrokeshire 002F,W01000617,1485,1464,21,8,11,1,1
2021,Pembrokeshire 003D,W01000618,1685,1673,12,6,3,3,0
2021,Pembrokeshire 016B,W01000619,1959,1939,20,7,7,5,1
2021,Pembrokeshire 008E,W01000622,1392,1382,10,8,1,1,0
2021,Pembrokeshire 004D,W01000623,1959,1946,13,12,1,0,0
2021,Carmarthenshire 005A,W01000624,2279,2258,21,15,4,2,0
2021,Carmarthenshire 013A,W01000625,1087,1067,20,4,15,1,0
2021,Carmarthenshire 013B,W01000626,1570,1518,52,19,24,7,2
2021,Carmarthenshire 013C,W01000627,2324,2311,13,5,3,5,0
2021,Carmarthenshire 024A,W01000628,1494,1441,53,22,16,11,4
2021,Carmarthenshire 024B,W01000629,1595,1451,144,33,44,58,9
2021,Carmarthenshire 024C,W01000630,1530,1404,126,40,42,35,9
2021,Carmarthenshire 024D,W01000631,1767,1653,114,33,47,27,7
2021,Carmarthenshire 021A,W01000632,1307,1296,11,4,6,0,1
2021,Carmarthenshire 021B,W01000633,1382,1374,8,4,4,0,0
2021,Carmarthenshire 021C,W01000634,1272,1268,4,4,0,0,0
2021,Carmarthenshire 025A,W01000635,2329,2311,18,8,4,6,0
2021,Carmarthenshire 025B,W01000636,2268,2205,63,27,17,15,4
2021,Carmarthenshire 007A,W01000637,1336,1265,71,30,26,10,5
2021,Carmarthenshire 007B,W01000638,1101,1047,54,25,21,7,1
2021,Carmarthenshire 007C,W01000639,1458,1362,96,29,32,31,4
2021,Carmarthenshire 007D,W01000640,1188,1123,65,42,13,8,2
2021,Carmarthenshire 008A,W01000641,1996,1839,157,60,50,39,8
2021,Carmarthenshire 008B,W01000642,1714,1678,36,23,13,0,0
2021,Carmarthenshire 006A,W01000643,1621,1533,88,52,20,12,4
2021,Carmarthenshire 006B,W01000644,1811,1740,71,42,24,5,0
2021,Carmarthenshire 006C,W01000645,1898,1807,91,38,37,14,2
2021,Carmarthenshire 003A,W01000646,2077,2053,24,7,14,2,1
2021,Carmarthenshire 002A,W01000647,1392,1385,7,2,5,0,0
2021,Carmarthenshire 006D,W01000648,1393,1388,5,3,0,1,1
2021,Carmarthenshire 006E,W01000649,1506,1496,10,6,4,0,0
2021,Carmarthenshire 002B,W01000650,1520,1504,16,8,5,3,0
2021,Carmarthenshire 020A,W01000651,1463,1432,31,10,5,13,3
2021,Carmarthenshire 020B,W01000652,1732,1659,73,36,23,7,7
2021,Carmarthenshire 023A,W01000653,1426,1394,32,16,6,10,0
2021,Carmarthenshire 023B,W01000654,1618,1478,140,35,46,50,9
2021,Carmarthenshire 020C,W01000655,1850,1782,68,28,24,12,4
2021,Carmarthenshire 010A,W01000656,1987,1956,31,10,11,10,0
2021,Carmarthenshire 010B,W01000657,1129,1125,4,2,0,2,0
2021,Carmarthenshire 010C,W01000658,1286,1266,20,3,16,1,0
2021,Carmarthenshire 026A,W01000659,1712,1562,150,55,39,51,5
2021,Carmarthenshire 026B,W01000660,1444,1384,60,10,21,23,6
2021,Carmarthenshire 016A,W01000662,2107,2097,10,4,5,1,0
2021,Carmarthenshire 016B,W01000663,2402,2394,8,2,5,1,0
2021,Carmarthenshire 016C,W01000664,2507,2474,33,15,13,3,2
2021,Carmarthenshire 017A,W01000665,1768,1747,21,18,2,1,0
2021,Carmarthenshire 017B,W01000666,1597,1569,28,14,6,6,2
2021,Carmarthenshire 023C,W01000667,2036,1984,52,22,17,11,2
2021,Carmarthenshire 018A,W01000670,1532,1507,25,10,9,5,1
2021,Carmarthenshire 018B,W01000671,2088,2078,10,7,2,0,1
2021,Carmarthenshire 027E,W01000672,1462,1450,12,6,1,4,1
2021,Carmarthenshire 027F,W01000673,1082,1075,7,5,1,1,0
2021,Carmarthenshire 027A,W01000674,2044,2036,8,7,1,0,0
2021,Carmarthenshire 012A,W01000675,2020,2011,9,9,0,0,0
2021,Carmarthenshire 004A,W01000676,1488,1480,8,3,3,2,0
2021,Carmarthenshire 004B,W01000677,1412,1374,38,15,13,7,3
2021,Carmarthenshire 002C,W01000678,1344,1316,28,14,8,3,3
2021,Carmarthenshire 002D,W01000679,1205,1166,39,13,15,8,3
2021,Carmarthenshire 011A,W01000680,2249,2221,28,12,9,7,0
2021,Carmarthenshire 011B,W01000681,2020,1999,21,12,6,2,1
2021,Carmarthenshire 005B,W01000682,1363,1353,10,6,1,3,0
2021,Carmarthenshire 005C,W01000683,1039,1022,17,12,2,3,0
2021,Carmarthenshire 005D,W01000684,1718,1699,19,9,7,3,0
2021,Carmarthenshire 001A,W01000685,1502,1479,23,9,9,5,0
2021,Carmarthenshire 001B,W01000686,1184,1170,14,10,3,1,0
2021,Carmarthenshire 004C,W01000687,1904,1889,15,8,3,3,1
2021,Carmarthenshire 003B,W01000688,1656,1640,16,10,1,0,5
2021,Carmarthenshire 003C,W01000689,1695,1684,11,4,1,4,2
2021,Carmarthenshire 019A,W01000690,1729,1704,25,14,5,5,1
2021,Carmarthenshire 019B,W01000691,1797,1763,34,17,12,3,2
2021,Carmarthenshire 019C,W01000692,1501,1487,14,10,3,1,0
2021,Carmarthenshire 008C,W01000693,1099,1083,16,7,5,4,0
2021,Carmarthenshire 008D,W01000694,1462,1430,32,15,17,0,0
2021,Carmarthenshire 012B,W01000695,2162,2130,32,13,12,7,0
2021,Carmarthenshire 012C,W01000696,1609,1597,12,5,3,3,1
2021,Carmarthenshire 015A,W01000697,1876,1821,55,15,23,14,3
2021,Carmarthenshire 015B,W01000698,1908,1887,21,10,6,3,2
2021,Carmarthenshire 015C,W01000699,1434,1424,10,5,2,1,2
2021,Carmarthenshire 027G,W01000700,1938,1910,28,14,5,7,2
2021,Carmarthenshire 001C,W01000701,1565,1537,28,13,10,4,1
2021,Carmarthenshire 001D,W01000702,1149,1037,112,22,39,39,12
2021,Carmarthenshire 022A,W01000703,1717,1588,129,38,39,45,7
2021,Carmarthenshire 022B,W01000704,1609,1577,32,9,9,11,3
2021,Carmarthenshire 022C,W01000705,1852,1759,93,30,44,15,4
2021,Carmarthenshire 025C,W01000706,1505,1437,68,25,19,17,7
2021,Carmarthenshire 025D,W01000707,1392,1348,44,14,20,7,3
2021,Carmarthenshire 025E,W01000708,1330,1276,54,14,26,10,4
2021,Carmarthenshire 004D,W01000709,2146,2129,17,6,6,0,5
2021,Carmarthenshire 021D,W01000710,2124,2113,11,7,2,0,2
2021,Carmarthenshire 021E,W01000711,1975,1949,26,11,9,5,1
2021,Carmarthenshire 015D,W01000712,1643,1624,19,8,6,5,0
2021,Carmarthenshire 015E,W01000713,1328,1328,0,0,0,0,0
2021,Carmarthenshire 013D,W01000714,1376,1350,26,9,11,6,0
2021,Carmarthenshire 013E,W01000715,1252,1232,20,8,8,4,0
2021,Carmarthenshire 016D,W01000716,1371,1368,3,2,0,0,1
2021,Carmarthenshire 016E,W01000717,1406,1399,7,6,1,0,0
2021,Carmarthenshire 010D,W01000718,1363,1352,11,2,5,3,1
2021,Carmarthenshire 010E,W01000719,1404,1399,5,2,1,2,0
2021,Carmarthenshire 027B,W01000720,1771,1745,26,12,7,5,2
2021,Carmarthenshire 027C,W01000721,1355,1342,13,7,2,3,1
2021,Carmarthenshire 012D,W01000722,1321,1311,10,8,2,0,0
2021,Carmarthenshire 012E,W01000723,1344,1337,7,5,1,1,0
2021,Carmarthenshire 011C,W01000724,1889,1850,39,24,10,5,0
2021,Carmarthenshire 011D,W01000725,2262,2240,22,12,3,5,2
2021,Carmarthenshire 003D,W01000728,2022,2005,17,8,4,5,0
2021,Carmarthenshire 018C,W01000729,1197,1193,4,4,0,0,0
2021,Carmarthenshire 018D,W01000730,1234,1232,2,1,1,0,0
2021,Carmarthenshire 017C,W01000731,2337,2290,47,25,14,5,3
2021,Carmarthenshire 026D,W01000732,1263,1096,167,36,49,63,19
2021,Carmarthenshire 026E,W01000733,1156,1012,144,31,37,63,13
2021,Carmarthenshire 026F,W01000734,1344,1154,190,51,61,58,20
2021,Carmarthenshire 027D,W01000735,2318,2291,27,13,8,5,1
2021,Swansea 028A,W01000736,1720,1697,23,14,2,6,1
2021,Swansea 028B,W01000737,1454,1438,16,10,1,4,1
2021,Swansea 014A,W01000738,1660,1605,55,22,20,12,1
2021,Swansea 014B,W01000739,2152,2030,122,61,45,11,5
2021,Swansea 014C,W01000740,1525,1507,18,7,7,3,1
2021,Swansea 014D,W01000741,1798,1728,70,21,31,17,1
2021,Swansea 016A,W01000742,1605,1413,192,42,74,69,7
2021,Swansea 016B,W01000744,1473,1261,212,71,86,52,3
2021,Swansea 025B,W01000745,2404,1893,511,194,179,106,32
2021,Swansea 025C,W01000746,1377,1251,126,50,40,32,4
2021,Swansea 024A,W01000747,1553,1294,259,81,104,64,10
2021,Swansea 026A,W01000749,1951,1685,266,90,101,63,12
2021,Swansea 002A,W01000750,1416,1391,25,13,6,4,2
2021,Swansea 002B,W01000751,1367,1352,15,6,3,4,2
2021,Swansea 002C,W01000752,1428,1398,30,9,13,5,3
2021,Swansea 002D,W01000753,1382,1364,18,9,7,2,0
2021,Swansea 002E,W01000754,1512,1475,37,12,16,7,2
2021,Swansea 017A,W01000755,1922,1848,74,24,27,18,5
2021,Swansea 017B,W01000756,1428,1398,30,7,11,5,7
2021,Swansea 017C,W01000757,1392,1329,63,19,24,15,5
2021,Swansea 017D,W01000758,1843,1740,103,45,41,15,2
2021,Swansea 012A,W01000759,1506,1483,23,12,7,3,1
2021,Swansea 013A,W01000760,1527,1478,49,13,20,14,2
2021,Swansea 013B,W01000761,1519,1458,61,24,19,12,6
2021,Swansea 013C,W01000762,1612,1534,78,24,24,27,3
2021,Swansea 015A,W01000763,1362,1318,44,21,17,6,0
2021,Swansea 015B,W01000764,1517,1472,45,20,13,8,4
2021,Swansea 015C,W01000765,1582,1501,81,19,25,33,4
2021,Swansea 015D,W01000766,1448,1391,57,24,22,11,0
2021,Swansea 015E,W01000767,1388,1351,37,16,18,2,1
2021,Swansea 032A,W01000768,1316,1293,23,5,12,6,0
2021,Swansea 032B,W01000769,1355,1344,11,7,1,2,1
2021,Swansea 032D,W01000770,1482,1457,25,16,7,2,0
2021,Swansea 032G,W01000771,1273,1262,11,2,8,0,1
2021,Swansea 018A,W01000772,1451,1438,13,6,5,2,0
2021,Swansea 005B,W01000774,1563,1528,35,16,16,3,0
2021,Swansea 030A,W01000775,1603,1594,9,5,4,0,0
2021,Swansea 030B,W01000776,1750,1732,18,12,4,1,1
2021,Swansea 012B,W01000777,1672,1657,15,7,4,2,2
2021,Swansea 012C,W01000778,1733,1707,26,7,14,4,1
2021,Swansea 012D,W01000779,1417,1399,18,9,6,2,1
2021,Swansea 032E,W01000781,1587,1539,48,23,19,5,1
2021,Swansea 032F,W01000782,1049,1035,14,7,5,2,0
2021,Swansea 007A,W01000784,1263,1248,15,7,8,0,0
2021,Swansea 007B,W01000785,1718,1716,2,1,0,1,0
2021,Swansea 007C,W01000786,1230,1225,5,1,3,1,0
2021,Swansea 016C,W01000787,1394,1319,75,27,30,15,3
2021,Swansea 016D,W01000788,1437,1341,96,29,36,22,9
2021,Swansea 016E,W01000789,1368,1275,93,31,25,33,4
2021,Swansea 016F,W01000790,2617,2217,400,156,127,102,15
2021,Swansea 004A,W01000791,1377,1347,30,21,4,4,1
2021,Swansea 004B,W01000792,1536,1529,7,4,3,0,0
2021,Swansea 004C,W01000793,1814,1791,23,12,8,3,0
2021,Swansea 010A,W01000794,2135,2074,61,13,28,13,7
2021,Swansea 006A,W01000795,1526,1495,31,20,4,6,1
2021,Swansea 010B,W01000797,1474,1453,21,14,5,2,0
2021,Swansea 010C,W01000798,1382,1349,33,12,14,4,3
2021,Swansea 010D,W01000799,1784,1672,112,43,47,20,2
2021,Swansea 006C,W01000800,1425,1411,14,6,3,4,1
2021,Swansea 006D,W01000801,1666,1622,44,12,22,10,0
2021,Swansea 007D,W01000802,2283,2257,26,15,3,7,1
2021,Swansea 002F,W01000803,1778,1718,60,40,13,4,3
2021,Swansea 028C,W01000804,1404,1368,36,28,6,2,0
2021,Swansea 028D,W01000805,1119,1088,31,18,9,3,1
2021,Swansea 003A,W01000806,1367,1311,56,27,23,4,2
2021,Swansea 003B,W01000807,1267,1227,40,28,6,6,0
2021,Swansea 003C,W01000808,1362,1327,35,20,10,4,1
2021,Swansea 008A,W01000809,1463,1388,75,25,21,26,3
2021,Swansea 003D,W01000810,1304,1226,78,41,26,8,3
2021,Swansea 008B,W01000811,1347,1282,65,34,20,10,1
2021,Swansea 008C,W01000812,1409,1281,128,34,57,33,4
2021,Swansea 008D,W01000813,1532,1487,45,12,16,12,5
2021,Swansea 008E,W01000814,1384,1312,72,29,29,14,0
2021,Swansea 003E,W01000815,1460,1434,26,9,7,5,5
2021,Swansea 003F,W01000816,1725,1636,89,46,32,7,4
2021,Swansea 009A,W01000817,1881,1789,92,45,25,17,5
2021,Swansea 009B,W01000818,1447,1383,64,36,19,8,1
2021,Swansea 009C,W01000819,1411,1389,22,11,5,5,1
2021,Swansea 009D,W01000820,1353,1314,39,13,11,9,6
2021,Swansea 009E,W01000821,1431,1388,43,17,13,11,2
2021,Swansea 009F,W01000822,1173,1137,36,12,15,7,2
2021,Swansea 031A,W01000823,1789,1775,14,10,3,1,0
2021,Swansea 031B,W01000824,1625,1609,16,12,2,0,2
2021,Swansea 031C,W01000825,1247,1222,25,13,10,2,0
2021,Swansea 031D,W01000826,1236,1217,19,14,4,1,0
2021,Swansea 031E,W01000827,1228,1188,40,16,21,3,0
2021,Swansea 018B,W01000828,1609,1597,12,3,5,4,0
2021,Swansea 018C,W01000829,1874,1857,17,11,1,5,0
2021,Swansea 011A,W01000830,1699,1444,255,85,122,41,7
2021,Swansea 013D,W01000831,1667,1586,81,30,33,16,2
2021,Swansea 011B,W01000832,1521,1404,117,46,47,21,3
2021,Swansea 011C,W01000833,1567,1457,110,37,35,34,4
2021,Swansea 011D,W01000834,1393,1348,45,15,17,12,1
2021,Swansea 013E,W01000835,1405,1344,61,23,22,15,1
2021,Swansea 011E,W01000836,2281,1972,309,101,127,72,9
2021,Swansea 004D,W01000837,2241,2152,89,58,18,10,3
2021,Swansea 004E,W01000838,1224,1205,19,8,8,3,0
2021,Swansea 030C,W01000839,1025,1014,11,8,2,0,1
2021,Swansea 030D,W01000840,1589,1578,11,7,3,0,1
2021,Swansea 005C,W01000841,1428,1406,22,8,10,4,0
2021,Swansea 005D,W01000842,1384,1380,4,1,3,0,0
2021,Swansea 005E,W01000843,1350,1334,16,7,5,2,2
2021,Swansea 005F,W01000844,1462,1430,32,18,9,3,2
2021,Swansea 001A,W01000845,1959,1950,9,4,3,0,2
2021,Swansea 001B,W01000846,1985,1945,40,24,7,7,2
2021,Swansea 001C,W01000847,1230,1221,9,4,3,1,1
2021,Swansea 001D,W01000848,1168,1163,5,2,2,1,0
2021,Swansea 021A,W01000849,2119,1977,142,62,56,16,8
2021,Swansea 021C,W01000851,1562,1479,83,41,31,10,1
2021,Swansea 021D,W01000852,1432,1322,110,46,50,12,2
2021,Swansea 022A,W01000853,1634,1575,59,35,11,12,1
2021,Swansea 022B,W01000854,1462,1402,60,34,17,8,1
2021,Swansea 022C,W01000855,1389,1344,45,27,9,5,4
2021,Swansea 022D,W01000856,1696,1495,201,95,64,36,6
2021,Swansea 022E,W01000857,1873,1739,134,52,49,24,9
2021,Swansea 027A,W01000858,1603,1523,80,45,19,15,1
2021,Swansea 027B,W01000859,1374,1302,72,40,23,8,1
2021,Swansea 027C,W01000860,1501,1430,71,43,18,8,2
2021,Swansea 027D,W01000861,1930,1813,117,72,43,1,1
2021,Swansea 019A,W01000862,1492,1272,220,83,74,60,3
2021,Swansea 019B,W01000863,1561,1425,136,33,46,50,7
2021,Swansea 019C,W01000864,1569,1385,184,48,90,39,7
2021,Swansea 019D,W01000865,1367,1243,124,20,53,50,1
2021,Swansea 019E,W01000866,1132,1048,84,37,25,17,5
2021,Swansea 019F,W01000867,1239,1179,60,26,22,12,0
2021,Swansea 024B,W01000868,1064,1032,32,19,10,3,0
2021,Swansea 024C,W01000869,1499,1422,77,37,20,17,3
2021,Swansea 024D,W01000870,1349,1261,88,37,28,18,5
2021,Swansea 026B,W01000871,1737,1501,236,97,79,47,13
2021,Swansea 024E,W01000872,1363,1308,55,31,14,7,3
2021,Swansea 026C,W01000873,1514,1408,106,58,34,12,2
2021,Swansea 024F,W01000874,1774,1676,98,59,21,14,4
2021,Swansea 026D,W01000875,1880,1744,136,63,48,21,4
2021,Swansea 026E,W01000876,1616,1486,130,92,25,7,6
2021,Swansea 007E,W01000877,1629,1617,12,3,3,5,1
2021,Swansea 007F,W01000878,1234,1217,17,10,2,5,0
2021,Swansea 029A,W01000879,1649,1634,15,12,2,1,0
2021,Swansea 029B,W01000880,1517,1490,27,13,11,2,1
2021,Swansea 029C,W01000881,1291,1249,42,18,18,4,2
2021,Swansea 029D,W01000882,1689,1630,59,23,26,9,1
2021,Neath Port Talbot 016A,W01000883,1300,1293,7,3,3,1,0
2021,Neath Port Talbot 017A,W01000884,1231,1161,70,33,12,22,3
2021,Neath Port Talbot 017B,W01000885,1406,1352,54,24,14,6,10
2021,Neath Port Talbot 017C,W01000886,1564,1501,63,25,31,4,3
2021,Neath Port Talbot 021C,W01000887,2315,2279,36,21,11,4,0
2021,Neath Port Talbot 004A,W01000888,2631,2610,21,9,9,1,2
2021,Neath Port Talbot 015A,W01000889,1763,1746,17,9,3,5,0
2021,Neath Port Talbot 015B,W01000890,1506,1495,11,4,5,2,0
2021,Neath Port Talbot 015C,W01000891,1403,1370,33,10,15,6,2
2021,Neath Port Talbot 015D,W01000892,1906,1891,15,12,2,1,0
2021,Neath Port Talbot 003A,W01000893,1868,1863,5,1,2,1,1
2021,Neath Port Talbot 013A,W01000894,1426,1412,14,5,7,2,0
2021,Neath Port Talbot 013B,W01000895,1421,1370,51,15,20,9,7
2021,Neath Port Talbot 013C,W01000896,1525,1504,21,9,7,4,1
2021,Neath Port Talbot 013D,W01000897,1279,1260,19,13,6,0,0
2021,Neath Port Talbot 014A,W01000898,1421,1418,3,1,1,1,0
2021,Neath Port Talbot 014B,W01000899,1817,1809,8,3,1,3,1
2021,Neath Port Talbot 014C,W01000900,1526,1521,5,4,0,0,1
2021,Neath Port Talbot 014D,W01000901,1616,1612,4,2,1,0,1
2021,Neath Port Talbot 006C,W01000904,1440,1431,9,6,2,1,0
2021,Neath Port Talbot 006D,W01000905,1450,1433,17,5,6,5,1
2021,Neath Port Talbot 007B,W01000907,1681,1668,13,3,4,3,3
2021,Neath Port Talbot 006E,W01000908,1558,1547,11,4,4,2,1
2021,Neath Port Talbot 009A,W01000909,1151,1135,16,9,4,3,0
2021,Neath Port Talbot 009B,W01000910,1337,1326,11,5,6,0,0
2021,Neath Port Talbot 009C,W01000911,1125,1116,9,4,2,3,0
2021,Neath Port Talbot 010A,W01000912,1169,1151,18,7,7,3,1
2021,Neath Port Talbot 010B,W01000913,1120,1091,29,6,10,12,1
2021,Neath Port Talbot 010C,W01000914,1598,1566,32,15,11,6,0
2021,Neath Port Talbot 010D,W01000915,1089,1073,16,10,3,2,1
2021,Neath Port Talbot 010E,W01000916,1154,1143,11,6,1,2,2
2021,Neath Port Talbot 002A,W01000918,1883,1873,10,3,4,3,0
2021,Neath Port Talbot 020A,W01000919,1120,1114,6,4,1,1,0
2021,Neath Port Talbot 021G,W01000921,1405,1385,20,8,8,3,1
2021,Neath Port Talbot 007C,W01000922,1541,1511,30,10,11,6,3
2021,Neath Port Talbot 003B,W01000925,1487,1480,7,3,3,0,1
2021,Neath Port Talbot 003C,W01000926,1798,1794,4,2,1,1,0
2021,Neath Port Talbot 020B,W01000927,1993,1973,20,13,3,3,1
2021,Neath Port Talbot 020C,W01000928,1544,1534,10,4,3,1,2
2021,Neath Port Talbot 020D,W01000929,1223,1209,14,7,3,3,1
2021,Neath Port Talbot 021F,W01000930,1111,1106,5,2,3,0,0
2021,Neath Port Talbot 020E,W01000931,1314,1308,6,2,3,1,0
2021,Neath Port Talbot 019A,W01000932,998,992,6,1,2,2,1
2021,Neath Port Talbot 019B,W01000933,1943,1931,12,6,4,2,0
2021,Neath Port Talbot 008A,W01000934,1207,1169,38,19,9,6,4
2021,Neath Port Talbot 008B,W01000935,1507,1456,51,21,8,19,3
2021,Neath Port Talbot 012A,W01000936,1327,1288,39,12,20,6,1
2021,Neath Port Talbot 013E,W01000937,1876,1845,31,13,10,8,0
2021,Neath Port Talbot 008C,W01000938,1358,1346,12,9,1,1,1
2021,Neath Port Talbot 008D,W01000939,1123,1101,22,10,10,2,0
2021,Neath Port Talbot 008E,W01000940,1227,1210,17,7,5,4,1
2021,Neath Port Talbot 012B,W01000941,1487,1445,42,16,10,15,1
2021,Neath Port Talbot 012C,W01000942,1735,1715,20,10,6,4,0
2021,Neath Port Talbot 012D,W01000943,1441,1429,12,7,4,1,0
2021,Neath Port Talbot 002B,W01000944,1145,1142,3,1,2,0,0
2021,Neath Port Talbot 014E,W01000945,1131,1121,10,3,3,4,0
2021,Neath Port Talbot 004B,W01000946,1750,1738,12,7,4,1,0
2021,Neath Port Talbot 004C,W01000947,2109,2084,25,11,11,2,1
2021,Neath Port Talbot 004D,W01000948,1777,1740,37,12,9,12,4
2021,Neath Port Talbot 018A,W01000949,1291,1277,14,6,6,2,0
2021,Neath Port Talbot 018B,W01000950,1417,1363,54,21,17,15,1
2021,Neath Port Talbot 018C,W01000951,1735,1643,92,29,37,23,3
2021,Neath Port Talbot 018D,W01000952,1134,1097,37,7,16,9,5
2021,Neath Port Talbot 021B,W01000953,1559,1552,7,3,1,3,0
2021,Neath Port Talbot 021A,W01000954,1312,1299,13,7,3,3,0
2021,Neath Port Talbot 004E,W01000955,1340,1331,9,7,0,1,1
2021,Neath Port Talbot 004F,W01000956,1173,1166,7,5,2,0,0
2021,Neath Port Talbot 017D,W01000957,1571,1556,15,7,6,0,2
2021,Neath Port Talbot 016B,W01000958,1513,1480,33,9,19,4,1
2021,Neath Port Talbot 017E,W01000959,1687,1659,28,17,7,3,1
2021,Neath Port Talbot 017F,W01000960,1715,1690,25,7,11,4,3
2021,Neath Port Talbot 016C,W01000961,1542,1529,13,3,9,1,0
2021,Neath Port Talbot 016D,W01000962,1488,1462,26,9,7,9,1
2021,Neath Port Talbot 016E,W01000963,1798,1761,37,11,17,9,0
2021,Neath Port Talbot 016F,W01000964,1758,1728,30,18,7,3,2
2021,Neath Port Talbot 002C,W01000965,1968,1955,13,3,4,3,3
2021,Neath Port Talbot 018E,W01000966,1401,1397,4,2,2,0,0
2021,Neath Port Talbot 019C,W01000967,1372,1338,34,13,8,12,1
2021,Neath Port Talbot 019D,W01000968,1906,1883,23,10,6,3,4
2021,Neath Port Talbot 009D,W01000969,1499,1489,10,5,5,0,0
2021,Neath Port Talbot 021D,W01000970,1082,1072,10,2,2,4,2
2021,Neath Port Talbot 004G,W01000971,1361,1339,22,10,9,3,0
2021,Neath Port Talbot 020F,W01000973,1296,1283,13,4,5,2,2
2021,Bridgend 006A,W01000974,2301,2261,40,16,10,9,5
2021,Bridgend 004A,W01000975,2165,2144,21,8,7,5,1
2021,Bridgend 003A,W01000976,1060,1060,0,0,0,0,0
2021,Bridgend 003B,W01000977,1376,1368,8,5,2,1,0
2021,Bridgend 004B,W01000978,1725,1716,9,4,3,2,0
2021,Bridgend 015A,W01000979,1558,1510,48,14,28,6,0
2021,Bridgend 016A,W01000980,1303,1239,64,26,21,16,1
2021,Bridgend 016B,W01000981,1202,1173,29,13,12,4,0
2021,Bridgend 016C,W01000982,1393,1353,40,18,15,6,1
2021,Bridgend 015B,W01000983,1464,1417,47,18,20,8,1
2021,Bridgend 016D,W01000984,2103,2021,82,45,26,8,3
2021,Bridgend 015C,W01000985,1234,1199,35,22,11,1,1
2021,Bridgend 007A,W01000986,1617,1601,16,11,5,0,0
2021,Bridgend 007B,W01000987,2334,2291,43,21,15,7,0
2021,Bridgend 013A,W01000989,1530,1507,23,12,4,6,1
2021,Bridgend 017B,W01000990,1508,1465,43,17,15,9,2
2021,Bridgend 001A,W01000991,1102,1082,20,8,10,1,1
2021,Bridgend 001B,W01000992,1348,1332,16,3,8,4,1
2021,Bridgend 001C,W01000993,1315,1308,7,2,5,0,0
2021,Bridgend 001D,W01000994,1351,1342,9,3,4,2,0
2021,Bridgend 001E,W01000995,1324,1314,10,4,4,2,0
2021,Bridgend 008A,W01000996,1497,1479,18,7,6,3,2
2021,Bridgend 012A,W01000997,1650,1606,44,13,19,11,1
2021,Bridgend 010A,W01000999,1355,1335,20,10,7,2,1
2021,Bridgend 010B,W01001000,1686,1676,10,5,2,2,1
2021,Bridgend 010C,W01001001,1758,1750,8,1,1,3,3
2021,Bridgend 010D,W01001002,2339,2299,40,16,16,7,1
2021,Bridgend 015D,W01001003,1310,1300,10,8,2,0,0
2021,Bridgend 009A,W01001004,1011,997,14,8,2,4,0
2021,Bridgend 009B,W01001005,1556,1547,9,3,5,1,0
2021,Bridgend 009C,W01001006,2187,2169,18,11,3,3,1
2021,Bridgend 009D,W01001007,1830,1796,34,15,13,3,3
2021,Bridgend 011B,W01001008,2474,2425,49,23,15,7,4
2021,Bridgend 004C,W01001009,1208,1193,15,6,6,3,0
2021,Bridgend 012B,W01001010,1126,1101,25,8,10,6,1
2021,Bridgend 012C,W01001011,1244,1242,2,0,0,2,0
2021,Bridgend 005A,W01001012,1469,1464,5,1,3,1,0
2021,Bridgend 005B,W01001013,1437,1419,18,11,6,0,1
2021,Bridgend 002A,W01001014,1575,1559,16,1,3,9,3
2021,Bridgend 002B,W01001015,1422,1416,6,2,2,1,1
2021,Bridgend 005C,W01001016,1597,1588,9,2,3,1,3
2021,Bridgend 002C,W01001017,1426,1421,5,4,1,0,0
2021,Bridgend 002D,W01001018,1252,1241,11,7,1,2,1
2021,Bridgend 005D,W01001019,1538,1523,15,5,4,5,1
2021,Bridgend 002E,W01001020,1316,1302,14,5,5,4,0
2021,Bridgend 014A,W01001021,1558,1450,108,46,39,21,2
2021,Bridgend 014B,W01001022,1380,1311,69,14,33,20,2
2021,Bridgend 014C,W01001023,1608,1536,72,28,33,9,2
2021,Bridgend 003C,W01001024,1104,1094,10,2,6,2,0
2021,Bridgend 003D,W01001025,1194,1178,16,11,4,0,1
2021,Bridgend 012D,W01001026,1941,1877,64,25,23,14,2
2021,Bridgend 017C,W01001027,1460,1437,23,8,10,5,0
2021,Bridgend 014D,W01001028,1844,1806,38,14,10,12,2
2021,Bridgend 019A,W01001029,1683,1674,9,6,2,1,0
2021,Bridgend 019B,W01001030,1918,1908,10,6,3,1,0
2021,Bridgend 018A,W01001031,1443,1442,1,1,0,0,0
2021,Bridgend 018B,W01001032,1726,1721,5,3,1,0,1
2021,Bridgend 003E,W01001033,1702,1681,21,12,7,0,2
2021,Bridgend 003F,W01001034,1299,1284,15,7,6,2,0
2021,Bridgend 014E,W01001035,1688,1522,166,55,60,41,10
2021,Bridgend 017D,W01001036,1583,1554,29,15,10,3,1
2021,Bridgend 013B,W01001037,1763,1729,34,19,8,5,2
2021,Bridgend 011C,W01001038,2493,2339,154,95,43,11,5
2021,Bridgend 009E,W01001039,1662,1650,12,4,4,4,0
2021,Bridgend 009F,W01001040,1522,1513,9,1,5,0,3
2021,Bridgend 013C,W01001041,2241,2220,21,10,6,2,3
2021,Bridgend 004D,W01001042,1220,1214,6,2,2,2,0
2021,Bridgend 004E,W01001043,1131,1124,7,2,1,4,0
2021,Bridgend 019C,W01001044,1557,1543,14,6,5,1,2
2021,Bridgend 019D,W01001045,1667,1657,10,4,4,1,1
2021,Bridgend 018C,W01001046,1886,1846,40,23,11,3,3
2021,Bridgend 018D,W01001047,1633,1628,5,4,0,1,0
2021,Bridgend 008B,W01001048,1381,1358,23,6,15,2,0
2021,Bridgend 008C,W01001049,1259,1247,12,6,4,0,2
2021,Bridgend 008D,W01001050,1502,1483,19,3,8,7,1
2021,Bridgend 008E,W01001051,1765,1749,16,10,3,2,1
2021,Bridgend 008F,W01001052,1240,1233,7,3,4,0,0
2021,Bridgend 018E,W01001053,992,984,8,8,0,0,0
2021,Bridgend 018F,W01001054,1333,1327,6,3,1,2,0
2021,Bridgend 007C,W01001055,1164,1150,14,4,9,1,0
2021,Bridgend 007D,W01001056,1153,1135,18,6,6,5,1
2021,Bridgend 006B,W01001057,1677,1651,26,15,4,7,0
2021,Bridgend 006C,W01001058,1840,1829,11,4,3,1,3
2021,Vale of Glamorgan 015A,W01001059,1702,1686,16,13,1,1,1
2021,Vale of Glamorgan 015B,W01001060,1383,1373,10,6,4,0,0
2021,Vale of Glamorgan 013A,W01001062,1303,1278,25,14,7,0,4
2021,Vale of Glamorgan 012A,W01001063,1544,1507,37,15,5,11,6
2021,Vale of Glamorgan 013B,W01001064,1371,1364,7,1,5,0,1
2021,Vale of Glamorgan 012B,W01001065,1518,1497,21,9,8,4,0
2021,Vale of Glamorgan 015D,W01001066,1576,1548,28,10,11,5,2
2021,Vale of Glamorgan 009A,W01001067,1344,1325,19,10,8,1,0
2021,Vale of Glamorgan 009B,W01001068,1601,1572,29,15,10,4,0
2021,Vale of Glamorgan 012C,W01001069,1474,1440,34,16,12,4,2
2021,Vale of Glamorgan 009C,W01001070,994,971,23,10,6,3,4
2021,Vale of Glamorgan 009D,W01001071,1436,1397,39,21,13,3,2
2021,Vale of Glamorgan 009E,W01001072,2630,2580,50,33,12,5,0
2021,Vale of Glamorgan 015E,W01001073,2016,1969,47,28,14,5,0
2021,Vale of Glamorgan 004A,W01001075,1144,1117,27,22,2,3,0
2021,Vale of Glamorgan 004B,W01001076,1342,1293,49,26,12,9,2
2021,Vale of Glamorgan 004C,W01001077,1384,1359,25,17,5,3,0
2021,Vale of Glamorgan 004D,W01001078,1256,1231,25,10,12,3,0
2021,Vale of Glamorgan 012E,W01001079,1438,1392,46,24,11,8,3
2021,Vale of Glamorgan 012F,W01001080,1529,1488,41,24,11,3,3
2021,Vale of Glamorgan 007A,W01001081,1676,1657,19,4,9,6,0
2021,Vale of Glamorgan 002A,W01001082,1525,1511,14,8,6,0,0
2021,Vale of Glamorgan 002B,W01001083,1668,1661,7,7,0,0,0
2021,Vale of Glamorgan 002C,W01001084,1626,1620,6,4,1,1,0
2021,Vale of Glamorgan 002D,W01001085,1610,1603,7,2,2,3,0
2021,Vale of Glamorgan 006A,W01001086,1468,1441,27,10,11,5,1
2021,Vale of Glamorgan 006B,W01001087,1472,1450,22,15,4,3,0
2021,Vale of Glamorgan 006C,W01001088,2073,2040,33,23,7,3,0
2021,Vale of Glamorgan 006D,W01001089,1553,1534,19,9,7,3,0
2021,Vale of Glamorgan 006E,W01001090,1411,1396,15,8,6,1,0
2021,Vale of Glamorgan 010A,W01001091,1588,1570,18,9,7,2,0
2021,Vale of Glamorgan 007B,W01001092,2046,2011,35,28,7,0,0
2021,Vale of Glamorgan 013C,W01001093,1716,1696,20,13,3,4,0
2021,Vale of Glamorgan 007C,W01001094,1195,1180,15,7,4,4,0
2021,Vale of Glamorgan 007D,W01001095,1321,1302,19,6,4,7,2
2021,Vale of Glamorgan 007E,W01001096,1274,1238,36,22,9,5,0
2021,Vale of Glamorgan 007F,W01001097,1471,1449,22,6,8,5,3
2021,Vale of Glamorgan 010B,W01001098,1010,1000,10,6,2,1,1
2021,Vale of Glamorgan 013D,W01001099,1165,1150,15,9,2,4,0
2021,Vale of Glamorgan 010C,W01001100,1452,1446,6,2,2,1,1
2021,Vale of Glamorgan 013E,W01001101,1472,1440,32,17,10,4,1
2021,Vale of Glamorgan 013F,W01001102,1467,1448,19,6,7,6,0
2021,Vale of Glamorgan 010D,W01001103,1150,1141,9,5,4,0,0
2021,Vale of Glamorgan 004E,W01001104,2039,1934,105,80,16,8,1
2021,Vale of Glamorgan 001A,W01001105,2757,2738,19,11,3,1,4
2021,Vale of Glamorgan 011A,W01001106,1415,1407,8,6,1,1,0
2021,Vale of Glamorgan 011B,W01001107,1476,1456,20,9,7,3,1
2021,Vale of Glamorgan 014A,W01001108,1756,1741,15,10,3,2,0
2021,Vale of Glamorgan 011C,W01001109,1347,1337,10,5,3,0,2
2021,Vale of Glamorgan 011D,W01001110,1661,1493,168,124,40,4,0
2021,Vale of Glamorgan 011E,W01001111,1315,1309,6,1,3,2,0
2021,Vale of Glamorgan 011F,W01001112,1279,1268,11,6,5,0,0
2021,Vale of Glamorgan 003A,W01001113,2263,2255,8,8,0,0,0
2021,Vale of Glamorgan 008A,W01001114,1545,1530,15,4,6,3,2
2021,Vale of Glamorgan 008B,W01001115,2100,2052,48,28,13,6,1
2021,Vale of Glamorgan 005A,W01001116,1905,1857,48,39,8,1,0
2021,Vale of Glamorgan 014B,W01001117,1263,1252,11,6,3,1,1
2021,Vale of Glamorgan 003B,W01001119,1816,1804,12,7,4,1,0
2021,Vale of Glamorgan 014D,W01001120,1321,1316,5,3,0,2,0
2021,Vale of Glamorgan 014E,W01001121,1659,1639,20,11,5,3,1
2021,Vale of Glamorgan 014F,W01001122,2369,2347,22,13,8,1,0
2021,Vale of Glamorgan 005B,W01001123,1447,1422,25,16,5,4,0
2021,Vale of Glamorgan 005C,W01001124,1421,1369,52,32,16,3,1
2021,Vale of Glamorgan 005D,W01001125,1386,1335,51,23,23,5,0
2021,Vale of Glamorgan 001B,W01001127,1589,1579,10,8,2,0,0
2021,Vale of Glamorgan 001C,W01001128,1638,1626,12,7,2,2,1
2021,Vale of Glamorgan 004F,W01001129,1595,1556,39,32,3,4,0
2021,Vale of Glamorgan 005F,W01001130,1240,1217,23,17,6,0,0
2021,Vale of Glamorgan 008C,W01001131,1650,1620,30,15,9,6,0
2021,Vale of Glamorgan 008D,W01001132,1307,1271,36,24,8,2,2
2021,Vale of Glamorgan 008E,W01001133,2186,2137,49,34,6,4,5
2021,Vale of Glamorgan 008F,W01001134,1084,1058,26,19,6,0,1
2021,Vale of Glamorgan 003C,W01001135,2240,2205,35,15,15,4,1
2021,Vale of Glamorgan 003D,W01001136,1465,1444,21,17,3,1,0
2021,Rhondda Cynon Taf 005A,W01001137,2292,2246,46,9,28,8,1
2021,Rhondda Cynon Taf 005B,W01001138,1289,1263,26,12,8,5,1
2021,Rhondda Cynon Taf 005C,W01001139,1353,1335,18,9,7,2,0
2021,Rhondda Cynon Taf 005D,W01001140,1363,1355,8,4,3,1,0
2021,Rhondda Cynon Taf 005E,W01001141,1463,1461,2,1,0,1,0
2021,Rhondda Cynon Taf 005F,W01001142,1840,1827,13,9,3,0,1
2021,Rhondda Cynon Taf 012A,W01001143,1433,1418,15,9,4,2,0
2021,Rhondda Cynon Taf 012B,W01001144,1674,1650,24,10,11,2,1
2021,Rhondda Cynon Taf 012C,W01001145,1686,1663,23,7,11,5,0
2021,Rhondda Cynon Taf 012D,W01001146,1366,1353,13,7,5,0,1
2021,Rhondda Cynon Taf 004A,W01001147,1760,1751,9,5,0,4,0
2021,Rhondda Cynon Taf 002A,W01001148,1683,1631,52,31,9,9,3
2021,Rhondda Cynon Taf 003A,W01001149,1357,1346,11,4,4,2,1
2021,Rhondda Cynon Taf 003B,W01001150,1819,1775,44,9,21,13,1
2021,Rhondda Cynon Taf 003C,W01001151,1772,1755,17,7,9,1,0
2021,Rhondda Cynon Taf 002B,W01001152,1882,1855,27,4,22,1,0
2021,Rhondda Cynon Taf 002C,W01001153,1517,1502,15,8,5,1,1
2021,Rhondda Cynon Taf 003D,W01001154,1370,1355,15,4,4,7,0
2021,Rhondda Cynon Taf 002D,W01001155,1482,1470,12,6,4,2,0
2021,Rhondda Cynon Taf 003E,W01001156,1375,1371,4,3,1,0,0
2021,Rhondda Cynon Taf 028A,W01001157,1268,1250,18,8,6,4,0
2021,Rhondda Cynon Taf 028B,W01001158,1437,1421,16,7,7,2,0
2021,Rhondda Cynon Taf 028C,W01001159,1513,1485,28,14,9,5,0
2021,Rhondda Cynon Taf 029A,W01001160,1586,1568,18,8,8,0,2
2021,Rhondda Cynon Taf 025A,W01001162,2435,2403,32,15,11,5,1
2021,Rhondda Cynon Taf 019A,W01001164,1517,1492,25,12,12,1,0
2021,Rhondda Cynon Taf 019B,W01001165,1303,1267,36,21,14,1,0
2021,Rhondda Cynon Taf 016A,W01001166,1325,1233,92,52,18,17,5
2021,Rhondda Cynon Taf 016B,W01001167,1362,1350,12,6,6,0,0
2021,Rhondda Cynon Taf 004B,W01001168,1357,1352,5,2,2,1,0
2021,Rhondda Cynon Taf 004C,W01001169,2444,2418,26,13,8,4,1
2021,Rhondda Cynon Taf 004D,W01001170,1162,1157,5,1,2,2,0
2021,Rhondda Cynon Taf 017A,W01001171,1256,1252,4,1,0,2,1
2021,Rhondda Cynon Taf 020A,W01001172,1351,1331,20,8,5,7,0
2021,Rhondda Cynon Taf 020B,W01001173,1315,1302,13,9,3,0,1
2021,Rhondda Cynon Taf 020C,W01001174,1363,1349,14,5,4,4,1
2021,Rhondda Cynon Taf 009A,W01001175,1260,1252,8,4,3,1,0
2021,Rhondda Cynon Taf 013A,W01001176,1400,1386,14,8,2,3,1
2021,Rhondda Cynon Taf 009B,W01001177,1256,1249,7,2,1,3,1
2021,Rhondda Cynon Taf 023A,W01001178,1568,1556,12,3,5,4,0
2021,Rhondda Cynon Taf 023B,W01001179,1660,1639,21,12,9,0,0
2021,Rhondda Cynon Taf 015A,W01001180,1479,1439,40,16,15,9,0
2021,Rhondda Cynon Taf 015B,W01001181,1346,1318,28,12,14,2,0
2021,Rhondda Cynon Taf 026A,W01001184,2024,1974,50,16,22,10,2
2021,Rhondda Cynon Taf 022A,W01001185,2003,1958,45,18,15,9,3
2021,Rhondda Cynon Taf 001A,W01001186,1691,1683,8,3,4,1,0
2021,Rhondda Cynon Taf 001B,W01001187,1322,1309,13,6,2,5,0
2021,Rhondda Cynon Taf 001C,W01001188,1266,1255,11,2,5,3,1
2021,Rhondda Cynon Taf 029C,W01001189,1462,1445,17,10,4,1,2
2021,Rhondda Cynon Taf 029D,W01001190,2879,2794,85,58,13,14,0
2021,Rhondda Cynon Taf 031B,W01001192,1380,1363,17,9,3,4,1
2021,Rhondda Cynon Taf 030A,W01001193,1111,1103,8,5,2,1,0
2021,Rhondda Cynon Taf 030B,W01001194,2059,2041,18,11,4,3,0
2021,Rhondda Cynon Taf 030C,W01001195,1424,1405,19,9,7,1,2
2021,Rhondda Cynon Taf 027B,W01001196,1401,1375,26,15,6,4,1
2021,Rhondda Cynon Taf 027C,W01001197,1185,1172,13,12,0,1,0
2021,Rhondda Cynon Taf 027D,W01001198,1457,1441,16,7,7,2,0
2021,Rhondda Cynon Taf 027E,W01001199,1616,1603,13,8,3,1,1
2021,Rhondda Cynon Taf 009C,W01001202,1712,1703,9,3,5,1,0
2021,Rhondda Cynon Taf 009D,W01001203,1316,1303,13,4,4,3,2
2021,Rhondda Cynon Taf 006A,W01001204,1471,1456,15,7,7,1,0
2021,Rhondda Cynon Taf 006B,W01001205,1426,1413,13,6,5,2,0
2021,Rhondda Cynon Taf 006C,W01001206,1425,1418,7,6,1,0,0
2021,Rhondda Cynon Taf 006D,W01001207,1230,1225,5,5,0,0,0
2021,Rhondda Cynon Taf 006E,W01001208,1472,1465,7,5,1,1,0
2021,Rhondda Cynon Taf 008A,W01001209,1402,1375,27,16,5,4,2
2021,Rhondda Cynon Taf 008B,W01001210,1415,1400,15,4,8,3,0
2021,Rhondda Cynon Taf 008C,W01001211,1474,1461,13,6,2,5,0
2021,Rhondda Cynon Taf 008D,W01001212,1264,1249,15,6,2,3,4
2021,Rhondda Cynon Taf 011B,W01001214,1272,1264,8,0,1,6,1
2021,Rhondda Cynon Taf 011D,W01001216,1462,1437,25,18,2,4,1
2021,Rhondda Cynon Taf 018A,W01001217,1083,1069,14,6,5,3,0
2021,Rhondda Cynon Taf 018B,W01001218,1476,1457,19,10,3,4,2
2021,Rhondda Cynon Taf 018C,W01001219,1181,1159,22,12,7,3,0
2021,Rhondda Cynon Taf 018D,W01001220,1448,1441,7,2,3,2,0
2021,Rhondda Cynon Taf 001D,W01001221,1387,1370,17,4,8,3,2
2021,Rhondda Cynon Taf 001E,W01001222,1500,1492,8,4,2,1,1
2021,Rhondda Cynon Taf 031C,W01001223,1691,1666,25,22,2,1,0
2021,Rhondda Cynon Taf 031D,W01001224,1982,1964,18,10,5,3,0
2021,Rhondda Cynon Taf 031E,W01001225,1537,1523,14,8,4,1,1
2021,Rhondda Cynon Taf 031F,W01001226,1641,1613,28,17,8,2,1
2021,Rhondda Cynon Taf 021C,W01001227,1231,1214,17,5,7,5,0
2021,Rhondda Cynon Taf 021D,W01001228,1575,1510,65,16,27,21,1
2021,Rhondda Cynon Taf 017B,W01001229,1364,1352,12,6,3,3,0
2021,Rhondda Cynon Taf 017C,W01001230,1504,1496,8,7,1,0,0
2021,Rhondda Cynon Taf 017D,W01001231,1387,1363,24,15,7,1,1
2021,Rhondda Cynon Taf 020D,W01001232,1236,1227,9,3,2,2,2
2021,Rhondda Cynon Taf 001F,W01001233,1779,1771,8,4,3,1,0
2021,Rhondda Cynon Taf 021E,W01001234,1453,1428,25,10,12,1,2
2021,Rhondda Cynon Taf 021F,W01001235,1600,1577,23,11,10,1,1
2021,Rhondda Cynon Taf 021G,W01001236,1564,1541,23,15,5,3,0
2021,Rhondda Cynon Taf 022B,W01001237,1407,1389,18,8,7,0,3
2021,Rhondda Cynon Taf 022C,W01001238,1651,1629,22,15,6,1,0
2021,Rhondda Cynon Taf 026B,W01001239,1265,1245,20,8,7,5,0
2021,Rhondda Cynon Taf 026C,W01001240,1856,1833,23,13,7,3,0
2021,Rhondda Cynon Taf 026D,W01001241,1613,1594,19,7,4,6,2
2021,Rhondda Cynon Taf 030D,W01001242,1321,1285,36,26,5,3,2
2021,Rhondda Cynon Taf 030E,W01001243,1367,1333,34,13,14,4,3
2021,Rhondda Cynon Taf 025B,W01001244,1352,1329,23,12,5,3,3
2021,Rhondda Cynon Taf 025C,W01001245,1199,1181,18,12,4,2,0
2021,Rhondda Cynon Taf 025D,W01001246,1309,1303,6,3,3,0,0
2021,Rhondda Cynon Taf 016C,W01001247,1544,1536,8,6,1,1,0
2021,Rhondda Cynon Taf 016D,W01001248,1931,1902,29,11,7,10,1
2021,Rhondda Cynon Taf 024A,W01001249,1418,1390,28,10,11,5,2
2021,Rhondda Cynon Taf 024B,W01001250,1491,1473,18,11,4,2,1
2021,Rhondda Cynon Taf 024C,W01001251,1451,1436,15,12,3,0,0
2021,Rhondda Cynon Taf 024D,W01001252,1521,1500,21,14,1,4,2
2021,Rhondda Cynon Taf 023C,W01001253,1406,1399,7,4,2,0,1
2021,Rhondda Cynon Taf 023E,W01001255,1938,1902,36,11,4,12,9
2021,Rhondda Cynon Taf 019C,W01001256,1157,1125,32,17,12,3,0
2021,Rhondda Cynon Taf 019D,W01001257,1202,1194,8,3,5,0,0
2021,Rhondda Cynon Taf 019E,W01001258,1211,1189,22,15,4,3,0
2021,Rhondda Cynon Taf 018E,W01001259,1558,1552,6,3,3,0,0
2021,Rhondda Cynon Taf 014C,W01001260,1138,1131,7,3,3,1,0
2021,Rhondda Cynon Taf 018F,W01001261,1208,1202,6,3,1,2,0
2021,Rhondda Cynon Taf 022D,W01001262,1532,1407,125,72,40,11,2
2021,Rhondda Cynon Taf 022E,W01001263,1642,1396,246,122,106,16,2
2021,Rhondda Cynon Taf 022F,W01001264,1884,1681,203,120,70,12,1
2021,Rhondda Cynon Taf 007A,W01001265,1493,1480,13,3,7,3,0
2021,Rhondda Cynon Taf 007B,W01001266,1332,1325,7,4,1,2,0
2021,Rhondda Cynon Taf 007C,W01001267,1439,1431,8,3,5,0,0
2021,Rhondda Cynon Taf 007D,W01001268,1276,1259,17,9,4,3,1
2021,Rhondda Cynon Taf 010A,W01001269,1411,1404,7,3,3,1,0
2021,Rhondda Cynon Taf 010B,W01001270,1406,1391,15,6,6,2,1
2021,Rhondda Cynon Taf 010C,W01001271,1479,1473,6,1,5,0,0
2021,Rhondda Cynon Taf 010D,W01001272,1425,1423,2,0,0,0,2
2021,Rhondda Cynon Taf 010E,W01001273,1710,1678,32,9,1,22,0
2021,Rhondda Cynon Taf 013B,W01001274,1146,1124,22,2,1,16,3
2021,Rhondda Cynon Taf 013C,W01001275,1729,1708,21,12,6,3,0
2021,Rhondda Cynon Taf 013D,W01001276,1225,1184,41,13,12,14,2
2021,Rhondda Cynon Taf 028D,W01001277,1089,1078,11,6,2,2,1
2021,Rhondda Cynon Taf 028E,W01001278,1107,1100,7,1,4,1,1
2021,Rhondda Cynon Taf 028F,W01001279,1069,1052,17,2,8,6,1
2021,Rhondda Cynon Taf 017E,W01001280,1518,1506,12,4,5,3,0
2021,Rhondda Cynon Taf 017F,W01001281,1629,1604,25,2,20,3,0
2021,Rhondda Cynon Taf 015C,W01001282,1961,1928,33,17,11,4,1
2021,Rhondda Cynon Taf 015D,W01001283,1405,1391,14,5,3,5,1
2021,Rhondda Cynon Taf 015E,W01001284,1047,1041,6,2,2,2,0
2021,Rhondda Cynon Taf 014D,W01001285,1332,1314,18,8,8,2,0
2021,Rhondda Cynon Taf 014E,W01001286,1421,1411,10,3,4,3,0
2021,Rhondda Cynon Taf 014F,W01001287,1417,1413,4,3,0,0,1
2021,Rhondda Cynon Taf 014G,W01001288,1384,1375,9,5,3,1,0
2021,Merthyr Tydfil 006A,W01001289,1313,1304,9,7,0,2,0
2021,Merthyr Tydfil 007A,W01001290,2304,2281,23,15,5,1,2
2021,Merthyr Tydfil 003A,W01001291,2002,1934,68,43,14,9,2
2021,Merthyr Tydfil 004A,W01001292,1760,1651,109,34,43,24,8
2021,Merthyr Tydfil 004B,W01001293,1637,1597,40,13,16,10,1
2021,Merthyr Tydfil 003B,W01001294,1628,1600,28,17,9,2,0
2021,Merthyr Tydfil 002A,W01001295,1454,1387,67,14,31,17,5
2021,Merthyr Tydfil 002B,W01001296,1521,1482,39,13,19,7,0
2021,Merthyr Tydfil 002C,W01001297,1763,1661,102,27,43,26,6
2021,Merthyr Tydfil 002D,W01001298,1679,1558,121,30,57,29,5
2021,Merthyr Tydfil 008A,W01001299,1616,1456,160,57,51,45,7
2021,Merthyr Tydfil 008B,W01001300,1677,1570,107,32,35,35,5
2021,Merthyr Tydfil 008C,W01001301,1836,1665,171,56,57,50,8
2021,Merthyr Tydfil 006B,W01001302,1372,1350,22,10,8,4,0
2021,Merthyr Tydfil 003C,W01001305,1192,1121,71,22,29,15,5
2021,Merthyr Tydfil 003D,W01001306,1388,1338,50,16,17,14,3
2021,Merthyr Tydfil 004C,W01001307,1492,1381,111,52,24,30,5
2021,Merthyr Tydfil 008D,W01001308,1195,1138,57,18,23,13,3
2021,Merthyr Tydfil 008E,W01001309,1256,1179,77,29,24,23,1
2021,Merthyr Tydfil 002E,W01001310,1494,1434,60,25,17,17,1
2021,Merthyr Tydfil 002F,W01001311,1105,1033,72,26,34,9,3
2021,Merthyr Tydfil 006E,W01001312,1432,1405,27,11,10,4,2
2021,Merthyr Tydfil 006F,W01001313,1436,1397,39,17,12,7,3
2021,Merthyr Tydfil 005A,W01001314,2050,2028,22,11,9,2,0
2021,Merthyr Tydfil 004D,W01001315,1658,1423,235,71,76,70,18
2021,Merthyr Tydfil 005C,W01001317,1692,1663,29,16,10,2,1
2021,Merthyr Tydfil 005D,W01001318,1438,1398,40,8,13,12,7
2021,Merthyr Tydfil 007B,W01001319,1566,1554,12,3,5,4,0
2021,Merthyr Tydfil 007C,W01001320,1386,1366,20,9,4,2,5
2021,Merthyr Tydfil 007D,W01001321,1567,1550,17,10,3,4,0
2021,Merthyr Tydfil 007E,W01001322,1577,1557,20,10,9,0,1
2021,Merthyr Tydfil 003E,W01001324,1880,1839,41,13,14,9,5
2021,Caerphilly 003A,W01001325,1605,1596,9,3,5,0,1
2021,Caerphilly 003B,W01001326,2079,2056,23,17,3,1,2
2021,Caerphilly 014A,W01001327,2359,2341,18,10,8,0,0
2021,Caerphilly 014B,W01001328,1465,1449,16,10,4,1,1
2021,Caerphilly 014C,W01001329,1446,1417,29,15,8,5,1
2021,Caerphilly 018A,W01001330,1400,1387,13,7,5,0,1
2021,Caerphilly 018B,W01001331,1679,1663,16,8,4,2,2
2021,Caerphilly 018C,W01001332,1782,1758,24,12,7,5,0
2021,Caerphilly 018D,W01001333,1419,1406,13,5,6,2,0
2021,Caerphilly 005A,W01001334,1398,1375,23,12,10,0,1
2021,Caerphilly 005B,W01001335,1237,1228,9,3,6,0,0
2021,Caerphilly 004A,W01001336,1370,1348,22,8,7,5,2
2021,Caerphilly 004B,W01001337,1407,1390,17,7,7,3,0
2021,Caerphilly 004C,W01001338,1662,1637,25,8,15,2,0
2021,Caerphilly 004D,W01001339,1368,1347,21,9,8,2,2
2021,Caerphilly 020A,W01001340,1826,1804,22,11,9,2,0
2021,Caerphilly 020B,W01001341,1651,1637,14,7,4,1,2
2021,Caerphilly 021A,W01001342,1158,1150,8,5,2,0,1
2021,Caerphilly 021B,W01001343,1071,1064,7,4,1,2,0
2021,Caerphilly 020C,W01001344,1630,1608,22,6,10,6,0
2021,Caerphilly 021C,W01001345,1337,1305,32,15,11,4,2
2021,Caerphilly 020D,W01001346,1475,1457,18,12,5,1,0
2021,Caerphilly 005C,W01001347,1454,1444,10,3,4,3,0
2021,Caerphilly 009A,W01001348,1700,1657,43,15,17,10,1
2021,Caerphilly 009B,W01001349,1679,1649,30,13,15,2,0
2021,Caerphilly 009C,W01001350,1681,1637,44,15,15,12,2
2021,Caerphilly 005D,W01001351,1374,1366,8,6,2,0,0
2021,Caerphilly 007A,W01001352,1699,1688,11,7,3,1,0
2021,Caerphilly 007B,W01001353,1493,1481,12,3,7,2,0
2021,Caerphilly 014D,W01001354,1631,1598,33,11,17,4,1
2021,Caerphilly 015A,W01001355,1494,1478,16,5,7,4,0
2021,Caerphilly 006A,W01001356,1166,1164,2,2,0,0,0
2021,Caerphilly 006B,W01001357,1656,1649,7,5,1,0,1
2021,Caerphilly 006C,W01001358,1441,1429,12,2,4,5,1
2021,Caerphilly 006D,W01001359,1365,1357,8,8,0,0,0
2021,Caerphilly 002A,W01001360,1267,1264,3,2,1,0,0
2021,Caerphilly 002B,W01001361,1120,1118,2,1,1,0,0
2021,Caerphilly 003C,W01001362,1941,1934,7,2,2,3,0
2021,Caerphilly 012A,W01001363,1746,1736,10,4,1,4,1
2021,Caerphilly 012B,W01001364,1724,1714,10,7,1,0,2
2021,Caerphilly 012C,W01001365,1888,1855,33,18,8,6,1
2021,Caerphilly 019A,W01001366,1528,1518,10,3,6,1,0
2021,Caerphilly 019B,W01001367,1409,1396,13,9,1,3,0
2021,Caerphilly 019C,W01001368,1391,1377,14,4,7,3,0
2021,Caerphilly 012D,W01001369,2350,2337,13,6,4,3,0
2021,Caerphilly 023A,W01001370,1791,1757,34,12,15,7,0
2021,Caerphilly 022A,W01001371,1834,1788,46,29,13,4,0
2021,Caerphilly 022B,W01001372,1759,1738,21,2,12,6,1
2021,Caerphilly 022C,W01001373,1876,1835,41,26,11,4,0
2021,Caerphilly 001A,W01001374,1375,1369,6,2,2,2,0
2021,Caerphilly 001B,W01001375,1435,1418,17,6,6,4,1
2021,Caerphilly 001C,W01001376,1378,1371,7,3,3,1,0
2021,Caerphilly 013A,W01001377,1417,1398,19,8,6,4,1
2021,Caerphilly 013B,W01001378,1459,1446,13,5,7,1,0
2021,Caerphilly 013C,W01001379,1486,1480,6,1,0,4,1
2021,Caerphilly 010A,W01001380,1733,1728,5,3,1,0,1
2021,Caerphilly 010B,W01001381,1429,1392,37,11,17,7,2
2021,Caerphilly 010C,W01001382,1507,1498,9,4,3,2,0
2021,Caerphilly 010D,W01001383,1410,1395,15,6,7,2,0
2021,Caerphilly 002C,W01001384,1450,1434,16,4,7,4,1
2021,Caerphilly 002D,W01001385,1478,1464,14,9,4,0,1
2021,Caerphilly 002E,W01001386,1527,1519,8,4,3,1,0
2021,Caerphilly 007C,W01001387,1161,1132,29,14,13,2,0
2021,Caerphilly 007D,W01001388,1742,1719,23,11,7,3,2
2021,Caerphilly 007E,W01001389,1072,1063,9,4,2,2,1
2021,Caerphilly 006E,W01001390,2046,2029,17,9,5,3,0
2021,Caerphilly 006F,W01001391,1582,1575,7,2,2,3,0
2021,Caerphilly 009D,W01001392,1893,1879,14,9,3,2,0
2021,Caerphilly 019D,W01001393,1302,1284,18,8,5,5,0
2021,Caerphilly 023B,W01001394,1257,1249,8,6,1,1,0
2021,Caerphilly 023C,W01001395,1282,1271,11,5,4,1,1
2021,Caerphilly 023D,W01001396,1497,1472,25,17,6,2,0
2021,Caerphilly 019E,W01001397,1533,1497,36,17,17,1,1
2021,Caerphilly 024A,W01001398,2683,2630,53,22,11,15,5
2021,Caerphilly 023E,W01001399,1221,1213,8,7,1,0,0
2021,Caerphilly 019F,W01001400,1358,1331,27,11,10,4,2
2021,Caerphilly 011A,W01001401,2001,1988,13,4,5,2,2
2021,Caerphilly 011B,W01001402,1548,1532,16,7,8,1,0
2021,Caerphilly 011C,W01001403,1541,1535,6,3,3,0,0
2021,Caerphilly 011D,W01001404,1321,1292,29,17,10,1,1
2021,Caerphilly 011E,W01001405,1735,1715,20,10,4,5,1
2021,Caerphilly 001D,W01001406,1774,1761,13,7,3,3,0
2021,Caerphilly 016A,W01001407,1276,1253,23,14,6,2,1
2021,Caerphilly 016B,W01001408,1389,1352,37,19,12,6,0
2021,Caerphilly 016C,W01001409,1532,1507,25,8,14,3,0
2021,Caerphilly 016D,W01001410,1746,1701,45,21,17,6,1
2021,Caerphilly 017A,W01001411,1569,1553,16,9,6,1,0
2021,Caerphilly 017B,W01001412,1603,1566,37,8,17,10,2
2021,Caerphilly 017C,W01001413,1766,1748,18,9,6,2,1
2021,Caerphilly 008A,W01001414,1525,1513,12,5,4,1,2
2021,Caerphilly 008B,W01001415,1673,1665,8,3,4,0,1
2021,Caerphilly 008C,W01001416,1341,1335,6,3,2,1,0
2021,Caerphilly 008D,W01001417,1341,1330,11,8,1,0,2
2021,Caerphilly 008E,W01001418,1355,1344,11,4,4,3,0
2021,Caerphilly 021D,W01001419,1570,1557,13,10,3,0,0
2021,Caerphilly 022D,W01001420,1183,1167,16,6,2,8,0
2021,Caerphilly 022E,W01001421,1390,1361,29,12,11,4,2
2021,Caerphilly 022F,W01001422,1420,1403,17,4,13,0,0
2021,Caerphilly 024B,W01001423,1341,1322,19,12,5,2,0
2021,Caerphilly 024C,W01001424,1368,1336,32,13,8,11,0
2021,Caerphilly 024D,W01001425,1685,1662,23,10,9,3,1
2021,Caerphilly 024E,W01001426,1411,1403,8,6,1,0,1
2021,Caerphilly 024F,W01001427,1798,1754,44,27,11,4,2
2021,Caerphilly 001E,W01001428,1188,1180,8,6,2,0,0
2021,Caerphilly 001F,W01001429,1129,1125,4,2,1,1,0
2021,Caerphilly 015B,W01001430,2307,2280,27,14,10,3,0
2021,Caerphilly 015C,W01001431,1535,1523,12,7,4,1,0
2021,Caerphilly 013D,W01001432,2660,2618,42,19,13,8,2
2021,Caerphilly 013E,W01001433,1326,1300,26,11,7,6,2
2021,Caerphilly 013F,W01001434,1340,1331,9,5,4,0,0
2021,Blaenau Gwent 008A,W01001435,1315,1257,58,16,28,12,2
2021,Blaenau Gwent 008B,W01001436,1328,1266,62,8,28,21,5
2021,Blaenau Gwent 008C,W01001437,1402,1382,20,5,10,5,0
2021,Blaenau Gwent 004A,W01001438,1435,1425,10,5,5,0,0
2021,Blaenau Gwent 004B,W01001439,1560,1544,16,9,3,1,3
2021,Blaenau Gwent 001A,W01001440,1303,1293,10,6,3,1,0
2021,Blaenau Gwent 001B,W01001441,1117,1086,31,17,5,7,2
2021,Blaenau Gwent 001C,W01001442,1068,1053,15,2,9,1,3
2021,Blaenau Gwent 005A,W01001443,1199,1186,13,3,6,4,0
2021,Blaenau Gwent 005B,W01001444,1901,1892,9,3,4,2,0
2021,Blaenau Gwent 005C,W01001445,1306,1291,15,7,5,3,0
2021,Blaenau Gwent 002A,W01001446,1196,1190,6,3,2,0,1
2021,Blaenau Gwent 002B,W01001447,1424,1399,25,11,10,4,0
2021,Blaenau Gwent 002C,W01001448,1129,1087,42,5,19,16,2
2021,Blaenau Gwent 002D,W01001449,1332,1320,12,4,7,0,1
2021,Blaenau Gwent 007A,W01001450,1180,1179,1,0,1,0,0
2021,Blaenau Gwent 007B,W01001451,1256,1246,10,5,3,2,0
2021,Blaenau Gwent 007C,W01001452,1398,1378,20,7,12,1,0
2021,Blaenau Gwent 008D,W01001453,1445,1429,16,6,7,3,0
2021,Blaenau Gwent 008E,W01001454,1239,1229,10,5,2,2,1
2021,Blaenau Gwent 008F,W01001455,1617,1572,45,14,20,9,2
2021,Blaenau Gwent 004C,W01001456,1218,1167,51,17,20,11,3
2021,Blaenau Gwent 004D,W01001457,1719,1687,32,13,7,8,4
2021,Blaenau Gwent 004E,W01001458,1575,1553,22,11,7,4,0
2021,Blaenau Gwent 007D,W01001459,1154,1116,38,22,10,6,0
2021,Blaenau Gwent 007E,W01001460,1681,1630,51,20,18,11,2
2021,Blaenau Gwent 007F,W01001461,1232,1171,61,22,25,11,3
2021,Blaenau Gwent 006A,W01001462,1748,1742,6,3,1,1,1
2021,Blaenau Gwent 006B,W01001463,1739,1725,14,9,3,2,0
2021,Blaenau Gwent 009A,W01001464,1397,1358,39,13,11,14,1
2021,Blaenau Gwent 009B,W01001465,1485,1460,25,9,13,3,0
2021,Blaenau Gwent 009C,W01001466,1408,1388,20,10,7,3,0
2021,Blaenau Gwent 005D,W01001467,1825,1800,25,18,3,4,0
2021,Blaenau Gwent 005E,W01001468,1285,1260,25,7,11,7,0
2021,Blaenau Gwent 005F,W01001469,1267,1251,16,7,8,1,0
2021,Blaenau Gwent 001D,W01001470,1368,1346,22,11,6,4,1
2021,Blaenau Gwent 001E,W01001471,1566,1539,27,6,13,6,2
2021,Blaenau Gwent 003A,W01001472,1342,1322,20,4,10,4,2
2021,Blaenau Gwent 003B,W01001473,1225,1211,14,4,3,6,1
2021,Blaenau Gwent 003C,W01001474,1383,1370,13,6,4,3,0
2021,Blaenau Gwent 003D,W01001475,1089,1054,35,10,15,6,4
2021,Blaenau Gwent 006C,W01001478,1327,1310,17,5,5,6,1
2021,Blaenau Gwent 006D,W01001479,1408,1369,39,18,14,7,0
2021,Blaenau Gwent 003E,W01001480,1420,1390,30,11,9,7,3
2021,Blaenau Gwent 006E,W01001481,1598,1533,65,18,30,16,1
2021,Torfaen 002A,W01001482,1192,1183,9,4,4,1,0
2021,Torfaen 002B,W01001483,1376,1370,6,3,0,3,0
2021,Torfaen 002C,W01001484,1595,1578,17,10,3,3,1
2021,Torfaen 002D,W01001485,1213,1210,3,3,0,0,0
2021,Torfaen 002E,W01001486,1427,1413,14,8,6,0,0
2021,Torfaen 001A,W01001487,1611,1606,5,2,3,0,0
2021,Torfaen 001B,W01001488,1443,1424,19,10,8,0,1
2021,Torfaen 001C,W01001489,1393,1379,14,5,4,2,3
2021,Torfaen 001D,W01001490,1364,1342,22,11,8,3,0
2021,Torfaen 004A,W01001491,1634,1608,26,16,5,2,3
2021,Torfaen 012A,W01001492,2359,2315,44,16,22,6,0
2021,Torfaen 008A,W01001493,1753,1721,32,14,14,4,0
2021,Torfaen 008B,W01001494,1501,1471,30,13,13,2,2
2021,Torfaen 008C,W01001495,1745,1728,17,8,6,3,0
2021,Torfaen 004B,W01001496,1403,1382,21,7,10,4,0
2021,Torfaen 011A,W01001497,1346,1323,23,12,8,3,0
2021,Torfaen 011B,W01001498,1209,1203,6,5,1,0,0
2021,Torfaen 011C,W01001499,1117,1109,8,5,1,1,1
2021,Torfaen 011D,W01001500,1213,1201,12,4,8,0,0
2021,Torfaen 009A,W01001501,1279,1261,18,7,6,2,3
2021,Torfaen 011E,W01001502,1175,1163,12,5,3,4,0
2021,Torfaen 009B,W01001503,1188,1163,25,12,5,7,1
2021,Torfaen 013A,W01001504,2253,2135,118,52,46,19,1
2021,Torfaen 013B,W01001505,2547,2458,89,37,29,16,7
2021,Torfaen 010A,W01001506,1477,1438,39,16,11,12,0
2021,Torfaen 008D,W01001507,1893,1851,42,18,17,5,2
2021,Torfaen 013C,W01001508,1160,1154,6,4,1,1,0
2021,Torfaen 013D,W01001509,1366,1357,9,5,3,1,0
2021,Torfaen 005A,W01001510,1556,1534,22,8,14,0,0
2021,Torfaen 005B,W01001511,1491,1481,10,5,5,0,0
2021,Torfaen 005C,W01001512,1270,1264,6,4,1,1,0
2021,Torfaen 005D,W01001513,1433,1421,12,4,6,2,0
2021,Torfaen 006A,W01001514,1052,1039,13,4,6,2,1
2021,Torfaen 006B,W01001515,1366,1350,16,2,10,4,0
2021,Torfaen 006C,W01001516,1382,1362,20,1,12,7,0
2021,Torfaen 006D,W01001517,2373,2348,25,11,10,4,0
2021,Torfaen 006E,W01001518,1112,1101,11,7,1,3,0
2021,Torfaen 007A,W01001519,1238,1196,42,16,13,10,3
2021,Torfaen 007B,W01001520,2493,2472,21,7,8,6,0
2021,Torfaen 007C,W01001521,1370,1340,30,3,17,9,1
2021,Torfaen 007D,W01001522,1562,1539,23,12,4,4,3
2021,Torfaen 004C,W01001523,1378,1367,11,8,3,0,0
2021,Torfaen 004D,W01001524,1807,1774,33,7,13,7,6
2021,Torfaen 003A,W01001525,1792,1777,15,10,2,2,1
2021,Torfaen 010B,W01001526,1332,1315,17,8,9,0,0
2021,Torfaen 010C,W01001527,1151,1129,22,11,9,2,0
2021,Torfaen 010D,W01001528,1698,1667,31,15,12,3,1
2021,Torfaen 003B,W01001529,1935,1900,35,13,15,2,5
2021,Torfaen 003C,W01001530,1703,1694,9,3,5,0,1
2021,Torfaen 003D,W01001531,1621,1607,14,7,6,0,1
2021,Torfaen 010E,W01001532,1707,1653,54,12,30,7,5
2021,Torfaen 012B,W01001533,1472,1453,19,11,7,0,1
2021,Torfaen 012C,W01001534,1365,1336,29,15,10,0,4
2021,Torfaen 012D,W01001535,1220,1208,12,8,3,1,0
2021,Torfaen 009C,W01001536,1091,1072,19,12,6,0,1
2021,Torfaen 007E,W01001537,1140,1125,15,8,6,1,0
2021,Torfaen 009D,W01001538,1288,1265,23,9,9,4,1
2021,Torfaen 009E,W01001539,1384,1367,17,6,7,3,1
2021,Torfaen 004E,W01001540,1229,1219,10,4,5,1,0
2021,Torfaen 004F,W01001541,1131,1127,4,3,1,0,0
2021,Monmouthshire 009A,W01001542,2066,2046,20,13,6,1,0
2021,Monmouthshire 009B,W01001543,1739,1721,18,8,10,0,0
2021,Monmouthshire 001A,W01001545,1497,1475,22,14,5,3,0
2021,Monmouthshire 002A,W01001546,1509,1462,47,29,13,4,1
2021,Monmouthshire 001B,W01001548,2049,2037,12,7,4,1,0
2021,Monmouthshire 007A,W01001549,1370,1353,17,15,2,0,0
2021,Monmouthshire 010C,W01001551,1137,1129,8,5,2,1,0
2021,Monmouthshire 004A,W01001552,1485,1480,5,5,0,0,0
2021,Monmouthshire 004C,W01001554,1508,1428,80,29,45,6,0
2021,Monmouthshire 006A,W01001555,1120,1115,5,3,2,0,0
2021,Monmouthshire 006B,W01001556,1331,1316,15,11,4,0,0
2021,Monmouthshire 001C,W01001557,1768,1652,116,58,42,16,0
2021,Monmouthshire 002C,W01001558,1543,1507,36,18,14,4,0
2021,Monmouthshire 008A,W01001559,1248,1208,40,24,13,3,0
2021,Monmouthshire 006C,W01001560,1349,1344,5,4,1,0,0
2021,Monmouthshire 003A,W01001561,1560,1551,9,8,1,0,0
2021,Monmouthshire 003B,W01001562,1329,1319,10,5,5,0,0
2021,Monmouthshire 003C,W01001563,1107,1101,6,3,2,1,0
2021,Monmouthshire 006D,W01001565,1780,1772,8,8,0,0,0
2021,Monmouthshire 005C,W01001568,1742,1726,16,9,7,0,0
2021,Monmouthshire 003E,W01001569,1315,1310,5,2,2,0,1
2021,Monmouthshire 001D,W01001571,1459,1448,11,4,4,3,0
2021,Monmouthshire 011A,W01001572,1574,1559,15,7,5,2,1
2021,Monmouthshire 011B,W01001573,1391,1381,10,5,4,1,0
2021,Monmouthshire 011C,W01001574,1276,1252,24,14,8,1,1
2021,Monmouthshire 005D,W01001575,1217,1214,3,1,0,2,0
2021,Monmouthshire 004D,W01001576,1042,1009,33,11,16,5,1
2021,Monmouthshire 004E,W01001577,1255,1234,21,7,9,5,0
2021,Monmouthshire 009C,W01001578,2425,2401,24,15,6,3,0
2021,Monmouthshire 001E,W01001579,1539,1484,55,25,26,4,0
2021,Monmouthshire 002E,W01001580,1712,1662,50,26,18,6,0
2021,Monmouthshire 005E,W01001581,1901,1889,12,11,1,0,0
2021,Monmouthshire 011D,W01001582,1728,1707,21,12,5,4,0
2021,Monmouthshire 007B,W01001583,1491,1487,4,3,1,0,0
2021,Monmouthshire 008B,W01001584,1716,1667,49,21,18,8,2
2021,Monmouthshire 007C,W01001585,1252,1239,13,9,3,1,0
2021,Monmouthshire 007D,W01001586,2424,2391,33,25,8,0,0
2021,Monmouthshire 008C,W01001587,1819,1753,66,42,18,5,1
2021,Monmouthshire 010D,W01001588,1580,1555,25,14,8,3,0
2021,Monmouthshire 010E,W01001589,1383,1359,24,7,10,6,1
2021,Monmouthshire 009D,W01001590,2078,2064,14,10,3,1,0
2021,Monmouthshire 011E,W01001591,1535,1527,8,5,1,2,0
2021,Monmouthshire 008D,W01001592,1577,1531,46,25,12,9,0
2021,Monmouthshire 008E,W01001593,1575,1508,67,30,27,9,1
2021,Monmouthshire 007E,W01001594,1373,1364,9,6,1,2,0
2021,Monmouthshire 007F,W01001595,1262,1257,5,4,1,0,0
2021,Monmouthshire 006E,W01001596,1203,1177,26,3,18,4,1
2021,Monmouthshire 006F,W01001597,1388,1376,12,6,3,3,0
2021,Monmouthshire 010F,W01001598,1608,1559,49,27,13,6,3
2021,Monmouthshire 004F,W01001599,2084,2057,27,18,5,3,1
2021,Newport 012A,W01001600,1779,1731,48,20,21,6,1
2021,Newport 006A,W01001601,1494,1417,77,27,20,29,1
2021,Newport 012B,W01001602,1573,1545,28,19,8,1,0
2021,Newport 012C,W01001603,1482,1359,123,43,41,30,9
2021,Newport 012D,W01001604,1455,1417,38,20,7,10,1
2021,Newport 014A,W01001605,1429,1302,127,52,48,23,4
2021,Newport 008A,W01001606,1234,1204,30,17,8,5,0
2021,Newport 015A,W01001607,1303,1171,132,51,51,24,6
2021,Newport 008B,W01001608,1449,1406,43,19,18,5,1
2021,Newport 015B,W01001609,1827,1643,184,82,69,27,6
2021,Newport 015C,W01001610,1279,1145,134,46,73,13,2
2021,Newport 011A,W01001611,1160,1017,143,51,60,30,2
2021,Newport 011B,W01001612,1481,1357,124,48,38,33,5
2021,Newport 011C,W01001613,1458,1370,88,25,35,22,6
2021,Newport 005A,W01001614,1528,1450,78,29,30,18,1
2021,Newport 005B,W01001615,1528,1479,49,22,15,11,1
2021,Newport 005C,W01001616,1369,1344,25,7,15,3,0
2021,Newport 003A,W01001617,1395,1347,48,26,12,10,0
2021,Newport 003B,W01001618,1090,1056,34,9,20,5,0
2021,Newport 003C,W01001619,1308,1278,30,12,8,9,1
2021,Newport 003D,W01001620,1620,1533,87,48,26,12,1
2021,Newport 003E,W01001621,1379,1313,66,22,31,12,1
2021,Newport 003F,W01001622,1170,1130,40,17,17,5,1
2021,Newport 001A,W01001623,1382,1341,41,18,14,4,5
2021,Newport 001B,W01001624,1184,1171,13,8,0,2,3
2021,Newport 001C,W01001625,1162,1147,15,5,6,3,1
2021,Newport 001D,W01001626,1468,1436,32,15,12,4,1
2021,Newport 001E,W01001627,1574,1559,15,11,3,1,0
2021,Newport 001F,W01001628,1026,1001,25,12,5,5,3
2021,Newport 017A,W01001629,1346,1310,36,14,16,6,0
2021,Newport 017B,W01001630,1584,1528,56,21,19,15,1
2021,Newport 017C,W01001631,1296,1265,31,17,12,1,1
2021,Newport 017D,W01001632,1365,1309,56,21,24,8,3
2021,Newport 019A,W01001633,1622,1501,121,60,42,19,0
2021,Newport 019B,W01001634,1435,1319,116,56,39,20,1
2021,Newport 016A,W01001635,1295,1276,19,5,9,4,1
2021,Newport 020A,W01001636,1874,1843,31,22,7,2,0
2021,Newport 016B,W01001637,2064,2028,36,20,13,3,0
2021,Newport 016C,W01001638,1182,1171,11,7,4,0,0
2021,Newport 004A,W01001639,2091,2045,46,20,16,7,3
2021,Newport 004B,W01001640,1089,1070,19,5,1,13,0
2021,Newport 004C,W01001641,1335,1312,23,16,4,3,0
2021,Newport 013A,W01001642,1587,1412,175,70,72,32,1
2021,Newport 013B,W01001643,1822,1611,211,74,89,41,7
2021,Newport 015D,W01001645,1248,1205,43,19,17,4,3
2021,Newport 015E,W01001646,1568,1505,63,17,29,12,5
2021,Newport 015G,W01001648,1509,1460,49,17,17,11,4
2021,Newport 004E,W01001650,1612,1578,34,22,10,2,0
2021,Newport 002A,W01001651,1402,1390,12,5,5,1,1
2021,Newport 002B,W01001652,1591,1504,87,16,45,20,6
2021,Newport 002C,W01001653,1326,1300,26,12,8,6,0
2021,Newport 002D,W01001654,1535,1488,47,21,18,7,1
2021,Newport 002E,W01001655,1528,1500,28,11,7,7,3
2021,Newport 020C,W01001657,1413,1378,35,17,11,7,0
2021,Newport 020D,W01001658,2018,1985,33,15,8,8,2
2021,Newport 018A,W01001659,1827,1472,355,109,128,106,12
2021,Newport 018B,W01001660,2589,2258,331,122,120,76,13
2021,Newport 018C,W01001661,2847,2207,640,215,251,147,27
2021,Newport 018D,W01001662,1629,1260,369,131,148,80,10
2021,Newport 008C,W01001663,1351,1275,76,26,32,17,1
2021,Newport 010A,W01001664,1171,1129,42,18,13,8,3
2021,Newport 008D,W01001665,1597,1529,68,26,30,10,2
2021,Newport 010B,W01001666,1451,1387,64,19,36,4,5
2021,Newport 010C,W01001667,1259,1219,40,13,22,5,0
2021,Newport 010D,W01001668,1183,1124,59,21,21,10,7
2021,Newport 009A,W01001669,1230,1215,15,9,0,4,2
2021,Newport 009B,W01001670,2227,2186,41,28,9,4,0
2021,Newport 016D,W01001671,2206,2142,64,26,25,13,0
2021,Newport 009D,W01001673,1389,1368,21,9,7,5,0
2021,Newport 009E,W01001674,1515,1475,40,16,18,3,3
2021,Newport 007A,W01001675,1524,1447,77,35,20,17,5
2021,Newport 007B,W01001676,1779,1575,204,79,79,41,5
2021,Newport 007C,W01001677,1350,1313,37,15,18,4,0
2021,Newport 005D,W01001678,1578,1531,47,14,14,19,0
2021,Newport 007D,W01001679,1079,1054,25,15,8,2,0
2021,Newport 007E,W01001680,1242,1185,57,16,25,14,2
2021,Newport 006B,W01001681,1282,1173,109,52,43,13,1
2021,Newport 006C,W01001682,1356,1295,61,37,14,7,3
2021,Newport 006D,W01001683,1058,1022,36,18,13,4,1
2021,Newport 006E,W01001684,1363,1300,63,25,25,11,2
2021,Newport 014B,W01001685,1642,1461,181,83,63,34,1
2021,Newport 014C,W01001686,1266,1179,87,40,30,15,2
2021,Newport 014D,W01001687,2263,1849,414,137,181,78,18
2021,Newport 019D,W01001689,2018,1928,90,25,42,15,8
2021,Newport 013D,W01001690,2105,1636,469,144,163,132,30
2021,Newport 011D,W01001691,1638,1370,268,93,117,43,15
2021,Newport 011E,W01001692,2192,1785,407,128,169,94,16
2021,Newport 013E,W01001693,2743,2170,573,216,204,133,20
2021,Cardiff 036A,W01001694,1930,1544,386,126,156,91,13
2021,Cardiff 036B,W01001695,3930,2909,1021,404,445,146,26
2021,Cardiff 036C,W01001696,1477,1193,284,122,97,55,10
2021,Cardiff 036D,W01001697,1867,1489,378,149,148,70,11
2021,Cardiff 036E,W01001698,2013,1519,494,156,185,120,33
2021,Cardiff 049A,W01001699,2422,1729,693,259,216,184,34
2021,Cardiff 045A,W01001702,1721,1648,73,31,22,19,1
2021,Cardiff 045B,W01001703,1161,1127,34,17,10,5,2
2021,Cardiff 041A,W01001704,1612,1494,118,49,34,32,3
2021,Cardiff 045C,W01001705,1899,1780,119,49,23,40,7
2021,Cardiff 041B,W01001706,1340,1255,85,26,42,14,3
2021,Cardiff 041C,W01001707,1958,1872,86,29,35,18,4
2021,Cardiff 045D,W01001708,1596,1511,85,32,32,19,2
2021,Cardiff 040B,W01001710,1775,1538,237,91,73,63,10
2021,Cardiff 040C,W01001711,2026,1775,251,79,96,68,8
2021,Cardiff 040D,W01001712,1412,1327,85,46,24,11,4
2021,Cardiff 040E,W01001713,1675,1540,135,74,38,20,3
2021,Cardiff 035A,W01001714,1528,1504,24,12,5,5,2
2021,Cardiff 035B,W01001715,1519,1447,72,33,29,7,3
2021,Cardiff 035C,W01001716,1242,1205,37,20,8,7,2
2021,Cardiff 035D,W01001717,1469,1392,77,29,24,24,0
2021,Cardiff 028A,W01001718,1728,1532,196,100,60,32,4
2021,Cardiff 028B,W01001719,1990,1741,249,70,139,35,5
2021,Cardiff 028C,W01001720,2224,2020,204,83,85,33,3
2021,Cardiff 032A,W01001721,2875,2524,351,182,136,32,1
2021,Cardiff 028D,W01001722,1749,1602,147,68,39,31,9
2021,Cardiff 032C,W01001724,2391,2284,107,59,31,16,1
2021,Cardiff 032D,W01001725,2300,2120,180,92,54,30,4
2021,Cardiff 028E,W01001726,1760,1581,179,76,61,35,7
2021,Cardiff 014A,W01001727,1172,1164,8,6,0,2,0
2021,Cardiff 014B,W01001728,1387,1373,14,7,4,2,1
2021,Cardiff 014C,W01001729,2786,2687,99,57,31,9,2
2021,Cardiff 008A,W01001730,1516,1440,76,46,23,6,1
2021,Cardiff 008B,W01001731,1418,1353,65,43,15,7,0
2021,Cardiff 019A,W01001732,1697,1537,160,85,50,22,3
2021,Cardiff 019B,W01001733,1465,1343,122,65,36,19,2
2021,Cardiff 019C,W01001734,1566,1439,127,73,33,15,6
2021,Cardiff 019D,W01001735,1998,1831,167,94,54,18,1
2021,Cardiff 008C,W01001736,1457,1403,54,25,22,4,3
2021,Cardiff 039A,W01001737,1573,1437,136,37,63,31,5
2021,Cardiff 039B,W01001738,1368,1258,110,38,42,24,6
2021,Cardiff 039C,W01001739,1408,1253,155,45,51,54,5
2021,Cardiff 039D,W01001740,1450,1377,73,22,26,21,4
2021,Cardiff 039E,W01001741,1573,1460,113,40,43,25,5
2021,Cardiff 043A,W01001742,1533,1433,100,36,48,13,3
2021,Cardiff 043B,W01001743,1412,1371,41,16,18,5,2
2021,Cardiff 043C,W01001744,1645,1544,101,51,29,21,0
2021,Cardiff 043D,W01001745,1235,1216,19,11,3,5,0
2021,Cardiff 041D,W01001746,1474,1353,121,47,41,27,6
2021,Cardiff 027A,W01001747,1627,1559,68,38,19,8,3
2021,Cardiff 027B,W01001748,1509,1453,56,36,14,6,0
2021,Cardiff 027C,W01001749,1491,1440,51,31,14,6,0
2021,Cardiff 031A,W01001750,1561,1515,46,19,19,7,1
2021,Cardiff 027D,W01001751,1730,1617,113,26,62,25,0
2021,Cardiff 031B,W01001752,1541,1509,32,18,10,4,0
2021,Cardiff 031C,W01001753,1590,1512,78,37,21,19,1
2021,Cardiff 031D,W01001754,1564,1539,25,15,6,3,1
2021,Cardiff 025A,W01001755,1451,1306,145,74,37,30,4
2021,Cardiff 025B,W01001756,4206,3900,306,149,114,42,1
2021,Cardiff 025C,W01001757,1422,1260,162,101,44,11,6
2021,Cardiff 025D,W01001758,2137,1914,223,108,66,41,8
2021,Cardiff 046A,W01001759,1531,1336,195,74,61,48,12
2021,Cardiff 046B,W01001760,1596,1385,211,61,76,70,4
2021,Cardiff 046C,W01001761,1711,1375,336,118,131,65,22
2021,Cardiff 046D,W01001762,1754,1447,307,98,119,76,14
2021,Cardiff 044A,W01001764,1959,1556,403,155,126,108,14
2021,Cardiff 044B,W01001765,1390,1129,261,107,74,71,9
2021,Cardiff 044C,W01001766,1627,1263,364,115,149,85,15
2021,Cardiff 044D,W01001767,1756,1294,462,163,142,137,20
2021,Cardiff 044E,W01001768,1606,1221,385,145,134,91,15
2021,Cardiff 018A,W01001769,1539,1504,35,26,5,3,1
2021,Cardiff 018B,W01001770,1013,948,65,39,16,10,0
2021,Cardiff 018C,W01001771,1611,1558,53,34,13,6,0
2021,Cardiff 021A,W01001772,1361,1317,44,28,13,0,3
2021,Cardiff 012A,W01001773,2462,2252,210,113,61,33,3
2021,Cardiff 018D,W01001774,1359,1318,41,22,13,6,0
2021,Cardiff 021B,W01001775,1549,1478,71,41,23,7,0
2021,Cardiff 021C,W01001776,1258,1207,51,30,16,5,0
2021,Cardiff 001A,W01001777,1715,1665,50,30,12,7,1
2021,Cardiff 001B,W01001778,1714,1679,35,25,4,5,1
2021,Cardiff 026A,W01001779,1473,1423,50,32,15,2,1
2021,Cardiff 026B,W01001780,1606,1551,55,32,15,6,2
2021,Cardiff 026C,W01001781,1639,1597,42,22,11,8,1
2021,Cardiff 026D,W01001782,1416,1395,21,17,1,3,0
2021,Cardiff 026E,W01001783,1184,1161,23,9,8,6,0
2021,Cardiff 026F,W01001784,1281,1223,58,22,21,15,0
2021,Cardiff 023A,W01001785,1165,1082,83,39,22,20,2
2021,Cardiff 023B,W01001786,1439,1399,40,17,12,8,3
2021,Cardiff 023C,W01001787,1343,1221,122,70,32,19,1
2021,Cardiff 023D,W01001788,1538,1381,157,58,56,38,5
2021,Cardiff 023E,W01001789,1495,1463,32,15,8,7,2
2021,Cardiff 023F,W01001790,1178,1126,52,19,15,18,0
2021,Cardiff 005A,W01001791,1772,1738,34,14,12,7,1
2021,Cardiff 005B,W01001792,1565,1472,93,39,35,16,3
2021,Cardiff 002A,W01001793,1315,1289,26,7,11,6,2
2021,Cardiff 001C,W01001794,1297,1258,39,22,10,7,0
2021,Cardiff 002B,W01001795,1456,1388,68,38,22,7,1
2021,Cardiff 002C,W01001796,1392,1324,68,34,22,9,3
2021,Cardiff 005C,W01001797,1389,1335,54,28,16,10,0
2021,Cardiff 002D,W01001798,1359,1335,24,17,4,3,0
2021,Cardiff 001D,W01001799,1241,1223,18,11,6,0,1
2021,Cardiff 005D,W01001800,1371,1334,37,19,14,3,1
2021,Cardiff 007A,W01001802,1656,1588,68,24,29,14,1
2021,Cardiff 015A,W01001803,1617,1525,92,47,28,15,2
2021,Cardiff 015B,W01001804,1539,1414,125,56,41,23,5
2021,Cardiff 015C,W01001805,1495,1408,87,57,19,11,0
2021,Cardiff 015D,W01001806,1666,1580,86,35,35,13,3
2021,Cardiff 007B,W01001807,1592,1468,124,44,46,25,9
2021,Cardiff 007C,W01001808,1659,1538,121,43,45,27,6
2021,Cardiff 017A,W01001809,1185,1125,60,30,21,8,1
2021,Cardiff 017B,W01001810,1682,1507,175,59,71,39,6
2021,Cardiff 009A,W01001811,1519,1345,174,68,58,46,2
2021,Cardiff 017C,W01001812,1236,1154,82,38,26,14,4
2021,Cardiff 017D,W01001813,1773,1593,180,64,77,33,6
2021,Cardiff 017E,W01001814,1399,1308,91,48,31,8,4
2021,Cardiff 008D,W01001815,1351,1275,76,40,23,12,1
2021,Cardiff 009B,W01001816,2672,2384,288,132,103,43,10
2021,Cardiff 009C,W01001817,1346,1281,65,40,18,7,0
2021,Cardiff 009D,W01001818,1503,1314,189,104,58,23,4
2021,Cardiff 014D,W01001819,2327,2299,28,20,7,1,0
2021,Cardiff 006A,W01001820,1170,1148,22,10,3,9,0
2021,Cardiff 024A,W01001821,1693,1602,91,52,24,13,2
2021,Cardiff 029A,W01001822,1796,1632,164,84,55,22,3
2021,Cardiff 029B,W01001823,1232,1176,56,23,15,16,2
2021,Cardiff 029C,W01001824,1511,1366,145,74,38,26,7
2021,Cardiff 029D,W01001825,1909,1720,189,77,67,39,6
2021,Cardiff 024B,W01001826,1342,1246,96,45,38,13,0
2021,Cardiff 024C,W01001827,1608,1477,131,61,47,20,3
2021,Cardiff 024D,W01001828,1473,1417,56,20,23,11,2
2021,Cardiff 033A,W01001829,1963,1570,393,198,115,65,15
2021,Cardiff 033B,W01001830,1595,1297,298,125,105,63,5
2021,Cardiff 030A,W01001831,1457,1270,187,101,55,29,2
2021,Cardiff 033C,W01001832,1742,1416,326,167,95,34,30
2021,Cardiff 033D,W01001833,1498,1348,150,75,52,18,5
2021,Cardiff 033E,W01001834,1609,1317,292,109,108,61,14
2021,Cardiff 033F,W01001835,2160,1752,408,200,161,42,5
2021,Cardiff 030B,W01001836,1301,1131,170,75,59,30,6
2021,Cardiff 030C,W01001837,1439,1252,187,83,62,35,7
2021,Cardiff 030D,W01001838,1595,1450,145,55,53,33,4
2021,Cardiff 030E,W01001839,1554,1366,188,78,51,44,15
2021,Cardiff 007D,W01001840,1887,1808,79,38,21,18,2
2021,Cardiff 003A,W01001841,1859,1757,102,66,22,11,3
2021,Cardiff 003B,W01001842,1697,1537,160,70,49,36,5
2021,Cardiff 003D,W01001844,1833,1708,125,54,36,34,1
2021,Cardiff 006C,W01001846,1699,1671,28,19,7,2,0
2021,Cardiff 006D,W01001847,1506,1481,25,20,4,1,0
2021,Cardiff 012B,W01001848,1416,1393,23,16,4,3,0
2021,Cardiff 004A,W01001849,1518,1500,18,10,6,2,0
2021,Cardiff 012C,W01001850,1869,1855,14,7,4,2,1
2021,Cardiff 012D,W01001851,1520,1475,45,30,8,5,2
2021,Cardiff 004B,W01001852,1826,1808,18,8,5,3,2
2021,Cardiff 004C,W01001853,1568,1540,28,8,13,7,0
2021,Cardiff 004D,W01001854,1500,1465,35,13,11,10,1
2021,Cardiff 042A,W01001855,1726,1239,487,171,168,122,26
2021,Cardiff 042B,W01001856,1660,1134,526,181,172,135,38
2021,Cardiff 042C,W01001857,2013,1553,460,193,143,107,17
2021,Cardiff 034A,W01001858,1554,1490,64,45,14,4,1
2021,Cardiff 034B,W01001859,1464,1405,59,39,13,7,0
2021,Cardiff 034C,W01001860,1615,1514,101,63,24,12,2
2021,Cardiff 034D,W01001861,1501,1359,142,74,43,20,5
2021,Cardiff 042D,W01001862,1805,1371,434,139,168,103,24
2021,Cardiff 022A,W01001863,1457,1401,56,27,17,9,3
2021,Cardiff 022B,W01001864,1435,1384,51,21,17,13,0
2021,Cardiff 022C,W01001865,1255,1218,37,12,13,10,2
2021,Cardiff 016A,W01001866,1520,1441,79,28,36,10,5
2021,Cardiff 016B,W01001867,1367,1237,130,72,40,14,4
2021,Cardiff 022D,W01001868,1470,1394,76,38,23,11,4
2021,Cardiff 038A,W01001869,1347,1245,102,42,38,17,5
2021,Cardiff 037A,W01001870,1404,1302,102,46,33,23,0
2021,Cardiff 037B,W01001871,1586,1438,148,67,57,18,6
2021,Cardiff 038B,W01001872,1554,1355,199,84,65,47,3
2021,Cardiff 038C,W01001873,1759,1518,241,99,69,59,14
2021,Cardiff 038D,W01001874,1467,1244,223,68,77,59,19
2021,Cardiff 037D,W01001876,1572,1367,205,83,73,40,9
2021,Cardiff 011A,W01001877,1771,1657,114,65,32,14,3
2021,Cardiff 011B,W01001878,1521,1408,113,59,45,8,1
2021,Cardiff 013A,W01001879,1831,1658,173,82,61,27,3
2021,Cardiff 013B,W01001880,1585,1438,147,55,37,51,4
2021,Cardiff 013C,W01001881,1422,1330,92,35,44,11,2
2021,Cardiff 011C,W01001882,1679,1601,78,36,30,9,3
2021,Cardiff 016C,W01001883,1608,1514,94,40,42,10,2
2021,Cardiff 013D,W01001884,1376,1244,132,38,43,48,3
2021,Cardiff 011D,W01001885,2496,2293,203,89,64,38,12
2021,Cardiff 016D,W01001886,1275,1207,68,27,29,11,1
2021,Cardiff 020A,W01001887,1579,1549,30,16,11,3,0
2021,Cardiff 010A,W01001888,1604,1568,36,20,13,3,0
2021,Cardiff 020B,W01001889,1432,1394,38,22,11,2,3
2021,Cardiff 021D,W01001890,1522,1471,51,27,12,8,4
2021,Cardiff 020C,W01001891,1586,1551,35,22,8,5,0
2021,Cardiff 020D,W01001892,1386,1365,21,14,5,2,0
2021,Cardiff 010B,W01001893,1783,1738,45,19,15,8,3
2021,Cardiff 010C,W01001894,1483,1471,12,8,4,0,0
2021,Cardiff 010D,W01001895,1587,1487,100,50,28,20,2
2021,Cardiff 020E,W01001896,1418,1396,22,8,6,8,0
2021,Powys 020D,W01001897,1831,1823,8,8,0,0,0
2021,Merthyr Tydfil 008F,W01001898,1427,1408,19,8,7,4,0
2021,Powys 021F,W01001899,2137,2122,15,4,7,3,1
2021,Neath Port Talbot 020G,W01001900,1373,1361,12,6,4,2,0
2021,Powys 017F,W01001901,1773,1688,85,35,39,8,3
2021,Powys 017G,W01001902,1344,1306,38,10,17,8,3
2021,Powys 018F,W01001903,2066,2033,33,14,12,6,1
2021,Powys 018G,W01001904,1614,1592,22,7,14,1,0
2021,Powys 018H,W01001905,2107,2098,9,6,1,2,0
2021,Powys 001F,W01001906,1907,1897,10,7,1,0,2
2021,Powys 001G,W01001907,1345,1334,11,6,4,1,0
2021,Monmouthshire 010G,W01001908,2073,2043,30,16,9,3,2
2021,Vale of Glamorgan 012G,W01001910,1602,1549,53,25,14,13,1
2021,Vale of Glamorgan 012H,W01001911,1102,1088,14,6,4,3,1
2021,Newport 020E,W01001912,1485,1452,33,17,15,1,0
2021,Newport 020F,W01001913,1409,1328,81,41,25,10,5
2021,Rhondda Cynon Taf 023F,W01001914,1870,1862,8,2,2,4,0
2021,Rhondda Cynon Taf 027F,W01001915,1599,1589,10,2,4,2,2
2021,Rhondda Cynon Taf 027G,W01001916,1448,1428,20,16,2,2,0
2021,Rhondda Cynon Taf 023G,W01001917,1426,1401,25,11,7,7,0
2021,Bridgend 017E,W01001918,1818,1770,48,29,14,4,1
2021,Bridgend 017F,W01001919,1331,1303,28,11,11,6,0
2021,Bridgend 017G,W01001920,1168,1146,22,14,7,0,1
2021,Bridgend 017H,W01001921,1479,1446,33,15,14,4,0
2021,Cardiff 032E,W01001922,2009,1811,198,105,65,27,1
2021,Carmarthenshire 026G,W01001923,1689,1643,46,20,14,9,3
2021,Carmarthenshire 026H,W01001924,1324,1239,85,16,30,27,12
2021,Carmarthenshire 023F,W01001925,2139,2123,16,12,3,1,0
2021,Conwy 011F,W01001926,2063,2051,12,6,3,3,0
2021,Conwy 010G,W01001927,1312,1300,12,5,2,3,2
2021,Conwy 010H,W01001928,1058,1043,15,5,9,0,1
2021,Wrexham 012F,W01001929,1132,809,323,68,138,105,12
2021,Wrexham 019F,W01001930,2026,2003,23,15,5,3,0
2021,Wrexham 012G,W01001931,1367,1017,350,81,158,92,19
2021,Gwynedd 014E,W01001932,2691,2671,20,11,7,2,0
2021,Gwynedd 017F,W01001933,1878,1868,10,3,6,0,1
2021,Ceredigion 003E,W01001935,1003,932,71,43,24,3,1
2021,Ceredigion 003F,W01001936,1434,1314,120,81,32,7,0
2021,Ceredigion 001F,W01001937,1916,1901,15,10,3,2,0
2021,Cardiff 048A,W01001940,1029,879,150,89,44,17,0
2021,Cardiff 049B,W01001942,1536,1326,210,92,71,40,7
2021,Cardiff 048B,W01001943,1163,955,208,109,67,28,4
2021,Cardiff 048C,W01001944,1152,973,179,121,38,18,2
2021,Cardiff 049C,W01001946,1283,1066,217,89,81,33,14
2021,Cardiff 048E,W01001947,1656,1397,259,121,100,34,4
2021,Cardiff 006E,W01001948,2187,2102,85,55,19,10,1
2021,Cardiff 005F,W01001949,1266,1149,117,57,32,19,9
2021,Cardiff 049D,W01001950,1131,910,221,139,66,13,3
2021,Cardiff 049E,W01001951,1498,1289,209,108,79,13,9
2021,Cardiff 049F,W01001952,1850,1494,356,149,155,48,4
2021,Cardiff 005G,W01001953,1457,1398,59,23,22,10,4
2021,Cardiff 006F,W01001954,1498,1468,30,22,2,5,1
2021,Swansea 025F,W01001955,1904,1586,318,153,101,55,9
2021,Swansea 032C,W01001956,2196,2094,102,66,30,3,3
2021,Swansea 025H,W01001958,1286,1117,169,76,75,13,5
2021,Merthyr Tydfil 005E,W01001959,1501,1459,42,13,20,4,5
2021,Merthyr Tydfil 005F,W01001960,1395,1359,36,14,12,6,4
2021,Merthyr Tydfil 006G,W01001961,2281,2261,20,10,6,3,1
2021,Rhondda Cynon Taf 011E,W01001962,2391,2384,7,3,4,0,0
2021,Rhondda Cynon Taf 014H,W01001963,2188,2164,24,9,6,7,2
2021,Rhondda Cynon Taf 021H,W01001964,2196,2120,76,34,25,16,1
2021,Rhondda Cynon Taf 029E,W01001965,1653,1631,22,10,8,4,0
2021,Rhondda Cynon Taf 029F,W01001966,1650,1637,13,3,6,4,0
2021,Rhondda Cynon Taf 031G,W01001967,1452,1431,21,15,5,1,0
2021,Rhondda Cynon Taf 031H,W01001968,1438,1420,18,5,12,1,0
2021,Wrexham 010F,W01001969,2210,2023,187,55,84,42,6
2021,Wrexham 021C,W01001970,2112,2092,20,12,3,5,0
2021,Wrexham 022D,W01001971,2639,2601,38,15,12,7,4
2021,Wrexham 022E,W01001972,1271,1216,55,26,19,8,2
2021,Blaenau Gwent 009F,W01001973,2190,2141,49,14,25,10,0
2021,Monmouthshire 002G,W01001974,1369,1332,37,16,14,5,2
2021,Monmouthshire 002H,W01001975,1269,1261,8,8,0,0,0
2021,Monmouthshire 003F,W01001976,1570,1561,9,7,2,0,0
2021,Monmouthshire 003G,W01001977,1405,1395,10,3,6,1,0
2021,Monmouthshire 004G,W01001978,1454,1431,23,19,1,3,0
2021,Monmouthshire 004H,W01001979,1967,1922,45,26,12,6,1
2021,Monmouthshire 005F,W01001980,2154,2123,31,18,9,3,1
2021,Bridgend 011D,W01001981,2891,2811,80,31,25,20,4
2021,Bridgend 011E,W01001982,1269,1237,32,21,9,2,0
2021,Bridgend 011F,W01001983,1404,1377,27,16,8,1,2
2021,Bridgend 011G,W01001984,1135,1084,51,28,13,10,0
2021,Neath Port Talbot 006F,W01001985,2005,1991,14,11,2,0,1
2021,Neath Port Talbot 007E,W01001986,2384,2371,13,7,3,0,3
2021,Neath Port Talbot 010G,W01001987,1439,1422,17,10,3,4,0
2021,Neath Port Talbot 010H,W01001988,1408,1391,17,12,3,2,0
2021,Neath Port Talbot 010I,W01001989,3364,3174,190,137,45,8,0
2021,Neath Port Talbot 021E,W01001990,2085,2077,8,3,4,0,1
2021,Swansea 005G,W01001991,1360,1329,31,6,7,16,2
2021,Swansea 005H,W01001992,1381,1349,32,12,8,11,1
2021,Swansea 006E,W01001993,1643,1610,33,21,11,1,0
2021,Swansea 006F,W01001994,1427,1410,17,12,4,1,0
2021,Swansea 021E,W01001995,1329,1195,134,63,37,33,1
2021,Swansea 021F,W01001996,1385,1160,225,116,87,18,4
2021,Swansea 025I,W01001997,1958,1701,257,131,90,35,1
2021,Vale of Glamorgan 015G,W01001998,2157,2119,38,18,14,5,1
2021,Carmarthenshire 019F,W01001999,2427,2407,20,11,7,2,0
2021,Ceredigion 002G,W01002000,2895,2736,159,112,37,10,0
2021,Ceredigion 002H,W01002001,1403,1283,120,85,30,5,0
2021,Ceredigion 007E,W01002002,4231,4199,32,15,10,7,0
2021,Gwynedd 013E,W01002003,2337,2331,6,3,3,0,0
2021,Gwynedd 016F,W01002004,2097,2060,37,17,11,7,2
2021,Isle of Anglesey 002E,W01002005,2190,2188,2,1,1,0,0
2021,Isle of Anglesey 004G,W01002007,2162,2160,2,0,1,0,1
2021,Isle of Anglesey 007F,W01002008,2047,2033,14,10,4,0,0
2021,Pembrokeshire 005E,W01002009,1174,1116,58,22,17,14,5
2021,Pembrokeshire 005F,W01002010,1075,1043,32,8,12,10,2
2021,Pembrokeshire 010D,W01002011,1530,1512,18,12,2,4,0
2021,Pembrokeshire 010E,W01002012,1393,1363,30,12,4,10,4
2021,Pembrokeshire 011G,W01002013,2322,2278,44,21,13,9,1
2021,Pembrokeshire 016E,W01002014,2049,1994,55,29,17,7,2
2021,Cardiff 003E,W01002016,1156,1075,81,60,12,7,2
2021,Cardiff 003F,W01002017,1297,1191,106,70,27,7,2
2021,Cardiff 003G,W01002018,1479,1364,115,51,38,23,3
2021,Cardiff 032H,W01002019,2584,1585,999,442,434,115,8
2021,Cardiff 037E,W01002020,1502,1319,183,70,97,12,4
2021,Cardiff 037F,W01002021,1442,1203,239,82,96,56,5
2021,Cardiff 040F,W01002022,1150,1062,88,50,25,10,3
2021,Cardiff 040G,W01002023,1750,1614,136,50,48,33,5
2021,Cardiff 048F,W01002024,1089,927,162,92,52,16,2
2021,Cardiff 048G,W01002025,1073,943,130,68,42,17,3
2021,Newport 004F,W01002026,1745,1650,95,51,34,7,3
2021,Newport 004G,W01002027,1734,1677,57,33,11,12,1
2021,Newport 009F,W01002028,1891,1846,45,24,18,1,2
2021,Newport 009G,W01002029,1635,1556,79,44,21,11,3
2021,Newport 013F,W01002030,1358,1163,195,85,78,27,5
2021,Newport 013G,W01002031,1605,1328,277,123,115,33,6
2021,Newport 015H,W01002032,1244,1210,34,14,17,3,0
2021,Newport 015I,W01002033,1332,1245,87,40,36,11,0
2021,Newport 019E,W01002034,1631,1497,134,59,43,32,0
2021,Newport 019F,W01002035,1526,1405,121,47,42,28,4
2021,Vale of Glamorgan 005G,W01002036,1505,1450,55,35,14,5,1
2021,Vale of Glamorgan 005H,W01002037,1041,992,49,31,16,0,2
2021,Vale of Glamorgan 014G,W01002038,1239,1235,4,4,0,0,0
2021,Vale of Glamorgan 014H,W01002039,1681,1660,21,19,0,1,1
2021,Vale of Glamorgan 015F,W01002040,1822,1762,60,34,22,2,2
