date,geography,geography code,Schoolchild or full-time student indicator: Total: All usual residents aged 5 years and over,Schoolchild or full-time student indicator: Student,Schoolchild or full-time student indicator: Not a student
2021,City of London 001A,E01000001,1423,154,1269
2021,City of London 001B,E01000002,1351,141,1210
2021,City of London 001C,E01000003,1574,138,1436
2021,City of London 001E,E01000005,1050,252,798
2021,Barking and Dagenham 016A,E01000006,1692,416,1276
2021,Barking and Dagenham 015A,E01000007,2643,771,1872
2021,Barking and Dagenham 015B,E01000008,1673,631,1042
2021,Barking and Dagenham 016B,E01000009,1661,395,1266
2021,Barking and Dagenham 016C,E01000011,1588,442,1146
2021,Barking and Dagenham 015D,E01000012,2074,693,1381
2021,Barking and Dagenham 013A,E01000013,1754,476,1278
2021,Barking and Dagenham 013B,E01000014,1622,419,1203
2021,Barking and Dagenham 009A,E01000015,2203,659,1544
2021,Barking and Dagenham 009B,E01000016,1731,478,1253
2021,Barking and Dagenham 009C,E01000017,1619,441,1178
2021,Barking and Dagenham 009D,E01000018,1660,435,1225
2021,Barking and Dagenham 023A,E01000019,1537,481,1056
2021,Barking and Dagenham 023B,E01000020,2030,588,1442
2021,Barking and Dagenham 008A,E01000021,1563,452,1111
2021,Barking and Dagenham 008B,E01000022,1380,408,972
2021,Barking and Dagenham 008D,E01000024,1385,374,1011
2021,Barking and Dagenham 008E,E01000025,1783,476,1307
2021,Barking and Dagenham 001A,E01000027,1914,591,1323
2021,Barking and Dagenham 001B,E01000028,1686,524,1162
2021,Barking and Dagenham 001C,E01000029,1711,402,1309
2021,Barking and Dagenham 001D,E01000030,2318,795,1523
2021,Barking and Dagenham 002A,E01000031,1649,383,1266
2021,Barking and Dagenham 002B,E01000032,1901,450,1451
2021,Barking and Dagenham 006A,E01000033,1444,426,1018
2021,Barking and Dagenham 003A,E01000034,1493,354,1139
2021,Barking and Dagenham 010A,E01000035,1737,452,1285
2021,Barking and Dagenham 010B,E01000036,1383,342,1041
2021,Barking and Dagenham 003B,E01000037,1608,308,1300
2021,Barking and Dagenham 003C,E01000038,1520,321,1199
2021,Barking and Dagenham 003D,E01000039,1623,361,1262
2021,Barking and Dagenham 019A,E01000040,1706,484,1222
2021,Barking and Dagenham 017A,E01000041,1720,496,1224
2021,Barking and Dagenham 017B,E01000042,1708,531,1177
2021,Barking and Dagenham 019B,E01000043,1456,399,1057
2021,Barking and Dagenham 016D,E01000044,1833,513,1320
2021,Barking and Dagenham 017C,E01000045,1584,444,1140
2021,Barking and Dagenham 017D,E01000046,1810,508,1302
2021,Barking and Dagenham 021C,E01000049,1807,714,1093
2021,Barking and Dagenham 019C,E01000050,1688,489,1199
2021,Barking and Dagenham 021D,E01000051,971,288,683
2021,Barking and Dagenham 019D,E01000052,2130,596,1534
2021,Barking and Dagenham 020A,E01000053,1480,361,1119
2021,Barking and Dagenham 018A,E01000054,1725,495,1230
2021,Barking and Dagenham 018B,E01000055,1579,428,1151
2021,Barking and Dagenham 018C,E01000056,1581,420,1161
2021,Barking and Dagenham 012A,E01000057,1442,423,1019
2021,Barking and Dagenham 018D,E01000058,1985,623,1362
2021,Barking and Dagenham 013C,E01000059,1582,413,1169
2021,Barking and Dagenham 006B,E01000060,2011,638,1373
2021,Barking and Dagenham 006C,E01000061,1764,536,1228
2021,Barking and Dagenham 006D,E01000062,2071,573,1498
2021,Barking and Dagenham 004A,E01000063,1653,444,1209
2021,Barking and Dagenham 006E,E01000064,2124,579,1545
2021,Barking and Dagenham 007A,E01000065,1860,480,1380
2021,Barking and Dagenham 011A,E01000066,2381,806,1575
2021,Barking and Dagenham 011B,E01000067,2068,599,1469
2021,Barking and Dagenham 016E,E01000068,1697,405,1292
2021,Barking and Dagenham 011C,E01000069,1958,468,1490
2021,Barking and Dagenham 011D,E01000070,1927,475,1452
2021,Barking and Dagenham 011E,E01000071,2438,684,1754
2021,Barking and Dagenham 017E,E01000072,1973,576,1397
2021,Barking and Dagenham 012B,E01000073,1716,492,1224
2021,Barking and Dagenham 012C,E01000074,1625,486,1139
2021,Barking and Dagenham 012D,E01000075,1889,488,1401
2021,Barking and Dagenham 012E,E01000076,2026,555,1471
2021,Barking and Dagenham 008F,E01000077,1585,412,1173
2021,Barking and Dagenham 007B,E01000078,1749,530,1219
2021,Barking and Dagenham 009E,E01000079,1587,425,1162
2021,Barking and Dagenham 007C,E01000080,1671,453,1218
2021,Barking and Dagenham 007D,E01000081,1841,509,1332
2021,Barking and Dagenham 007E,E01000082,1788,489,1299
2021,Barking and Dagenham 007F,E01000083,1787,541,1246
2021,Barking and Dagenham 013D,E01000084,1354,372,982
2021,Barking and Dagenham 013E,E01000085,1536,425,1111
2021,Barking and Dagenham 013F,E01000086,1345,383,962
2021,Barking and Dagenham 020B,E01000087,1536,466,1070
2021,Barking and Dagenham 020C,E01000088,1844,542,1302
2021,Barking and Dagenham 020D,E01000089,1699,570,1129
2021,Barking and Dagenham 020E,E01000090,1576,515,1061
2021,Barking and Dagenham 022A,E01000091,1952,659,1293
2021,Barking and Dagenham 022B,E01000093,1652,488,1164
2021,Barking and Dagenham 022C,E01000094,2219,748,1471
2021,Barking and Dagenham 018E,E01000095,1961,592,1369
2021,Barking and Dagenham 022D,E01000096,1525,616,909
2021,Barking and Dagenham 023C,E01000097,1808,510,1298
2021,Barking and Dagenham 023D,E01000098,1771,534,1237
2021,Barking and Dagenham 023E,E01000099,2542,733,1809
2021,Barking and Dagenham 004B,E01000100,1767,484,1283
2021,Barking and Dagenham 004C,E01000101,1583,403,1180
2021,Barking and Dagenham 007G,E01000102,1655,488,1167
2021,Barking and Dagenham 014A,E01000103,1656,486,1170
2021,Barking and Dagenham 014B,E01000104,1757,515,1242
2021,Barking and Dagenham 014C,E01000105,2148,550,1598
2021,Barking and Dagenham 014D,E01000106,1987,566,1421
2021,Barking and Dagenham 010C,E01000107,1665,427,1238
2021,Barking and Dagenham 010D,E01000108,1737,437,1300
2021,Barking and Dagenham 002C,E01000110,1469,364,1105
2021,Barking and Dagenham 002D,E01000111,1942,503,1439
2021,Barking and Dagenham 002E,E01000112,1773,421,1352
2021,Barking and Dagenham 002F,E01000113,1856,515,1341
2021,Barking and Dagenham 004E,E01000114,2209,699,1510
2021,Barnet 009A,E01000115,1343,261,1082
2021,Barnet 009B,E01000116,1659,415,1244
2021,Barnet 010A,E01000117,1643,321,1322
2021,Barnet 010B,E01000118,1960,446,1514
2021,Barnet 009C,E01000119,1729,378,1351
2021,Barnet 009D,E01000120,1455,325,1130
2021,Barnet 010C,E01000121,1415,332,1083
2021,Barnet 009E,E01000122,1447,344,1103
2021,Barnet 010D,E01000123,1658,298,1360
2021,Barnet 010E,E01000124,1755,412,1343
2021,Barnet 026A,E01000126,2135,551,1584
2021,Barnet 024B,E01000127,1456,371,1085
2021,Barnet 024C,E01000128,1938,524,1414
2021,Barnet 024D,E01000129,1517,383,1134
2021,Barnet 021A,E01000130,1822,417,1405
2021,Barnet 024E,E01000131,1859,399,1460
2021,Barnet 021B,E01000132,1490,406,1084
2021,Barnet 021C,E01000133,1551,397,1154
2021,Barnet 024F,E01000134,1673,452,1221
2021,Barnet 038A,E01000135,1601,332,1269
2021,Barnet 038B,E01000136,1427,346,1081
2021,Barnet 041A,E01000137,1556,420,1136
2021,Barnet 040A,E01000138,1535,310,1225
2021,Barnet 041B,E01000139,1326,270,1056
2021,Barnet 041C,E01000140,1843,382,1461
2021,Barnet 039A,E01000141,1767,347,1420
2021,Barnet 040B,E01000142,2089,434,1655
2021,Barnet 041D,E01000143,1502,384,1118
2021,Barnet 038C,E01000144,1557,362,1195
2021,Barnet 037A,E01000145,1507,468,1039
2021,Barnet 038D,E01000146,1794,356,1438
2021,Barnet 043F,E01000147,1805,357,1448
2021,Barnet 036A,E01000150,2115,500,1615
2021,Barnet 026B,E01000151,1579,588,991
2021,Barnet 026C,E01000152,2456,699,1757
2021,Barnet 026D,E01000153,1797,485,1312
2021,Barnet 026E,E01000154,1779,416,1363
2021,Barnet 022A,E01000156,1912,511,1401
2021,Barnet 022B,E01000157,1483,346,1137
2021,Barnet 015A,E01000158,1394,315,1079
2021,Barnet 015B,E01000159,1707,370,1337
2021,Barnet 015C,E01000160,1843,401,1442
2021,Barnet 015D,E01000161,1907,414,1493
2021,Barnet 015E,E01000162,1580,332,1248
2021,Barnet 022C,E01000163,1571,348,1223
2021,Barnet 022D,E01000164,1605,406,1199
2021,Barnet 022E,E01000165,1699,377,1322
2021,Barnet 003A,E01000166,1512,284,1228
2021,Barnet 002A,E01000167,1316,297,1019
2021,Barnet 003B,E01000168,1464,274,1190
2021,Barnet 003C,E01000169,1535,298,1237
2021,Barnet 006A,E01000170,1793,430,1363
2021,Barnet 006B,E01000171,2042,431,1611
2021,Barnet 003D,E01000172,1539,366,1173
2021,Barnet 006C,E01000173,1607,424,1183
2021,Barnet 006D,E01000174,1638,358,1280
2021,Barnet 006E,E01000175,1852,422,1430
2021,Barnet 027A,E01000176,1645,304,1341
2021,Barnet 029A,E01000177,1551,350,1201
2021,Barnet 027B,E01000178,1587,381,1206
2021,Barnet 029B,E01000179,1610,305,1305
2021,Barnet 029C,E01000180,1528,329,1199
2021,Barnet 029D,E01000181,1620,295,1325
2021,Barnet 029E,E01000182,1552,297,1255
2021,Barnet 033A,E01000183,1424,295,1129
2021,Barnet 027C,E01000184,1785,510,1275
2021,Barnet 029F,E01000185,1421,309,1112
2021,Barnet 014A,E01000186,1658,456,1202
2021,Barnet 014B,E01000187,1601,443,1158
2021,Barnet 014C,E01000188,1504,403,1101
2021,Barnet 014D,E01000189,2251,510,1741
2021,Barnet 014E,E01000190,1649,415,1234
2021,Barnet 014F,E01000191,1464,377,1087
2021,Barnet 018A,E01000192,1855,417,1438
2021,Barnet 018B,E01000193,1838,397,1441
2021,Barnet 018C,E01000194,1782,470,1312
2021,Barnet 013A,E01000195,1896,541,1355
2021,Barnet 028A,E01000196,2005,281,1724
2021,Barnet 023A,E01000197,1734,328,1406
2021,Barnet 025A,E01000198,2021,548,1473
2021,Barnet 025B,E01000199,1492,307,1185
2021,Barnet 028B,E01000200,1864,355,1509
2021,Barnet 028C,E01000201,1473,348,1125
2021,Barnet 028D,E01000202,1570,321,1249
2021,Barnet 028E,E01000203,1736,398,1338
2021,Barnet 025C,E01000204,1616,325,1291
2021,Barnet 035A,E01000205,1395,301,1094
2021,Barnet 033B,E01000206,1458,340,1118
2021,Barnet 033C,E01000207,1502,330,1172
2021,Barnet 033D,E01000208,1525,308,1217
2021,Barnet 035B,E01000209,1387,211,1176
2021,Barnet 033E,E01000210,1440,359,1081
2021,Barnet 035C,E01000211,1986,422,1564
2021,Barnet 035D,E01000212,1293,255,1038
2021,Barnet 033F,E01000213,1281,362,919
2021,Barnet 038E,E01000214,1556,296,1260
2021,Barnet 037B,E01000215,1886,607,1279
2021,Barnet 035E,E01000216,1830,555,1275
2021,Barnet 035F,E01000217,1618,470,1148
2021,Barnet 037C,E01000218,1674,509,1165
2021,Barnet 037D,E01000219,1938,582,1356
2021,Barnet 037E,E01000220,1681,412,1269
2021,Barnet 039B,E01000221,1322,402,920
2021,Barnet 040C,E01000222,1925,500,1425
2021,Barnet 039C,E01000223,1906,525,1381
2021,Barnet 040D,E01000224,1592,410,1182
2021,Barnet 037F,E01000225,1722,629,1093
2021,Barnet 018D,E01000226,1648,435,1213
2021,Barnet 018E,E01000227,1773,402,1371
2021,Barnet 007A,E01000228,1390,362,1028
2021,Barnet 013B,E01000229,1577,388,1189
2021,Barnet 013C,E01000230,1784,442,1342
2021,Barnet 013D,E01000231,1694,425,1269
2021,Barnet 013E,E01000232,1779,398,1381
2021,Barnet 013F,E01000233,1802,390,1412
2021,Barnet 021D,E01000234,1651,372,1279
2021,Barnet 021E,E01000235,1768,465,1303
2021,Barnet 034A,E01000236,1716,482,1234
2021,Barnet 032A,E01000237,1960,550,1410
2021,Barnet 034B,E01000238,1924,643,1281
2021,Barnet 031A,E01000239,1920,436,1484
2021,Barnet 031B,E01000240,1639,345,1294
2021,Barnet 031C,E01000241,1689,420,1269
2021,Barnet 032B,E01000242,1496,410,1086
2021,Barnet 032C,E01000243,2014,529,1485
2021,Barnet 032D,E01000244,1563,461,1102
2021,Barnet 032E,E01000245,1927,455,1472
2021,Barnet 002B,E01000246,1435,247,1188
2021,Barnet 002C,E01000247,1591,305,1286
2021,Barnet 001A,E01000248,1594,283,1311
2021,Barnet 001B,E01000249,1521,279,1242
2021,Barnet 001C,E01000250,2473,469,2004
2021,Barnet 002D,E01000251,2122,467,1655
2021,Barnet 002E,E01000252,1619,277,1342
2021,Barnet 007B,E01000253,1857,374,1483
2021,Barnet 001D,E01000254,1535,306,1229
2021,Barnet 017A,E01000255,1609,396,1213
2021,Barnet 016A,E01000256,1799,467,1332
2021,Barnet 017B,E01000257,1932,385,1547
2021,Barnet 016B,E01000258,1784,314,1470
2021,Barnet 025D,E01000259,2464,562,1902
2021,Barnet 025E,E01000260,1994,445,1549
2021,Barnet 017C,E01000261,1698,461,1237
2021,Barnet 016C,E01000263,1421,334,1087
2021,Barnet 016D,E01000264,1679,347,1332
2021,Barnet 011A,E01000265,1787,400,1387
2021,Barnet 011B,E01000266,1369,281,1088
2021,Barnet 005A,E01000267,1441,272,1169
2021,Barnet 005B,E01000268,1930,399,1531
2021,Barnet 005C,E01000269,1322,256,1066
2021,Barnet 005D,E01000270,1460,291,1169
2021,Barnet 008A,E01000271,1558,289,1269
2021,Barnet 008B,E01000272,1367,254,1113
2021,Barnet 008C,E01000273,1580,242,1338
2021,Barnet 011C,E01000274,1838,455,1383
2021,Barnet 012A,E01000275,1644,292,1352
2021,Barnet 020A,E01000276,1451,400,1051
2021,Barnet 012B,E01000277,1553,288,1265
2021,Barnet 020B,E01000278,1402,356,1046
2021,Barnet 007C,E01000279,1321,270,1051
2021,Barnet 007D,E01000280,1274,228,1046
2021,Barnet 008D,E01000281,1632,302,1330
2021,Barnet 008E,E01000282,1699,358,1341
2021,Barnet 012C,E01000283,1301,281,1020
2021,Barnet 012D,E01000284,1718,312,1406
2021,Barnet 004A,E01000285,1424,289,1135
2021,Barnet 007E,E01000286,1623,359,1264
2021,Barnet 004B,E01000287,1550,367,1183
2021,Barnet 004C,E01000288,1472,332,1140
2021,Barnet 004D,E01000289,1493,402,1091
2021,Barnet 007F,E01000290,1559,299,1260
2021,Barnet 004E,E01000291,1467,334,1133
2021,Barnet 001E,E01000292,1466,268,1198
2021,Barnet 001F,E01000293,1687,324,1363
2021,Barnet 004F,E01000294,1702,305,1397
2021,Barnet 023B,E01000295,1512,250,1262
2021,Barnet 023C,E01000296,1649,280,1369
2021,Barnet 027D,E01000297,1330,247,1083
2021,Barnet 023D,E01000298,1610,318,1292
2021,Barnet 019A,E01000299,2033,406,1627
2021,Barnet 019B,E01000300,1550,297,1253
2021,Barnet 020C,E01000301,1402,311,1091
2021,Barnet 019C,E01000302,1684,314,1370
2021,Barnet 020D,E01000303,1396,294,1102
2021,Barnet 020E,E01000304,1470,272,1198
2021,Barnet 036B,E01000305,1536,284,1252
2021,Barnet 036C,E01000306,1835,320,1515
2021,Barnet 039D,E01000307,1549,359,1190
2021,Barnet 036D,E01000308,1939,304,1635
2021,Barnet 031D,E01000309,1950,455,1495
2021,Barnet 034C,E01000310,2075,441,1634
2021,Barnet 034D,E01000311,1625,572,1053
2021,Barnet 036E,E01000312,1667,336,1331
2021,Barnet 036F,E01000313,1792,378,1414
2021,Barnet 032F,E01000314,2068,480,1588
2021,Barnet 022F,E01000315,1635,368,1267
2021,Barnet 027E,E01000316,2148,501,1647
2021,Barnet 019D,E01000317,1506,335,1171
2021,Barnet 019E,E01000318,1865,461,1404
2021,Barnet 027F,E01000319,1326,314,1012
2021,Barnet 011D,E01000320,1829,330,1499
2021,Barnet 012E,E01000321,1856,283,1573
2021,Barnet 011E,E01000322,1743,385,1358
2021,Barnet 019F,E01000323,2257,415,1842
2021,Barnet 015F,E01000324,1752,418,1334
2021,Bexley 014A,E01000325,1552,286,1266
2021,Bexley 014B,E01000326,1266,243,1023
2021,Bexley 017A,E01000327,1547,294,1253
2021,Bexley 017B,E01000328,1550,316,1234
2021,Bexley 017C,E01000329,1574,330,1244
2021,Bexley 017D,E01000330,1561,252,1309
2021,Bexley 017E,E01000331,1561,365,1196
2021,Bexley 005A,E01000332,1510,265,1245
2021,Bexley 003A,E01000333,1775,375,1400
2021,Bexley 006A,E01000334,1579,341,1238
2021,Bexley 003B,E01000335,2497,567,1930
2021,Bexley 003C,E01000336,1845,495,1350
2021,Bexley 003D,E01000337,1603,388,1215
2021,Bexley 003E,E01000338,1751,399,1352
2021,Bexley 025A,E01000339,1527,334,1193
2021,Bexley 018A,E01000340,1468,267,1201
2021,Bexley 022A,E01000341,1475,252,1223
2021,Bexley 022B,E01000342,1444,272,1172
2021,Bexley 022C,E01000343,1429,300,1129
2021,Bexley 025B,E01000344,1513,326,1187
2021,Bexley 022D,E01000345,1280,234,1046
2021,Bexley 021A,E01000346,1489,271,1218
2021,Bexley 021B,E01000347,1418,283,1135
2021,Bexley 020A,E01000348,1438,279,1159
2021,Bexley 020B,E01000349,1616,313,1303
2021,Bexley 021C,E01000350,1396,262,1134
2021,Bexley 024A,E01000351,1500,243,1257
2021,Bexley 021D,E01000352,1529,310,1219
2021,Bexley 011A,E01000353,1585,257,1328
2021,Bexley 011B,E01000354,1418,268,1150
2021,Bexley 011C,E01000355,1373,190,1183
2021,Bexley 009A,E01000356,1473,270,1203
2021,Bexley 009B,E01000357,1332,277,1055
2021,Bexley 011D,E01000358,1579,289,1290
2021,Bexley 009C,E01000359,1197,196,1001
2021,Bexley 015A,E01000360,1794,330,1464
2021,Bexley 020C,E01000361,1496,287,1209
2021,Bexley 015B,E01000362,1761,324,1437
2021,Bexley 020D,E01000363,1458,282,1176
2021,Bexley 023A,E01000364,1612,331,1281
2021,Bexley 015C,E01000365,1620,300,1320
2021,Bexley 015D,E01000366,1529,283,1246
2021,Bexley 010A,E01000367,2105,584,1521
2021,Bexley 010B,E01000368,1556,401,1155
2021,Bexley 014C,E01000369,1643,325,1318
2021,Bexley 014D,E01000370,1476,234,1242
2021,Bexley 014E,E01000371,1494,271,1223
2021,Bexley 010C,E01000372,1600,396,1204
2021,Bexley 008A,E01000373,1185,366,819
2021,Bexley 019A,E01000374,1481,419,1062
2021,Bexley 019B,E01000375,1973,453,1520
2021,Bexley 019C,E01000376,1522,328,1194
2021,Bexley 019D,E01000377,1389,224,1165
2021,Bexley 019F,E01000379,1628,365,1263
2021,Bexley 010D,E01000380,1651,232,1419
2021,Bexley 028A,E01000381,1519,319,1200
2021,Bexley 027A,E01000382,1494,296,1198
2021,Bexley 028B,E01000383,1493,243,1250
2021,Bexley 027B,E01000384,1602,306,1296
2021,Bexley 028C,E01000385,1863,499,1364
2021,Bexley 028D,E01000386,1450,302,1148
2021,Bexley 027C,E01000387,1479,252,1227
2021,Bexley 016A,E01000388,1434,264,1170
2021,Bexley 020E,E01000389,1618,303,1315
2021,Bexley 020F,E01000390,1253,238,1015
2021,Bexley 021E,E01000391,1639,354,1285
2021,Bexley 016B,E01000392,1824,442,1382
2021,Bexley 020G,E01000393,1603,334,1269
2021,Bexley 015E,E01000394,1550,278,1272
2021,Bexley 018B,E01000395,1445,271,1174
2021,Bexley 018C,E01000396,1370,265,1105
2021,Bexley 029A,E01000398,1506,279,1227
2021,Bexley 029B,E01000399,1487,262,1225
2021,Bexley 029C,E01000400,1494,281,1213
2021,Bexley 013A,E01000401,1709,360,1349
2021,Bexley 005B,E01000402,1490,339,1151
2021,Bexley 004A,E01000403,2225,495,1730
2021,Bexley 004B,E01000404,2173,651,1522
2021,Bexley 004C,E01000405,1437,399,1038
2021,Bexley 005C,E01000406,1942,443,1499
2021,Bexley 005D,E01000407,1770,348,1422
2021,Bexley 004D,E01000408,1650,438,1212
2021,Bexley 016C,E01000409,1634,326,1308
2021,Bexley 018D,E01000410,1556,346,1210
2021,Bexley 016D,E01000411,1412,270,1142
2021,Bexley 018E,E01000412,1653,363,1290
2021,Bexley 018F,E01000413,1282,256,1026
2021,Bexley 016E,E01000414,1791,369,1422
2021,Bexley 016F,E01000415,1411,240,1171
2021,Bexley 002A,E01000416,1568,429,1139
2021,Bexley 006B,E01000417,1632,331,1301
2021,Bexley 002B,E01000418,1826,429,1397
2021,Bexley 006C,E01000419,1411,244,1167
2021,Bexley 006D,E01000420,1424,267,1157
2021,Bexley 009D,E01000421,1448,217,1231
2021,Bexley 002C,E01000422,1246,376,870
2021,Bexley 025C,E01000423,1514,304,1210
2021,Bexley 026A,E01000424,1669,274,1395
2021,Bexley 025D,E01000425,1687,300,1387
2021,Bexley 026B,E01000426,1566,281,1285
2021,Bexley 026C,E01000427,1897,341,1556
2021,Bexley 027D,E01000428,1770,324,1446
2021,Bexley 008B,E01000429,1541,421,1120
2021,Bexley 008C,E01000430,1930,576,1354
2021,Bexley 008D,E01000431,1116,311,805
2021,Bexley 008F,E01000433,1802,501,1301
2021,Bexley 008G,E01000434,1494,362,1132
2021,Bexley 010E,E01000435,1382,327,1055
2021,Bexley 011E,E01000436,1659,351,1308
2021,Bexley 007A,E01000437,1302,266,1036
2021,Bexley 007B,E01000438,1562,367,1195
2021,Bexley 007C,E01000439,1336,325,1011
2021,Bexley 007D,E01000440,1334,229,1105
2021,Bexley 007E,E01000441,1683,455,1228
2021,Bexley 006E,E01000442,1595,312,1283
2021,Bexley 024B,E01000443,1253,255,998
2021,Bexley 023B,E01000444,1548,264,1284
2021,Bexley 024C,E01000445,1577,300,1277
2021,Bexley 024D,E01000446,1426,253,1173
2021,Bexley 023C,E01000447,1826,322,1504
2021,Bexley 023D,E01000448,1291,237,1054
2021,Bexley 023E,E01000449,1478,247,1231
2021,Bexley 009E,E01000450,1700,409,1291
2021,Bexley 009F,E01000451,1649,322,1327
2021,Bexley 009G,E01000452,1341,262,1079
2021,Bexley 013B,E01000453,1384,287,1097
2021,Bexley 013C,E01000454,1524,290,1234
2021,Bexley 013D,E01000455,1710,349,1361
2021,Bexley 013E,E01000456,1344,281,1063
2021,Bexley 026D,E01000457,2059,487,1572
2021,Bexley 027E,E01000458,1485,264,1221
2021,Bexley 027F,E01000459,1784,319,1465
2021,Bexley 022E,E01000460,1192,206,986
2021,Bexley 024E,E01000461,1547,338,1209
2021,Bexley 026E,E01000462,1958,463,1495
2021,Bexley 025E,E01000463,1178,238,940
2021,Bexley 002D,E01000464,1452,422,1030
2021,Bexley 002E,E01000465,1570,410,1160
2021,Bexley 001A,E01000466,1611,496,1115
2021,Bexley 001B,E01000467,1561,434,1127
2021,Bexley 001C,E01000468,2732,982,1750
2021,Bexley 001D,E01000469,1610,465,1145
2021,Bexley 002F,E01000470,1193,327,866
2021,Brent 026A,E01000471,1662,331,1331
2021,Brent 029A,E01000472,2221,523,1698
2021,Brent 029B,E01000473,2553,617,1936
2021,Brent 026B,E01000474,2144,505,1639
2021,Brent 029C,E01000475,1998,444,1554
2021,Brent 026C,E01000476,2070,390,1680
2021,Brent 026D,E01000477,2235,514,1721
2021,Brent 029D,E01000478,2344,489,1855
2021,Brent 009A,E01000479,1685,367,1318
2021,Brent 006A,E01000480,1617,361,1256
2021,Brent 009B,E01000481,1530,410,1120
2021,Brent 009D,E01000483,1725,491,1234
2021,Brent 006B,E01000484,1669,416,1253
2021,Brent 006C,E01000485,1530,296,1234
2021,Brent 006D,E01000486,1605,385,1220
2021,Brent 006E,E01000487,1882,444,1438
2021,Brent 022A,E01000488,1566,345,1221
2021,Brent 030A,E01000489,1646,338,1308
2021,Brent 023A,E01000490,1670,283,1387
2021,Brent 030B,E01000491,1957,431,1526
2021,Brent 030C,E01000492,1213,258,955
2021,Brent 030D,E01000493,1508,288,1220
2021,Brent 023B,E01000494,1681,328,1353
2021,Brent 023C,E01000495,1528,289,1239
2021,Brent 011A,E01000497,1976,338,1638
2021,Brent 010B,E01000498,1572,452,1120
2021,Brent 011B,E01000499,1766,502,1264
2021,Brent 011C,E01000501,1893,537,1356
2021,Brent 011D,E01000502,1720,464,1256
2021,Brent 011E,E01000503,1961,436,1525
2021,Brent 018A,E01000504,1684,355,1329
2021,Brent 018B,E01000505,1554,340,1214
2021,Brent 014A,E01000506,1561,364,1197
2021,Brent 018C,E01000507,1541,339,1202
2021,Brent 025A,E01000508,2408,789,1619
2021,Brent 014B,E01000509,1385,332,1053
2021,Brent 014C,E01000510,1554,369,1185
2021,Brent 014D,E01000511,1584,422,1162
2021,Brent 018D,E01000512,1620,391,1229
2021,Brent 002A,E01000513,1587,372,1215
2021,Brent 002B,E01000514,1492,369,1123
2021,Brent 003A,E01000515,1741,421,1320
2021,Brent 002C,E01000516,2174,494,1680
2021,Brent 003B,E01000517,1555,322,1233
2021,Brent 005A,E01000518,1824,395,1429
2021,Brent 005B,E01000519,1885,469,1416
2021,Brent 002D,E01000520,1589,376,1213
2021,Brent 025B,E01000521,2127,542,1585
2021,Brent 025C,E01000522,1911,534,1377
2021,Brent 031A,E01000523,2157,594,1563
2021,Brent 031B,E01000524,2270,589,1681
2021,Brent 031C,E01000525,1738,420,1318
2021,Brent 025D,E01000526,2076,554,1522
2021,Brent 025E,E01000527,1773,471,1302
2021,Brent 025F,E01000528,1609,369,1240
2021,Brent 033A,E01000530,1717,355,1362
2021,Brent 033B,E01000531,1701,322,1379
2021,Brent 033C,E01000532,1400,241,1159
2021,Brent 031E,E01000533,2048,473,1575
2021,Brent 033D,E01000534,1641,344,1297
2021,Brent 031F,E01000535,1932,391,1541
2021,Brent 004A,E01000536,1493,290,1203
2021,Brent 004B,E01000538,1506,331,1175
2021,Brent 004C,E01000539,1492,293,1199
2021,Brent 004D,E01000540,1383,220,1163
2021,Brent 004E,E01000541,1316,254,1062
2021,Brent 003E,E01000543,1548,317,1231
2021,Brent 034A,E01000544,1678,414,1264
2021,Brent 028A,E01000545,1816,308,1508
2021,Brent 028B,E01000546,1564,270,1294
2021,Brent 028C,E01000547,1558,345,1213
2021,Brent 028D,E01000548,1894,324,1570
2021,Brent 028E,E01000549,1709,272,1437
2021,Brent 034B,E01000550,1925,409,1516
2021,Brent 034C,E01000551,2742,697,2045
2021,Brent 034D,E01000552,1414,408,1006
2021,Brent 015A,E01000553,1927,372,1555
2021,Brent 015B,E01000554,1842,409,1433
2021,Brent 015C,E01000555,1515,349,1166
2021,Brent 015D,E01000556,1965,308,1657
2021,Brent 015E,E01000557,1778,355,1423
2021,Brent 015F,E01000558,1332,256,1076
2021,Brent 018E,E01000559,1326,200,1126
2021,Brent 023D,E01000560,1491,265,1226
2021,Brent 023E,E01000561,1837,419,1418
2021,Brent 008A,E01000562,1458,276,1182
2021,Brent 008B,E01000563,1524,292,1232
2021,Brent 013A,E01000564,1516,389,1127
2021,Brent 013B,E01000565,1464,378,1086
2021,Brent 008C,E01000566,1477,313,1164
2021,Brent 016A,E01000567,1313,296,1017
2021,Brent 008D,E01000568,2105,623,1482
2021,Brent 008E,E01000569,1399,248,1151
2021,Brent 012A,E01000570,1487,265,1222
2021,Brent 012B,E01000571,1697,304,1393
2021,Brent 007A,E01000572,1399,306,1093
2021,Brent 007B,E01000573,1548,328,1220
2021,Brent 007C,E01000574,1518,357,1161
2021,Brent 007D,E01000575,2000,423,1577
2021,Brent 012C,E01000576,1782,390,1392
2021,Brent 007E,E01000577,2365,698,1667
2021,Brent 012D,E01000578,2180,499,1681
2021,Brent 032A,E01000579,1495,255,1240
2021,Brent 032B,E01000580,1909,408,1501
2021,Brent 030E,E01000581,1439,334,1105
2021,Brent 032C,E01000582,1694,412,1282
2021,Brent 032D,E01000583,1946,349,1597
2021,Brent 033E,E01000584,1448,280,1168
2021,Brent 033F,E01000585,1393,268,1125
2021,Brent 032E,E01000586,2240,406,1834
2021,Brent 001A,E01000587,1536,301,1235
2021,Brent 001B,E01000589,2401,517,1884
2021,Brent 001C,E01000590,1809,353,1456
2021,Brent 003F,E01000591,2042,445,1597
2021,Brent 001D,E01000592,1741,340,1401
2021,Brent 001E,E01000593,1998,445,1553
2021,Brent 001F,E01000594,1721,380,1341
2021,Brent 027A,E01000595,1647,533,1114
2021,Brent 021A,E01000596,1732,550,1182
2021,Brent 027D,E01000599,1782,454,1328
2021,Brent 021B,E01000601,1328,436,892
2021,Brent 021C,E01000602,1390,381,1009
2021,Brent 021D,E01000603,1324,345,979
2021,Brent 021E,E01000604,1656,510,1146
2021,Brent 021F,E01000605,1704,528,1176
2021,Brent 016B,E01000606,1771,444,1327
2021,Brent 013C,E01000607,2401,673,1728
2021,Brent 013D,E01000608,2165,464,1701
2021,Brent 016C,E01000609,1946,437,1509
2021,Brent 019A,E01000610,2052,482,1570
2021,Brent 016D,E01000611,1793,431,1362
2021,Brent 019B,E01000612,1677,394,1283
2021,Brent 013E,E01000613,1622,354,1268
2021,Brent 036A,E01000615,3026,1389,1637
2021,Brent 020A,E01000616,1853,396,1457
2021,Brent 036B,E01000617,2152,427,1725
2021,Brent 036D,E01000618,1590,331,1259
2021,Brent 036C,E01000619,1620,388,1232
2021,Brent 020B,E01000620,1681,304,1377
2021,Brent 020C,E01000621,1723,374,1349
2021,Brent 010D,E01000622,1768,472,1296
2021,Brent 005C,E01000623,1756,364,1392
2021,Brent 005D,E01000624,1648,323,1325
2021,Brent 009E,E01000625,1578,363,1215
2021,Brent 010E,E01000626,1435,336,1099
2021,Brent 014E,E01000627,1946,507,1439
2021,Brent 014F,E01000628,1685,348,1337
2021,Brent 005E,E01000629,1864,406,1458
2021,Brent 026E,E01000630,2567,527,2040
2021,Brent 019C,E01000631,1950,369,1581
2021,Brent 029E,E01000632,2350,521,1829
2021,Brent 019D,E01000633,2427,532,1895
2021,Brent 019E,E01000634,2480,643,1837
2021,Brent 020E,E01000636,2437,504,1933
2021,Brent 022B,E01000637,1430,299,1131
2021,Brent 024A,E01000638,1962,490,1472
2021,Brent 022C,E01000639,1618,306,1312
2021,Brent 024B,E01000640,2036,500,1536
2021,Brent 024C,E01000641,1807,445,1362
2021,Brent 022D,E01000642,2114,320,1794
2021,Brent 024D,E01000643,2132,548,1584
2021,Brent 022E,E01000644,1801,336,1465
2021,Bromley 007A,E01000645,1378,273,1105
2021,Bromley 016A,E01000646,1714,314,1400
2021,Bromley 016B,E01000647,1604,380,1224
2021,Bromley 016C,E01000648,1781,382,1399
2021,Bromley 007B,E01000649,1958,431,1527
2021,Bromley 022A,E01000650,1734,358,1376
2021,Bromley 020A,E01000651,1606,282,1324
2021,Bromley 022B,E01000652,1630,306,1324
2021,Bromley 016D,E01000653,1471,277,1194
2021,Bromley 039A,E01000654,1216,247,969
2021,Bromley 039B,E01000655,1252,253,999
2021,Bromley 039C,E01000656,1431,251,1180
2021,Bromley 039D,E01000657,1478,251,1227
2021,Bromley 042A,E01000658,1298,177,1121
2021,Bromley 039E,E01000659,1386,297,1089
2021,Bromley 026A,E01000661,2597,636,1961
2021,Bromley 026B,E01000662,1688,372,1316
2021,Bromley 026C,E01000663,1575,351,1224
2021,Bromley 026D,E01000664,1566,357,1209
2021,Bromley 033A,E01000665,1747,330,1417
2021,Bromley 033B,E01000666,1817,275,1542
2021,Bromley 033C,E01000667,1608,303,1305
2021,Bromley 020B,E01000668,2047,360,1687
2021,Bromley 020C,E01000669,1612,320,1292
2021,Bromley 018A,E01000670,1839,321,1518
2021,Bromley 020D,E01000671,2120,394,1726
2021,Bromley 011A,E01000672,1576,301,1275
2021,Bromley 011B,E01000673,1567,366,1201
2021,Bromley 008A,E01000674,1602,317,1285
2021,Bromley 008B,E01000676,1894,380,1514
2021,Bromley 018C,E01000677,1764,356,1408
2021,Bromley 016E,E01000678,1733,371,1362
2021,Bromley 020E,E01000679,1648,362,1286
2021,Bromley 037A,E01000680,1590,271,1319
2021,Bromley 035A,E01000681,1660,355,1305
2021,Bromley 035B,E01000682,1533,307,1226
2021,Bromley 035C,E01000683,1614,337,1277
2021,Bromley 035D,E01000684,1980,462,1518
2021,Bromley 037B,E01000685,1517,321,1196
2021,Bromley 037C,E01000686,1415,275,1140
2021,Bromley 037D,E01000687,1486,242,1244
2021,Bromley 037E,E01000688,1324,271,1053
2021,Bromley 002A,E01000689,1545,404,1141
2021,Bromley 002B,E01000690,1295,244,1051
2021,Bromley 002C,E01000691,1429,261,1168
2021,Bromley 002D,E01000692,1551,288,1263
2021,Bromley 010A,E01000693,1456,229,1227
2021,Bromley 007C,E01000694,2165,450,1715
2021,Bromley 007D,E01000695,1447,285,1162
2021,Bromley 007E,E01000696,1551,256,1295
2021,Bromley 007F,E01000697,1692,316,1376
2021,Bromley 010B,E01000698,1130,217,913
2021,Bromley 015A,E01000699,1344,239,1105
2021,Bromley 013A,E01000700,1415,267,1148
2021,Bromley 015B,E01000701,1318,247,1071
2021,Bromley 013B,E01000702,1323,200,1123
2021,Bromley 013C,E01000703,1625,390,1235
2021,Bromley 015C,E01000704,1368,260,1108
2021,Bromley 015D,E01000705,1274,232,1042
2021,Bromley 013D,E01000706,1282,230,1052
2021,Bromley 041A,E01000707,1384,350,1034
2021,Bromley 041B,E01000708,1579,328,1251
2021,Bromley 006A,E01000709,1287,144,1143
2021,Bromley 006B,E01000710,2192,266,1926
2021,Bromley 006C,E01000711,1759,188,1571
2021,Bromley 012A,E01000712,1698,221,1477
2021,Bromley 012B,E01000713,1704,221,1483
2021,Bromley 006D,E01000714,2023,310,1713
2021,Bromley 012C,E01000715,1675,217,1458
2021,Bromley 011C,E01000716,1574,257,1317
2021,Bromley 011D,E01000717,1592,220,1372
2021,Bromley 006E,E01000718,1934,431,1503
2021,Bromley 019A,E01000719,1953,461,1492
2021,Bromley 019B,E01000720,1669,428,1241
2021,Bromley 019C,E01000721,1474,375,1099
2021,Bromley 023A,E01000722,1733,324,1409
2021,Bromley 029A,E01000723,1190,161,1029
2021,Bromley 019D,E01000724,1547,409,1138
2021,Bromley 023B,E01000725,1627,295,1332
2021,Bromley 029B,E01000726,1227,169,1058
2021,Bromley 028A,E01000727,1589,270,1319
2021,Bromley 019E,E01000728,1511,242,1269
2021,Bromley 014A,E01000729,1807,453,1354
2021,Bromley 014B,E01000730,1643,415,1228
2021,Bromley 023C,E01000731,1274,282,992
2021,Bromley 023D,E01000732,1431,267,1164
2021,Bromley 023E,E01000733,1570,329,1241
2021,Bromley 028B,E01000734,1284,289,995
2021,Bromley 014C,E01000735,1440,349,1091
2021,Bromley 010C,E01000736,1530,336,1194
2021,Bromley 010D,E01000737,1304,266,1038
2021,Bromley 014D,E01000738,1576,280,1296
2021,Bromley 014E,E01000739,1545,380,1165
2021,Bromley 005B,E01000741,1689,211,1478
2021,Bromley 005C,E01000742,1987,341,1646
2021,Bromley 009A,E01000743,1764,313,1451
2021,Bromley 009B,E01000744,1464,308,1156
2021,Bromley 005D,E01000745,1737,286,1451
2021,Bromley 005E,E01000746,1868,290,1578
2021,Bromley 042B,E01000747,1906,381,1525
2021,Bromley 042C,E01000748,1633,222,1411
2021,Bromley 036A,E01000749,1610,293,1317
2021,Bromley 036B,E01000750,1405,288,1117
2021,Bromley 036C,E01000751,2125,464,1661
2021,Bromley 036D,E01000752,1684,307,1377
2021,Bromley 031A,E01000753,1870,403,1467
2021,Bromley 031B,E01000754,1658,332,1326
2021,Bromley 031C,E01000755,1557,326,1231
2021,Bromley 033D,E01000756,1636,338,1298
2021,Bromley 031D,E01000757,1517,302,1215
2021,Bromley 031E,E01000758,1393,305,1088
2021,Bromley 034A,E01000759,1576,338,1238
2021,Bromley 034B,E01000760,1560,309,1251
2021,Bromley 034C,E01000761,1477,303,1174
2021,Bromley 018D,E01000762,1637,306,1331
2021,Bromley 027A,E01000763,1413,321,1092
2021,Bromley 027B,E01000764,1711,364,1347
2021,Bromley 034D,E01000765,1713,376,1337
2021,Bromley 027C,E01000766,1736,410,1326
2021,Bromley 027D,E01000767,1573,345,1228
2021,Bromley 034E,E01000768,1441,296,1145
2021,Bromley 024A,E01000769,1348,285,1063
2021,Bromley 012D,E01000770,1453,238,1215
2021,Bromley 041C,E01000771,1570,333,1237
2021,Bromley 012E,E01000772,1498,197,1301
2021,Bromley 024B,E01000773,1518,356,1162
2021,Bromley 041D,E01000774,1401,293,1108
2021,Bromley 024C,E01000775,2172,478,1694
2021,Bromley 024D,E01000777,1553,361,1192
2021,Bromley 024E,E01000778,1532,310,1222
2021,Bromley 001A,E01000779,1324,217,1107
2021,Bromley 001B,E01000780,1507,320,1187
2021,Bromley 001C,E01000781,1454,353,1101
2021,Bromley 001D,E01000782,1425,322,1103
2021,Bromley 001E,E01000783,1491,353,1138
2021,Bromley 002E,E01000784,1448,307,1141
2021,Bromley 001F,E01000785,1473,356,1117
2021,Bromley 032A,E01000786,1393,187,1206
2021,Bromley 029C,E01000787,1414,237,1177
2021,Bromley 029D,E01000788,1521,313,1208
2021,Bromley 032B,E01000789,1730,559,1171
2021,Bromley 028C,E01000790,2179,338,1841
2021,Bromley 029E,E01000791,1435,226,1209
2021,Bromley 032C,E01000792,1408,310,1098
2021,Bromley 032D,E01000793,1484,251,1233
2021,Bromley 035E,E01000794,1464,252,1212
2021,Bromley 032E,E01000795,1295,275,1020
2021,Bromley 009C,E01000796,1445,383,1062
2021,Bromley 013E,E01000797,1543,294,1249
2021,Bromley 009D,E01000798,1430,276,1154
2021,Bromley 004A,E01000799,1668,323,1345
2021,Bromley 009E,E01000800,1568,286,1282
2021,Bromley 015E,E01000801,1406,247,1159
2021,Bromley 004B,E01000802,1707,264,1443
2021,Bromley 004C,E01000803,1516,240,1276
2021,Bromley 004D,E01000804,1390,295,1095
2021,Bromley 004E,E01000805,1599,308,1291
2021,Bromley 009F,E01000806,1588,380,1208
2021,Bromley 022C,E01000807,1538,325,1213
2021,Bromley 025A,E01000808,1459,267,1192
2021,Bromley 022D,E01000809,1458,257,1201
2021,Bromley 025B,E01000810,1442,275,1167
2021,Bromley 025C,E01000811,1255,228,1027
2021,Bromley 028D,E01000812,1543,276,1267
2021,Bromley 025D,E01000813,1471,273,1198
2021,Bromley 028E,E01000814,1447,251,1196
2021,Bromley 025E,E01000815,1433,274,1159
2021,Bromley 040A,E01000816,1433,251,1182
2021,Bromley 040B,E01000818,1597,283,1314
2021,Bromley 040C,E01000819,1728,355,1373
2021,Bromley 008C,E01000820,1524,302,1222
2021,Bromley 008D,E01000822,1493,306,1187
2021,Bromley 008E,E01000823,1584,291,1293
2021,Bromley 008F,E01000824,1316,264,1052
2021,Bromley 008G,E01000825,1546,262,1284
2021,Bromley 021A,E01000826,1581,372,1209
2021,Bromley 021B,E01000827,1653,299,1354
2021,Bromley 011E,E01000828,1597,287,1310
2021,Bromley 018E,E01000829,1642,315,1327
2021,Bromley 021C,E01000830,1536,354,1182
2021,Bromley 021D,E01000831,1602,282,1320
2021,Bromley 030A,E01000832,1503,314,1189
2021,Bromley 021E,E01000833,1394,325,1069
2021,Bromley 027E,E01000834,1276,291,985
2021,Bromley 030B,E01000835,1658,346,1312
2021,Bromley 030C,E01000836,1316,281,1035
2021,Bromley 030D,E01000837,1499,338,1161
2021,Bromley 030E,E01000838,1353,231,1122
2021,Bromley 030F,E01000839,1331,223,1108
2021,Bromley 030G,E01000840,1463,199,1264
2021,Bromley 030H,E01000841,1621,287,1334
2021,Camden 011A,E01000842,1349,194,1155
2021,Camden 014A,E01000843,1144,187,957
2021,Camden 011B,E01000844,1534,304,1230
2021,Camden 014B,E01000845,1417,281,1136
2021,Camden 014C,E01000846,1382,379,1003
2021,Camden 014D,E01000847,1521,427,1094
2021,Camden 011C,E01000848,1406,229,1177
2021,Camden 011D,E01000849,1289,182,1107
2021,Camden 026A,E01000850,1400,486,914
2021,Camden 026B,E01000851,1446,693,753
2021,Camden 029H,E01000853,1356,330,1026
2021,Camden 028A,E01000855,1270,296,974
2021,Camden 019A,E01000856,1531,402,1129
2021,Camden 018A,E01000857,1327,264,1063
2021,Camden 018B,E01000858,1851,453,1398
2021,Camden 018C,E01000859,1385,248,1137
2021,Camden 018D,E01000860,1057,166,891
2021,Camden 019B,E01000861,1322,260,1062
2021,Camden 018E,E01000862,1584,298,1286
2021,Camden 021A,E01000863,1424,374,1050
2021,Camden 009A,E01000866,1870,418,1452
2021,Camden 015C,E01000867,1675,438,1237
2021,Camden 015D,E01000868,1629,428,1201
2021,Camden 015E,E01000869,1880,452,1428
2021,Camden 009B,E01000870,1524,293,1231
2021,Camden 005A,E01000871,1571,353,1218
2021,Camden 005B,E01000872,1635,273,1362
2021,Camden 005C,E01000873,1502,294,1208
2021,Camden 005D,E01000874,1397,278,1119
2021,Camden 013A,E01000875,1495,232,1263
2021,Camden 013B,E01000876,1830,375,1455
2021,Camden 005E,E01000877,1397,268,1129
2021,Camden 004A,E01000878,1606,345,1261
2021,Camden 004B,E01000879,1227,243,984
2021,Camden 004C,E01000880,1311,280,1031
2021,Camden 008A,E01000881,1293,284,1009
2021,Camden 008B,E01000882,1358,277,1081
2021,Camden 008C,E01000883,1430,275,1155
2021,Camden 004D,E01000884,1374,329,1045
2021,Camden 004E,E01000885,1211,249,962
2021,Camden 006A,E01000886,1287,235,1052
2021,Camden 006B,E01000887,1320,218,1102
2021,Camden 006C,E01000888,1401,305,1096
2021,Camden 007A,E01000889,1685,397,1288
2021,Camden 007B,E01000890,1210,250,960
2021,Camden 007C,E01000891,1417,350,1067
2021,Camden 006D,E01000892,1693,344,1349
2021,Camden 002A,E01000893,1333,247,1086
2021,Camden 002B,E01000894,1206,248,958
2021,Camden 002C,E01000895,1471,248,1223
2021,Camden 002D,E01000896,1378,256,1122
2021,Camden 008D,E01000897,1438,317,1121
2021,Camden 008E,E01000898,1509,219,1290
2021,Camden 002E,E01000899,1467,268,1199
2021,Camden 012A,E01000900,1604,325,1279
2021,Camden 007D,E01000901,1844,572,1272
2021,Camden 012B,E01000902,1350,354,996
2021,Camden 006E,E01000903,1335,253,1082
2021,Camden 012C,E01000904,1977,450,1527
2021,Camden 012D,E01000905,1763,491,1272
2021,Camden 012E,E01000906,1365,213,1152
2021,Camden 001A,E01000907,1392,307,1085
2021,Camden 001B,E01000908,1465,271,1194
2021,Camden 001C,E01000909,1498,284,1214
2021,Camden 003A,E01000910,1289,262,1027
2021,Camden 003B,E01000911,1376,312,1064
2021,Camden 001D,E01000912,1507,281,1226
2021,Camden 001E,E01000913,1551,276,1275
2021,Camden 028B,E01000914,1385,401,984
2021,Camden 027A,E01000915,1458,429,1029
2021,Camden 027B,E01000916,1806,417,1389
2021,Camden 027C,E01000917,1566,361,1205
2021,Camden 028C,E01000918,1742,582,1160
2021,Camden 028D,E01000919,1407,411,996
2021,Camden 027D,E01000920,1575,325,1250
2021,Camden 003C,E01000921,1778,280,1498
2021,Camden 007E,E01000922,1856,579,1277
2021,Camden 003D,E01000923,1382,223,1159
2021,Camden 009C,E01000924,1496,292,1204
2021,Camden 009D,E01000925,1426,437,989
2021,Camden 009E,E01000926,1400,361,1039
2021,Camden 007F,E01000927,1461,288,1173
2021,Camden 003E,E01000928,1637,312,1325
2021,Camden 020A,E01000929,1824,553,1271
2021,Camden 020B,E01000930,1962,397,1565
2021,Camden 013C,E01000931,1914,395,1519
2021,Camden 013D,E01000932,1678,257,1421
2021,Camden 020C,E01000933,1684,312,1372
2021,Camden 020D,E01000934,1448,333,1115
2021,Camden 020E,E01000935,1498,371,1127
2021,Camden 029G,E01000937,1095,592,503
2021,Camden 029A,E01000938,1300,360,940
2021,Camden 029B,E01000939,1382,490,892
2021,Camden 029D,E01000941,1128,274,854
2021,Camden 029C,E01000942,991,390,601
2021,Camden 029F,E01000943,1574,995,579
2021,Camden 023A,E01000944,1410,450,960
2021,Camden 021B,E01000946,1490,388,1102
2021,Camden 021C,E01000947,1611,499,1112
2021,Camden 021D,E01000948,1464,336,1128
2021,Camden 023C,E01000949,1507,365,1142
2021,Camden 023E,E01000951,1441,488,953
2021,Camden 022A,E01000952,1624,536,1088
2021,Camden 022C,E01000954,1628,601,1027
2021,Camden 022D,E01000955,1275,408,867
2021,Camden 022E,E01000956,1434,468,966
2021,Camden 019C,E01000957,1255,222,1033
2021,Camden 019D,E01000958,2813,1294,1519
2021,Camden 019E,E01000959,1614,527,1087
2021,Camden 017A,E01000960,1755,357,1398
2021,Camden 017B,E01000961,1688,423,1265
2021,Camden 016A,E01000962,1463,230,1233
2021,Camden 017C,E01000963,1780,416,1364
2021,Camden 016B,E01000964,1633,306,1327
2021,Camden 016C,E01000965,1623,313,1310
2021,Camden 016D,E01000966,1510,278,1232
2021,Camden 017D,E01000967,1435,321,1114
2021,Camden 016E,E01000968,1385,172,1213
2021,Camden 010A,E01000969,1745,278,1467
2021,Camden 010B,E01000970,1345,135,1210
2021,Camden 010C,E01000971,1242,230,1012
2021,Camden 010D,E01000972,1865,377,1488
2021,Camden 010E,E01000973,2442,592,1850
2021,Camden 013E,E01000974,1509,234,1275
2021,Croydon 022A,E01000975,2182,411,1771
2021,Croydon 022B,E01000976,1966,416,1550
2021,Croydon 022C,E01000977,1792,279,1513
2021,Croydon 022D,E01000978,1592,265,1327
2021,Croydon 022E,E01000979,1640,273,1367
2021,Croydon 017A,E01000980,1401,356,1045
2021,Croydon 017B,E01000981,1612,347,1265
2021,Croydon 017C,E01000982,1543,321,1222
2021,Croydon 017D,E01000983,1727,309,1418
2021,Croydon 022F,E01000984,1734,356,1378
2021,Croydon 021A,E01000985,1384,263,1121
2021,Croydon 021B,E01000986,1654,303,1351
2021,Croydon 021C,E01000987,1285,205,1080
2021,Croydon 018A,E01000989,1656,336,1320
2021,Croydon 045A,E01000990,1379,341,1038
2021,Croydon 018B,E01000991,1671,264,1407
2021,Croydon 014A,E01000992,1778,400,1378
2021,Croydon 021D,E01000993,1522,337,1185
2021,Croydon 009A,E01000994,1514,359,1155
2021,Croydon 009B,E01000995,1604,405,1199
2021,Croydon 009C,E01000996,1259,249,1010
2021,Croydon 009D,E01000997,1436,356,1080
2021,Croydon 010A,E01000998,1378,299,1079
2021,Croydon 009E,E01000999,1267,302,965
2021,Croydon 010B,E01001000,1263,283,980
2021,Croydon 013A,E01001001,1312,313,999
2021,Croydon 009F,E01001002,1383,370,1013
2021,Croydon 010C,E01001003,1486,371,1115
2021,Croydon 015A,E01001004,2025,505,1520
2021,Croydon 019A,E01001005,1617,428,1189
2021,Croydon 016A,E01001006,1666,479,1187
2021,Croydon 016B,E01001007,1908,543,1365
2021,Croydon 019B,E01001008,1573,445,1128
2021,Croydon 019C,E01001009,1884,512,1372
2021,Croydon 019D,E01001010,1614,436,1178
2021,Croydon 019E,E01001011,2095,580,1515
2021,Croydon 020A,E01001012,1925,457,1468
2021,Croydon 020B,E01001013,1975,486,1489
2021,Croydon 041A,E01001015,1403,334,1069
2021,Croydon 041B,E01001016,1655,349,1306
2021,Croydon 043A,E01001017,1539,276,1263
2021,Croydon 044A,E01001018,1559,284,1275
2021,Croydon 044B,E01001019,1370,205,1165
2021,Croydon 044C,E01001020,1521,289,1232
2021,Croydon 044D,E01001021,1279,316,963
2021,Croydon 044E,E01001022,1409,218,1191
2021,Croydon 041C,E01001023,2352,466,1886
2021,Croydon 043B,E01001024,1260,234,1026
2021,Croydon 043C,E01001025,1256,241,1015
2021,Croydon 043D,E01001026,1735,399,1336
2021,Croydon 043E,E01001027,2626,604,2022
2021,Croydon 038A,E01001028,1591,304,1287
2021,Croydon 038B,E01001029,1608,269,1339
2021,Croydon 038C,E01001030,1379,288,1091
2021,Croydon 038D,E01001031,1385,265,1120
2021,Croydon 035A,E01001032,1477,308,1169
2021,Croydon 031A,E01001033,1542,267,1275
2021,Croydon 031B,E01001034,1481,273,1208
2021,Croydon 047C,E01001035,1727,275,1452
2021,Croydon 029A,E01001036,1549,258,1291
2021,Croydon 029B,E01001037,1393,275,1118
2021,Croydon 029C,E01001038,1785,299,1486
2021,Croydon 029D,E01001039,1472,299,1173
2021,Croydon 029E,E01001040,1594,332,1262
2021,Croydon 031C,E01001041,1609,368,1241
2021,Croydon 024B,E01001042,1998,406,1592
2021,Croydon 023A,E01001044,1953,418,1535
2021,Croydon 023B,E01001046,1768,371,1397
2021,Croydon 047A,E01001047,1605,270,1335
2021,Croydon 023C,E01001049,1360,223,1137
2021,Croydon 023D,E01001050,1618,313,1305
2021,Croydon 030A,E01001051,1496,480,1016
2021,Croydon 030B,E01001052,1402,471,931
2021,Croydon 032A,E01001053,1500,394,1106
2021,Croydon 030C,E01001054,1753,546,1207
2021,Croydon 032B,E01001055,1493,373,1120
2021,Croydon 030D,E01001056,1693,648,1045
2021,Croydon 030E,E01001057,1676,655,1021
2021,Croydon 034A,E01001058,1272,269,1003
2021,Croydon 034B,E01001059,1338,264,1074
2021,Croydon 034C,E01001060,1510,328,1182
2021,Croydon 034D,E01001061,1527,284,1243
2021,Croydon 026A,E01001062,1460,246,1214
2021,Croydon 026B,E01001063,1455,260,1195
2021,Croydon 026C,E01001064,1536,256,1280
2021,Croydon 034E,E01001065,1270,178,1092
2021,Croydon 034F,E01001066,1377,376,1001
2021,Croydon 041D,E01001067,1576,320,1256
2021,Croydon 042A,E01001068,1716,315,1401
2021,Croydon 040A,E01001069,1275,226,1049
2021,Croydon 040B,E01001070,1684,398,1286
2021,Croydon 042B,E01001071,1791,353,1438
2021,Croydon 042C,E01001072,1416,217,1199
2021,Croydon 037A,E01001073,1325,232,1093
2021,Croydon 041E,E01001074,1814,394,1420
2021,Croydon 040C,E01001075,1521,302,1219
2021,Croydon 036A,E01001076,1545,448,1097
2021,Croydon 032C,E01001077,1266,256,1010
2021,Croydon 032D,E01001078,1372,364,1008
2021,Croydon 036B,E01001079,1531,387,1144
2021,Croydon 036C,E01001080,1394,335,1059
2021,Croydon 036D,E01001081,1396,375,1021
2021,Croydon 032E,E01001082,1453,365,1088
2021,Croydon 003A,E01001083,1543,289,1254
2021,Croydon 002A,E01001084,1835,353,1482
2021,Croydon 004A,E01001085,1613,310,1303
2021,Croydon 003B,E01001086,1634,276,1358
2021,Croydon 003C,E01001087,2582,494,2088
2021,Croydon 004B,E01001088,1601,363,1238
2021,Croydon 004C,E01001089,1696,411,1285
2021,Croydon 004D,E01001090,2133,485,1648
2021,Croydon 004E,E01001091,1506,308,1198
2021,Croydon 037B,E01001092,1833,312,1521
2021,Croydon 037C,E01001093,1688,353,1335
2021,Croydon 038E,E01001094,1580,308,1272
2021,Croydon 031D,E01001095,1412,341,1071
2021,Croydon 037D,E01001096,1391,247,1144
2021,Croydon 037E,E01001097,2223,382,1841
2021,Croydon 037F,E01001098,1393,272,1121
2021,Croydon 040D,E01001099,1471,339,1132
2021,Croydon 031E,E01001100,1413,254,1159
2021,Croydon 035B,E01001101,1341,257,1084
2021,Croydon 035C,E01001102,1440,269,1171
2021,Croydon 039A,E01001103,1554,278,1276
2021,Croydon 042D,E01001104,1579,291,1288
2021,Croydon 039B,E01001105,1654,369,1285
2021,Croydon 039C,E01001106,1426,290,1136
2021,Croydon 035D,E01001107,1581,280,1301
2021,Croydon 035E,E01001108,1695,342,1353
2021,Croydon 013B,E01001109,2168,557,1611
2021,Croydon 020D,E01001110,1966,501,1465
2021,Croydon 010D,E01001111,1633,372,1261
2021,Croydon 013C,E01001112,1858,420,1438
2021,Croydon 013D,E01001113,1813,340,1473
2021,Croydon 013E,E01001114,1407,396,1011
2021,Croydon 015B,E01001115,1682,483,1199
2021,Croydon 013F,E01001116,1426,355,1071
2021,Croydon 020E,E01001118,1996,508,1488
2021,Croydon 034G,E01001119,1373,253,1120
2021,Croydon 033A,E01001120,1259,241,1018
2021,Croydon 039D,E01001121,1272,185,1087
2021,Croydon 033B,E01001122,1386,323,1063
2021,Croydon 033C,E01001123,1551,292,1259
2021,Croydon 033D,E01001124,1503,232,1271
2021,Croydon 033E,E01001125,1567,339,1228
2021,Croydon 034H,E01001126,1333,199,1134
2021,Croydon 025A,E01001127,1547,270,1277
2021,Croydon 025B,E01001128,1512,479,1033
2021,Croydon 026D,E01001129,1349,238,1111
2021,Croydon 025C,E01001130,1630,653,977
2021,Croydon 018C,E01001131,1460,323,1137
2021,Croydon 018D,E01001132,1546,264,1282
2021,Croydon 026E,E01001133,1527,196,1331
2021,Croydon 018E,E01001134,1523,257,1266
2021,Croydon 025D,E01001135,1612,298,1314
2021,Croydon 007A,E01001136,1882,311,1571
2021,Croydon 001A,E01001137,1949,315,1634
2021,Croydon 001B,E01001138,1411,271,1140
2021,Croydon 007B,E01001139,1575,312,1263
2021,Croydon 007C,E01001140,1515,275,1240
2021,Croydon 008A,E01001141,1206,249,957
2021,Croydon 007D,E01001142,1827,407,1420
2021,Croydon 008B,E01001143,1785,362,1423
2021,Croydon 007E,E01001144,1651,330,1321
2021,Croydon 008C,E01001145,1696,435,1261
2021,Croydon 006A,E01001146,1453,317,1136
2021,Croydon 005A,E01001147,1657,429,1228
2021,Croydon 005B,E01001148,1656,389,1267
2021,Croydon 006B,E01001149,1462,355,1107
2021,Croydon 006C,E01001150,1599,343,1256
2021,Croydon 005C,E01001151,1640,389,1251
2021,Croydon 005D,E01001152,1922,454,1468
2021,Croydon 006D,E01001153,1557,313,1244
2021,Croydon 006E,E01001154,1831,442,1389
2021,Croydon 010E,E01001155,1663,375,1288
2021,Croydon 001C,E01001156,1660,331,1329
2021,Croydon 002B,E01001157,1744,419,1325
2021,Croydon 005E,E01001158,1435,290,1145
2021,Croydon 002C,E01001159,1809,387,1422
2021,Croydon 002D,E01001160,1844,432,1412
2021,Croydon 003D,E01001161,1669,394,1275
2021,Croydon 001D,E01001162,1708,380,1328
2021,Croydon 002E,E01001163,1842,346,1496
2021,Croydon 001E,E01001164,1858,260,1598
2021,Croydon 024C,E01001165,1732,363,1369
2021,Croydon 024D,E01001166,1833,451,1382
2021,Croydon 028A,E01001167,2176,562,1614
2021,Croydon 024E,E01001168,1723,340,1383
2021,Croydon 028B,E01001169,1699,475,1224
2021,Croydon 047D,E01001170,1818,373,1445
2021,Croydon 028C,E01001171,1643,374,1269
2021,Croydon 028D,E01001172,2087,640,1447
2021,Croydon 028E,E01001173,2554,569,1985
2021,Croydon 011A,E01001174,1591,421,1170
2021,Croydon 011B,E01001175,1530,379,1151
2021,Croydon 011C,E01001176,1717,417,1300
2021,Croydon 016C,E01001177,1574,429,1145
2021,Croydon 015D,E01001178,1467,376,1091
2021,Croydon 016D,E01001179,1539,409,1130
2021,Croydon 016E,E01001180,1845,565,1280
2021,Croydon 015E,E01001181,1954,587,1367
2021,Croydon 011D,E01001182,1286,264,1022
2021,Croydon 011E,E01001183,1673,431,1242
2021,Croydon 011F,E01001184,1228,221,1007
2021,Croydon 014B,E01001185,1591,319,1272
2021,Croydon 014C,E01001186,1588,332,1256
2021,Croydon 017E,E01001187,1868,440,1428
2021,Croydon 014D,E01001188,1791,432,1359
2021,Croydon 045B,E01001189,1132,248,884
2021,Croydon 045C,E01001190,1453,322,1131
2021,Croydon 008D,E01001191,1921,451,1470
2021,Croydon 008E,E01001192,1482,317,1165
2021,Croydon 014E,E01001193,1624,396,1228
2021,Croydon 045D,E01001194,1493,324,1169
2021,Ealing 021A,E01001195,1712,395,1317
2021,Ealing 015A,E01001196,1522,338,1184
2021,Ealing 021B,E01001197,1770,448,1322
2021,Ealing 021C,E01001198,1450,306,1144
2021,Ealing 021D,E01001199,1569,314,1255
2021,Ealing 025A,E01001200,1490,316,1174
2021,Ealing 025B,E01001201,1499,287,1212
2021,Ealing 025C,E01001202,2339,581,1758
2021,Ealing 025D,E01001203,1594,281,1313
2021,Ealing 018A,E01001204,1538,332,1206
2021,Ealing 018B,E01001205,1646,414,1232
2021,Ealing 018C,E01001206,1449,491,958
2021,Ealing 018D,E01001207,1638,271,1367
2021,Ealing 018E,E01001208,1306,303,1003
2021,Ealing 013A,E01001209,1588,331,1257
2021,Ealing 016A,E01001210,1754,471,1283
2021,Ealing 013B,E01001211,1663,346,1317
2021,Ealing 018F,E01001212,1709,315,1394
2021,Ealing 023A,E01001213,1904,426,1478
2021,Ealing 023B,E01001214,1670,372,1298
2021,Ealing 023C,E01001215,1960,480,1480
2021,Ealing 023D,E01001216,1651,451,1200
2021,Ealing 014A,E01001217,1386,303,1083
2021,Ealing 012A,E01001218,1897,479,1418
2021,Ealing 029A,E01001219,2060,599,1461
2021,Ealing 029B,E01001220,1427,433,994
2021,Ealing 041B,E01001223,1370,215,1155
2021,Ealing 019B,E01001224,1492,293,1199
2021,Ealing 041A,E01001225,1738,335,1403
2021,Ealing 019C,E01001226,1429,218,1211
2021,Ealing 019D,E01001227,1453,273,1180
2021,Ealing 019E,E01001228,1753,264,1489
2021,Ealing 031A,E01001229,1433,306,1127
2021,Ealing 031B,E01001230,1303,213,1090
2021,Ealing 027A,E01001231,1956,434,1522
2021,Ealing 031C,E01001232,1490,327,1163
2021,Ealing 031D,E01001233,1357,229,1128
2021,Ealing 027B,E01001234,1312,232,1080
2021,Ealing 042D,E01001235,1687,265,1422
2021,Ealing 042C,E01001236,1401,218,1183
2021,Ealing 031E,E01001237,1488,201,1287
2021,Ealing 015C,E01001239,1398,297,1101
2021,Ealing 024A,E01001240,1761,330,1431
2021,Ealing 024B,E01001241,1776,361,1415
2021,Ealing 024C,E01001242,1534,355,1179
2021,Ealing 024D,E01001243,2244,545,1699
2021,Ealing 024E,E01001244,2607,635,1972
2021,Ealing 024F,E01001245,1974,350,1624
2021,Ealing 015D,E01001246,1727,327,1400
2021,Ealing 015E,E01001247,2166,519,1647
2021,Ealing 035A,E01001248,1527,319,1208
2021,Ealing 028A,E01001249,2271,493,1778
2021,Ealing 028B,E01001250,2033,403,1630
2021,Ealing 030A,E01001251,1698,374,1324
2021,Ealing 030B,E01001252,2306,488,1818
2021,Ealing 030C,E01001253,2003,491,1512
2021,Ealing 030D,E01001254,1647,350,1297
2021,Ealing 028C,E01001255,1491,354,1137
2021,Ealing 008A,E01001257,2069,591,1478
2021,Ealing 010B,E01001258,1750,405,1345
2021,Ealing 014B,E01001259,1493,334,1159
2021,Ealing 012B,E01001260,1928,409,1519
2021,Ealing 012C,E01001261,2181,460,1721
2021,Ealing 010C,E01001262,1541,373,1168
2021,Ealing 010D,E01001263,1807,449,1358
2021,Ealing 010E,E01001264,1727,410,1317
2021,Ealing 006A,E01001265,1615,340,1275
2021,Ealing 006B,E01001266,1750,342,1408
2021,Ealing 006C,E01001267,1923,450,1473
2021,Ealing 012D,E01001268,1860,426,1434
2021,Ealing 001A,E01001269,2147,499,1648
2021,Ealing 004A,E01001270,1687,416,1271
2021,Ealing 001B,E01001271,1801,448,1353
2021,Ealing 006D,E01001272,1625,353,1272
2021,Ealing 041C,E01001273,1599,352,1247
2021,Ealing 041E,E01001274,1498,402,1096
2021,Ealing 041D,E01001275,1710,253,1457
2021,Ealing 011A,E01001276,1687,344,1343
2021,Ealing 011B,E01001277,1833,371,1462
2021,Ealing 011C,E01001278,1931,447,1484
2021,Ealing 013C,E01001279,1422,304,1118
2021,Ealing 011D,E01001280,1692,351,1341
2021,Ealing 013D,E01001281,1496,332,1164
2021,Ealing 016B,E01001282,1508,349,1159
2021,Ealing 016C,E01001283,1670,326,1344
2021,Ealing 022A,E01001284,1651,438,1213
2021,Ealing 016D,E01001285,1673,433,1240
2021,Ealing 016E,E01001286,1577,427,1150
2021,Ealing 016F,E01001287,1532,497,1035
2021,Ealing 022B,E01001288,1382,343,1039
2021,Ealing 022C,E01001289,1271,296,975
2021,Ealing 022D,E01001290,1935,398,1537
2021,Ealing 014C,E01001291,1658,400,1258
2021,Ealing 014D,E01001292,1605,327,1278
2021,Ealing 014E,E01001293,1722,443,1279
2021,Ealing 017A,E01001294,1909,427,1482
2021,Ealing 017B,E01001295,1709,374,1335
2021,Ealing 017C,E01001296,1366,306,1060
2021,Ealing 017D,E01001297,1742,435,1307
2021,Ealing 017E,E01001298,2034,444,1590
2021,Ealing 035B,E01001299,1677,379,1298
2021,Ealing 039A,E01001300,1509,345,1164
2021,Ealing 039B,E01001301,1800,400,1400
2021,Ealing 039C,E01001302,1513,331,1182
2021,Ealing 032A,E01001303,1621,379,1242
2021,Ealing 039D,E01001304,1517,286,1231
2021,Ealing 035C,E01001305,1656,389,1267
2021,Ealing 035D,E01001306,1524,314,1210
2021,Ealing 002A,E01001307,1770,379,1391
2021,Ealing 002B,E01001308,1857,330,1527
2021,Ealing 001C,E01001309,1760,417,1343
2021,Ealing 001D,E01001310,2032,430,1602
2021,Ealing 001E,E01001311,2349,494,1855
2021,Ealing 002C,E01001312,1863,416,1447
2021,Ealing 002D,E01001313,1650,357,1293
2021,Ealing 002E,E01001314,1452,318,1134
2021,Ealing 003A,E01001315,1384,300,1084
2021,Ealing 003B,E01001316,1606,412,1194
2021,Ealing 003C,E01001317,2048,554,1494
2021,Ealing 003D,E01001318,1832,438,1394
2021,Ealing 004B,E01001319,1456,292,1164
2021,Ealing 003E,E01001320,1502,449,1053
2021,Ealing 003F,E01001321,2124,506,1618
2021,Ealing 004C,E01001322,1956,470,1486
2021,Ealing 004D,E01001323,1857,447,1410
2021,Ealing 008B,E01001324,1522,351,1171
2021,Ealing 009A,E01001325,1871,500,1371
2021,Ealing 008C,E01001326,1738,437,1301
2021,Ealing 009B,E01001327,1783,441,1342
2021,Ealing 009C,E01001328,1721,480,1241
2021,Ealing 009D,E01001329,1831,509,1322
2021,Ealing 008D,E01001330,1715,482,1233
2021,Ealing 009E,E01001331,1637,482,1155
2021,Ealing 008E,E01001332,1458,384,1074
2021,Ealing 038A,E01001333,2323,587,1736
2021,Ealing 029C,E01001334,1555,439,1116
2021,Ealing 038B,E01001335,1712,359,1353
2021,Ealing 038C,E01001336,1745,349,1396
2021,Ealing 029D,E01001337,1988,404,1584
2021,Ealing 029E,E01001338,1761,386,1375
2021,Ealing 029F,E01001339,2035,503,1532
2021,Ealing 029G,E01001340,1454,288,1166
2021,Ealing 005A,E01001341,1702,397,1305
2021,Ealing 005B,E01001342,1798,364,1434
2021,Ealing 005C,E01001343,1363,257,1106
2021,Ealing 007A,E01001344,2136,435,1701
2021,Ealing 005D,E01001345,1677,415,1262
2021,Ealing 007B,E01001346,1860,448,1412
2021,Ealing 007C,E01001347,1888,389,1499
2021,Ealing 007D,E01001348,1552,318,1234
2021,Ealing 006E,E01001349,1339,294,1045
2021,Ealing 027C,E01001350,1373,245,1128
2021,Ealing 025E,E01001351,1855,377,1478
2021,Ealing 027D,E01001352,1517,262,1255
2021,Ealing 033A,E01001353,1347,241,1106
2021,Ealing 027E,E01001354,1962,299,1663
2021,Ealing 033B,E01001355,1844,292,1552
2021,Ealing 033C,E01001356,1362,372,990
2021,Ealing 033D,E01001357,2544,495,2049
2021,Ealing 033E,E01001358,1810,379,1431
2021,Ealing 026A,E01001359,2339,606,1733
2021,Ealing 026B,E01001360,2116,446,1670
2021,Ealing 023E,E01001361,2132,549,1583
2021,Ealing 026C,E01001362,2459,666,1793
2021,Ealing 026D,E01001363,1852,517,1335
2021,Ealing 026E,E01001364,1728,436,1292
2021,Ealing 026F,E01001365,2441,581,1860
2021,Ealing 044C,E01001366,1919,522,1397
2021,Ealing 043B,E01001367,2528,685,1843
2021,Ealing 044D,E01001368,1691,406,1285
2021,Ealing 038D,E01001369,1949,513,1436
2021,Ealing 044A,E01001370,2057,504,1553
2021,Ealing 044B,E01001371,2164,580,1584
2021,Ealing 043C,E01001372,2362,628,1734
2021,Ealing 043A,E01001373,1966,510,1456
2021,Ealing 040A,E01001374,1830,307,1523
2021,Ealing 034A,E01001375,1591,292,1299
2021,Ealing 040B,E01001376,1588,303,1285
2021,Ealing 034B,E01001377,1568,313,1255
2021,Ealing 034C,E01001379,1614,328,1286
2021,Ealing 040C,E01001380,2166,334,1832
2021,Ealing 034D,E01001381,1752,325,1427
2021,Ealing 032B,E01001382,1394,305,1089
2021,Ealing 028D,E01001383,1655,316,1339
2021,Ealing 032C,E01001384,1614,288,1326
2021,Ealing 032D,E01001385,1564,310,1254
2021,Ealing 031F,E01001386,1705,331,1374
2021,Ealing 032E,E01001387,1463,189,1274
2021,Ealing 028E,E01001388,1362,257,1105
2021,Ealing 028F,E01001389,1702,276,1426
2021,Enfield 036A,E01001390,1711,272,1439
2021,Enfield 036B,E01001391,1661,304,1357
2021,Enfield 032A,E01001392,1763,320,1443
2021,Enfield 036C,E01001393,1844,323,1521
2021,Enfield 035A,E01001394,1922,363,1559
2021,Enfield 035B,E01001395,1557,356,1201
2021,Enfield 036D,E01001396,1387,240,1147
2021,Enfield 035C,E01001397,1978,454,1524
2021,Enfield 021A,E01001398,1263,253,1010
2021,Enfield 021B,E01001399,1412,279,1133
2021,Enfield 021C,E01001400,1490,230,1260
2021,Enfield 016A,E01001401,1317,316,1001
2021,Enfield 021D,E01001402,1756,293,1463
2021,Enfield 021E,E01001403,1574,291,1283
2021,Enfield 026A,E01001404,1388,288,1100
2021,Enfield 015A,E01001405,1701,226,1475
2021,Enfield 015B,E01001406,1526,308,1218
2021,Enfield 005A,E01001407,1509,357,1152
2021,Enfield 004A,E01001408,1534,322,1212
2021,Enfield 005B,E01001409,1879,467,1412
2021,Enfield 005C,E01001410,2038,609,1429
2021,Enfield 004B,E01001411,1769,430,1339
2021,Enfield 004C,E01001412,1640,319,1321
2021,Enfield 004D,E01001413,1549,309,1240
2021,Enfield 004E,E01001414,1559,406,1153
2021,Enfield 011A,E01001415,1896,354,1542
2021,Enfield 013A,E01001416,1649,326,1323
2021,Enfield 011B,E01001417,1806,330,1476
2021,Enfield 011C,E01001418,1653,328,1325
2021,Enfield 020A,E01001419,1851,375,1476
2021,Enfield 020B,E01001420,1691,419,1272
2021,Enfield 020C,E01001421,1560,325,1235
2021,Enfield 011D,E01001422,1609,306,1303
2021,Enfield 027A,E01001423,1612,422,1190
2021,Enfield 030A,E01001424,1119,289,830
2021,Enfield 027B,E01001425,1852,563,1289
2021,Enfield 030B,E01001426,1704,474,1230
2021,Enfield 030C,E01001427,1633,452,1181
2021,Enfield 027C,E01001428,1627,451,1176
2021,Enfield 030D,E01001429,2143,553,1590
2021,Enfield 030E,E01001430,1865,626,1239
2021,Enfield 033A,E01001431,1646,493,1153
2021,Enfield 033B,E01001432,1748,421,1327
2021,Enfield 007A,E01001433,1718,529,1189
2021,Enfield 007B,E01001434,1495,409,1086
2021,Enfield 007C,E01001435,1431,364,1067
2021,Enfield 007D,E01001436,1806,483,1323
2021,Enfield 014A,E01001437,2109,607,1502
2021,Enfield 007E,E01001438,1564,398,1166
2021,Enfield 006A,E01001439,1960,584,1376
2021,Enfield 012A,E01001440,1575,440,1135
2021,Enfield 006B,E01001441,1505,431,1074
2021,Enfield 002A,E01001442,1607,493,1114
2021,Enfield 001A,E01001444,1760,522,1238
2021,Enfield 003B,E01001445,2522,687,1835
2021,Enfield 001B,E01001446,1735,459,1276
2021,Enfield 003C,E01001447,1869,504,1365
2021,Enfield 003D,E01001448,1848,580,1268
2021,Enfield 003E,E01001449,1571,485,1086
2021,Enfield 015C,E01001450,2216,419,1797
2021,Enfield 017A,E01001451,1592,255,1337
2021,Enfield 017B,E01001452,1308,264,1044
2021,Enfield 017C,E01001453,1579,318,1261
2021,Enfield 017D,E01001454,1623,356,1267
2021,Enfield 021F,E01001455,1368,259,1109
2021,Enfield 022A,E01001456,1334,271,1063
2021,Enfield 010A,E01001457,1723,316,1407
2021,Enfield 037A,E01001458,1658,462,1196
2021,Enfield 024A,E01001459,1629,417,1212
2021,Enfield 024B,E01001460,1907,613,1294
2021,Enfield 027D,E01001461,1461,351,1110
2021,Enfield 024C,E01001462,1349,280,1069
2021,Enfield 031A,E01001463,1489,353,1136
2021,Enfield 027E,E01001464,1251,304,947
2021,Enfield 031B,E01001465,1474,334,1140
2021,Enfield 031C,E01001466,1848,599,1249
2021,Enfield 031D,E01001467,1879,598,1281
2021,Enfield 010B,E01001468,1324,269,1055
2021,Enfield 008A,E01001469,1658,356,1302
2021,Enfield 013B,E01001470,1581,322,1259
2021,Enfield 010C,E01001471,1790,304,1486
2021,Enfield 010D,E01001472,1562,296,1266
2021,Enfield 013C,E01001473,1499,338,1161
2021,Enfield 010E,E01001474,1792,304,1488
2021,Enfield 013D,E01001475,1721,359,1362
2021,Enfield 018A,E01001476,1643,422,1221
2021,Enfield 018B,E01001477,1883,537,1346
2021,Enfield 016B,E01001478,1568,372,1196
2021,Enfield 023A,E01001479,1658,436,1222
2021,Enfield 024D,E01001480,1436,306,1130
2021,Enfield 018C,E01001481,1692,452,1240
2021,Enfield 023B,E01001482,1788,512,1276
2021,Enfield 025A,E01001483,1075,277,798
2021,Enfield 016C,E01001484,1306,328,978
2021,Enfield 025B,E01001485,1763,518,1245
2021,Enfield 025C,E01001486,2022,541,1481
2021,Enfield 023C,E01001487,1829,555,1274
2021,Enfield 024E,E01001488,1860,559,1301
2021,Enfield 023D,E01001489,1755,523,1232
2021,Enfield 023E,E01001491,1839,520,1319
2021,Enfield 025E,E01001492,1919,520,1399
2021,Enfield 026B,E01001493,1822,360,1462
2021,Enfield 026C,E01001494,1400,282,1118
2021,Enfield 029A,E01001495,1731,318,1413
2021,Enfield 026D,E01001496,1806,341,1465
2021,Enfield 031E,E01001497,1363,331,1032
2021,Enfield 029B,E01001498,1715,317,1398
2021,Enfield 031F,E01001499,1461,278,1183
2021,Enfield 035D,E01001500,1454,285,1169
2021,Enfield 036E,E01001501,2039,410,1629
2021,Enfield 018D,E01001502,1854,510,1344
2021,Enfield 018E,E01001503,1769,503,1266
2021,Enfield 012B,E01001504,1952,609,1343
2021,Enfield 012C,E01001505,1864,556,1308
2021,Enfield 012D,E01001507,2437,862,1575
2021,Enfield 012E,E01001508,2254,714,1540
2021,Enfield 014C,E01001509,1630,490,1140
2021,Enfield 016D,E01001511,1776,483,1293
2021,Enfield 015D,E01001512,2104,446,1658
2021,Enfield 012F,E01001513,1817,467,1350
2021,Enfield 016E,E01001514,1641,405,1236
2021,Enfield 015E,E01001515,1887,554,1333
2021,Enfield 005D,E01001516,1982,535,1447
2021,Enfield 006C,E01001517,1934,628,1306
2021,Enfield 016F,E01001518,1594,357,1237
2021,Enfield 019A,E01001520,1733,352,1381
2021,Enfield 028A,E01001521,1775,404,1371
2021,Enfield 019B,E01001522,1697,411,1286
2021,Enfield 019C,E01001523,1715,383,1332
2021,Enfield 019D,E01001524,1476,319,1157
2021,Enfield 020E,E01001525,1868,403,1465
2021,Enfield 019E,E01001526,1535,288,1247
2021,Enfield 036F,E01001527,1880,336,1544
2021,Enfield 032B,E01001528,1571,383,1188
2021,Enfield 032C,E01001529,1670,330,1340
2021,Enfield 032D,E01001530,1623,408,1215
2021,Enfield 028B,E01001531,1357,262,1095
2021,Enfield 028C,E01001532,1575,287,1288
2021,Enfield 028D,E01001533,1576,336,1240
2021,Enfield 032E,E01001534,1602,311,1291
2021,Enfield 028E,E01001535,1339,242,1097
2021,Enfield 008B,E01001536,1867,385,1482
2021,Enfield 005E,E01001537,1590,353,1237
2021,Enfield 009A,E01001538,1586,310,1276
2021,Enfield 009B,E01001539,1547,306,1241
2021,Enfield 008C,E01001540,1744,311,1433
2021,Enfield 008D,E01001541,1411,279,1132
2021,Enfield 008E,E01001542,1460,315,1145
2021,Enfield 009C,E01001543,1530,308,1222
2021,Enfield 009D,E01001544,1608,300,1308
2021,Enfield 002B,E01001545,1766,521,1245
2021,Enfield 001C,E01001546,1701,485,1216
2021,Enfield 002C,E01001547,1988,532,1456
2021,Enfield 002D,E01001548,1803,565,1238
2021,Enfield 006D,E01001549,2132,781,1351
2021,Enfield 006E,E01001550,1643,457,1186
2021,Enfield 002E,E01001551,1695,414,1281
2021,Enfield 001D,E01001552,1838,438,1400
2021,Enfield 037B,E01001553,1647,499,1148
2021,Enfield 037C,E01001554,1681,455,1226
2021,Enfield 033C,E01001555,2096,592,1504
2021,Enfield 035E,E01001556,1507,302,1205
2021,Enfield 033D,E01001557,1596,433,1163
2021,Enfield 033E,E01001558,1872,637,1235
2021,Enfield 033F,E01001559,1961,573,1388
2021,Enfield 035F,E01001560,1480,321,1159
2021,Enfield 037D,E01001562,2072,564,1508
2021,Enfield 029C,E01001563,1603,266,1337
2021,Enfield 022B,E01001564,1546,293,1253
2021,Enfield 029D,E01001565,1592,302,1290
2021,Enfield 029E,E01001566,1672,267,1405
2021,Enfield 022C,E01001567,1450,285,1165
2021,Enfield 022D,E01001568,1812,338,1474
2021,Enfield 022E,E01001569,1648,282,1366
2021,Enfield 026E,E01001570,1762,399,1363
2021,Greenwich 008A,E01001571,1709,422,1287
2021,Greenwich 008B,E01001572,1617,354,1263
2021,Greenwich 008C,E01001573,1501,331,1170
2021,Greenwich 008D,E01001574,1764,482,1282
2021,Greenwich 003A,E01001575,1721,600,1121
2021,Greenwich 003B,E01001576,1876,633,1243
2021,Greenwich 003C,E01001577,1816,519,1297
2021,Greenwich 003D,E01001578,2150,535,1615
2021,Greenwich 003E,E01001579,1633,473,1160
2021,Greenwich 021A,E01001580,1559,253,1306
2021,Greenwich 016A,E01001581,1506,264,1242
2021,Greenwich 021B,E01001582,1451,347,1104
2021,Greenwich 021C,E01001583,1495,234,1261
2021,Greenwich 021D,E01001584,1416,212,1204
2021,Greenwich 016B,E01001585,1427,336,1091
2021,Greenwich 016C,E01001586,1331,224,1107
2021,Greenwich 016D,E01001587,1885,287,1598
2021,Greenwich 012A,E01001588,1618,339,1279
2021,Greenwich 012B,E01001589,1721,407,1314
2021,Greenwich 014A,E01001590,1618,292,1326
2021,Greenwich 012C,E01001591,1938,454,1484
2021,Greenwich 014B,E01001592,1787,339,1448
2021,Greenwich 014C,E01001593,1667,299,1368
2021,Greenwich 014D,E01001594,2248,524,1724
2021,Greenwich 012D,E01001595,2076,609,1467
2021,Greenwich 032A,E01001596,1607,312,1295
2021,Greenwich 031A,E01001597,1467,267,1200
2021,Greenwich 031B,E01001598,1529,258,1271
2021,Greenwich 032B,E01001599,1551,338,1213
2021,Greenwich 032C,E01001600,1415,249,1166
2021,Greenwich 032D,E01001601,1425,245,1180
2021,Greenwich 031C,E01001602,2008,496,1512
2021,Greenwich 031D,E01001603,1625,372,1253
2021,Greenwich 027A,E01001604,1454,300,1154
2021,Greenwich 023A,E01001605,1431,269,1162
2021,Greenwich 023B,E01001606,1510,274,1236
2021,Greenwich 027B,E01001607,1505,280,1225
2021,Greenwich 027C,E01001608,1376,286,1090
2021,Greenwich 027D,E01001609,1593,270,1323
2021,Greenwich 023C,E01001610,1619,319,1300
2021,Greenwich 023D,E01001611,1653,335,1318
2021,Greenwich 028A,E01001613,1645,325,1320
2021,Greenwich 028B,E01001614,1433,267,1166
2021,Greenwich 028C,E01001615,1856,330,1526
2021,Greenwich 028D,E01001617,1532,234,1298
2021,Greenwich 030C,E01001618,1786,385,1401
2021,Greenwich 030D,E01001619,1829,337,1492
2021,Greenwich 025A,E01001620,1511,387,1124
2021,Greenwich 025B,E01001621,1593,325,1268
2021,Greenwich 025C,E01001623,1694,423,1271
2021,Greenwich 025D,E01001624,1520,288,1232
2021,Greenwich 025E,E01001625,1678,436,1242
2021,Greenwich 009A,E01001629,1991,515,1476
2021,Greenwich 007B,E01001631,1937,540,1397
2021,Greenwich 007C,E01001632,1917,394,1523
2021,Greenwich 009B,E01001633,1886,439,1447
2021,Greenwich 009C,E01001634,1629,426,1203
2021,Greenwich 007D,E01001635,1521,304,1217
2021,Greenwich 007E,E01001636,1571,339,1232
2021,Greenwich 009D,E01001637,1684,390,1294
2021,Greenwich 038A,E01001638,1653,406,1247
2021,Greenwich 038B,E01001641,1760,386,1374
2021,Greenwich 038C,E01001642,1628,270,1358
2021,Greenwich 038D,E01001644,2453,472,1981
2021,Greenwich 022A,E01001645,1756,407,1349
2021,Greenwich 019A,E01001646,2604,635,1969
2021,Greenwich 022B,E01001647,1408,265,1143
2021,Greenwich 022C,E01001648,1587,294,1293
2021,Greenwich 022D,E01001649,1479,362,1117
2021,Greenwich 019B,E01001650,1721,428,1293
2021,Greenwich 019C,E01001651,1716,404,1312
2021,Greenwich 019D,E01001652,1627,276,1351
2021,Greenwich 029A,E01001653,1472,377,1095
2021,Greenwich 029B,E01001654,1492,380,1112
2021,Greenwich 029C,E01001655,1466,371,1095
2021,Greenwich 034A,E01001656,1251,277,974
2021,Greenwich 034B,E01001657,1474,271,1203
2021,Greenwich 034C,E01001658,1529,302,1227
2021,Greenwich 034D,E01001659,1489,286,1203
2021,Greenwich 029D,E01001660,1477,364,1113
2021,Greenwich 029E,E01001661,1559,416,1143
2021,Greenwich 037B,E01001664,1967,356,1611
2021,Greenwich 037C,E01001665,1786,330,1456
2021,Greenwich 041G,E01001666,1837,422,1415
2021,Greenwich 033A,E01001669,2323,608,1715
2021,Greenwich 033B,E01001671,1547,365,1182
2021,Greenwich 006A,E01001672,1803,404,1399
2021,Greenwich 006B,E01001673,2177,571,1606
2021,Greenwich 006C,E01001674,2055,501,1554
2021,Greenwich 006D,E01001675,2209,496,1713
2021,Greenwich 033C,E01001676,1678,439,1239
2021,Greenwich 006E,E01001677,2015,563,1452
2021,Greenwich 017A,E01001678,1641,375,1266
2021,Greenwich 020A,E01001679,1265,252,1013
2021,Greenwich 020B,E01001680,1432,257,1175
2021,Greenwich 020C,E01001681,1322,330,992
2021,Greenwich 020D,E01001682,1305,264,1041
2021,Greenwich 017B,E01001683,1428,305,1123
2021,Greenwich 017C,E01001684,1372,296,1076
2021,Greenwich 017D,E01001685,1472,289,1183
2021,Greenwich 020E,E01001686,1676,371,1305
2021,Greenwich 002A,E01001687,1588,322,1266
2021,Greenwich 002B,E01001688,2465,815,1650
2021,Greenwich 001A,E01001690,1616,376,1240
2021,Greenwich 001B,E01001692,1381,419,962
2021,Greenwich 001C,E01001693,1429,435,994
2021,Greenwich 001D,E01001694,1630,461,1169
2021,Greenwich 011A,E01001695,1419,306,1113
2021,Greenwich 011B,E01001696,2408,597,1811
2021,Greenwich 011C,E01001697,2430,649,1781
2021,Greenwich 015A,E01001698,1770,515,1255
2021,Greenwich 015B,E01001699,1327,236,1091
2021,Greenwich 011D,E01001700,2240,653,1587
2021,Greenwich 015C,E01001701,1626,335,1291
2021,Greenwich 015D,E01001702,1406,411,995
2021,Greenwich 011E,E01001703,1904,609,1295
2021,Greenwich 011F,E01001704,1541,333,1208
2021,Greenwich 005A,E01001705,2088,611,1477
2021,Greenwich 005C,E01001708,1585,323,1262
2021,Greenwich 005D,E01001710,1631,453,1178
2021,Greenwich 042A,E01001712,1930,473,1457
2021,Hackney 002A,E01001714,1948,392,1556
2021,Hackney 007A,E01001715,1232,167,1065
2021,Hackney 007B,E01001716,1640,320,1320
2021,Hackney 007C,E01001717,1079,189,890
2021,Hackney 007D,E01001718,1638,237,1401
2021,Hackney 007E,E01001719,1565,320,1245
2021,Hackney 007F,E01001720,1616,282,1334
2021,Hackney 029A,E01001722,2093,530,1563
2021,Hackney 006A,E01001723,1791,433,1358
2021,Hackney 006B,E01001724,2688,420,2268
2021,Hackney 004A,E01001725,1630,582,1048
2021,Hackney 004B,E01001726,1243,398,845
2021,Hackney 006C,E01001727,1810,591,1219
2021,Hackney 029B,E01001728,1610,522,1088
2021,Hackney 019A,E01001729,1855,505,1350
2021,Hackney 019B,E01001730,2582,689,1893
2021,Hackney 017A,E01001731,2497,538,1959
2021,Hackney 019C,E01001732,1752,514,1238
2021,Hackney 015A,E01001733,1758,307,1451
2021,Hackney 017B,E01001734,1747,279,1468
2021,Hackney 019D,E01001735,1512,304,1208
2021,Hackney 012A,E01001736,1478,245,1233
2021,Hackney 012B,E01001737,1651,337,1314
2021,Hackney 012C,E01001738,1657,271,1386
2021,Hackney 012D,E01001739,1879,305,1574
2021,Hackney 014A,E01001740,1479,338,1141
2021,Hackney 009A,E01001741,1353,245,1108
2021,Hackney 008A,E01001742,1661,326,1335
2021,Hackney 031A,E01001744,1898,361,1537
2021,Hackney 016A,E01001745,2033,470,1563
2021,Hackney 016B,E01001746,1565,464,1101
2021,Hackney 014B,E01001747,2235,352,1883
2021,Hackney 020B,E01001749,1420,248,1172
2021,Hackney 031D,E01001750,1992,330,1662
2021,Hackney 031B,E01001751,1397,184,1213
2021,Hackney 025B,E01001753,1413,397,1016
2021,Hackney 025D,E01001755,1587,343,1244
2021,Hackney 030C,E01001756,1938,241,1697
2021,Hackney 016C,E01001757,1501,423,1078
2021,Hackney 016D,E01001758,2452,616,1836
2021,Hackney 016E,E01001759,1575,300,1275
2021,Hackney 017C,E01001760,1815,319,1496
2021,Hackney 016F,E01001761,1735,279,1456
2021,Hackney 017D,E01001762,1604,224,1380
2021,Hackney 020C,E01001763,1683,323,1360
2021,Hackney 010A,E01001764,1688,376,1312
2021,Hackney 010B,E01001765,1722,412,1310
2021,Hackney 010D,E01001767,1521,313,1208
2021,Hackney 006D,E01001768,1748,281,1467
2021,Hackney 006E,E01001769,1449,305,1144
2021,Hackney 010E,E01001770,1628,365,1263
2021,Hackney 024A,E01001772,1666,323,1343
2021,Hackney 025E,E01001773,2358,397,1961
2021,Hackney 024B,E01001774,1906,388,1518
2021,Hackney 024C,E01001775,1562,353,1209
2021,Hackney 025F,E01001776,1630,274,1356
2021,Hackney 033A,E01001777,2558,573,1985
2021,Hackney 032D,E01001780,1730,317,1413
2021,Hackney 026B,E01001781,1529,404,1125
2021,Hackney 026D,E01001783,1520,409,1111
2021,Hackney 032A,E01001784,1688,395,1293
2021,Hackney 015B,E01001785,1475,320,1155
2021,Hackney 013A,E01001786,2093,544,1549
2021,Hackney 013B,E01001787,1529,356,1173
2021,Hackney 013C,E01001788,1429,359,1070
2021,Hackney 015C,E01001789,1609,310,1299
2021,Hackney 013D,E01001790,1420,421,999
2021,Hackney 015D,E01001791,1394,374,1020
2021,Hackney 011A,E01001792,1808,364,1444
2021,Hackney 011B,E01001793,1438,263,1175
2021,Hackney 011C,E01001794,1804,300,1504
2021,Hackney 011D,E01001795,1249,244,1005
2021,Hackney 011E,E01001796,1400,232,1168
2021,Hackney 028A,E01001798,2086,574,1512
2021,Hackney 003A,E01001799,1296,471,825
2021,Hackney 004C,E01001800,1522,460,1062
2021,Hackney 008B,E01001801,1503,459,1044
2021,Hackney 003B,E01001802,1254,339,915
2021,Hackney 008C,E01001803,1717,364,1353
2021,Hackney 003C,E01001804,1444,550,894
2021,Hackney 009B,E01001805,1145,230,915
2021,Hackney 008D,E01001806,1390,248,1142
2021,Hackney 003D,E01001807,1661,542,1119
2021,Hackney 001A,E01001808,1428,481,947
2021,Hackney 001B,E01001809,1688,605,1083
2021,Hackney 002D,E01001811,1634,478,1156
2021,Hackney 003E,E01001812,1589,538,1051
2021,Hackney 002E,E01001813,1753,408,1345
2021,Hackney 001C,E01001814,1501,523,978
2021,Hackney 024D,E01001815,1684,368,1316
2021,Hackney 020D,E01001816,1465,304,1161
2021,Hackney 020E,E01001819,1510,252,1258
2021,Hackney 024E,E01001820,1329,291,1038
2021,Hackney 024F,E01001821,1280,272,1008
2021,Hackney 029C,E01001822,1750,570,1180
2021,Hackney 001D,E01001823,1470,490,980
2021,Hackney 004D,E01001824,1422,530,892
2021,Hackney 001E,E01001825,1188,425,763
2021,Hackney 004E,E01001826,1380,483,897
2021,Hackney 029D,E01001827,1510,476,1034
2021,Hackney 028B,E01001828,1895,501,1394
2021,Hackney 009C,E01001829,1643,330,1313
2021,Hackney 014C,E01001830,1798,281,1517
2021,Hackney 009D,E01001831,1623,202,1421
2021,Hackney 009E,E01001832,1585,290,1295
2021,Hackney 014D,E01001833,2008,389,1619
2021,Hackney 014E,E01001834,1881,311,1570
2021,Hackney 014F,E01001835,1167,176,991
2021,Hackney 022A,E01001836,1770,326,1444
2021,Hackney 023B,E01001837,1378,234,1144
2021,Hackney 019E,E01001838,1695,515,1180
2021,Hackney 023C,E01001839,2247,372,1875
2021,Hackney 022B,E01001840,1514,333,1181
2021,Hackney 022C,E01001841,1295,255,1040
2021,Hackney 023D,E01001842,1451,320,1131
2021,Hackney 023E,E01001843,1143,255,888
2021,Hackney 022D,E01001844,1824,451,1373
2021,Hackney 022E,E01001845,1514,329,1185
2021,Hackney 018A,E01001846,1163,220,943
2021,Hackney 018B,E01001847,1271,237,1034
2021,Hackney 018C,E01001848,1866,442,1424
2021,Hackney 018D,E01001849,2342,444,1898
2021,Hackney 019F,E01001850,1749,543,1206
2021,Hammersmith and Fulham 010A,E01001851,1379,293,1086
2021,Hammersmith and Fulham 007A,E01001852,1577,219,1358
2021,Hammersmith and Fulham 007B,E01001853,1431,274,1157
2021,Hammersmith and Fulham 007C,E01001854,1688,286,1402
2021,Hammersmith and Fulham 010B,E01001855,1579,227,1352
2021,Hammersmith and Fulham 010C,E01001856,1569,329,1240
2021,Hammersmith and Fulham 007D,E01001857,1466,280,1186
2021,Hammersmith and Fulham 006A,E01001858,1691,452,1239
2021,Hammersmith and Fulham 008A,E01001859,2521,576,1945
2021,Hammersmith and Fulham 006B,E01001860,1623,332,1291
2021,Hammersmith and Fulham 006C,E01001861,1306,244,1062
2021,Hammersmith and Fulham 005A,E01001862,1677,291,1386
2021,Hammersmith and Fulham 006D,E01001863,1336,252,1084
2021,Hammersmith and Fulham 006E,E01001864,1415,252,1163
2021,Hammersmith and Fulham 008B,E01001865,1476,276,1200
2021,Hammersmith and Fulham 012A,E01001866,1461,339,1122
2021,Hammersmith and Fulham 012B,E01001867,1097,240,857
2021,Hammersmith and Fulham 012C,E01001868,1217,241,976
2021,Hammersmith and Fulham 010D,E01001869,1294,287,1007
2021,Hammersmith and Fulham 012D,E01001870,1634,337,1297
2021,Hammersmith and Fulham 012E,E01001871,1434,276,1158
2021,Hammersmith and Fulham 012F,E01001872,1306,192,1114
2021,Hammersmith and Fulham 010E,E01001873,1418,268,1150
2021,Hammersmith and Fulham 001B,E01001875,1749,446,1303
2021,Hammersmith and Fulham 001C,E01001876,2273,405,1868
2021,Hammersmith and Fulham 001D,E01001877,1268,221,1047
2021,Hammersmith and Fulham 001E,E01001878,1543,376,1167
2021,Hammersmith and Fulham 019A,E01001879,1369,229,1140
2021,Hammersmith and Fulham 017A,E01001880,1404,211,1193
2021,Hammersmith and Fulham 017B,E01001881,1790,329,1461
2021,Hammersmith and Fulham 017C,E01001882,1571,286,1285
2021,Hammersmith and Fulham 017D,E01001883,1780,337,1443
2021,Hammersmith and Fulham 017E,E01001884,1749,330,1419
2021,Hammersmith and Fulham 015A,E01001885,1220,308,912
2021,Hammersmith and Fulham 016A,E01001886,1455,313,1142
2021,Hammersmith and Fulham 016B,E01001887,1406,315,1091
2021,Hammersmith and Fulham 018A,E01001888,1490,348,1142
2021,Hammersmith and Fulham 014A,E01001889,1324,278,1046
2021,Hammersmith and Fulham 016C,E01001890,1666,396,1270
2021,Hammersmith and Fulham 018B,E01001891,2424,511,1913
2021,Hammersmith and Fulham 016D,E01001892,1248,279,969
2021,Hammersmith and Fulham 013A,E01001893,1420,328,1092
2021,Hammersmith and Fulham 013B,E01001894,1327,219,1108
2021,Hammersmith and Fulham 009A,E01001895,1374,260,1114
2021,Hammersmith and Fulham 009B,E01001896,1335,197,1138
2021,Hammersmith and Fulham 009C,E01001897,1225,240,985
2021,Hammersmith and Fulham 013C,E01001898,2002,491,1511
2021,Hammersmith and Fulham 013D,E01001899,1525,289,1236
2021,Hammersmith and Fulham 013E,E01001900,1642,400,1242
2021,Hammersmith and Fulham 019B,E01001901,1537,312,1225
2021,Hammersmith and Fulham 019C,E01001902,1571,252,1319
2021,Hammersmith and Fulham 019D,E01001903,1372,292,1080
2021,Hammersmith and Fulham 022A,E01001904,1522,286,1236
2021,Hammersmith and Fulham 022B,E01001905,1557,327,1230
2021,Hammersmith and Fulham 022C,E01001906,1342,217,1125
2021,Hammersmith and Fulham 022D,E01001907,1174,234,940
2021,Hammersmith and Fulham 015B,E01001908,1343,207,1136
2021,Hammersmith and Fulham 015C,E01001909,1702,320,1382
2021,Hammersmith and Fulham 014B,E01001910,1272,177,1095
2021,Hammersmith and Fulham 015D,E01001911,1619,409,1210
2021,Hammersmith and Fulham 015E,E01001912,1386,399,987
2021,Hammersmith and Fulham 014C,E01001913,1349,239,1110
2021,Hammersmith and Fulham 014D,E01001914,1463,250,1213
2021,Hammersmith and Fulham 024A,E01001915,1380,283,1097
2021,Hammersmith and Fulham 024B,E01001916,1178,176,1002
2021,Hammersmith and Fulham 018C,E01001917,1421,302,1119
2021,Hammersmith and Fulham 018D,E01001918,1429,315,1114
2021,Hammersmith and Fulham 018E,E01001919,1468,317,1151
2021,Hammersmith and Fulham 020A,E01001920,1398,224,1174
2021,Hammersmith and Fulham 020B,E01001921,1376,254,1122
2021,Hammersmith and Fulham 020C,E01001922,1509,331,1178
2021,Hammersmith and Fulham 020D,E01001923,1443,272,1171
2021,Hammersmith and Fulham 020E,E01001924,1452,315,1137
2021,Hammersmith and Fulham 025A,E01001925,1471,353,1118
2021,Hammersmith and Fulham 024C,E01001926,1265,207,1058
2021,Hammersmith and Fulham 008C,E01001927,1300,305,995
2021,Hammersmith and Fulham 011A,E01001928,1722,535,1187
2021,Hammersmith and Fulham 009D,E01001929,1239,245,994
2021,Hammersmith and Fulham 008D,E01001930,1663,292,1371
2021,Hammersmith and Fulham 011B,E01001931,1249,219,1030
2021,Hammersmith and Fulham 011C,E01001932,1503,267,1236
2021,Hammersmith and Fulham 011D,E01001933,1432,202,1230
2021,Hammersmith and Fulham 025B,E01001934,1848,440,1408
2021,Hammersmith and Fulham 023A,E01001935,1915,310,1605
2021,Hammersmith and Fulham 025C,E01001937,1673,326,1347
2021,Hammersmith and Fulham 025D,E01001938,1506,379,1127
2021,Hammersmith and Fulham 005B,E01001940,1459,255,1204
2021,Hammersmith and Fulham 005C,E01001941,1525,240,1285
2021,Hammersmith and Fulham 005D,E01001942,1758,268,1490
2021,Hammersmith and Fulham 004A,E01001943,2136,427,1709
2021,Hammersmith and Fulham 004B,E01001944,1576,395,1181
2021,Hammersmith and Fulham 004C,E01001945,1579,284,1295
2021,Hammersmith and Fulham 004D,E01001946,1792,347,1445
2021,Hammersmith and Fulham 021A,E01001947,1342,331,1011
2021,Hammersmith and Fulham 021B,E01001948,1761,336,1425
2021,Hammersmith and Fulham 021C,E01001949,1390,284,1106
2021,Hammersmith and Fulham 021D,E01001950,1406,343,1063
2021,Hammersmith and Fulham 021E,E01001951,1444,266,1178
2021,Hammersmith and Fulham 024D,E01001952,1593,276,1317
2021,Hammersmith and Fulham 021F,E01001953,1408,272,1136
2021,Hammersmith and Fulham 003A,E01001954,1429,315,1114
2021,Hammersmith and Fulham 002A,E01001955,1989,478,1511
2021,Hammersmith and Fulham 003B,E01001956,1504,354,1150
2021,Hammersmith and Fulham 002B,E01001957,1537,475,1062
2021,Hammersmith and Fulham 002C,E01001958,1648,470,1178
2021,Hammersmith and Fulham 003C,E01001959,1931,684,1247
2021,Hammersmith and Fulham 003D,E01001960,1685,303,1382
2021,Hammersmith and Fulham 002D,E01001961,1485,495,990
2021,Haringey 004A,E01001962,1709,474,1235
2021,Haringey 009A,E01001963,1714,439,1275
2021,Haringey 009B,E01001964,1512,348,1164
2021,Haringey 009C,E01001965,1540,394,1146
2021,Haringey 009D,E01001966,1356,319,1037
2021,Haringey 014A,E01001967,1423,287,1136
2021,Haringey 014B,E01001968,1555,343,1212
2021,Haringey 001A,E01001969,1860,312,1548
2021,Haringey 004B,E01001970,1818,365,1453
2021,Haringey 001B,E01001971,1826,430,1396
2021,Haringey 004C,E01001972,1626,329,1297
2021,Haringey 004D,E01001973,2396,567,1829
2021,Haringey 001C,E01001974,2086,356,1730
2021,Haringey 001D,E01001975,1707,320,1387
2021,Haringey 011A,E01001976,1747,355,1392
2021,Haringey 011B,E01001977,1422,313,1109
2021,Haringey 011C,E01001978,1824,390,1434
2021,Haringey 011D,E01001979,2159,487,1672
2021,Haringey 018A,E01001980,1727,381,1346
2021,Haringey 018B,E01001981,1724,343,1381
2021,Haringey 018C,E01001982,1663,325,1338
2021,Haringey 018D,E01001983,1541,281,1260
2021,Haringey 033A,E01001984,1649,212,1437
2021,Haringey 033B,E01001985,1521,288,1233
2021,Haringey 034A,E01001986,1481,267,1214
2021,Haringey 033C,E01001987,1619,290,1329
2021,Haringey 034B,E01001988,1563,249,1314
2021,Haringey 033D,E01001989,1636,301,1335
2021,Haringey 034C,E01001990,1840,270,1570
2021,Haringey 017A,E01001991,1559,333,1226
2021,Haringey 017B,E01001992,1665,386,1279
2021,Haringey 017C,E01001993,1580,403,1177
2021,Haringey 030A,E01001994,1728,333,1395
2021,Haringey 017D,E01001995,2522,659,1863
2021,Haringey 014C,E01001996,1420,324,1096
2021,Haringey 014D,E01001997,1681,439,1242
2021,Haringey 023A,E01001998,1816,254,1562
2021,Haringey 023B,E01001999,2281,373,1908
2021,Haringey 031A,E01002000,1669,272,1397
2021,Haringey 031B,E01002001,1522,204,1318
2021,Haringey 031C,E01002002,1611,199,1412
2021,Haringey 023C,E01002003,2441,458,1983
2021,Haringey 023D,E01002004,1717,265,1452
2021,Haringey 035A,E01002005,1388,156,1232
2021,Haringey 035B,E01002006,1459,227,1232
2021,Haringey 035C,E01002007,1376,213,1163
2021,Haringey 030B,E01002008,1283,315,968
2021,Haringey 035D,E01002009,1360,240,1120
2021,Haringey 030C,E01002010,1517,306,1211
2021,Haringey 030D,E01002011,1645,275,1370
2021,Haringey 022A,E01002013,1267,240,1027
2021,Haringey 020B,E01002014,1655,251,1404
2021,Haringey 020C,E01002015,1342,224,1118
2021,Haringey 028A,E01002016,1814,318,1496
2021,Haringey 028B,E01002017,1496,276,1220
2021,Haringey 020D,E01002018,1291,241,1050
2021,Haringey 022B,E01002019,1296,245,1051
2021,Haringey 021A,E01002020,1476,250,1226
2021,Haringey 022C,E01002021,1377,276,1101
2021,Haringey 021B,E01002022,2070,388,1682
2021,Haringey 021C,E01002023,1317,252,1065
2021,Haringey 022D,E01002024,1220,227,993
2021,Haringey 021D,E01002025,1398,274,1124
2021,Haringey 016A,E01002026,1704,378,1326
2021,Haringey 010A,E01002027,1372,229,1143
2021,Haringey 010B,E01002028,1575,278,1297
2021,Haringey 016B,E01002029,2033,462,1571
2021,Haringey 016C,E01002030,1492,254,1238
2021,Haringey 016D,E01002031,1790,286,1504
2021,Haringey 010C,E01002032,1765,342,1423
2021,Haringey 010D,E01002033,1703,309,1394
2021,Haringey 037A,E01002034,2224,626,1598
2021,Haringey 002A,E01002036,1744,506,1238
2021,Haringey 002B,E01002037,1619,394,1225
2021,Haringey 037B,E01002038,1690,435,1255
2021,Haringey 002C,E01002039,1562,441,1121
2021,Haringey 002D,E01002040,2126,487,1639
2021,Haringey 037C,E01002041,1764,423,1341
2021,Haringey 027A,E01002042,1460,209,1251
2021,Haringey 026A,E01002043,1683,332,1351
2021,Haringey 027B,E01002044,1707,283,1424
2021,Haringey 026B,E01002045,1924,430,1494
2021,Haringey 026C,E01002046,1538,287,1251
2021,Haringey 027C,E01002047,1576,248,1328
2021,Haringey 027D,E01002048,1828,268,1560
2021,Haringey 026D,E01002049,1803,388,1415
2021,Haringey 029A,E01002050,1762,722,1040
2021,Haringey 029B,E01002051,1719,468,1251
2021,Haringey 029C,E01002052,1990,829,1161
2021,Haringey 032A,E01002053,1895,509,1386
2021,Haringey 032B,E01002054,1596,472,1124
2021,Haringey 029D,E01002055,1819,797,1022
2021,Haringey 032C,E01002056,2741,499,2242
2021,Haringey 032D,E01002057,1705,281,1424
2021,Haringey 031D,E01002058,1494,251,1243
2021,Haringey 028C,E01002059,1482,254,1228
2021,Haringey 028D,E01002060,1610,264,1346
2021,Haringey 036A,E01002061,1491,189,1302
2021,Haringey 034D,E01002062,1647,236,1411
2021,Haringey 036B,E01002063,1430,217,1213
2021,Haringey 036C,E01002064,1426,249,1177
2021,Haringey 036D,E01002065,1477,178,1299
2021,Haringey 025A,E01002066,2466,595,1871
2021,Haringey 024A,E01002067,1654,274,1380
2021,Haringey 025B,E01002068,2137,461,1676
2021,Haringey 024B,E01002069,1948,317,1631
2021,Haringey 024C,E01002070,2392,389,2003
2021,Haringey 025C,E01002071,1643,360,1283
2021,Haringey 025D,E01002072,1795,458,1337
2021,Haringey 024D,E01002073,1551,323,1228
2021,Haringey 012A,E01002074,2075,576,1499
2021,Haringey 015A,E01002075,1835,448,1387
2021,Haringey 015B,E01002076,1752,431,1321
2021,Haringey 012B,E01002077,2143,512,1631
2021,Haringey 015C,E01002078,2414,435,1979
2021,Haringey 012C,E01002079,1674,415,1259
2021,Haringey 012D,E01002081,1846,415,1431
2021,Haringey 013A,E01002082,1360,294,1066
2021,Haringey 019A,E01002083,1325,204,1121
2021,Haringey 019B,E01002084,1639,320,1319
2021,Haringey 019C,E01002085,2057,481,1576
2021,Haringey 013B,E01002086,1437,233,1204
2021,Haringey 019D,E01002087,1829,309,1520
2021,Haringey 013C,E01002088,1678,300,1378
2021,Haringey 013D,E01002089,1265,361,904
2021,Haringey 005A,E01002090,1659,368,1291
2021,Haringey 006A,E01002091,1761,421,1340
2021,Haringey 006B,E01002092,1464,386,1078
2021,Haringey 005B,E01002093,1747,421,1326
2021,Haringey 006C,E01002094,1384,321,1063
2021,Haringey 006D,E01002095,1502,347,1155
2021,Haringey 005C,E01002096,1632,408,1224
2021,Haringey 005D,E01002097,1520,415,1105
2021,Haringey 007A,E01002098,1459,284,1175
2021,Haringey 008A,E01002099,1932,488,1444
2021,Haringey 008B,E01002100,1693,390,1303
2021,Haringey 007B,E01002101,1806,332,1474
2021,Haringey 007C,E01002102,1768,388,1380
2021,Haringey 008C,E01002103,1757,334,1423
2021,Haringey 008D,E01002104,1390,241,1149
2021,Haringey 007D,E01002105,1986,311,1675
2021,Harrow 008A,E01002106,1910,411,1499
2021,Harrow 012A,E01002107,1729,425,1304
2021,Harrow 008B,E01002108,1750,415,1335
2021,Harrow 008C,E01002109,1744,373,1371
2021,Harrow 008D,E01002110,1581,343,1238
2021,Harrow 008E,E01002111,2089,480,1609
2021,Harrow 001A,E01002112,1875,376,1499
2021,Harrow 002A,E01002113,1505,304,1201
2021,Harrow 001B,E01002114,2112,396,1716
2021,Harrow 002B,E01002115,1405,267,1138
2021,Harrow 002C,E01002116,1499,254,1245
2021,Harrow 002E,E01002118,1737,330,1407
2021,Harrow 007A,E01002119,2329,584,1745
2021,Harrow 007B,E01002120,1262,313,949
2021,Harrow 007C,E01002121,1699,358,1341
2021,Harrow 007D,E01002122,1754,407,1347
2021,Harrow 007E,E01002123,1591,348,1243
2021,Harrow 010A,E01002124,1683,404,1279
2021,Harrow 010B,E01002125,1848,436,1412
2021,Harrow 023B,E01002127,1724,313,1411
2021,Harrow 020A,E01002128,1973,394,1579
2021,Harrow 023C,E01002129,2536,496,2040
2021,Harrow 020B,E01002130,2676,699,1977
2021,Harrow 023D,E01002131,1583,321,1262
2021,Harrow 029A,E01002132,1899,391,1508
2021,Harrow 027A,E01002133,1924,469,1455
2021,Harrow 029B,E01002134,1405,261,1144
2021,Harrow 029C,E01002135,1891,395,1496
2021,Harrow 027B,E01002136,1916,425,1491
2021,Harrow 029D,E01002137,1686,864,822
2021,Harrow 027C,E01002138,1526,390,1136
2021,Harrow 006A,E01002139,1424,365,1059
2021,Harrow 005A,E01002140,1696,396,1300
2021,Harrow 005B,E01002141,1700,345,1355
2021,Harrow 005C,E01002142,1741,343,1398
2021,Harrow 005D,E01002143,1540,407,1133
2021,Harrow 004A,E01002144,1551,303,1248
2021,Harrow 005E,E01002145,1613,308,1305
2021,Harrow 004B,E01002146,1395,279,1116
2021,Harrow 004C,E01002147,1304,200,1104
2021,Harrow 006B,E01002148,1402,284,1118
2021,Harrow 004D,E01002149,1259,209,1050
2021,Harrow 006C,E01002150,2132,514,1618
2021,Harrow 006D,E01002151,1491,381,1110
2021,Harrow 006E,E01002152,1551,305,1246
2021,Harrow 019A,E01002153,1770,354,1416
2021,Harrow 019B,E01002155,1642,364,1278
2021,Harrow 015B,E01002156,1508,303,1205
2021,Harrow 019C,E01002157,1598,316,1282
2021,Harrow 019D,E01002158,1349,263,1086
2021,Harrow 021A,E01002159,1817,376,1441
2021,Harrow 021B,E01002160,2286,507,1779
2021,Harrow 021C,E01002161,1926,420,1506
2021,Harrow 015C,E01002162,1805,447,1358
2021,Harrow 015D,E01002163,1570,327,1243
2021,Harrow 021D,E01002164,1779,369,1410
2021,Harrow 017A,E01002165,1642,312,1330
2021,Harrow 017B,E01002166,1594,310,1284
2021,Harrow 017C,E01002167,1530,331,1199
2021,Harrow 017D,E01002168,1470,368,1102
2021,Harrow 017E,E01002169,1555,294,1261
2021,Harrow 033A,E01002170,1290,271,1019
2021,Harrow 033B,E01002171,1608,359,1249
2021,Harrow 033C,E01002172,1496,338,1158
2021,Harrow 033D,E01002173,1806,284,1522
2021,Harrow 033E,E01002174,1496,259,1237
2021,Harrow 033F,E01002175,1332,248,1084
2021,Harrow 033G,E01002176,1606,303,1303
2021,Harrow 033H,E01002177,1397,271,1126
2021,Harrow 033I,E01002178,1564,298,1266
2021,Harrow 013A,E01002179,2411,563,1848
2021,Harrow 020C,E01002181,2156,448,1708
2021,Harrow 020D,E01002182,1993,472,1521
2021,Harrow 013C,E01002183,1973,429,1544
2021,Harrow 013D,E01002184,1789,416,1373
2021,Harrow 009A,E01002185,1736,415,1321
2021,Harrow 009B,E01002186,1801,396,1405
2021,Harrow 009C,E01002187,1862,396,1466
2021,Harrow 016A,E01002188,1536,286,1250
2021,Harrow 016B,E01002189,1638,296,1342
2021,Harrow 009D,E01002190,1630,296,1334
2021,Harrow 022A,E01002191,1932,485,1447
2021,Harrow 016C,E01002192,1600,316,1284
2021,Harrow 016D,E01002193,1891,460,1431
2021,Harrow 022B,E01002194,1726,402,1324
2021,Harrow 022C,E01002195,1593,372,1221
2021,Harrow 022D,E01002196,1731,400,1331
2021,Harrow 012B,E01002197,1347,284,1063
2021,Harrow 010C,E01002198,1698,327,1371
2021,Harrow 012C,E01002199,1485,336,1149
2021,Harrow 010D,E01002200,2027,481,1546
2021,Harrow 012D,E01002201,1629,302,1327
2021,Harrow 012E,E01002202,2009,528,1481
2021,Harrow 010E,E01002203,1701,397,1304
2021,Harrow 032A,E01002204,1750,444,1306
2021,Harrow 032B,E01002206,1321,311,1010
2021,Harrow 032C,E01002207,1701,438,1263
2021,Harrow 025A,E01002208,1320,261,1059
2021,Harrow 025B,E01002209,1776,380,1396
2021,Harrow 032D,E01002210,1479,335,1144
2021,Harrow 028A,E01002211,1417,329,1088
2021,Harrow 028B,E01002212,1742,452,1290
2021,Harrow 031A,E01002214,1811,473,1338
2021,Harrow 031B,E01002215,1635,412,1223
2021,Harrow 028C,E01002216,1624,435,1189
2021,Harrow 028D,E01002217,2032,496,1536
2021,Harrow 030A,E01002218,1695,340,1355
2021,Harrow 030B,E01002219,1829,466,1363
2021,Harrow 031C,E01002220,1560,384,1176
2021,Harrow 030C,E01002221,1552,347,1205
2021,Harrow 030D,E01002222,1518,358,1160
2021,Harrow 031D,E01002223,1719,382,1337
2021,Harrow 031E,E01002224,1555,428,1127
2021,Harrow 001C,E01002225,1687,236,1451
2021,Harrow 001D,E01002226,2506,482,2024
2021,Harrow 003A,E01002227,2145,639,1506
2021,Harrow 003B,E01002228,2121,476,1645
2021,Harrow 003C,E01002229,1718,321,1397
2021,Harrow 003D,E01002230,1738,341,1397
2021,Harrow 013E,E01002231,1919,495,1424
2021,Harrow 011A,E01002232,2051,490,1561
2021,Harrow 011B,E01002233,2251,553,1698
2021,Harrow 011C,E01002234,1756,452,1304
2021,Harrow 011D,E01002235,1807,479,1328
2021,Harrow 011E,E01002236,2151,579,1572
2021,Harrow 024A,E01002237,1998,356,1642
2021,Harrow 024B,E01002238,1772,406,1366
2021,Harrow 025C,E01002239,1849,357,1492
2021,Harrow 024C,E01002240,1829,418,1411
2021,Harrow 025D,E01002241,1802,430,1372
2021,Harrow 024D,E01002242,1783,388,1395
2021,Havering 013A,E01002243,1816,390,1426
2021,Havering 011A,E01002244,1670,342,1328
2021,Havering 011B,E01002245,1539,306,1233
2021,Havering 017A,E01002246,1753,307,1446
2021,Havering 017B,E01002247,2245,591,1654
2021,Havering 017C,E01002248,1589,402,1187
2021,Havering 017E,E01002250,1697,366,1331
2021,Havering 017F,E01002251,1476,356,1120
2021,Havering 018A,E01002252,1502,262,1240
2021,Havering 019A,E01002253,1489,247,1242
2021,Havering 019B,E01002254,1574,293,1281
2021,Havering 022A,E01002255,1457,278,1179
2021,Havering 018B,E01002256,1429,242,1187
2021,Havering 019C,E01002257,1671,351,1320
2021,Havering 018C,E01002258,1721,373,1348
2021,Havering 018D,E01002259,1456,281,1175
2021,Havering 026A,E01002260,1692,341,1351
2021,Havering 026B,E01002261,1668,362,1306
2021,Havering 026C,E01002262,1669,303,1366
2021,Havering 026D,E01002263,1506,266,1240
2021,Havering 026E,E01002264,1555,373,1182
2021,Havering 025A,E01002265,1404,206,1198
2021,Havering 027A,E01002266,1453,278,1175
2021,Havering 027B,E01002267,1665,295,1370
2021,Havering 010A,E01002268,1413,309,1104
2021,Havering 010B,E01002269,1751,358,1393
2021,Havering 015A,E01002270,1673,293,1380
2021,Havering 015B,E01002271,1521,258,1263
2021,Havering 014A,E01002272,1271,209,1062
2021,Havering 015C,E01002273,1291,215,1076
2021,Havering 014B,E01002274,1585,257,1328
2021,Havering 015D,E01002275,1262,185,1077
2021,Havering 001A,E01002276,1979,430,1549
2021,Havering 002A,E01002277,1522,323,1199
2021,Havering 001B,E01002278,1608,409,1199
2021,Havering 002B,E01002279,1645,385,1260
2021,Havering 004A,E01002280,1720,516,1204
2021,Havering 002C,E01002281,2192,569,1623
2021,Havering 004B,E01002282,1768,549,1219
2021,Havering 002D,E01002283,1599,389,1210
2021,Havering 004C,E01002284,1924,506,1418
2021,Havering 025B,E01002285,1293,180,1113
2021,Havering 025C,E01002286,1542,249,1293
2021,Havering 023A,E01002287,1507,266,1241
2021,Havering 025D,E01002288,1521,263,1258
2021,Havering 022B,E01002289,1569,263,1306
2021,Havering 025E,E01002290,1427,209,1218
2021,Havering 023B,E01002291,1426,129,1297
2021,Havering 022C,E01002292,1583,318,1265
2021,Havering 007B,E01002294,1465,251,1214
2021,Havering 010C,E01002295,1856,361,1495
2021,Havering 007C,E01002296,1601,235,1366
2021,Havering 004D,E01002297,1540,358,1182
2021,Havering 007D,E01002298,1512,276,1236
2021,Havering 002E,E01002299,1726,393,1333
2021,Havering 007E,E01002300,1905,297,1608
2021,Havering 003A,E01002301,1540,241,1299
2021,Havering 005A,E01002302,1612,333,1279
2021,Havering 003B,E01002303,2013,451,1562
2021,Havering 003C,E01002304,1474,231,1243
2021,Havering 005B,E01002305,1606,360,1246
2021,Havering 003D,E01002306,1661,415,1246
2021,Havering 003E,E01002307,1757,419,1338
2021,Havering 005C,E01002308,1730,388,1342
2021,Havering 006A,E01002309,1647,405,1242
2021,Havering 006B,E01002310,1751,344,1407
2021,Havering 006C,E01002311,1752,438,1314
2021,Havering 001C,E01002312,1580,303,1277
2021,Havering 001D,E01002313,2093,478,1615
2021,Havering 004E,E01002314,1745,502,1243
2021,Havering 006D,E01002315,1593,371,1222
2021,Havering 004F,E01002316,1917,580,1337
2021,Havering 014C,E01002317,1479,250,1229
2021,Havering 014D,E01002318,1581,275,1306
2021,Havering 016A,E01002319,1743,385,1358
2021,Havering 021A,E01002320,1419,263,1156
2021,Havering 021B,E01002321,1720,303,1417
2021,Havering 021C,E01002322,1814,350,1464
2021,Havering 021D,E01002323,1627,311,1316
2021,Havering 021E,E01002324,1470,240,1230
2021,Havering 011C,E01002325,1969,452,1517
2021,Havering 005D,E01002326,1576,332,1244
2021,Havering 009A,E01002327,1475,261,1214
2021,Havering 009B,E01002328,1681,362,1319
2021,Havering 011D,E01002329,1628,332,1296
2021,Havering 011E,E01002330,1712,400,1312
2021,Havering 005E,E01002331,1576,345,1231
2021,Havering 009C,E01002332,1659,319,1340
2021,Havering 008A,E01002333,1290,202,1088
2021,Havering 008B,E01002334,1650,278,1372
2021,Havering 009D,E01002335,1386,265,1121
2021,Havering 008C,E01002336,1549,269,1280
2021,Havering 012A,E01002337,1280,181,1099
2021,Havering 009E,E01002338,1315,271,1044
2021,Havering 008D,E01002339,1572,290,1282
2021,Havering 009F,E01002340,1401,307,1094
2021,Havering 008E,E01002341,1384,260,1124
2021,Havering 030A,E01002342,1588,382,1206
2021,Havering 029A,E01002343,1663,275,1388
2021,Havering 029B,E01002344,1850,402,1448
2021,Havering 030B,E01002345,1778,446,1332
2021,Havering 030C,E01002346,1441,311,1130
2021,Havering 030D,E01002347,1434,298,1136
2021,Havering 029C,E01002348,1486,222,1264
2021,Havering 029D,E01002349,1476,239,1237
2021,Havering 016B,E01002350,1589,341,1248
2021,Havering 016C,E01002351,1639,316,1323
2021,Havering 016D,E01002352,1834,381,1453
2021,Havering 013B,E01002353,1943,344,1599
2021,Havering 012B,E01002354,1307,209,1098
2021,Havering 014E,E01002355,1402,257,1145
2021,Havering 013C,E01002356,1894,390,1504
2021,Havering 016E,E01002358,1942,378,1564
2021,Havering 020A,E01002359,1259,202,1057
2021,Havering 020B,E01002360,1412,183,1229
2021,Havering 020C,E01002361,1839,320,1519
2021,Havering 022D,E01002362,1422,226,1196
2021,Havering 020D,E01002363,1406,252,1154
2021,Havering 023C,E01002364,1304,175,1129
2021,Havering 023D,E01002365,1272,239,1033
2021,Havering 023E,E01002366,1446,277,1169
2021,Havering 020E,E01002367,1639,264,1375
2021,Havering 028A,E01002368,2283,571,1712
2021,Havering 028B,E01002369,1919,435,1484
2021,Havering 028C,E01002370,2268,562,1706
2021,Havering 028D,E01002371,1606,338,1268
2021,Havering 027C,E01002372,1604,337,1267
2021,Havering 027D,E01002373,1588,337,1251
2021,Havering 027E,E01002374,1608,334,1274
2021,Havering 028E,E01002375,1814,435,1379
2021,Havering 012C,E01002376,1383,244,1139
2021,Havering 010D,E01002377,1654,287,1367
2021,Havering 010E,E01002378,1589,322,1267
2021,Havering 012D,E01002379,1485,258,1227
2021,Havering 012E,E01002380,2136,380,1756
2021,Havering 012F,E01002381,1448,246,1202
2021,Havering 014F,E01002382,1695,297,1398
2021,Havering 010F,E01002383,1560,297,1263
2021,Havering 019D,E01002384,1570,313,1257
2021,Havering 024A,E01002385,1512,228,1284
2021,Havering 022E,E01002386,1954,346,1608
2021,Havering 024B,E01002387,1545,300,1245
2021,Havering 024C,E01002388,1575,282,1293
2021,Havering 024D,E01002389,1539,232,1307
2021,Havering 024E,E01002390,1414,273,1141
2021,Havering 018E,E01002391,1660,301,1359
2021,Hillingdon 020A,E01002392,1633,486,1147
2021,Hillingdon 020B,E01002393,1970,489,1481
2021,Hillingdon 021A,E01002394,1629,443,1186
2021,Hillingdon 021B,E01002395,1317,326,991
2021,Hillingdon 026A,E01002396,1733,433,1300
2021,Hillingdon 021C,E01002397,1832,564,1268
2021,Hillingdon 021D,E01002398,1751,453,1298
2021,Hillingdon 021E,E01002399,1574,367,1207
2021,Hillingdon 024A,E01002400,1880,429,1451
2021,Hillingdon 024B,E01002401,2142,570,1572
2021,Hillingdon 024C,E01002402,1565,384,1181
2021,Hillingdon 024D,E01002403,2298,683,1615
2021,Hillingdon 024E,E01002404,1854,509,1345
2021,Hillingdon 027A,E01002405,1825,463,1362
2021,Hillingdon 019A,E01002408,1542,370,1172
2021,Hillingdon 019B,E01002409,1868,461,1407
2021,Hillingdon 017A,E01002410,1814,444,1370
2021,Hillingdon 022A,E01002411,2013,651,1362
2021,Hillingdon 017B,E01002412,2198,498,1700
2021,Hillingdon 022B,E01002413,1504,378,1126
2021,Hillingdon 015A,E01002414,2636,1661,975
2021,Hillingdon 010A,E01002415,1601,312,1289
2021,Hillingdon 008A,E01002416,1634,356,1278
2021,Hillingdon 008B,E01002417,1709,303,1406
2021,Hillingdon 006A,E01002418,1683,322,1361
2021,Hillingdon 006B,E01002419,1582,312,1270
2021,Hillingdon 008C,E01002420,1514,292,1222
2021,Hillingdon 008D,E01002421,1593,305,1288
2021,Hillingdon 018A,E01002422,1479,366,1113
2021,Hillingdon 018B,E01002423,1725,396,1329
2021,Hillingdon 018C,E01002424,1561,376,1185
2021,Hillingdon 018D,E01002425,1570,406,1164
2021,Hillingdon 021F,E01002426,1867,522,1345
2021,Hillingdon 018E,E01002427,1503,322,1181
2021,Hillingdon 018F,E01002428,1457,324,1133
2021,Hillingdon 019C,E01002429,1474,391,1083
2021,Hillingdon 007A,E01002430,1357,262,1095
2021,Hillingdon 006C,E01002431,1277,263,1014
2021,Hillingdon 006D,E01002432,1413,245,1168
2021,Hillingdon 004A,E01002433,2331,475,1856
2021,Hillingdon 007B,E01002434,1292,226,1066
2021,Hillingdon 007C,E01002435,1462,286,1176
2021,Hillingdon 004B,E01002436,1602,327,1275
2021,Hillingdon 006E,E01002437,1384,224,1160
2021,Hillingdon 003A,E01002438,1371,238,1133
2021,Hillingdon 003B,E01002439,1486,293,1193
2021,Hillingdon 003C,E01002440,1479,256,1223
2021,Hillingdon 003D,E01002441,1514,245,1269
2021,Hillingdon 003E,E01002442,1540,294,1246
2021,Hillingdon 032A,E01002443,1899,368,1531
2021,Hillingdon 031A,E01002444,1791,306,1485
2021,Hillingdon 029A,E01002445,1647,492,1155
2021,Hillingdon 031B,E01002446,1846,419,1427
2021,Hillingdon 031C,E01002447,1924,383,1541
2021,Hillingdon 032B,E01002448,1999,452,1547
2021,Hillingdon 032C,E01002449,1995,447,1548
2021,Hillingdon 014A,E01002450,1395,327,1068
2021,Hillingdon 014B,E01002451,1427,328,1099
2021,Hillingdon 014C,E01002452,1451,314,1137
2021,Hillingdon 014D,E01002453,1675,391,1284
2021,Hillingdon 014E,E01002454,1768,437,1331
2021,Hillingdon 019D,E01002455,1820,437,1383
2021,Hillingdon 017C,E01002456,1625,375,1250
2021,Hillingdon 019E,E01002457,1487,351,1136
2021,Hillingdon 011A,E01002458,1374,261,1113
2021,Hillingdon 011B,E01002459,1601,317,1284
2021,Hillingdon 011C,E01002460,1349,215,1134
2021,Hillingdon 013A,E01002461,1440,253,1187
2021,Hillingdon 011D,E01002462,1402,315,1087
2021,Hillingdon 013B,E01002463,1431,268,1163
2021,Hillingdon 011E,E01002464,1509,291,1218
2021,Hillingdon 009A,E01002465,1586,331,1255
2021,Hillingdon 010B,E01002466,1592,307,1285
2021,Hillingdon 009B,E01002467,1498,292,1206
2021,Hillingdon 010C,E01002468,1607,304,1303
2021,Hillingdon 010D,E01002469,1571,262,1309
2021,Hillingdon 007D,E01002470,1709,292,1417
2021,Hillingdon 008E,E01002471,1529,286,1243
2021,Hillingdon 002A,E01002472,1585,294,1291
2021,Hillingdon 001A,E01002473,1603,258,1345
2021,Hillingdon 002B,E01002474,1661,360,1301
2021,Hillingdon 001B,E01002475,1550,270,1280
2021,Hillingdon 001C,E01002476,1555,290,1265
2021,Hillingdon 001D,E01002477,1289,235,1054
2021,Hillingdon 002C,E01002478,1503,279,1224
2021,Hillingdon 004C,E01002479,1738,370,1368
2021,Hillingdon 004D,E01002480,1762,353,1409
2021,Hillingdon 004E,E01002481,1549,297,1252
2021,Hillingdon 001E,E01002482,1593,325,1268
2021,Hillingdon 002D,E01002483,1828,374,1454
2021,Hillingdon 002E,E01002484,1336,268,1068
2021,Hillingdon 002F,E01002485,1892,414,1478
2021,Hillingdon 028A,E01002486,2090,563,1527
2021,Hillingdon 028B,E01002487,1800,448,1352
2021,Hillingdon 030B,E01002488,1653,414,1239
2021,Hillingdon 030C,E01002489,1830,448,1382
2021,Hillingdon 030D,E01002490,2036,525,1511
2021,Hillingdon 032D,E01002491,1605,424,1181
2021,Hillingdon 030E,E01002492,1582,371,1211
2021,Hillingdon 032E,E01002493,1857,599,1258
2021,Hillingdon 009C,E01002494,1675,384,1291
2021,Hillingdon 010E,E01002495,1729,329,1400
2021,Hillingdon 033A,E01002496,1815,361,1454
2021,Hillingdon 033B,E01002497,2282,442,1840
2021,Hillingdon 033C,E01002498,1337,245,1092
2021,Hillingdon 033D,E01002499,1933,337,1596
2021,Hillingdon 026B,E01002501,1653,417,1236
2021,Hillingdon 026C,E01002502,1865,652,1213
2021,Hillingdon 027C,E01002503,1816,486,1330
2021,Hillingdon 026D,E01002505,1656,390,1266
2021,Hillingdon 027E,E01002506,1898,478,1420
2021,Hillingdon 027F,E01002507,1843,483,1360
2021,Hillingdon 026E,E01002508,2063,575,1488
2021,Hillingdon 017D,E01002509,1418,273,1145
2021,Hillingdon 017E,E01002511,1547,344,1203
2021,Hillingdon 013C,E01002512,1926,369,1557
2021,Hillingdon 013D,E01002513,1367,233,1134
2021,Hillingdon 015C,E01002514,1834,342,1492
2021,Hillingdon 013E,E01002516,1415,279,1136
2021,Hillingdon 022C,E01002518,1243,315,928
2021,Hillingdon 022D,E01002519,1842,344,1498
2021,Hillingdon 016B,E01002520,1862,480,1382
2021,Hillingdon 016C,E01002521,1921,416,1505
2021,Hillingdon 016D,E01002523,1447,353,1094
2021,Hillingdon 029B,E01002525,1688,318,1370
2021,Hillingdon 028C,E01002526,2720,607,2113
2021,Hillingdon 031D,E01002527,1486,309,1177
2021,Hillingdon 028D,E01002528,1770,443,1327
2021,Hillingdon 029C,E01002529,2325,580,1745
2021,Hillingdon 029D,E01002530,1653,421,1232
2021,Hillingdon 029E,E01002531,1586,255,1331
2021,Hillingdon 005A,E01002533,1361,264,1097
2021,Hillingdon 005B,E01002534,1439,283,1156
2021,Hillingdon 007E,E01002535,2076,349,1727
2021,Hillingdon 009D,E01002536,1233,232,1001
2021,Hillingdon 009E,E01002537,2272,416,1856
2021,Hillingdon 005C,E01002538,1572,234,1338
2021,Hillingdon 005D,E01002539,1622,287,1335
2021,Hillingdon 020C,E01002540,1682,447,1235
2021,Hillingdon 023A,E01002541,1879,386,1493
2021,Hillingdon 020D,E01002542,1907,576,1331
2021,Hillingdon 020E,E01002543,1773,492,1281
2021,Hillingdon 023B,E01002544,1598,371,1227
2021,Hillingdon 023C,E01002545,1393,407,986
2021,Hillingdon 023D,E01002546,1649,459,1190
2021,Hillingdon 023E,E01002547,1580,407,1173
2021,Hillingdon 025A,E01002548,1784,422,1362
2021,Hillingdon 025B,E01002549,1745,403,1342
2021,Hillingdon 022E,E01002550,1693,366,1327
2021,Hillingdon 025C,E01002551,2008,608,1400
2021,Hillingdon 025D,E01002552,1622,400,1222
2021,Hillingdon 025E,E01002553,1670,401,1269
2021,Hounslow 022A,E01002555,1976,388,1588
2021,Hounslow 022B,E01002556,1707,368,1339
2021,Hounslow 023A,E01002557,1975,475,1500
2021,Hounslow 023B,E01002558,2041,489,1552
2021,Hounslow 023C,E01002559,2378,546,1832
2021,Hounslow 023D,E01002560,1903,432,1471
2021,Hounslow 023E,E01002561,1554,421,1133
2021,Hounslow 030D,E01002562,1405,363,1042
2021,Hounslow 006A,E01002563,1803,380,1423
2021,Hounslow 031E,E01002564,1801,446,1355
2021,Hounslow 006B,E01002565,2338,520,1818
2021,Hounslow 006C,E01002567,1724,281,1443
2021,Hounslow 001A,E01002569,2005,341,1664
2021,Hounslow 001B,E01002570,1547,261,1286
2021,Hounslow 007A,E01002571,1217,203,1014
2021,Hounslow 007B,E01002572,1452,354,1098
2021,Hounslow 001C,E01002573,1490,327,1163
2021,Hounslow 001D,E01002574,1649,397,1252
2021,Hounslow 001E,E01002575,1546,310,1236
2021,Hounslow 008A,E01002576,1598,363,1235
2021,Hounslow 007C,E01002577,1581,269,1312
2021,Hounslow 007D,E01002578,1456,331,1125
2021,Hounslow 008B,E01002579,1639,340,1299
2021,Hounslow 008C,E01002580,1380,274,1106
2021,Hounslow 008D,E01002581,1762,304,1458
2021,Hounslow 008E,E01002582,1573,353,1220
2021,Hounslow 013A,E01002583,1701,360,1341
2021,Hounslow 013B,E01002584,1997,389,1608
2021,Hounslow 013C,E01002585,1744,384,1360
2021,Hounslow 013D,E01002586,1733,343,1390
2021,Hounslow 016A,E01002587,2240,459,1781
2021,Hounslow 016B,E01002588,1855,499,1356
2021,Hounslow 013E,E01002589,2334,587,1747
2021,Hounslow 022C,E01002590,2464,560,1904
2021,Hounslow 024A,E01002591,1802,406,1396
2021,Hounslow 022D,E01002592,1988,434,1554
2021,Hounslow 024B,E01002593,2162,439,1723
2021,Hounslow 024C,E01002594,2154,460,1694
2021,Hounslow 022E,E01002595,2138,537,1601
2021,Hounslow 027A,E01002596,1992,480,1512
2021,Hounslow 025B,E01002598,1809,406,1403
2021,Hounslow 025C,E01002599,1492,352,1140
2021,Hounslow 025D,E01002600,1580,399,1181
2021,Hounslow 027B,E01002601,1742,417,1325
2021,Hounslow 027C,E01002602,1418,296,1122
2021,Hounslow 025E,E01002603,1830,440,1390
2021,Hounslow 026A,E01002604,1525,431,1094
2021,Hounslow 026B,E01002605,2134,508,1626
2021,Hounslow 026C,E01002606,1600,433,1167
2021,Hounslow 026D,E01002607,2263,506,1757
2021,Hounslow 028A,E01002608,1780,458,1322
2021,Hounslow 028B,E01002609,1717,367,1350
2021,Hounslow 028C,E01002610,1643,423,1220
2021,Hounslow 024D,E01002611,1918,454,1464
2021,Hounslow 024E,E01002612,1971,430,1541
2021,Hounslow 024F,E01002613,1832,457,1375
2021,Hounslow 027D,E01002614,1950,432,1518
2021,Hounslow 026E,E01002615,1540,370,1170
2021,Hounslow 027E,E01002616,1540,346,1194
2021,Hounslow 028D,E01002617,1524,273,1251
2021,Hounslow 011A,E01002618,1956,490,1466
2021,Hounslow 010A,E01002619,1978,423,1555
2021,Hounslow 004A,E01002620,2536,703,1833
2021,Hounslow 011B,E01002621,1898,466,1432
2021,Hounslow 010B,E01002622,1791,409,1382
2021,Hounslow 011C,E01002623,1797,344,1453
2021,Hounslow 017A,E01002624,1682,391,1291
2021,Hounslow 004B,E01002625,1630,353,1277
2021,Hounslow 004C,E01002626,1548,339,1209
2021,Hounslow 004D,E01002627,1663,466,1197
2021,Hounslow 011D,E01002628,2061,513,1548
2021,Hounslow 011E,E01002629,2483,551,1932
2021,Hounslow 012A,E01002630,1963,594,1369
2021,Hounslow 004E,E01002631,1692,376,1316
2021,Hounslow 010C,E01002632,1819,369,1450
2021,Hounslow 005A,E01002633,2079,621,1458
2021,Hounslow 005B,E01002634,1641,502,1139
2021,Hounslow 010D,E01002635,1884,422,1462
2021,Hounslow 010E,E01002636,2022,496,1526
2021,Hounslow 005C,E01002637,1770,446,1324
2021,Hounslow 005D,E01002638,2047,599,1448
2021,Hounslow 012B,E01002639,1679,340,1339
2021,Hounslow 012C,E01002640,2155,535,1620
2021,Hounslow 018A,E01002641,2485,489,1996
2021,Hounslow 015B,E01002643,2546,563,1983
2021,Hounslow 015C,E01002645,2125,498,1627
2021,Hounslow 017B,E01002646,2157,616,1541
2021,Hounslow 021A,E01002647,2071,585,1486
2021,Hounslow 018D,E01002649,1896,446,1450
2021,Hounslow 021B,E01002650,2314,602,1712
2021,Hounslow 021C,E01002651,1823,471,1352
2021,Hounslow 021D,E01002652,1830,393,1437
2021,Hounslow 019A,E01002653,1780,372,1408
2021,Hounslow 019B,E01002654,1827,385,1442
2021,Hounslow 019C,E01002655,1796,403,1393
2021,Hounslow 019D,E01002656,1351,262,1089
2021,Hounslow 018E,E01002657,1831,390,1441
2021,Hounslow 015D,E01002658,1275,240,1035
2021,Hounslow 019E,E01002659,1376,281,1095
2021,Hounslow 016C,E01002660,1969,404,1565
2021,Hounslow 016D,E01002661,2196,443,1753
2021,Hounslow 017C,E01002662,2355,403,1952
2021,Hounslow 017D,E01002663,2023,430,1593
2021,Hounslow 016E,E01002665,1638,375,1263
2021,Hounslow 021E,E01002666,1758,344,1414
2021,Hounslow 020A,E01002667,2048,395,1653
2021,Hounslow 014A,E01002668,2147,469,1678
2021,Hounslow 014B,E01002669,1805,433,1372
2021,Hounslow 020B,E01002670,1819,410,1409
2021,Hounslow 020C,E01002671,1729,408,1321
2021,Hounslow 020D,E01002672,1498,336,1162
2021,Hounslow 020E,E01002673,1541,544,997
2021,Hounslow 012D,E01002674,1932,396,1536
2021,Hounslow 009A,E01002675,2414,563,1851
2021,Hounslow 012E,E01002676,1571,243,1328
2021,Hounslow 015E,E01002677,1911,371,1540
2021,Hounslow 009B,E01002678,1949,408,1541
2021,Hounslow 009C,E01002679,1725,300,1425
2021,Hounslow 009D,E01002680,1966,388,1578
2021,Hounslow 014C,E01002681,2288,540,1748
2021,Hounslow 014D,E01002682,2174,454,1720
2021,Hounslow 006E,E01002686,1696,418,1278
2021,Hounslow 029A,E01002687,1562,271,1291
2021,Hounslow 007E,E01002689,1469,265,1204
2021,Hounslow 007F,E01002690,1307,239,1068
2021,Hounslow 029B,E01002691,1578,368,1210
2021,Hounslow 029C,E01002692,1985,322,1663
2021,Hounslow 029D,E01002693,1695,268,1427
2021,Islington 019A,E01002694,1591,396,1195
2021,Islington 021A,E01002695,1423,201,1222
2021,Islington 020A,E01002696,1671,224,1447
2021,Islington 019B,E01002697,1887,475,1412
2021,Islington 017A,E01002698,1932,266,1666
2021,Islington 017B,E01002699,1428,205,1223
2021,Islington 017C,E01002700,1294,206,1088
2021,Islington 023A,E01002701,1416,318,1098
2021,Islington 023B,E01002702,2322,653,1669
2021,Islington 023C,E01002703,2206,466,1740
2021,Islington 023D,E01002704,2242,554,1688
2021,Islington 023E,E01002706,1943,503,1440
2021,Islington 022B,E01002707,1729,353,1376
2021,Islington 015A,E01002708,2011,455,1556
2021,Islington 019C,E01002709,1626,404,1222
2021,Islington 019D,E01002710,1524,414,1110
2021,Islington 021B,E01002711,1955,579,1376
2021,Islington 015B,E01002712,1288,266,1022
2021,Islington 015C,E01002713,2641,454,2187
2021,Islington 017D,E01002714,1454,238,1216
2021,Islington 019E,E01002715,1561,424,1137
2021,Islington 014A,E01002716,2148,400,1748
2021,Islington 016A,E01002717,1138,209,929
2021,Islington 014B,E01002718,1512,188,1324
2021,Islington 016B,E01002719,1398,227,1171
2021,Islington 016C,E01002720,1991,488,1503
2021,Islington 014C,E01002721,1517,189,1328
2021,Islington 018A,E01002722,1311,191,1120
2021,Islington 022C,E01002723,1550,443,1107
2021,Islington 022D,E01002724,1866,494,1372
2021,Islington 022E,E01002725,1279,385,894
2021,Islington 022F,E01002726,1554,301,1253
2021,Islington 021C,E01002727,1452,199,1253
2021,Islington 021D,E01002728,1266,590,676
2021,Islington 021E,E01002729,1440,250,1190
2021,Islington 007A,E01002730,1679,314,1365
2021,Islington 005A,E01002732,1727,346,1381
2021,Islington 007C,E01002733,1385,247,1138
2021,Islington 005B,E01002734,2226,619,1607
2021,Islington 003A,E01002735,2842,732,2110
2021,Islington 005C,E01002736,1378,328,1050
2021,Islington 005D,E01002737,1829,468,1361
2021,Islington 009A,E01002738,1782,317,1465
2021,Islington 013A,E01002739,1746,326,1420
2021,Islington 013B,E01002740,2057,327,1730
2021,Islington 009B,E01002741,1448,327,1121
2021,Islington 006A,E01002742,1909,426,1483
2021,Islington 009C,E01002743,1435,261,1174
2021,Islington 009D,E01002744,1248,137,1111
2021,Islington 013C,E01002745,1346,204,1142
2021,Islington 006B,E01002747,1457,272,1185
2021,Islington 006C,E01002748,1565,350,1215
2021,Islington 006D,E01002749,1415,325,1090
2021,Islington 005E,E01002751,1670,329,1341
2021,Islington 009E,E01002752,1551,284,1267
2021,Islington 002A,E01002753,1387,275,1112
2021,Islington 002B,E01002754,1464,327,1137
2021,Islington 001A,E01002755,1236,219,1017
2021,Islington 001B,E01002756,1238,193,1045
2021,Islington 002C,E01002757,1361,319,1042
2021,Islington 001C,E01002758,1627,413,1214
2021,Islington 002D,E01002759,1446,282,1164
2021,Islington 002E,E01002760,1619,409,1210
2021,Islington 011C,E01002762,1802,270,1532
2021,Islington 007D,E01002763,1246,274,972
2021,Islington 010A,E01002764,1728,412,1316
2021,Islington 015D,E01002765,2766,952,1814
2021,Islington 015E,E01002766,2086,510,1576
2021,Islington 011D,E01002767,2056,447,1609
2021,Islington 004A,E01002768,1542,217,1325
2021,Islington 008A,E01002769,1775,508,1267
2021,Islington 004B,E01002770,1766,291,1475
2021,Islington 004C,E01002771,1484,308,1176
2021,Islington 002F,E01002772,1812,298,1514
2021,Islington 004D,E01002773,1539,407,1132
2021,Islington 004E,E01002774,2036,318,1718
2021,Islington 014D,E01002775,1337,180,1157
2021,Islington 014E,E01002776,1744,310,1434
2021,Islington 012A,E01002777,1593,215,1378
2021,Islington 012B,E01002778,1838,510,1328
2021,Islington 012C,E01002779,1660,384,1276
2021,Islington 014F,E01002780,1629,225,1404
2021,Islington 012D,E01002781,1670,288,1382
2021,Islington 012E,E01002782,1363,362,1001
2021,Islington 010B,E01002783,1625,372,1253
2021,Islington 010C,E01002784,1680,376,1304
2021,Islington 008B,E01002785,1778,345,1433
2021,Islington 010D,E01002786,1840,393,1447
2021,Islington 010E,E01002787,1392,305,1087
2021,Islington 008C,E01002788,1735,271,1464
2021,Islington 008D,E01002789,1777,330,1447
2021,Islington 016D,E01002790,1325,251,1074
2021,Islington 016E,E01002791,1748,297,1451
2021,Islington 017E,E01002792,1756,294,1462
2021,Islington 016F,E01002793,1763,303,1460
2021,Islington 020B,E01002794,1948,244,1704
2021,Islington 013D,E01002795,1844,351,1493
2021,Islington 013E,E01002796,1067,193,874
2021,Islington 018B,E01002797,1741,332,1409
2021,Islington 018C,E01002798,1832,272,1560
2021,Islington 018D,E01002799,1785,419,1366
2021,Islington 018E,E01002800,1642,299,1343
2021,Islington 020C,E01002801,1401,172,1229
2021,Islington 020D,E01002802,1753,326,1427
2021,Islington 001D,E01002804,1447,303,1144
2021,Islington 003B,E01002805,1372,143,1229
2021,Islington 003C,E01002806,1534,255,1279
2021,Islington 001E,E01002807,1616,337,1279
2021,Islington 003D,E01002808,1787,300,1487
2021,Islington 003E,E01002809,1623,285,1338
2021,Islington 003F,E01002810,1663,277,1386
2021,Islington 001F,E01002811,1647,359,1288
2021,Kensington and Chelsea 013A,E01002812,1431,408,1023
2021,Kensington and Chelsea 011A,E01002813,1412,278,1134
2021,Kensington and Chelsea 015A,E01002814,2121,541,1580
2021,Kensington and Chelsea 011B,E01002815,1117,204,913
2021,Kensington and Chelsea 011C,E01002816,1003,196,807
2021,Kensington and Chelsea 011D,E01002817,1288,245,1043
2021,Kensington and Chelsea 012A,E01002818,1328,347,981
2021,Kensington and Chelsea 012B,E01002819,1040,189,851
2021,Kensington and Chelsea 014A,E01002821,1036,204,832
2021,Kensington and Chelsea 014B,E01002823,1194,240,954
2021,Kensington and Chelsea 008A,E01002824,1179,230,949
2021,Kensington and Chelsea 008B,E01002825,1691,421,1270
2021,Kensington and Chelsea 008C,E01002826,1192,209,983
2021,Kensington and Chelsea 008D,E01002827,1624,351,1273
2021,Kensington and Chelsea 008E,E01002828,1143,218,925
2021,Kensington and Chelsea 004A,E01002829,1345,168,1177
2021,Kensington and Chelsea 004B,E01002830,1662,219,1443
2021,Kensington and Chelsea 004C,E01002831,1651,277,1374
2021,Kensington and Chelsea 004D,E01002832,1568,261,1307
2021,Kensington and Chelsea 007A,E01002833,1148,190,958
2021,Kensington and Chelsea 013B,E01002834,1181,269,912
2021,Kensington and Chelsea 016C,E01002835,1346,340,1006
2021,Kensington and Chelsea 016D,E01002836,1254,250,1004
2021,Kensington and Chelsea 016E,E01002837,994,197,797
2021,Kensington and Chelsea 013C,E01002839,1501,267,1234
2021,Kensington and Chelsea 021A,E01002840,999,198,801
2021,Kensington and Chelsea 021B,E01002841,1173,197,976
2021,Kensington and Chelsea 021C,E01002842,968,227,741
2021,Kensington and Chelsea 021D,E01002843,1249,253,996
2021,Kensington and Chelsea 019A,E01002844,1095,158,937
2021,Kensington and Chelsea 019B,E01002845,1115,217,898
2021,Kensington and Chelsea 017A,E01002846,1259,348,911
2021,Kensington and Chelsea 015B,E01002847,1346,267,1079
2021,Kensington and Chelsea 015C,E01002848,1197,199,998
2021,Kensington and Chelsea 017B,E01002849,1390,277,1113
2021,Kensington and Chelsea 013D,E01002850,1362,350,1012
2021,Kensington and Chelsea 015D,E01002851,1299,266,1033
2021,Kensington and Chelsea 001A,E01002852,2115,709,1406
2021,Kensington and Chelsea 001B,E01002853,1380,248,1132
2021,Kensington and Chelsea 001C,E01002854,1058,254,804
2021,Kensington and Chelsea 001D,E01002855,1517,256,1261
2021,Kensington and Chelsea 004E,E01002856,1386,216,1170
2021,Kensington and Chelsea 001E,E01002857,1335,275,1060
2021,Kensington and Chelsea 014C,E01002858,1229,195,1034
2021,Kensington and Chelsea 012C,E01002859,1215,208,1007
2021,Kensington and Chelsea 012D,E01002860,1094,216,878
2021,Kensington and Chelsea 014D,E01002861,1214,271,943
2021,Kensington and Chelsea 014E,E01002862,1071,196,875
2021,Kensington and Chelsea 012E,E01002863,1063,191,872
2021,Kensington and Chelsea 009A,E01002864,1407,329,1078
2021,Kensington and Chelsea 011E,E01002865,1393,330,1063
2021,Kensington and Chelsea 009B,E01002866,1763,335,1428
2021,Kensington and Chelsea 009C,E01002867,1624,262,1362
2021,Kensington and Chelsea 009D,E01002868,1246,254,992
2021,Kensington and Chelsea 009E,E01002869,1675,460,1215
2021,Kensington and Chelsea 005A,E01002870,1550,276,1274
2021,Kensington and Chelsea 007B,E01002871,1384,300,1084
2021,Kensington and Chelsea 005B,E01002872,1287,227,1060
2021,Kensington and Chelsea 007C,E01002873,1326,207,1119
2021,Kensington and Chelsea 007D,E01002874,1083,194,889
2021,Kensington and Chelsea 007E,E01002875,1209,197,1012
2021,Kensington and Chelsea 003A,E01002876,1699,335,1364
2021,Kensington and Chelsea 003B,E01002877,2026,497,1529
2021,Kensington and Chelsea 003C,E01002878,1401,213,1188
2021,Kensington and Chelsea 005C,E01002879,1865,417,1448
2021,Kensington and Chelsea 005D,E01002880,1090,337,753
2021,Kensington and Chelsea 005E,E01002881,1303,295,1008
2021,Kensington and Chelsea 006A,E01002882,1003,213,790
2021,Kensington and Chelsea 006B,E01002883,1400,252,1148
2021,Kensington and Chelsea 006C,E01002884,1342,229,1113
2021,Kensington and Chelsea 006D,E01002885,1266,197,1069
2021,Kensington and Chelsea 006E,E01002886,1247,202,1045
2021,Kensington and Chelsea 010A,E01002887,998,219,779
2021,Kensington and Chelsea 013E,E01002888,1515,533,982
2021,Kensington and Chelsea 010B,E01002889,1515,275,1240
2021,Kensington and Chelsea 010C,E01002890,1329,332,997
2021,Kensington and Chelsea 010D,E01002891,1148,237,911
2021,Kensington and Chelsea 010E,E01002892,1233,339,894
2021,Kensington and Chelsea 017C,E01002893,1512,229,1283
2021,Kensington and Chelsea 017D,E01002894,1264,335,929
2021,Kensington and Chelsea 020C,E01002896,1518,302,1216
2021,Kensington and Chelsea 020D,E01002897,1449,308,1141
2021,Kensington and Chelsea 017E,E01002898,1574,393,1181
2021,Kensington and Chelsea 018A,E01002899,1202,224,978
2021,Kensington and Chelsea 018B,E01002900,1646,168,1478
2021,Kensington and Chelsea 018C,E01002901,1023,112,911
2021,Kensington and Chelsea 018D,E01002902,1186,179,1007
2021,Kensington and Chelsea 018E,E01002903,1223,233,990
2021,Kensington and Chelsea 002A,E01002904,1230,308,922
2021,Kensington and Chelsea 002B,E01002905,1579,340,1239
2021,Kensington and Chelsea 002C,E01002906,1681,317,1364
2021,Kensington and Chelsea 002D,E01002907,1185,352,833
2021,Kensington and Chelsea 003D,E01002908,1310,249,1061
2021,Kensington and Chelsea 003E,E01002909,2042,322,1720
2021,Kensington and Chelsea 019C,E01002910,1300,261,1039
2021,Kensington and Chelsea 019D,E01002911,1236,226,1010
2021,Kensington and Chelsea 020E,E01002912,1439,244,1195
2021,Kensington and Chelsea 021E,E01002913,1680,329,1351
2021,Kensington and Chelsea 019E,E01002914,1132,221,911
2021,Kingston upon Thames 014A,E01002915,1328,287,1041
2021,Kingston upon Thames 014B,E01002916,1398,337,1061
2021,Kingston upon Thames 014C,E01002917,1354,292,1062
2021,Kingston upon Thames 017A,E01002918,1689,415,1274
2021,Kingston upon Thames 017B,E01002919,1852,440,1412
2021,Kingston upon Thames 014D,E01002920,1508,330,1178
2021,Kingston upon Thames 011A,E01002921,1627,224,1403
2021,Kingston upon Thames 010A,E01002922,1555,303,1252
2021,Kingston upon Thames 013A,E01002923,1599,361,1238
2021,Kingston upon Thames 014E,E01002924,1479,342,1137
2021,Kingston upon Thames 013B,E01002925,1484,199,1285
2021,Kingston upon Thames 010B,E01002926,1515,383,1132
2021,Kingston upon Thames 008A,E01002927,1592,321,1271
2021,Kingston upon Thames 008B,E01002928,1829,369,1460
2021,Kingston upon Thames 007A,E01002929,1611,354,1257
2021,Kingston upon Thames 007B,E01002930,1842,370,1472
2021,Kingston upon Thames 007C,E01002931,1878,455,1423
2021,Kingston upon Thames 006A,E01002932,1918,659,1259
2021,Kingston upon Thames 004A,E01002933,1911,497,1414
2021,Kingston upon Thames 004B,E01002934,1753,468,1285
2021,Kingston upon Thames 003A,E01002935,1768,384,1384
2021,Kingston upon Thames 004D,E01002937,1679,425,1254
2021,Kingston upon Thames 003B,E01002938,1874,482,1392
2021,Kingston upon Thames 018A,E01002939,1564,357,1207
2021,Kingston upon Thames 020A,E01002940,1577,306,1271
2021,Kingston upon Thames 018B,E01002941,1549,284,1265
2021,Kingston upon Thames 018C,E01002942,1333,282,1051
2021,Kingston upon Thames 020B,E01002943,1399,304,1095
2021,Kingston upon Thames 019A,E01002944,1251,256,995
2021,Kingston upon Thames 019B,E01002945,1484,285,1199
2021,Kingston upon Thames 019C,E01002946,1412,230,1182
2021,Kingston upon Thames 019D,E01002947,1553,320,1233
2021,Kingston upon Thames 020C,E01002948,2069,402,1667
2021,Kingston upon Thames 020D,E01002949,1745,361,1384
2021,Kingston upon Thames 020E,E01002950,1534,286,1248
2021,Kingston upon Thames 003C,E01002951,1422,353,1069
2021,Kingston upon Thames 002A,E01002952,1328,295,1033
2021,Kingston upon Thames 002B,E01002953,1291,264,1027
2021,Kingston upon Thames 003D,E01002954,1285,254,1031
2021,Kingston upon Thames 002C,E01002955,1448,349,1099
2021,Kingston upon Thames 002D,E01002956,1349,386,963
2021,Kingston upon Thames 003E,E01002957,1499,456,1043
2021,Kingston upon Thames 008C,E01002958,1611,346,1265
2021,Kingston upon Thames 002E,E01002959,1341,324,1017
2021,Kingston upon Thames 006B,E01002960,1507,328,1179
2021,Kingston upon Thames 008D,E01002961,1660,397,1263
2021,Kingston upon Thames 006C,E01002962,1530,383,1147
2021,Kingston upon Thames 007D,E01002963,1713,358,1355
2021,Kingston upon Thames 005A,E01002964,2390,853,1537
2021,Kingston upon Thames 009A,E01002965,2383,747,1636
2021,Kingston upon Thames 010C,E01002966,1845,449,1396
2021,Kingston upon Thames 009B,E01002967,1744,275,1469
2021,Kingston upon Thames 009C,E01002968,2795,908,1887
2021,Kingston upon Thames 005B,E01002969,1737,647,1090
2021,Kingston upon Thames 006D,E01002970,1692,409,1283
2021,Kingston upon Thames 005C,E01002971,1691,436,1255
2021,Kingston upon Thames 005D,E01002972,1893,476,1417
2021,Kingston upon Thames 006E,E01002973,1495,436,1059
2021,Kingston upon Thames 005E,E01002974,1939,571,1368
2021,Kingston upon Thames 012A,E01002975,1422,342,1080
2021,Kingston upon Thames 015A,E01002976,1586,301,1285
2021,Kingston upon Thames 012B,E01002977,1596,361,1235
2021,Kingston upon Thames 015B,E01002978,1745,320,1425
2021,Kingston upon Thames 015C,E01002979,1457,269,1188
2021,Kingston upon Thames 012C,E01002980,1354,264,1090
2021,Kingston upon Thames 012D,E01002981,1543,328,1215
2021,Kingston upon Thames 015D,E01002982,1444,280,1164
2021,Kingston upon Thames 015E,E01002983,1574,296,1278
2021,Kingston upon Thames 012E,E01002984,1363,290,1073
2021,Kingston upon Thames 007E,E01002985,1614,384,1230
2021,Kingston upon Thames 008E,E01002986,1308,280,1028
2021,Kingston upon Thames 011B,E01002987,1810,220,1590
2021,Kingston upon Thames 011C,E01002988,1593,584,1009
2021,Kingston upon Thames 011D,E01002989,1768,247,1521
2021,Kingston upon Thames 009D,E01002990,1600,202,1398
2021,Kingston upon Thames 009E,E01002991,1471,290,1181
2021,Kingston upon Thames 010D,E01002992,1499,706,793
2021,Kingston upon Thames 013C,E01002993,1468,193,1275
2021,Kingston upon Thames 016A,E01002994,1400,243,1157
2021,Kingston upon Thames 013D,E01002995,1524,243,1281
2021,Kingston upon Thames 016B,E01002996,1444,327,1117
2021,Kingston upon Thames 016C,E01002997,1434,280,1154
2021,Kingston upon Thames 016D,E01002998,1458,362,1096
2021,Kingston upon Thames 013E,E01002999,1426,276,1150
2021,Kingston upon Thames 017C,E01003000,1738,379,1359
2021,Kingston upon Thames 017D,E01003001,1809,394,1415
2021,Kingston upon Thames 016E,E01003002,1788,379,1409
2021,Kingston upon Thames 017E,E01003003,1639,375,1264
2021,Kingston upon Thames 018D,E01003004,1536,325,1211
2021,Kingston upon Thames 018E,E01003005,1473,318,1155
2021,Kingston upon Thames 001A,E01003006,1457,339,1118
2021,Kingston upon Thames 001B,E01003007,1560,423,1137
2021,Kingston upon Thames 001C,E01003008,1384,377,1007
2021,Kingston upon Thames 001D,E01003009,1951,549,1402
2021,Kingston upon Thames 001E,E01003010,1381,335,1046
2021,Kingston upon Thames 004E,E01003011,1613,373,1240
2021,Lambeth 036A,E01003013,1916,892,1024
2021,Lambeth 036B,E01003014,1453,301,1152
2021,Lambeth 002A,E01003015,1648,337,1311
2021,Lambeth 036C,E01003016,1175,465,710
2021,Lambeth 036D,E01003017,1580,326,1254
2021,Lambeth 020A,E01003018,1957,229,1728
2021,Lambeth 015A,E01003019,1969,207,1762
2021,Lambeth 016A,E01003020,1753,316,1437
2021,Lambeth 021A,E01003021,2092,279,1813
2021,Lambeth 021B,E01003022,1549,209,1340
2021,Lambeth 021C,E01003023,2455,423,2032
2021,Lambeth 021D,E01003024,1726,367,1359
2021,Lambeth 021E,E01003025,1947,397,1550
2021,Lambeth 019A,E01003026,1416,167,1249
2021,Lambeth 019B,E01003027,1313,230,1083
2021,Lambeth 019C,E01003028,1387,237,1150
2021,Lambeth 017A,E01003029,1754,207,1547
2021,Lambeth 019D,E01003030,1664,193,1471
2021,Lambeth 023A,E01003031,1501,270,1231
2021,Lambeth 017B,E01003032,1662,277,1385
2021,Lambeth 019E,E01003033,1520,283,1237
2021,Lambeth 012A,E01003034,1564,288,1276
2021,Lambeth 012B,E01003035,1631,188,1443
2021,Lambeth 012C,E01003036,1697,205,1492
2021,Lambeth 013A,E01003037,1391,244,1147
2021,Lambeth 013B,E01003038,1625,162,1463
2021,Lambeth 013C,E01003039,1956,263,1693
2021,Lambeth 013D,E01003040,1199,181,1018
2021,Lambeth 017C,E01003041,1467,271,1196
2021,Lambeth 013E,E01003042,1070,171,899
2021,Lambeth 018A,E01003043,1560,238,1322
2021,Lambeth 018B,E01003044,1333,328,1005
2021,Lambeth 011A,E01003045,1897,520,1377
2021,Lambeth 009A,E01003046,1610,384,1226
2021,Lambeth 011B,E01003047,1726,326,1400
2021,Lambeth 009B,E01003048,1797,521,1276
2021,Lambeth 011C,E01003049,1690,387,1303
2021,Lambeth 016B,E01003050,1533,201,1332
2021,Lambeth 018C,E01003051,2028,340,1688
2021,Lambeth 016C,E01003052,2091,488,1603
2021,Lambeth 015B,E01003053,1641,140,1501
2021,Lambeth 015C,E01003054,2143,200,1943
2021,Lambeth 016D,E01003055,1540,160,1380
2021,Lambeth 015D,E01003056,1673,193,1480
2021,Lambeth 017D,E01003057,1627,322,1305
2021,Lambeth 015E,E01003058,1922,186,1736
2021,Lambeth 011D,E01003059,2129,348,1781
2021,Lambeth 011E,E01003060,1628,350,1278
2021,Lambeth 011F,E01003061,1296,180,1116
2021,Lambeth 033A,E01003062,1739,264,1475
2021,Lambeth 033B,E01003063,1279,270,1009
2021,Lambeth 028A,E01003064,1368,280,1088
2021,Lambeth 031A,E01003065,1532,432,1100
2021,Lambeth 028B,E01003066,1758,372,1386
2021,Lambeth 033C,E01003067,1428,309,1119
2021,Lambeth 031B,E01003068,1469,351,1118
2021,Lambeth 033D,E01003069,1289,315,974
2021,Lambeth 033E,E01003070,1447,300,1147
2021,Lambeth 018D,E01003071,2215,381,1834
2021,Lambeth 014A,E01003072,1658,307,1351
2021,Lambeth 014B,E01003073,1509,329,1180
2021,Lambeth 018E,E01003074,2245,297,1948
2021,Lambeth 009C,E01003075,1624,412,1212
2021,Lambeth 014C,E01003076,2562,602,1960
2021,Lambeth 014D,E01003077,1774,267,1507
2021,Lambeth 014E,E01003078,1542,320,1222
2021,Lambeth 027A,E01003079,1577,360,1217
2021,Lambeth 027B,E01003080,1566,367,1199
2021,Lambeth 028C,E01003081,1740,339,1401
2021,Lambeth 031C,E01003082,1284,248,1036
2021,Lambeth 030A,E01003083,1455,300,1155
2021,Lambeth 030B,E01003084,1404,259,1145
2021,Lambeth 030C,E01003085,1650,335,1315
2021,Lambeth 031D,E01003086,1471,324,1147
2021,Lambeth 031E,E01003087,1540,407,1133
2021,Lambeth 010A,E01003088,1491,256,1235
2021,Lambeth 008A,E01003089,1851,437,1414
2021,Lambeth 012D,E01003090,2317,291,2026
2021,Lambeth 008B,E01003091,1632,331,1301
2021,Lambeth 008C,E01003092,2206,463,1743
2021,Lambeth 010B,E01003093,2192,536,1656
2021,Lambeth 010C,E01003094,1424,176,1248
2021,Lambeth 012E,E01003095,1576,234,1342
2021,Lambeth 010D,E01003096,2038,353,1685
2021,Lambeth 006A,E01003097,1497,276,1221
2021,Lambeth 005A,E01003098,1402,225,1177
2021,Lambeth 005B,E01003099,1626,295,1331
2021,Lambeth 005C,E01003100,1959,203,1756
2021,Lambeth 003A,E01003101,1379,244,1135
2021,Lambeth 004A,E01003102,1654,230,1424
2021,Lambeth 004C,E01003104,1668,260,1408
2021,Lambeth 003B,E01003105,1626,328,1298
2021,Lambeth 003C,E01003106,2045,432,1613
2021,Lambeth 003D,E01003107,1791,220,1571
2021,Lambeth 002B,E01003108,1474,307,1167
2021,Lambeth 002C,E01003110,1979,304,1675
2021,Lambeth 002D,E01003111,1835,467,1368
2021,Lambeth 002E,E01003112,1702,362,1340
2021,Lambeth 032A,E01003113,1691,306,1385
2021,Lambeth 032B,E01003114,2258,338,1920
2021,Lambeth 034A,E01003115,1502,269,1233
2021,Lambeth 029A,E01003116,1685,333,1352
2021,Lambeth 029B,E01003117,1758,279,1479
2021,Lambeth 029C,E01003118,1749,399,1350
2021,Lambeth 032C,E01003119,1969,365,1604
2021,Lambeth 032D,E01003120,2279,310,1969
2021,Lambeth 006B,E01003121,1510,380,1130
2021,Lambeth 004D,E01003122,1835,289,1546
2021,Lambeth 006C,E01003123,1544,194,1350
2021,Lambeth 006D,E01003124,1310,246,1064
2021,Lambeth 006E,E01003125,1714,453,1261
2021,Lambeth 008D,E01003126,1591,310,1281
2021,Lambeth 010E,E01003127,1989,371,1618
2021,Lambeth 008E,E01003128,1570,339,1231
2021,Lambeth 004E,E01003129,1728,274,1454
2021,Lambeth 026A,E01003130,1757,339,1418
2021,Lambeth 026B,E01003131,2052,314,1738
2021,Lambeth 024A,E01003132,1384,284,1100
2021,Lambeth 027C,E01003133,1567,279,1288
2021,Lambeth 027D,E01003134,1518,322,1196
2021,Lambeth 026C,E01003135,1853,364,1489
2021,Lambeth 022A,E01003136,1581,273,1308
2021,Lambeth 022B,E01003137,1512,324,1188
2021,Lambeth 026D,E01003138,1379,205,1174
2021,Lambeth 035A,E01003139,1440,298,1142
2021,Lambeth 035B,E01003140,1412,323,1089
2021,Lambeth 034B,E01003141,1702,319,1383
2021,Lambeth 035C,E01003142,1298,281,1017
2021,Lambeth 035D,E01003143,1433,309,1124
2021,Lambeth 034C,E01003144,1478,235,1243
2021,Lambeth 034D,E01003145,1569,260,1309
2021,Lambeth 035E,E01003146,1541,287,1254
2021,Lambeth 034E,E01003147,1937,342,1595
2021,Lambeth 032E,E01003148,1727,313,1414
2021,Lambeth 030D,E01003149,1658,248,1410
2021,Lambeth 032F,E01003150,1831,344,1487
2021,Lambeth 026E,E01003151,1858,424,1434
2021,Lambeth 027E,E01003152,1769,268,1501
2021,Lambeth 029D,E01003153,2086,234,1852
2021,Lambeth 030E,E01003154,1849,436,1413
2021,Lambeth 029E,E01003155,1743,294,1449
2021,Lambeth 023B,E01003156,1499,230,1269
2021,Lambeth 023C,E01003157,1451,309,1142
2021,Lambeth 023D,E01003158,1506,171,1335
2021,Lambeth 022C,E01003159,1715,236,1479
2021,Lambeth 022D,E01003160,1405,269,1136
2021,Lambeth 023E,E01003161,1247,224,1023
2021,Lambeth 022E,E01003162,1767,380,1387
2021,Lambeth 023F,E01003163,1532,320,1212
2021,Lambeth 025A,E01003164,2140,442,1698
2021,Lambeth 025B,E01003165,1544,302,1242
2021,Lambeth 028D,E01003166,2431,406,2025
2021,Lambeth 028E,E01003167,1635,333,1302
2021,Lambeth 025C,E01003168,1600,358,1242
2021,Lambeth 025D,E01003169,2205,404,1801
2021,Lambeth 025E,E01003170,1785,380,1405
2021,Lambeth 020B,E01003171,1561,220,1341
2021,Lambeth 024B,E01003172,1831,465,1366
2021,Lambeth 020C,E01003173,1553,255,1298
2021,Lambeth 024C,E01003174,1933,542,1391
2021,Lambeth 024D,E01003175,1494,360,1134
2021,Lambeth 016E,E01003176,1847,467,1380
2021,Lambeth 020D,E01003177,1522,216,1306
2021,Lambeth 020E,E01003178,1447,184,1263
2021,Lambeth 024E,E01003179,1516,419,1097
2021,Lambeth 005D,E01003180,1532,344,1188
2021,Lambeth 007A,E01003181,1466,245,1221
2021,Lambeth 009D,E01003182,1705,358,1347
2021,Lambeth 005E,E01003183,1530,286,1244
2021,Lambeth 007B,E01003184,1344,318,1026
2021,Lambeth 007C,E01003185,1842,275,1567
2021,Lambeth 007D,E01003186,2365,368,1997
2021,Lambeth 007E,E01003187,2200,437,1763
2021,Lambeth 009E,E01003188,1212,216,996
2021,Lewisham 034A,E01003189,1674,484,1190
2021,Lewisham 034B,E01003190,2137,573,1564
2021,Lewisham 034C,E01003191,1537,330,1207
2021,Lewisham 034D,E01003192,1677,431,1246
2021,Lewisham 029A,E01003193,1606,334,1272
2021,Lewisham 029B,E01003194,1649,349,1300
2021,Lewisham 029C,E01003195,1390,295,1095
2021,Lewisham 029D,E01003196,1659,429,1230
2021,Lewisham 029E,E01003197,1582,400,1182
2021,Lewisham 009A,E01003198,1403,265,1138
2021,Lewisham 007A,E01003199,1857,338,1519
2021,Lewisham 009B,E01003200,1396,222,1174
2021,Lewisham 007B,E01003201,1598,314,1284
2021,Lewisham 009C,E01003202,1484,203,1281
2021,Lewisham 009D,E01003203,1829,363,1466
2021,Lewisham 007C,E01003204,1528,339,1189
2021,Lewisham 007D,E01003205,1311,325,986
2021,Lewisham 007E,E01003206,1339,217,1122
2021,Lewisham 005A,E01003207,2232,573,1659
2021,Lewisham 005B,E01003209,1798,582,1216
2021,Lewisham 005C,E01003210,1661,291,1370
2021,Lewisham 008B,E01003211,1474,247,1227
2021,Lewisham 005D,E01003212,1902,389,1513
2021,Lewisham 008C,E01003213,1828,418,1410
2021,Lewisham 008D,E01003214,1681,337,1344
2021,Lewisham 005E,E01003215,1824,722,1102
2021,Lewisham 025A,E01003216,1569,296,1273
2021,Lewisham 022A,E01003217,1794,466,1328
2021,Lewisham 022B,E01003218,1453,341,1112
2021,Lewisham 025B,E01003219,1619,342,1277
2021,Lewisham 022C,E01003220,1551,255,1296
2021,Lewisham 025C,E01003221,1980,391,1589
2021,Lewisham 022D,E01003222,1451,242,1209
2021,Lewisham 025D,E01003223,1584,278,1306
2021,Lewisham 022E,E01003224,1590,317,1273
2021,Lewisham 015A,E01003225,1464,314,1150
2021,Lewisham 019A,E01003226,1689,326,1363
2021,Lewisham 019B,E01003227,1525,275,1250
2021,Lewisham 019C,E01003228,1450,249,1201
2021,Lewisham 019D,E01003229,1568,310,1258
2021,Lewisham 019E,E01003230,1822,334,1488
2021,Lewisham 015B,E01003231,1449,271,1178
2021,Lewisham 015C,E01003232,1574,333,1241
2021,Lewisham 015D,E01003233,1713,393,1320
2021,Lewisham 038A,E01003235,1328,297,1031
2021,Lewisham 037A,E01003236,1600,386,1214
2021,Lewisham 037B,E01003237,1572,411,1161
2021,Lewisham 037C,E01003238,1400,399,1001
2021,Lewisham 037D,E01003239,1500,423,1077
2021,Lewisham 038B,E01003240,1915,544,1371
2021,Lewisham 038C,E01003241,1528,280,1248
2021,Lewisham 038D,E01003243,1414,328,1086
2021,Lewisham 001A,E01003244,1795,516,1279
2021,Lewisham 001B,E01003245,1900,616,1284
2021,Lewisham 002A,E01003246,2280,473,1807
2021,Lewisham 001C,E01003247,2010,322,1688
2021,Lewisham 002B,E01003248,1563,390,1173
2021,Lewisham 001D,E01003249,1952,389,1563
2021,Lewisham 002C,E01003251,1630,513,1117
2021,Lewisham 002D,E01003252,1480,446,1034
2021,Lewisham 002E,E01003253,1350,293,1057
2021,Lewisham 021A,E01003254,1364,290,1074
2021,Lewisham 021B,E01003255,1865,289,1576
2021,Lewisham 028A,E01003256,1980,414,1566
2021,Lewisham 028B,E01003257,1505,325,1180
2021,Lewisham 028C,E01003258,1462,410,1052
2021,Lewisham 028D,E01003259,1605,316,1289
2021,Lewisham 021C,E01003260,1553,329,1224
2021,Lewisham 021D,E01003261,1435,273,1162
2021,Lewisham 021E,E01003262,1441,267,1174
2021,Lewisham 023A,E01003263,1668,368,1300
2021,Lewisham 031A,E01003264,1543,250,1293
2021,Lewisham 031B,E01003265,1515,333,1182
2021,Lewisham 031C,E01003266,1623,347,1276
2021,Lewisham 031D,E01003267,1659,400,1259
2021,Lewisham 023B,E01003268,1725,367,1358
2021,Lewisham 023C,E01003269,1495,303,1192
2021,Lewisham 023D,E01003270,1555,285,1270
2021,Lewisham 023E,E01003271,1527,288,1239
2021,Lewisham 014A,E01003272,1872,368,1504
2021,Lewisham 011A,E01003273,1422,289,1133
2021,Lewisham 014B,E01003274,1489,305,1184
2021,Lewisham 014C,E01003275,1589,312,1277
2021,Lewisham 014D,E01003276,1765,432,1333
2021,Lewisham 011B,E01003277,1592,257,1335
2021,Lewisham 011C,E01003278,1969,421,1548
2021,Lewisham 011D,E01003279,1428,279,1149
2021,Lewisham 016A,E01003280,1513,416,1097
2021,Lewisham 016B,E01003281,1365,282,1083
2021,Lewisham 013A,E01003282,2279,367,1912
2021,Lewisham 013B,E01003283,1959,394,1565
2021,Lewisham 013C,E01003284,1743,355,1388
2021,Lewisham 016C,E01003285,1626,344,1282
2021,Lewisham 013D,E01003286,1630,389,1241
2021,Lewisham 016D,E01003287,1788,371,1417
2021,Lewisham 041A,E01003288,2021,367,1654
2021,Lewisham 041E,E01003290,1803,331,1472
2021,Lewisham 041D,E01003291,1453,348,1105
2021,Lewisham 017A,E01003292,1643,288,1355
2021,Lewisham 017B,E01003293,1447,275,1172
2021,Lewisham 017D,E01003295,1649,299,1350
2021,Lewisham 003A,E01003297,1577,305,1272
2021,Lewisham 039A,E01003298,1213,318,895
2021,Lewisham 003B,E01003299,1685,374,1311
2021,Lewisham 039B,E01003300,1413,363,1050
2021,Lewisham 003C,E01003301,2522,686,1836
2021,Lewisham 003D,E01003302,1765,437,1328
2021,Lewisham 039C,E01003303,1626,422,1204
2021,Lewisham 039D,E01003304,2152,425,1727
2021,Lewisham 003E,E01003305,2127,683,1444
2021,Lewisham 024A,E01003307,1499,289,1210
2021,Lewisham 024B,E01003308,1671,343,1328
2021,Lewisham 027A,E01003309,1504,350,1154
2021,Lewisham 027B,E01003310,1505,255,1250
2021,Lewisham 027C,E01003311,1484,313,1171
2021,Lewisham 027D,E01003312,1629,313,1316
2021,Lewisham 027E,E01003313,1436,369,1067
2021,Lewisham 024C,E01003314,1484,318,1166
2021,Lewisham 024D,E01003315,1231,210,1021
2021,Lewisham 024E,E01003316,1365,240,1125
2021,Lewisham 020B,E01003318,1942,445,1497
2021,Lewisham 018A,E01003319,1674,358,1316
2021,Lewisham 018B,E01003320,1487,321,1166
2021,Lewisham 020C,E01003321,1627,280,1347
2021,Lewisham 020D,E01003322,1524,264,1260
2021,Lewisham 018C,E01003323,1409,225,1184
2021,Lewisham 020E,E01003324,1538,347,1191
2021,Lewisham 018D,E01003325,1659,367,1292
2021,Lewisham 035A,E01003326,1633,313,1320
2021,Lewisham 035B,E01003327,1536,282,1254
2021,Lewisham 035C,E01003328,1682,280,1402
2021,Lewisham 033A,E01003329,1533,331,1202
2021,Lewisham 033B,E01003330,1476,379,1097
2021,Lewisham 033C,E01003331,1453,320,1133
2021,Lewisham 033D,E01003332,1490,317,1173
2021,Lewisham 035D,E01003333,1420,261,1159
2021,Lewisham 033E,E01003334,1680,341,1339
2021,Lewisham 035E,E01003335,1428,350,1078
2021,Lewisham 010A,E01003336,1448,380,1068
2021,Lewisham 010B,E01003337,1352,384,968
2021,Lewisham 006A,E01003338,1928,452,1476
2021,Lewisham 006B,E01003339,1614,348,1266
2021,Lewisham 006C,E01003340,1977,367,1610
2021,Lewisham 006D,E01003341,1323,234,1089
2021,Lewisham 010C,E01003342,1542,260,1282
2021,Lewisham 006E,E01003343,1367,260,1107
2021,Lewisham 010D,E01003344,1592,324,1268
2021,Lewisham 010E,E01003345,1815,392,1423
2021,Lewisham 026A,E01003346,1597,350,1247
2021,Lewisham 030A,E01003347,1630,549,1081
2021,Lewisham 030B,E01003348,1691,434,1257
2021,Lewisham 026B,E01003349,1424,411,1013
2021,Lewisham 030C,E01003350,1254,344,910
2021,Lewisham 026C,E01003351,1565,425,1140
2021,Lewisham 030D,E01003352,2145,592,1553
2021,Lewisham 030E,E01003353,1681,388,1293
2021,Lewisham 026D,E01003354,1868,448,1420
2021,Merton 009A,E01003355,1662,205,1457
2021,Merton 009B,E01003356,1697,321,1376
2021,Merton 012A,E01003357,1742,455,1287
2021,Merton 009C,E01003358,1672,242,1430
2021,Merton 006A,E01003359,1628,236,1392
2021,Merton 006B,E01003360,1639,244,1395
2021,Merton 015A,E01003361,1562,323,1239
2021,Merton 021A,E01003362,1293,246,1047
2021,Merton 021B,E01003363,1581,347,1234
2021,Merton 021C,E01003364,1722,375,1347
2021,Merton 021D,E01003365,1417,307,1110
2021,Merton 016A,E01003366,1616,275,1341
2021,Merton 008A,E01003368,1568,274,1294
2021,Merton 005B,E01003369,1536,197,1339
2021,Merton 005C,E01003370,1873,293,1580
2021,Merton 005D,E01003371,1470,205,1265
2021,Merton 008B,E01003372,1601,324,1277
2021,Merton 018A,E01003373,1427,358,1069
2021,Merton 022A,E01003374,1679,340,1339
2021,Merton 022B,E01003375,1685,345,1340
2021,Merton 012B,E01003376,1476,314,1162
2021,Merton 012C,E01003377,1545,425,1120
2021,Merton 018B,E01003378,2072,487,1585
2021,Merton 018C,E01003379,1886,511,1375
2021,Merton 011A,E01003380,1613,338,1275
2021,Merton 016B,E01003381,1428,182,1246
2021,Merton 011B,E01003382,1644,306,1338
2021,Merton 009D,E01003383,1509,265,1244
2021,Merton 009E,E01003384,1557,277,1280
2021,Merton 011C,E01003385,1500,353,1147
2021,Merton 013A,E01003386,2112,523,1589
2021,Merton 014A,E01003387,1944,451,1493
2021,Merton 013B,E01003388,1633,364,1269
2021,Merton 013C,E01003389,1699,370,1329
2021,Merton 018D,E01003390,1659,484,1175
2021,Merton 014B,E01003391,1228,377,851
2021,Merton 013D,E01003392,1331,262,1069
2021,Merton 008C,E01003393,1509,253,1256
2021,Merton 007A,E01003394,1936,361,1575
2021,Merton 007B,E01003395,1534,299,1235
2021,Merton 007C,E01003396,1413,275,1138
2021,Merton 007D,E01003397,1436,250,1186
2021,Merton 007E,E01003398,1791,349,1442
2021,Merton 011D,E01003399,1326,205,1121
2021,Merton 003A,E01003400,1374,218,1156
2021,Merton 004A,E01003401,1312,209,1103
2021,Merton 004B,E01003402,1415,268,1147
2021,Merton 004C,E01003403,1419,207,1212
2021,Merton 004D,E01003404,1724,234,1490
2021,Merton 018E,E01003405,2275,539,1736
2021,Merton 008D,E01003406,1607,325,1282
2021,Merton 008E,E01003407,1814,357,1457
2021,Merton 012D,E01003408,1823,295,1528
2021,Merton 013E,E01003409,1709,394,1315
2021,Merton 012E,E01003410,1547,335,1212
2021,Merton 014C,E01003411,1838,431,1407
2021,Merton 014D,E01003412,1649,414,1235
2021,Merton 017A,E01003413,1946,443,1503
2021,Merton 017B,E01003414,1651,328,1323
2021,Merton 017C,E01003415,2243,545,1698
2021,Merton 017D,E01003416,1515,275,1240
2021,Merton 025A,E01003417,1481,277,1204
2021,Merton 025B,E01003418,1375,255,1120
2021,Merton 025C,E01003419,1706,353,1353
2021,Merton 025D,E01003420,1397,314,1083
2021,Merton 021E,E01003421,1497,275,1222
2021,Merton 025E,E01003422,1380,249,1131
2021,Merton 011E,E01003423,1544,322,1222
2021,Merton 015B,E01003424,1473,318,1155
2021,Merton 015C,E01003425,1417,322,1095
2021,Merton 015D,E01003426,1676,315,1361
2021,Merton 023A,E01003427,1836,390,1446
2021,Merton 015E,E01003428,1426,297,1129
2021,Merton 019A,E01003429,1536,348,1188
2021,Merton 019B,E01003430,1550,416,1134
2021,Merton 019C,E01003431,1607,444,1163
2021,Merton 019D,E01003432,1614,492,1122
2021,Merton 019E,E01003433,1507,303,1204
2021,Merton 017E,E01003434,1474,340,1134
2021,Merton 014E,E01003435,1982,507,1475
2021,Merton 023B,E01003436,1631,344,1287
2021,Merton 022C,E01003437,1924,347,1577
2021,Merton 024A,E01003438,1714,397,1317
2021,Merton 023C,E01003439,1483,321,1162
2021,Merton 022D,E01003440,1556,363,1193
2021,Merton 022E,E01003441,1770,383,1387
2021,Merton 010A,E01003442,1618,369,1249
2021,Merton 010B,E01003443,1513,359,1154
2021,Merton 010C,E01003444,1517,315,1202
2021,Merton 010D,E01003445,1708,380,1328
2021,Merton 016C,E01003446,1839,318,1521
2021,Merton 016D,E01003447,1503,298,1205
2021,Merton 023D,E01003448,2155,471,1684
2021,Merton 024B,E01003449,1764,387,1377
2021,Merton 024C,E01003450,1685,425,1260
2021,Merton 024D,E01003451,1829,388,1441
2021,Merton 024E,E01003452,2087,467,1620
2021,Merton 023E,E01003453,1737,383,1354
2021,Merton 003B,E01003454,1293,204,1089
2021,Merton 005E,E01003455,1551,250,1301
2021,Merton 003C,E01003456,1510,232,1278
2021,Merton 006C,E01003457,1484,320,1164
2021,Merton 006D,E01003458,1611,288,1323
2021,Merton 006E,E01003459,2016,316,1700
2021,Merton 002A,E01003460,1353,221,1132
2021,Merton 004E,E01003461,1401,227,1174
2021,Merton 002B,E01003462,1351,274,1077
2021,Merton 010E,E01003463,1427,350,1077
2021,Merton 002C,E01003464,1337,244,1093
2021,Merton 002D,E01003465,1266,287,979
2021,Merton 020A,E01003466,1598,316,1282
2021,Merton 020B,E01003467,1648,355,1293
2021,Merton 020C,E01003468,1633,355,1278
2021,Merton 020D,E01003469,1549,335,1214
2021,Merton 020E,E01003470,1899,439,1460
2021,Merton 016E,E01003471,1611,309,1302
2021,Merton 001A,E01003472,1204,272,932
2021,Merton 001B,E01003473,1364,264,1100
2021,Merton 001C,E01003474,1290,324,966
2021,Merton 003D,E01003476,1267,309,958
2021,Merton 003E,E01003477,1488,324,1164
2021,Merton 001E,E01003478,1720,393,1327
2021,Newham 035A,E01003479,1444,368,1076
2021,Newham 033A,E01003480,1912,724,1188
2021,Newham 035B,E01003481,1397,474,923
2021,Newham 032A,E01003483,1571,343,1228
2021,Newham 032B,E01003484,1675,459,1216
2021,Newham 035C,E01003485,1602,412,1190
2021,Newham 033C,E01003486,1142,233,909
2021,Newham 033D,E01003487,1274,321,953
2021,Newham 019A,E01003488,1812,457,1355
2021,Newham 019B,E01003489,2771,806,1965
2021,Newham 019C,E01003490,1850,561,1289
2021,Newham 022A,E01003491,1826,447,1379
2021,Newham 025A,E01003492,1904,573,1331
2021,Newham 025C,E01003494,1961,580,1381
2021,Newham 025D,E01003495,1934,579,1355
2021,Newham 027A,E01003496,1264,260,1004
2021,Newham 034A,E01003497,1567,390,1177
2021,Newham 027B,E01003498,1727,423,1304
2021,Newham 030A,E01003499,2232,625,1607
2021,Newham 027C,E01003500,1946,496,1450
2021,Newham 030B,E01003501,2228,579,1649
2021,Newham 030C,E01003502,2503,797,1706
2021,Newham 030D,E01003503,2752,558,2194
2021,Newham 034D,E01003506,1350,369,981
2021,Newham 031A,E01003507,2123,544,1579
2021,Newham 031B,E01003508,2350,584,1766
2021,Newham 031C,E01003509,1886,484,1402
2021,Newham 036A,E01003511,1803,433,1370
2021,Newham 036B,E01003512,1871,476,1395
2021,Newham 035D,E01003513,1463,383,1080
2021,Newham 036C,E01003514,1552,459,1093
2021,Newham 036D,E01003515,1971,474,1497
2021,Newham 032C,E01003516,1781,520,1261
2021,Newham 036E,E01003517,1766,513,1253
2021,Newham 032D,E01003518,1510,376,1134
2021,Newham 032E,E01003519,1535,409,1126
2021,Newham 018A,E01003520,1857,524,1333
2021,Newham 018B,E01003521,2032,549,1483
2021,Newham 018C,E01003522,1727,498,1229
2021,Newham 024A,E01003523,2287,590,1697
2021,Newham 019D,E01003524,1794,514,1280
2021,Newham 018D,E01003525,1935,618,1317
2021,Newham 018E,E01003526,1727,493,1234
2021,Newham 024B,E01003527,1708,502,1206
2021,Newham 005A,E01003528,1260,406,854
2021,Newham 010A,E01003529,2224,473,1751
2021,Newham 010B,E01003530,1764,458,1306
2021,Newham 010C,E01003531,2051,587,1464
2021,Newham 010D,E01003532,2140,568,1572
2021,Newham 011A,E01003533,2161,661,1500
2021,Newham 010E,E01003534,2159,632,1527
2021,Newham 023A,E01003535,1725,518,1207
2021,Newham 023B,E01003536,1945,630,1315
2021,Newham 024C,E01003537,2013,611,1402
2021,Newham 029A,E01003538,1988,545,1443
2021,Newham 029B,E01003539,2343,724,1619
2021,Newham 029C,E01003540,1867,563,1304
2021,Newham 029D,E01003541,1885,597,1288
2021,Newham 024D,E01003542,2112,714,1398
2021,Newham 001A,E01003543,2184,512,1672
2021,Newham 001B,E01003544,1685,381,1304
2021,Newham 006A,E01003545,1654,391,1263
2021,Newham 001C,E01003546,1644,402,1242
2021,Newham 007A,E01003547,1827,365,1462
2021,Newham 006B,E01003548,2127,456,1671
2021,Newham 006C,E01003549,1984,476,1508
2021,Newham 001D,E01003550,1635,401,1234
2021,Newham 009A,E01003551,1726,370,1356
2021,Newham 016A,E01003552,1493,373,1120
2021,Newham 009B,E01003553,1898,511,1387
2021,Newham 009C,E01003554,1804,325,1479
2021,Newham 007B,E01003555,1738,432,1306
2021,Newham 008A,E01003556,1825,556,1269
2021,Newham 006D,E01003557,1805,401,1404
2021,Newham 008B,E01003558,1583,427,1156
2021,Newham 009D,E01003559,2259,449,1810
2021,Newham 011B,E01003560,1568,451,1117
2021,Newham 007C,E01003561,1593,476,1117
2021,Newham 014A,E01003562,1945,463,1482
2021,Newham 011C,E01003563,2286,705,1581
2021,Newham 014B,E01003564,2227,665,1562
2021,Newham 014C,E01003565,1933,634,1299
2021,Newham 014D,E01003566,1813,609,1204
2021,Newham 007D,E01003567,1774,556,1218
2021,Newham 017A,E01003568,2429,739,1690
2021,Newham 017B,E01003569,2188,433,1755
2021,Newham 008C,E01003570,1767,487,1280
2021,Newham 008D,E01003571,2108,598,1510
2021,Newham 008E,E01003572,1552,414,1138
2021,Newham 017C,E01003573,2071,558,1513
2021,Newham 017D,E01003574,2360,618,1742
2021,Newham 005B,E01003575,1540,478,1062
2021,Newham 002A,E01003576,1639,501,1138
2021,Newham 005C,E01003577,2182,742,1440
2021,Newham 003A,E01003578,1839,626,1213
2021,Newham 004A,E01003579,1845,611,1234
2021,Newham 005D,E01003580,1872,645,1227
2021,Newham 002B,E01003581,1673,509,1164
2021,Newham 002C,E01003582,1479,493,986
2021,Newham 002D,E01003583,1916,665,1251
2021,Newham 003B,E01003584,1780,390,1390
2021,Newham 004B,E01003585,1528,433,1095
2021,Newham 003C,E01003586,1702,497,1205
2021,Newham 004C,E01003587,2284,667,1617
2021,Newham 011D,E01003588,1471,424,1047
2021,Newham 011E,E01003589,1729,493,1236
2021,Newham 003D,E01003590,1483,379,1104
2021,Newham 004D,E01003591,2092,645,1447
2021,Newham 022B,E01003592,1778,471,1307
2021,Newham 027D,E01003593,1426,332,1094
2021,Newham 026A,E01003594,1724,453,1271
2021,Newham 026B,E01003595,1686,394,1292
2021,Newham 016B,E01003596,1580,440,1140
2021,Newham 016C,E01003597,1926,422,1504
2021,Newham 021A,E01003598,1764,509,1255
2021,Newham 022C,E01003599,1546,498,1048
2021,Newham 021B,E01003600,1560,399,1161
2021,Newham 028A,E01003601,2081,566,1515
2021,Newham 026C,E01003602,2050,634,1416
2021,Newham 028B,E01003603,1801,543,1258
2021,Newham 031D,E01003604,2135,623,1512
2021,Newham 028C,E01003605,1943,527,1416
2021,Newham 026D,E01003607,1740,442,1298
2021,Newham 028D,E01003608,1901,484,1417
2021,Newham 041C,E01003611,1825,560,1265
2021,Newham 039A,E01003615,1579,358,1221
2021,Newham 012A,E01003616,1748,373,1375
2021,Newham 012C,E01003618,2150,482,1668
2021,Newham 012D,E01003619,2275,572,1703
2021,Newham 023C,E01003621,1547,470,1077
2021,Newham 023D,E01003622,1683,558,1125
2021,Newham 023E,E01003623,1660,525,1135
2021,Newham 024E,E01003624,1585,472,1113
2021,Newham 015A,E01003625,1563,447,1116
2021,Newham 015B,E01003626,1591,427,1164
2021,Newham 015C,E01003627,1429,370,1059
2021,Newham 015D,E01003628,1589,466,1123
2021,Newham 015E,E01003629,1802,502,1300
2021,Newham 021C,E01003630,1780,388,1392
2021,Newham 020A,E01003631,1784,436,1348
2021,Newham 020B,E01003632,2302,494,1808
2021,Newham 020C,E01003633,1736,458,1278
2021,Newham 020D,E01003634,1654,406,1248
2021,Newham 016D,E01003635,1729,316,1413
2021,Newham 020E,E01003636,2015,503,1512
2021,Newham 021D,E01003637,1770,333,1437
2021,Redbridge 017A,E01003638,1799,407,1392
2021,Redbridge 013A,E01003639,2099,519,1580
2021,Redbridge 013B,E01003640,1828,483,1345
2021,Redbridge 013C,E01003641,1892,384,1508
2021,Redbridge 013D,E01003642,1681,396,1285
2021,Redbridge 017B,E01003643,2136,522,1614
2021,Redbridge 017C,E01003644,1580,422,1158
2021,Redbridge 017D,E01003645,2562,657,1905
2021,Redbridge 012A,E01003646,1815,435,1380
2021,Redbridge 015A,E01003647,1836,428,1408
2021,Redbridge 012B,E01003648,1435,289,1146
2021,Redbridge 012C,E01003649,1600,396,1204
2021,Redbridge 015B,E01003650,1671,421,1250
2021,Redbridge 012D,E01003651,1438,301,1137
2021,Redbridge 015C,E01003652,1531,380,1151
2021,Redbridge 015D,E01003653,1956,505,1451
2021,Redbridge 004A,E01003654,1591,358,1233
2021,Redbridge 004B,E01003655,1466,220,1246
2021,Redbridge 005A,E01003656,1475,300,1175
2021,Redbridge 005B,E01003657,2063,399,1664
2021,Redbridge 004C,E01003658,1636,366,1270
2021,Redbridge 005C,E01003659,1619,342,1277
2021,Redbridge 004D,E01003660,1648,320,1328
2021,Redbridge 038A,E01003661,2073,563,1510
2021,Redbridge 038C,E01003662,1961,508,1453
2021,Redbridge 037A,E01003663,1866,496,1370
2021,Redbridge 037B,E01003664,1783,539,1244
2021,Redbridge 037E,E01003665,1624,446,1178
2021,Redbridge 038B,E01003666,2612,775,1837
2021,Redbridge 007A,E01003668,1625,231,1394
2021,Redbridge 007B,E01003669,1455,298,1157
2021,Redbridge 007C,E01003670,1454,325,1129
2021,Redbridge 007D,E01003671,1461,309,1152
2021,Redbridge 007E,E01003672,1561,301,1260
2021,Redbridge 007F,E01003673,1773,329,1444
2021,Redbridge 007G,E01003674,2229,375,1854
2021,Redbridge 036A,E01003675,1612,393,1219
2021,Redbridge 036B,E01003676,1832,473,1359
2021,Redbridge 036C,E01003677,1731,451,1280
2021,Redbridge 036D,E01003678,1583,407,1176
2021,Redbridge 036E,E01003679,1678,432,1246
2021,Redbridge 036F,E01003680,1601,404,1197
2021,Redbridge 036G,E01003681,1916,444,1472
2021,Redbridge 036H,E01003682,1788,463,1325
2021,Redbridge 040C,E01003683,1980,561,1419
2021,Redbridge 040E,E01003684,1757,555,1202
2021,Redbridge 040D,E01003685,1784,498,1286
2021,Redbridge 040A,E01003686,1854,446,1408
2021,Redbridge 040B,E01003688,1669,473,1196
2021,Redbridge 039C,E01003689,2077,498,1579
2021,Redbridge 035A,E01003690,1995,403,1592
2021,Redbridge 035B,E01003691,1517,402,1115
2021,Redbridge 035C,E01003692,1549,412,1137
2021,Redbridge 035D,E01003693,1596,421,1175
2021,Redbridge 035E,E01003694,1403,321,1082
2021,Redbridge 035F,E01003695,1418,313,1105
2021,Redbridge 035G,E01003696,1705,393,1312
2021,Redbridge 035H,E01003697,1632,398,1234
2021,Redbridge 006A,E01003698,1426,337,1089
2021,Redbridge 006B,E01003699,1443,288,1155
2021,Redbridge 006C,E01003700,2370,545,1825
2021,Redbridge 006D,E01003701,1919,470,1449
2021,Redbridge 006E,E01003702,2056,401,1655
2021,Redbridge 006F,E01003703,2515,606,1909
2021,Redbridge 006G,E01003704,1897,512,1385
2021,Redbridge 010A,E01003705,2277,553,1724
2021,Redbridge 010B,E01003706,1594,406,1188
2021,Redbridge 008A,E01003707,1448,338,1110
2021,Redbridge 008B,E01003708,1938,556,1382
2021,Redbridge 008C,E01003709,1678,409,1269
2021,Redbridge 008D,E01003710,1444,295,1149
2021,Redbridge 010C,E01003711,1809,436,1373
2021,Redbridge 010D,E01003712,1401,360,1041
2021,Redbridge 034A,E01003713,1780,506,1274
2021,Redbridge 034B,E01003714,2219,573,1646
2021,Redbridge 034C,E01003715,2061,523,1538
2021,Redbridge 034D,E01003716,1703,395,1308
2021,Redbridge 034E,E01003718,1806,466,1340
2021,Redbridge 034F,E01003719,2191,550,1641
2021,Redbridge 002A,E01003720,1821,379,1442
2021,Redbridge 003A,E01003721,1747,392,1355
2021,Redbridge 002B,E01003722,2218,584,1634
2021,Redbridge 002C,E01003723,1791,399,1392
2021,Redbridge 003B,E01003724,1392,318,1074
2021,Redbridge 003C,E01003725,1562,328,1234
2021,Redbridge 002D,E01003726,2302,522,1780
2021,Redbridge 003D,E01003727,1674,396,1278
2021,Redbridge 032B,E01003729,1647,497,1150
2021,Redbridge 032C,E01003730,1727,522,1205
2021,Redbridge 033A,E01003731,1328,391,937
2021,Redbridge 032D,E01003732,1623,474,1149
2021,Redbridge 032E,E01003733,1688,509,1179
2021,Redbridge 033B,E01003734,1691,523,1168
2021,Redbridge 033C,E01003735,1950,627,1323
2021,Redbridge 033D,E01003736,1854,564,1290
2021,Redbridge 031A,E01003737,2744,924,1820
2021,Redbridge 031B,E01003738,2227,625,1602
2021,Redbridge 031C,E01003739,2236,657,1579
2021,Redbridge 031D,E01003740,2101,519,1582
2021,Redbridge 031E,E01003741,1834,438,1396
2021,Redbridge 031F,E01003742,2214,673,1541
2021,Redbridge 031G,E01003743,1765,504,1261
2021,Redbridge 001A,E01003744,1379,248,1131
2021,Redbridge 001B,E01003745,1357,302,1055
2021,Redbridge 001C,E01003746,1545,281,1264
2021,Redbridge 001D,E01003747,1293,276,1017
2021,Redbridge 001E,E01003748,1556,284,1272
2021,Redbridge 001F,E01003749,1666,342,1324
2021,Redbridge 001G,E01003750,1802,302,1500
2021,Redbridge 020A,E01003751,2149,583,1566
2021,Redbridge 023A,E01003752,2589,668,1921
2021,Redbridge 020B,E01003753,1854,492,1362
2021,Redbridge 020C,E01003754,1641,374,1267
2021,Redbridge 023B,E01003755,2243,695,1548
2021,Redbridge 023C,E01003756,2315,622,1693
2021,Redbridge 020D,E01003757,2006,535,1471
2021,Redbridge 009A,E01003759,1481,329,1152
2021,Redbridge 009B,E01003760,1781,407,1374
2021,Redbridge 009C,E01003761,1695,540,1155
2021,Redbridge 009D,E01003762,1613,334,1279
2021,Redbridge 009E,E01003763,1898,454,1444
2021,Redbridge 009F,E01003764,1950,395,1555
2021,Redbridge 009G,E01003765,1782,350,1432
2021,Redbridge 024A,E01003766,1983,519,1464
2021,Redbridge 024B,E01003767,2004,598,1406
2021,Redbridge 024C,E01003768,1758,405,1353
2021,Redbridge 022A,E01003769,1735,445,1290
2021,Redbridge 022B,E01003770,2725,803,1922
2021,Redbridge 022C,E01003771,1678,470,1208
2021,Redbridge 024D,E01003772,1705,468,1237
2021,Redbridge 022D,E01003773,1715,490,1225
2021,Redbridge 014A,E01003774,1780,304,1476
2021,Redbridge 014B,E01003775,1579,310,1269
2021,Redbridge 014C,E01003776,1657,225,1432
2021,Redbridge 014D,E01003777,1727,236,1491
2021,Redbridge 014E,E01003778,1808,264,1544
2021,Redbridge 014F,E01003779,1545,239,1306
2021,Redbridge 014G,E01003780,1494,302,1192
2021,Redbridge 026A,E01003781,1896,505,1391
2021,Redbridge 026B,E01003782,1587,450,1137
2021,Redbridge 029A,E01003783,2286,577,1709
2021,Redbridge 029B,E01003784,1864,453,1411
2021,Redbridge 029C,E01003785,1839,431,1408
2021,Redbridge 026C,E01003786,1525,429,1096
2021,Redbridge 026D,E01003787,1528,378,1150
2021,Redbridge 029D,E01003788,1655,396,1259
2021,Redbridge 018A,E01003789,1336,213,1123
2021,Redbridge 027A,E01003790,1401,314,1087
2021,Redbridge 027B,E01003791,1389,266,1123
2021,Redbridge 027C,E01003792,1327,271,1056
2021,Redbridge 027D,E01003793,1456,282,1174
2021,Redbridge 018B,E01003794,1453,325,1128
2021,Redbridge 018C,E01003795,1155,260,895
2021,Redbridge 018D,E01003796,1497,312,1185
2021,Richmond upon Thames 001A,E01003797,1380,345,1035
2021,Richmond upon Thames 001B,E01003798,1322,236,1086
2021,Richmond upon Thames 001C,E01003799,1495,324,1171
2021,Richmond upon Thames 001D,E01003800,1442,340,1102
2021,Richmond upon Thames 001E,E01003801,1225,283,942
2021,Richmond upon Thames 001F,E01003802,1311,242,1069
2021,Richmond upon Thames 001G,E01003803,1482,344,1138
2021,Richmond upon Thames 005A,E01003804,1771,440,1331
2021,Richmond upon Thames 012A,E01003805,1628,442,1186
2021,Richmond upon Thames 012B,E01003806,1396,378,1018
2021,Richmond upon Thames 005B,E01003807,1834,358,1476
2021,Richmond upon Thames 005C,E01003808,1716,352,1364
2021,Richmond upon Thames 005D,E01003809,1637,383,1254
2021,Richmond upon Thames 019A,E01003810,1533,356,1177
2021,Richmond upon Thames 018A,E01003811,1705,448,1257
2021,Richmond upon Thames 018B,E01003812,1743,404,1339
2021,Richmond upon Thames 019B,E01003813,1558,349,1209
2021,Richmond upon Thames 019C,E01003814,1721,282,1439
2021,Richmond upon Thames 019D,E01003815,1881,354,1527
2021,Richmond upon Thames 012C,E01003816,1657,449,1208
2021,Richmond upon Thames 012D,E01003817,1877,383,1494
2021,Richmond upon Thames 017A,E01003818,1498,340,1158
2021,Richmond upon Thames 017B,E01003819,1681,399,1282
2021,Richmond upon Thames 017C,E01003820,1931,532,1399
2021,Richmond upon Thames 008A,E01003821,1582,289,1293
2021,Richmond upon Thames 023A,E01003822,1424,299,1125
2021,Richmond upon Thames 023B,E01003823,1663,251,1412
2021,Richmond upon Thames 023C,E01003824,1539,337,1202
2021,Richmond upon Thames 023D,E01003825,1661,381,1280
2021,Richmond upon Thames 023E,E01003826,1658,298,1360
2021,Richmond upon Thames 023F,E01003827,1813,326,1487
2021,Richmond upon Thames 020A,E01003828,1451,300,1151
2021,Richmond upon Thames 020B,E01003829,1588,341,1247
2021,Richmond upon Thames 020C,E01003830,1764,374,1390
2021,Richmond upon Thames 020D,E01003831,1585,334,1251
2021,Richmond upon Thames 020E,E01003832,1411,262,1149
2021,Richmond upon Thames 020F,E01003833,1392,261,1131
2021,Richmond upon Thames 022A,E01003834,1535,239,1296
2021,Richmond upon Thames 022B,E01003835,1573,420,1153
2021,Richmond upon Thames 022C,E01003836,1320,314,1006
2021,Richmond upon Thames 022D,E01003837,1974,420,1554
2021,Richmond upon Thames 022E,E01003838,1684,356,1328
2021,Richmond upon Thames 022F,E01003839,2137,391,1746
2021,Richmond upon Thames 013A,E01003840,1701,382,1319
2021,Richmond upon Thames 013B,E01003841,2011,545,1466
2021,Richmond upon Thames 013C,E01003842,1627,387,1240
2021,Richmond upon Thames 013D,E01003843,2091,491,1600
2021,Richmond upon Thames 013E,E01003844,1401,295,1106
2021,Richmond upon Thames 013F,E01003845,1633,315,1318
2021,Richmond upon Thames 002A,E01003846,1624,384,1240
2021,Richmond upon Thames 002B,E01003847,1615,230,1385
2021,Richmond upon Thames 004A,E01003848,1783,354,1429
2021,Richmond upon Thames 002C,E01003849,1441,251,1190
2021,Richmond upon Thames 002D,E01003851,1546,311,1235
2021,Richmond upon Thames 003A,E01003852,1301,203,1098
2021,Richmond upon Thames 003B,E01003853,1350,279,1071
2021,Richmond upon Thames 003C,E01003854,1318,246,1072
2021,Richmond upon Thames 003D,E01003855,1803,347,1456
2021,Richmond upon Thames 003E,E01003856,1523,285,1238
2021,Richmond upon Thames 003F,E01003857,1691,364,1327
2021,Richmond upon Thames 003G,E01003858,1491,306,1185
2021,Richmond upon Thames 005E,E01003859,1515,371,1144
2021,Richmond upon Thames 002E,E01003860,1610,238,1372
2021,Richmond upon Thames 004C,E01003861,1816,299,1517
2021,Richmond upon Thames 004D,E01003862,1809,430,1379
2021,Richmond upon Thames 004E,E01003863,1360,278,1082
2021,Richmond upon Thames 002F,E01003864,1388,277,1111
2021,Richmond upon Thames 004F,E01003865,1354,281,1073
2021,Richmond upon Thames 007A,E01003866,1562,348,1214
2021,Richmond upon Thames 011A,E01003867,1507,368,1139
2021,Richmond upon Thames 007B,E01003868,1466,302,1164
2021,Richmond upon Thames 011B,E01003869,1573,314,1259
2021,Richmond upon Thames 011C,E01003870,1943,428,1515
2021,Richmond upon Thames 007C,E01003871,1643,396,1247
2021,Richmond upon Thames 007D,E01003872,1491,306,1185
2021,Richmond upon Thames 006A,E01003873,1557,276,1281
2021,Richmond upon Thames 006B,E01003874,1425,197,1228
2021,Richmond upon Thames 006C,E01003875,1583,388,1195
2021,Richmond upon Thames 008B,E01003876,1793,248,1545
2021,Richmond upon Thames 008C,E01003877,1393,264,1129
2021,Richmond upon Thames 006D,E01003878,1421,273,1148
2021,Richmond upon Thames 008D,E01003879,1324,321,1003
2021,Richmond upon Thames 016A,E01003880,1481,355,1126
2021,Richmond upon Thames 016B,E01003881,1732,876,856
2021,Richmond upon Thames 014A,E01003882,1890,403,1487
2021,Richmond upon Thames 014B,E01003883,1829,358,1471
2021,Richmond upon Thames 016C,E01003884,1651,366,1285
2021,Richmond upon Thames 016D,E01003885,1465,323,1142
2021,Richmond upon Thames 021A,E01003886,1536,326,1210
2021,Richmond upon Thames 021B,E01003887,1702,325,1377
2021,Richmond upon Thames 021C,E01003888,1927,403,1524
2021,Richmond upon Thames 021D,E01003889,1582,264,1318
2021,Richmond upon Thames 018C,E01003890,1560,349,1211
2021,Richmond upon Thames 018D,E01003891,1672,255,1417
2021,Richmond upon Thames 009A,E01003892,1982,420,1562
2021,Richmond upon Thames 009B,E01003893,1570,275,1295
2021,Richmond upon Thames 009C,E01003894,1576,289,1287
2021,Richmond upon Thames 009D,E01003895,1682,406,1276
2021,Richmond upon Thames 014C,E01003896,1791,333,1458
2021,Richmond upon Thames 014D,E01003897,1843,405,1438
2021,Richmond upon Thames 015A,E01003898,1590,326,1264
2021,Richmond upon Thames 015B,E01003899,1399,327,1072
2021,Richmond upon Thames 015C,E01003900,1611,380,1231
2021,Richmond upon Thames 015D,E01003901,1650,430,1220
2021,Richmond upon Thames 015E,E01003902,1307,336,971
2021,Richmond upon Thames 015F,E01003903,1560,404,1156
2021,Richmond upon Thames 015G,E01003904,1514,375,1139
2021,Richmond upon Thames 010A,E01003905,1207,234,973
2021,Richmond upon Thames 010B,E01003906,1607,297,1310
2021,Richmond upon Thames 010C,E01003907,1587,360,1227
2021,Richmond upon Thames 010D,E01003908,1728,348,1380
2021,Richmond upon Thames 010E,E01003909,1556,331,1225
2021,Richmond upon Thames 011D,E01003910,1569,311,1258
2021,Southwark 020A,E01003911,1984,616,1368
2021,Southwark 019A,E01003912,1819,726,1093
2021,Southwark 024A,E01003913,1962,381,1581
2021,Southwark 024B,E01003914,1755,318,1437
2021,Southwark 024C,E01003915,1764,320,1444
2021,Southwark 020B,E01003916,2279,578,1701
2021,Southwark 020C,E01003917,1759,279,1480
2021,Southwark 020D,E01003918,1386,264,1122
2021,Southwark 021A,E01003919,1494,277,1217
2021,Southwark 021B,E01003920,2010,472,1538
2021,Southwark 021C,E01003921,1825,288,1537
2021,Southwark 021D,E01003922,2102,456,1646
2021,Southwark 017A,E01003923,1579,278,1301
2021,Southwark 021E,E01003924,1923,468,1455
2021,Southwark 020E,E01003925,1918,386,1532
2021,Southwark 021F,E01003926,1354,342,1012
2021,Southwark 002B,E01003929,1920,301,1619
2021,Southwark 034A,E01003930,1901,732,1169
2021,Southwark 034B,E01003932,1464,373,1091
2021,Southwark 034C,E01003933,2290,612,1678
2021,Southwark 002C,E01003934,1920,316,1604
2021,Southwark 002D,E01003935,1238,517,721
2021,Southwark 009A,E01003936,1580,546,1034
2021,Southwark 009B,E01003937,1497,343,1154
2021,Southwark 006A,E01003938,1750,557,1193
2021,Southwark 002E,E01003939,1915,627,1288
2021,Southwark 006B,E01003940,1524,431,1093
2021,Southwark 006C,E01003941,1900,321,1579
2021,Southwark 006D,E01003942,1800,701,1099
2021,Southwark 009C,E01003943,1445,394,1051
2021,Southwark 033A,E01003945,1606,316,1290
2021,Southwark 033B,E01003946,1784,433,1351
2021,Southwark 033C,E01003947,1500,483,1017
2021,Southwark 033D,E01003948,1632,291,1341
2021,Southwark 032A,E01003949,1763,308,1455
2021,Southwark 032B,E01003950,1871,485,1386
2021,Southwark 033E,E01003951,1433,395,1038
2021,Southwark 030A,E01003952,1548,278,1270
2021,Southwark 028A,E01003953,1894,229,1665
2021,Southwark 030B,E01003954,1450,247,1203
2021,Southwark 028B,E01003955,1749,265,1484
2021,Southwark 030C,E01003956,1672,279,1393
2021,Southwark 032C,E01003957,1648,298,1350
2021,Southwark 032D,E01003958,1816,373,1443
2021,Southwark 012A,E01003960,1712,420,1292
2021,Southwark 012B,E01003961,1971,499,1472
2021,Southwark 016A,E01003963,1633,445,1188
2021,Southwark 015B,E01003966,2040,460,1580
2021,Southwark 017B,E01003969,2371,441,1930
2021,Southwark 015D,E01003971,1321,405,916
2021,Southwark 016D,E01003972,1355,340,1015
2021,Southwark 016E,E01003973,1578,336,1242
2021,Southwark 004A,E01003975,1697,436,1261
2021,Southwark 036D,E01003976,2265,461,1804
2021,Southwark 010A,E01003977,1753,343,1410
2021,Southwark 006E,E01003979,1902,322,1580
2021,Southwark 013A,E01003980,1928,480,1448
2021,Southwark 006F,E01003981,1461,458,1003
2021,Southwark 018A,E01003983,1715,529,1186
2021,Southwark 023A,E01003984,2174,362,1812
2021,Southwark 011A,E01003986,1492,310,1182
2021,Southwark 011B,E01003987,1766,395,1371
2021,Southwark 018B,E01003988,1949,452,1497
2021,Southwark 018C,E01003989,2116,537,1579
2021,Southwark 018D,E01003990,2212,593,1619
2021,Southwark 017C,E01003991,1206,261,945
2021,Southwark 014A,E01003992,1517,440,1077
2021,Southwark 017D,E01003993,1929,563,1366
2021,Southwark 012E,E01003994,1759,260,1499
2021,Southwark 014B,E01003995,1298,212,1086
2021,Southwark 017E,E01003997,1221,276,945
2021,Southwark 014D,E01003998,1370,206,1164
2021,Southwark 014E,E01003999,1437,388,1049
2021,Southwark 026A,E01004000,1817,345,1472
2021,Southwark 026B,E01004001,1675,331,1344
2021,Southwark 029A,E01004002,1575,330,1245
2021,Southwark 023B,E01004003,1735,372,1363
2021,Southwark 023C,E01004004,2475,494,1981
2021,Southwark 023D,E01004005,2184,424,1760
2021,Southwark 023E,E01004006,1726,313,1413
2021,Southwark 018E,E01004007,1366,378,988
2021,Southwark 022B,E01004008,1994,510,1484
2021,Southwark 022D,E01004010,1404,317,1087
2021,Southwark 019B,E01004011,2023,522,1501
2021,Southwark 019C,E01004012,2239,483,1756
2021,Southwark 019D,E01004013,1622,275,1347
2021,Southwark 019E,E01004014,1965,556,1409
2021,Southwark 028C,E01004015,1677,500,1177
2021,Southwark 029B,E01004016,2353,503,1850
2021,Southwark 029C,E01004017,1531,306,1225
2021,Southwark 032E,E01004018,1762,335,1427
2021,Southwark 026C,E01004019,1963,376,1587
2021,Southwark 029D,E01004020,1625,436,1189
2021,Southwark 028D,E01004021,1977,281,1696
2021,Southwark 004D,E01004023,1563,265,1298
2021,Southwark 011C,E01004024,1876,409,1467
2021,Southwark 004E,E01004028,2298,480,1818
2021,Southwark 001A,E01004029,1885,281,1604
2021,Southwark 007A,E01004030,1424,221,1203
2021,Southwark 007B,E01004031,2511,522,1989
2021,Southwark 001B,E01004032,1424,195,1229
2021,Southwark 007C,E01004033,2291,456,1835
2021,Southwark 007D,E01004034,1529,416,1113
2021,Southwark 011D,E01004035,1338,269,1069
2021,Southwark 007E,E01004036,1986,536,1450
2021,Southwark 010B,E01004037,1879,435,1444
2021,Southwark 010C,E01004038,2273,527,1746
2021,Southwark 013B,E01004039,1461,328,1133
2021,Southwark 013C,E01004040,1751,471,1280
2021,Southwark 013D,E01004041,1511,346,1165
2021,Southwark 010D,E01004042,1857,386,1471
2021,Southwark 010E,E01004043,1290,201,1089
2021,Southwark 013E,E01004044,1361,352,1009
2021,Southwark 027A,E01004045,1496,411,1085
2021,Southwark 028E,E01004046,1463,273,1190
2021,Southwark 027B,E01004047,1562,391,1171
2021,Southwark 027C,E01004048,1518,342,1176
2021,Southwark 027D,E01004049,1254,317,937
2021,Southwark 024D,E01004050,1331,205,1126
2021,Southwark 027E,E01004051,1223,194,1029
2021,Southwark 024E,E01004052,1647,274,1373
2021,Southwark 001C,E01004053,1778,199,1579
2021,Southwark 001D,E01004054,1456,172,1284
2021,Southwark 001E,E01004055,1264,229,1035
2021,Southwark 008A,E01004056,2180,304,1876
2021,Southwark 008B,E01004057,2072,392,1680
2021,Southwark 008C,E01004058,1624,162,1462
2021,Southwark 008D,E01004059,1949,286,1663
2021,Southwark 008E,E01004060,1886,359,1527
2021,Southwark 025A,E01004061,1551,218,1333
2021,Southwark 025B,E01004062,2075,407,1668
2021,Southwark 025C,E01004063,1764,260,1504
2021,Southwark 026D,E01004064,1826,336,1490
2021,Southwark 025D,E01004065,1420,209,1211
2021,Southwark 025E,E01004066,1973,459,1514
2021,Southwark 022E,E01004067,2098,479,1619
2021,Southwark 026E,E01004068,1821,369,1452
2021,Southwark 031A,E01004069,1229,294,935
2021,Southwark 031B,E01004070,1842,443,1399
2021,Southwark 030D,E01004071,1427,273,1154
2021,Southwark 030E,E01004072,1565,333,1232
2021,Southwark 031C,E01004073,1763,436,1327
2021,Southwark 031D,E01004074,1622,393,1229
2021,Southwark 031E,E01004075,1623,421,1202
2021,Sutton 011A,E01004076,1522,330,1192
2021,Sutton 011B,E01004077,1534,297,1237
2021,Sutton 011C,E01004078,1641,375,1266
2021,Sutton 011D,E01004079,1328,253,1075
2021,Sutton 011E,E01004080,1333,250,1083
2021,Sutton 011F,E01004081,1534,356,1178
2021,Sutton 011G,E01004082,1331,293,1038
2021,Sutton 019A,E01004083,1415,332,1083
2021,Sutton 024A,E01004084,1411,268,1143
2021,Sutton 024B,E01004085,1543,292,1251
2021,Sutton 019B,E01004086,1880,456,1424
2021,Sutton 017A,E01004087,1517,319,1198
2021,Sutton 019C,E01004088,1828,500,1328
2021,Sutton 019D,E01004089,1251,349,902
2021,Sutton 021A,E01004090,1240,300,940
2021,Sutton 022A,E01004091,1251,244,1007
2021,Sutton 022B,E01004092,1437,249,1188
2021,Sutton 025A,E01004093,1605,391,1214
2021,Sutton 025B,E01004094,1744,384,1360
2021,Sutton 025C,E01004095,1484,268,1216
2021,Sutton 021B,E01004096,1461,251,1210
2021,Sutton 015A,E01004097,1551,331,1220
2021,Sutton 015B,E01004098,1226,230,996
2021,Sutton 015C,E01004099,1504,262,1242
2021,Sutton 015D,E01004100,1418,323,1095
2021,Sutton 013A,E01004101,1353,285,1068
2021,Sutton 015E,E01004102,1415,283,1132
2021,Sutton 013B,E01004103,1650,318,1332
2021,Sutton 020A,E01004104,1501,347,1154
2021,Sutton 022C,E01004105,1768,411,1357
2021,Sutton 022D,E01004106,1571,324,1247
2021,Sutton 020B,E01004107,1535,355,1180
2021,Sutton 024C,E01004108,1849,413,1436
2021,Sutton 024D,E01004109,1616,375,1241
2021,Sutton 016A,E01004110,1925,382,1543
2021,Sutton 016B,E01004111,1604,345,1259
2021,Sutton 016C,E01004112,1585,307,1278
2021,Sutton 025D,E01004114,1729,326,1403
2021,Sutton 009A,E01004115,1734,399,1335
2021,Sutton 008A,E01004116,1488,244,1244
2021,Sutton 006A,E01004117,1350,256,1094
2021,Sutton 009B,E01004118,1722,412,1310
2021,Sutton 009C,E01004119,1367,304,1063
2021,Sutton 016D,E01004120,1458,292,1166
2021,Sutton 006B,E01004121,1480,310,1170
2021,Sutton 008B,E01004122,1316,248,1068
2021,Sutton 002A,E01004123,2127,536,1591
2021,Sutton 002B,E01004124,1886,472,1414
2021,Sutton 001A,E01004125,1518,352,1166
2021,Sutton 002C,E01004126,1487,385,1102
2021,Sutton 005A,E01004127,1730,425,1305
2021,Sutton 002D,E01004128,1378,298,1080
2021,Sutton 002E,E01004129,1757,398,1359
2021,Sutton 003A,E01004130,1670,320,1350
2021,Sutton 003B,E01004131,1772,400,1372
2021,Sutton 009D,E01004132,1414,335,1079
2021,Sutton 009E,E01004133,1491,343,1148
2021,Sutton 003C,E01004134,1523,311,1212
2021,Sutton 003D,E01004135,1377,290,1087
2021,Sutton 003E,E01004136,1494,295,1199
2021,Sutton 012A,E01004137,2369,428,1941
2021,Sutton 013C,E01004138,1670,365,1305
2021,Sutton 013D,E01004139,1448,298,1150
2021,Sutton 012B,E01004140,1735,398,1337
2021,Sutton 012C,E01004141,1652,398,1254
2021,Sutton 014A,E01004143,1426,293,1133
2021,Sutton 007A,E01004144,1686,335,1351
2021,Sutton 007B,E01004145,2143,537,1606
2021,Sutton 007C,E01004146,1856,419,1437
2021,Sutton 007D,E01004147,1515,281,1234
2021,Sutton 014B,E01004148,1695,467,1228
2021,Sutton 012E,E01004149,1745,334,1411
2021,Sutton 021C,E01004150,1849,279,1570
2021,Sutton 021D,E01004151,1837,317,1520
2021,Sutton 018A,E01004152,1662,281,1381
2021,Sutton 021E,E01004153,1779,347,1432
2021,Sutton 022E,E01004154,1412,279,1133
2021,Sutton 018B,E01004155,1779,335,1444
2021,Sutton 018C,E01004156,1890,337,1553
2021,Sutton 016E,E01004157,1227,257,970
2021,Sutton 018D,E01004158,1522,244,1278
2021,Sutton 014C,E01004159,1549,324,1225
2021,Sutton 014D,E01004160,1552,341,1211
2021,Sutton 014E,E01004161,1417,303,1114
2021,Sutton 018E,E01004162,1583,320,1263
2021,Sutton 005B,E01004163,1631,329,1302
2021,Sutton 004A,E01004164,1357,218,1139
2021,Sutton 005C,E01004165,1679,367,1312
2021,Sutton 004B,E01004166,1446,232,1214
2021,Sutton 005D,E01004167,1530,428,1102
2021,Sutton 013E,E01004168,1515,304,1211
2021,Sutton 004C,E01004169,1623,423,1200
2021,Sutton 017B,E01004170,2036,417,1619
2021,Sutton 010A,E01004171,1520,334,1186
2021,Sutton 010B,E01004172,1766,413,1353
2021,Sutton 010C,E01004173,1313,273,1040
2021,Sutton 017C,E01004174,1491,322,1169
2021,Sutton 010D,E01004175,1617,298,1319
2021,Sutton 010E,E01004176,1421,289,1132
2021,Sutton 020C,E01004177,1701,314,1387
2021,Sutton 017D,E01004178,2178,462,1716
2021,Sutton 017E,E01004179,1552,325,1227
2021,Sutton 020D,E01004180,1705,336,1369
2021,Sutton 020E,E01004181,1639,316,1323
2021,Sutton 019E,E01004182,1634,420,1214
2021,Sutton 001B,E01004183,1664,394,1270
2021,Sutton 001C,E01004184,1592,453,1139
2021,Sutton 001D,E01004185,1919,476,1443
2021,Sutton 004D,E01004186,1581,302,1279
2021,Sutton 005E,E01004187,1570,329,1241
2021,Sutton 001E,E01004189,1985,464,1521
2021,Sutton 008C,E01004190,1321,241,1080
2021,Sutton 008D,E01004191,1752,373,1379
2021,Sutton 006C,E01004192,1744,375,1369
2021,Sutton 006D,E01004193,2621,663,1958
2021,Sutton 008E,E01004194,1494,293,1201
2021,Sutton 006E,E01004195,1579,306,1273
2021,Sutton 008F,E01004196,1486,295,1191
2021,Tower Hamlets 002B,E01004198,1403,299,1104
2021,Tower Hamlets 002C,E01004199,1578,406,1172
2021,Tower Hamlets 005A,E01004200,1447,379,1068
2021,Tower Hamlets 002D,E01004201,1605,334,1271
2021,Tower Hamlets 005B,E01004202,1876,370,1506
2021,Tower Hamlets 005C,E01004203,1742,364,1378
2021,Tower Hamlets 005D,E01004204,1769,372,1397
2021,Tower Hamlets 013A,E01004205,2033,545,1488
2021,Tower Hamlets 013B,E01004206,1388,342,1046
2021,Tower Hamlets 011A,E01004207,1349,372,977
2021,Tower Hamlets 013C,E01004208,1874,454,1420
2021,Tower Hamlets 011B,E01004209,1292,417,875
2021,Tower Hamlets 013D,E01004211,1542,267,1275
2021,Tower Hamlets 011D,E01004212,2117,685,1432
2021,Tower Hamlets 030A,E01004214,1494,379,1115
2021,Tower Hamlets 030B,E01004216,1680,372,1308
2021,Tower Hamlets 030C,E01004217,1939,428,1511
2021,Tower Hamlets 030D,E01004218,1811,336,1475
2021,Tower Hamlets 035B,E01004219,2522,685,1837
2021,Tower Hamlets 036A,E01004221,1845,403,1442
2021,Tower Hamlets 001A,E01004222,2576,569,2007
2021,Tower Hamlets 001B,E01004223,2064,453,1611
2021,Tower Hamlets 001D,E01004226,2229,612,1617
2021,Tower Hamlets 003A,E01004228,1855,344,1511
2021,Tower Hamlets 004C,E01004229,1329,283,1046
2021,Tower Hamlets 003B,E01004230,2032,465,1567
2021,Tower Hamlets 004D,E01004231,1553,427,1126
2021,Tower Hamlets 003C,E01004232,1675,332,1343
2021,Tower Hamlets 003D,E01004233,2112,471,1641
2021,Tower Hamlets 003E,E01004234,2294,345,1949
2021,Tower Hamlets 008A,E01004235,1200,321,879
2021,Tower Hamlets 008B,E01004236,1459,445,1014
2021,Tower Hamlets 008C,E01004237,1403,365,1038
2021,Tower Hamlets 008E,E01004239,1638,457,1181
2021,Tower Hamlets 012A,E01004240,1581,475,1106
2021,Tower Hamlets 012B,E01004241,1556,490,1066
2021,Tower Hamlets 020A,E01004243,1465,530,935
2021,Tower Hamlets 020B,E01004244,1942,537,1405
2021,Tower Hamlets 018A,E01004245,2741,730,2011
2021,Tower Hamlets 020C,E01004247,2446,681,1765
2021,Tower Hamlets 018C,E01004248,1736,577,1159
2021,Tower Hamlets 018D,E01004249,2231,602,1629
2021,Tower Hamlets 023A,E01004251,2369,652,1717
2021,Tower Hamlets 023C,E01004255,1481,318,1163
2021,Tower Hamlets 024C,E01004256,1577,429,1148
2021,Tower Hamlets 024D,E01004257,2078,644,1434
2021,Tower Hamlets 023D,E01004258,1389,217,1172
2021,Tower Hamlets 007A,E01004259,1659,318,1341
2021,Tower Hamlets 007B,E01004260,1663,495,1168
2021,Tower Hamlets 007C,E01004263,1318,368,950
2021,Tower Hamlets 010C,E01004264,1352,458,894
2021,Tower Hamlets 007D,E01004266,1376,273,1103
2021,Tower Hamlets 012D,E01004267,2069,424,1645
2021,Tower Hamlets 012E,E01004268,1667,393,1274
2021,Tower Hamlets 014B,E01004270,2288,599,1689
2021,Tower Hamlets 014C,E01004271,2289,643,1646
2021,Tower Hamlets 014D,E01004272,2469,633,1836
2021,Tower Hamlets 031A,E01004274,1818,414,1404
2021,Tower Hamlets 031B,E01004275,2324,687,1637
2021,Tower Hamlets 031C,E01004276,1919,281,1638
2021,Tower Hamlets 033A,E01004277,1511,162,1349
2021,Tower Hamlets 032A,E01004280,1813,424,1389
2021,Tower Hamlets 031D,E01004281,1860,343,1517
2021,Tower Hamlets 016A,E01004283,2045,558,1487
2021,Tower Hamlets 019C,E01004286,2313,573,1740
2021,Tower Hamlets 016B,E01004287,2091,560,1531
2021,Tower Hamlets 019D,E01004288,1687,480,1207
2021,Tower Hamlets 016C,E01004289,1840,504,1336
2021,Tower Hamlets 016D,E01004290,1856,471,1385
2021,Tower Hamlets 027A,E01004291,1828,290,1538
2021,Tower Hamlets 026A,E01004292,1582,215,1367
2021,Tower Hamlets 027B,E01004293,1908,194,1714
2021,Tower Hamlets 026C,E01004295,1859,592,1267
2021,Tower Hamlets 026D,E01004296,2302,444,1858
2021,Tower Hamlets 027C,E01004297,1774,186,1588
2021,Tower Hamlets 022A,E01004298,1493,372,1121
2021,Tower Hamlets 022B,E01004300,1360,374,986
2021,Tower Hamlets 025B,E01004301,1328,337,991
2021,Tower Hamlets 025C,E01004302,1525,444,1081
2021,Tower Hamlets 025D,E01004303,2698,787,1911
2021,Tower Hamlets 022C,E01004304,1987,566,1421
2021,Tower Hamlets 022D,E01004305,1748,482,1266
2021,Tower Hamlets 015A,E01004306,1723,369,1354
2021,Tower Hamlets 015B,E01004307,2301,774,1527
2021,Tower Hamlets 015C,E01004308,1368,308,1060
2021,Tower Hamlets 015D,E01004309,2626,778,1848
2021,Tower Hamlets 015E,E01004310,1936,452,1484
2021,Tower Hamlets 006A,E01004311,1753,413,1340
2021,Tower Hamlets 009A,E01004312,1433,365,1068
2021,Tower Hamlets 009B,E01004313,2012,555,1457
2021,Tower Hamlets 006C,E01004315,1502,303,1199
2021,Tower Hamlets 009C,E01004316,978,198,780
2021,Tower Hamlets 021A,E01004319,2325,626,1699
2021,Tower Hamlets 021C,E01004321,1996,522,1474
2021,Tower Hamlets 017A,E01004322,1318,421,897
2021,Tower Hamlets 017B,E01004323,1486,403,1083
2021,Tower Hamlets 017C,E01004324,1495,439,1056
2021,Tower Hamlets 017D,E01004326,1745,405,1340
2021,Waltham Forest 028A,E01004327,1448,423,1025
2021,Waltham Forest 028B,E01004328,1723,385,1338
2021,Waltham Forest 028C,E01004329,1675,367,1308
2021,Waltham Forest 028D,E01004330,1550,296,1254
2021,Waltham Forest 028E,E01004331,1541,364,1177
2021,Waltham Forest 028F,E01004332,1842,481,1361
2021,Waltham Forest 024A,E01004333,1538,392,1146
2021,Waltham Forest 024B,E01004334,1753,405,1348
2021,Waltham Forest 027A,E01004335,1630,407,1223
2021,Waltham Forest 026A,E01004336,1475,246,1229
2021,Waltham Forest 027B,E01004337,1645,408,1237
2021,Waltham Forest 027C,E01004338,1916,362,1554
2021,Waltham Forest 027D,E01004339,1671,291,1380
2021,Waltham Forest 027E,E01004340,1803,437,1366
2021,Waltham Forest 027F,E01004341,1856,406,1450
2021,Waltham Forest 011A,E01004342,1928,480,1448
2021,Waltham Forest 008A,E01004343,1722,357,1365
2021,Waltham Forest 008B,E01004344,1754,471,1283
2021,Waltham Forest 010A,E01004345,1680,389,1291
2021,Waltham Forest 011B,E01004346,1655,437,1218
2021,Waltham Forest 011C,E01004347,1972,423,1549
2021,Waltham Forest 010B,E01004348,2750,633,2117
2021,Waltham Forest 001A,E01004349,1448,336,1112
2021,Waltham Forest 001B,E01004350,1802,288,1514
2021,Waltham Forest 001C,E01004351,1558,289,1269
2021,Waltham Forest 002A,E01004352,1814,263,1551
2021,Waltham Forest 002B,E01004353,1715,263,1452
2021,Waltham Forest 002C,E01004354,1815,380,1435
2021,Waltham Forest 004A,E01004355,1572,360,1212
2021,Waltham Forest 001D,E01004356,1599,340,1259
2021,Waltham Forest 001E,E01004357,1512,333,1179
2021,Waltham Forest 002D,E01004358,1831,332,1499
2021,Waltham Forest 002E,E01004359,1603,325,1278
2021,Waltham Forest 004B,E01004360,1285,259,1026
2021,Waltham Forest 005A,E01004361,1314,260,1054
2021,Waltham Forest 021A,E01004362,1490,281,1209
2021,Waltham Forest 019A,E01004363,1544,367,1177
2021,Waltham Forest 019B,E01004364,1855,483,1372
2021,Waltham Forest 020A,E01004365,2308,497,1811
2021,Waltham Forest 019C,E01004366,1827,350,1477
2021,Waltham Forest 019D,E01004367,1467,302,1165
2021,Waltham Forest 019E,E01004368,2259,623,1636
2021,Waltham Forest 023A,E01004369,1617,311,1306
2021,Waltham Forest 023B,E01004370,1916,321,1595
2021,Waltham Forest 025A,E01004371,1505,268,1237
2021,Waltham Forest 023C,E01004372,1533,252,1281
2021,Waltham Forest 025B,E01004373,1659,330,1329
2021,Waltham Forest 025C,E01004374,1810,331,1479
2021,Waltham Forest 025D,E01004375,1775,286,1489
2021,Waltham Forest 025E,E01004376,1804,347,1457
2021,Waltham Forest 010C,E01004377,1717,384,1333
2021,Waltham Forest 010D,E01004378,1731,369,1362
2021,Waltham Forest 007A,E01004379,1791,318,1473
2021,Waltham Forest 007B,E01004380,1682,399,1283
2021,Waltham Forest 007C,E01004381,1845,372,1473
2021,Waltham Forest 008C,E01004382,1625,462,1163
2021,Waltham Forest 007D,E01004383,1571,346,1225
2021,Waltham Forest 003A,E01004384,1895,434,1461
2021,Waltham Forest 003B,E01004385,1448,317,1131
2021,Waltham Forest 003C,E01004386,1597,273,1324
2021,Waltham Forest 007E,E01004387,1359,247,1112
2021,Waltham Forest 007F,E01004388,1549,295,1254
2021,Waltham Forest 003D,E01004389,1634,332,1302
2021,Waltham Forest 003E,E01004390,1528,348,1180
2021,Waltham Forest 014A,E01004391,2168,501,1667
2021,Waltham Forest 017A,E01004392,2367,470,1897
2021,Waltham Forest 014B,E01004393,1589,346,1243
2021,Waltham Forest 017B,E01004394,1882,366,1516
2021,Waltham Forest 018A,E01004395,1564,309,1255
2021,Waltham Forest 012A,E01004396,1840,376,1464
2021,Waltham Forest 017C,E01004397,2735,524,2211
2021,Waltham Forest 009A,E01004398,1933,468,1465
2021,Waltham Forest 009B,E01004399,1786,540,1246
2021,Waltham Forest 009C,E01004400,1759,444,1315
2021,Waltham Forest 014C,E01004401,2198,489,1709
2021,Waltham Forest 009D,E01004402,1734,421,1313
2021,Waltham Forest 009E,E01004403,2373,581,1792
2021,Waltham Forest 014D,E01004404,2632,745,1887
2021,Waltham Forest 020B,E01004405,1599,359,1240
2021,Waltham Forest 016A,E01004406,1703,295,1408
2021,Waltham Forest 013A,E01004407,1519,397,1122
2021,Waltham Forest 016B,E01004408,1634,313,1321
2021,Waltham Forest 016C,E01004409,1627,291,1336
2021,Waltham Forest 013B,E01004410,1718,325,1393
2021,Waltham Forest 016D,E01004411,1835,345,1490
2021,Waltham Forest 015A,E01004412,1671,315,1356
2021,Waltham Forest 004C,E01004413,1475,267,1208
2021,Waltham Forest 005B,E01004414,1710,383,1327
2021,Waltham Forest 004D,E01004415,1526,304,1222
2021,Waltham Forest 004E,E01004416,1700,310,1390
2021,Waltham Forest 005C,E01004417,1755,333,1422
2021,Waltham Forest 008D,E01004418,1654,354,1300
2021,Waltham Forest 008E,E01004419,2415,585,1830
2021,Waltham Forest 020C,E01004420,2132,412,1720
2021,Waltham Forest 018B,E01004421,2009,421,1588
2021,Waltham Forest 022A,E01004422,2439,501,1938
2021,Waltham Forest 020D,E01004423,1951,447,1504
2021,Waltham Forest 022B,E01004424,1983,430,1553
2021,Waltham Forest 022C,E01004425,1837,389,1448
2021,Waltham Forest 022D,E01004426,1709,363,1346
2021,Waltham Forest 022E,E01004427,1829,389,1440
2021,Waltham Forest 026B,E01004428,1971,527,1444
2021,Waltham Forest 026C,E01004429,1708,401,1307
2021,Waltham Forest 026D,E01004430,2526,427,2099
2021,Waltham Forest 023D,E01004432,1784,391,1393
2021,Waltham Forest 026E,E01004434,1994,524,1470
2021,Waltham Forest 023E,E01004435,1960,418,1542
2021,Waltham Forest 021B,E01004436,1448,266,1182
2021,Waltham Forest 021C,E01004437,1658,300,1358
2021,Waltham Forest 024C,E01004438,2013,335,1678
2021,Waltham Forest 021D,E01004439,1534,265,1269
2021,Waltham Forest 024D,E01004440,1944,373,1571
2021,Waltham Forest 024E,E01004441,1436,255,1181
2021,Waltham Forest 021E,E01004442,1462,247,1215
2021,Waltham Forest 016E,E01004443,2099,422,1677
2021,Waltham Forest 017D,E01004444,2648,525,2123
2021,Waltham Forest 018C,E01004445,1879,352,1527
2021,Waltham Forest 017E,E01004446,2416,592,1824
2021,Waltham Forest 016F,E01004447,1735,342,1393
2021,Waltham Forest 018D,E01004448,1787,369,1418
2021,Waltham Forest 018E,E01004449,1794,486,1308
2021,Waltham Forest 006A,E01004450,1621,341,1280
2021,Waltham Forest 005D,E01004451,1756,394,1362
2021,Waltham Forest 005E,E01004452,1767,366,1401
2021,Waltham Forest 006B,E01004453,1686,382,1304
2021,Waltham Forest 006C,E01004454,1826,465,1361
2021,Waltham Forest 006D,E01004455,1662,383,1279
2021,Waltham Forest 006E,E01004456,1591,410,1181
2021,Waltham Forest 012B,E01004457,1787,329,1458
2021,Waltham Forest 012C,E01004458,1906,429,1477
2021,Waltham Forest 012D,E01004459,1579,511,1068
2021,Waltham Forest 011D,E01004460,1920,492,1428
2021,Waltham Forest 011E,E01004462,2053,381,1672
2021,Waltham Forest 012E,E01004463,1877,366,1511
2021,Waltham Forest 013C,E01004464,1592,438,1154
2021,Waltham Forest 015B,E01004465,1474,329,1145
2021,Waltham Forest 015C,E01004466,1595,291,1304
2021,Waltham Forest 015D,E01004467,2192,566,1626
2021,Waltham Forest 015E,E01004468,1651,342,1309
2021,Waltham Forest 013D,E01004469,1791,550,1241
2021,Waltham Forest 013E,E01004470,1534,368,1166
2021,Waltham Forest 013F,E01004471,1617,376,1241
2021,Wandsworth 021A,E01004472,1694,237,1457
2021,Wandsworth 026A,E01004473,1674,207,1467
2021,Wandsworth 021B,E01004474,1918,183,1735
2021,Wandsworth 026B,E01004475,1409,197,1212
2021,Wandsworth 021C,E01004476,1746,208,1538
2021,Wandsworth 017A,E01004477,1530,321,1209
2021,Wandsworth 017B,E01004478,1428,377,1051
2021,Wandsworth 017C,E01004479,1437,271,1166
2021,Wandsworth 026C,E01004480,1647,187,1460
2021,Wandsworth 029A,E01004481,1571,182,1389
2021,Wandsworth 030A,E01004482,1499,234,1265
2021,Wandsworth 026D,E01004483,1991,277,1714
2021,Wandsworth 026E,E01004484,1424,179,1245
2021,Wandsworth 030B,E01004485,1645,204,1441
2021,Wandsworth 026F,E01004486,1372,139,1233
2021,Wandsworth 030C,E01004487,1432,195,1237
2021,Wandsworth 029B,E01004488,1261,231,1030
2021,Wandsworth 030D,E01004489,1253,223,1030
2021,Wandsworth 031A,E01004490,1416,236,1180
2021,Wandsworth 031B,E01004491,2386,660,1726
2021,Wandsworth 031C,E01004492,1596,256,1340
2021,Wandsworth 019A,E01004493,1788,257,1531
2021,Wandsworth 018A,E01004494,1670,218,1452
2021,Wandsworth 024A,E01004495,1510,354,1156
2021,Wandsworth 024B,E01004496,1836,178,1658
2021,Wandsworth 024C,E01004497,1341,278,1063
2021,Wandsworth 031D,E01004498,1542,183,1359
2021,Wandsworth 020A,E01004499,1543,239,1304
2021,Wandsworth 014A,E01004500,1851,206,1645
2021,Wandsworth 014B,E01004501,1477,245,1232
2021,Wandsworth 020B,E01004502,1549,252,1297
2021,Wandsworth 014C,E01004503,1630,249,1381
2021,Wandsworth 020C,E01004504,1430,307,1123
2021,Wandsworth 014D,E01004505,1545,228,1317
2021,Wandsworth 011A,E01004506,2124,220,1904
2021,Wandsworth 014E,E01004507,2453,347,2106
2021,Wandsworth 012A,E01004508,1937,189,1748
2021,Wandsworth 012B,E01004510,1759,215,1544
2021,Wandsworth 010B,E01004511,1512,234,1278
2021,Wandsworth 019B,E01004512,1366,241,1125
2021,Wandsworth 018B,E01004513,1831,321,1510
2021,Wandsworth 012C,E01004514,1670,189,1481
2021,Wandsworth 012D,E01004515,1627,210,1417
2021,Wandsworth 036A,E01004516,1671,569,1102
2021,Wandsworth 037A,E01004517,2103,383,1720
2021,Wandsworth 036B,E01004518,1645,344,1301
2021,Wandsworth 036C,E01004519,1650,364,1286
2021,Wandsworth 036D,E01004520,1345,383,962
2021,Wandsworth 037B,E01004521,1875,382,1493
2021,Wandsworth 037C,E01004522,1635,338,1297
2021,Wandsworth 036E,E01004523,1545,288,1257
2021,Wandsworth 037D,E01004524,1734,392,1342
2021,Wandsworth 035A,E01004525,1819,399,1420
2021,Wandsworth 035B,E01004526,1653,301,1352
2021,Wandsworth 035C,E01004527,1552,271,1281
2021,Wandsworth 035D,E01004528,1573,328,1245
2021,Wandsworth 035E,E01004529,1974,310,1664
2021,Wandsworth 035F,E01004530,1664,269,1395
2021,Wandsworth 033A,E01004531,1634,350,1284
2021,Wandsworth 032A,E01004532,1341,205,1136
2021,Wandsworth 033B,E01004533,1371,255,1116
2021,Wandsworth 008A,E01004534,1802,240,1562
2021,Wandsworth 007A,E01004535,1691,529,1162
2021,Wandsworth 008B,E01004536,2241,719,1522
2021,Wandsworth 007B,E01004537,1989,416,1573
2021,Wandsworth 007C,E01004538,2301,394,1907
2021,Wandsworth 003A,E01004539,1938,523,1415
2021,Wandsworth 003B,E01004540,2105,291,1814
2021,Wandsworth 007D,E01004541,1611,324,1287
2021,Wandsworth 021D,E01004542,1487,309,1178
2021,Wandsworth 027A,E01004543,1673,287,1386
2021,Wandsworth 021E,E01004544,1422,237,1185
2021,Wandsworth 027B,E01004545,1857,120,1737
2021,Wandsworth 027C,E01004546,1407,188,1219
2021,Wandsworth 029C,E01004547,1357,199,1158
2021,Wandsworth 029D,E01004548,1944,249,1695
2021,Wandsworth 027D,E01004549,1597,256,1341
2021,Wandsworth 017D,E01004550,1276,240,1036
2021,Wandsworth 012E,E01004551,1522,187,1335
2021,Wandsworth 008C,E01004552,1874,145,1729
2021,Wandsworth 015A,E01004553,1674,242,1432
2021,Wandsworth 009A,E01004554,1533,301,1232
2021,Wandsworth 017E,E01004555,1601,427,1174
2021,Wandsworth 009B,E01004556,1482,375,1107
2021,Wandsworth 015B,E01004557,1602,386,1216
2021,Wandsworth 015C,E01004558,1681,385,1296
2021,Wandsworth 015D,E01004559,1376,333,1043
2021,Wandsworth 001A,E01004560,1832,307,1525
2021,Wandsworth 039E,E01004563,2062,465,1597
2021,Wandsworth 039D,E01004564,1803,253,1550
2021,Wandsworth 005A,E01004565,1589,213,1376
2021,Wandsworth 001B,E01004566,1565,165,1400
2021,Wandsworth 039A,E01004567,2214,526,1688
2021,Wandsworth 013A,E01004568,1644,920,724
2021,Wandsworth 023A,E01004569,2263,805,1458
2021,Wandsworth 023B,E01004570,1801,506,1295
2021,Wandsworth 023C,E01004571,1743,454,1289
2021,Wandsworth 016A,E01004572,1572,373,1199
2021,Wandsworth 023D,E01004573,1590,339,1251
2021,Wandsworth 013B,E01004574,1976,829,1147
2021,Wandsworth 013C,E01004575,1808,594,1214
2021,Wandsworth 013D,E01004576,1477,383,1094
2021,Wandsworth 003C,E01004577,1746,283,1463
2021,Wandsworth 004B,E01004579,1761,271,1490
2021,Wandsworth 004C,E01004580,1996,362,1634
2021,Wandsworth 004D,E01004581,1709,248,1461
2021,Wandsworth 001C,E01004582,2118,336,1782
2021,Wandsworth 001D,E01004583,1642,216,1426
2021,Wandsworth 003D,E01004584,1639,396,1243
2021,Wandsworth 008D,E01004585,1755,207,1548
2021,Wandsworth 009C,E01004586,1802,205,1597
2021,Wandsworth 009D,E01004587,1697,296,1401
2021,Wandsworth 008E,E01004588,1937,224,1713
2021,Wandsworth 009E,E01004589,1680,280,1400
2021,Wandsworth 005B,E01004590,1756,274,1482
2021,Wandsworth 005C,E01004591,1797,253,1544
2021,Wandsworth 005D,E01004592,1591,234,1357
2021,Wandsworth 025A,E01004593,1768,272,1496
2021,Wandsworth 020D,E01004594,1561,282,1279
2021,Wandsworth 025B,E01004595,1664,247,1417
2021,Wandsworth 020E,E01004596,1479,275,1204
2021,Wandsworth 025C,E01004597,1728,329,1399
2021,Wandsworth 025D,E01004598,1963,263,1700
2021,Wandsworth 025E,E01004599,1416,304,1112
2021,Wandsworth 018D,E01004601,2342,380,1962
2021,Wandsworth 010C,E01004602,1565,250,1315
2021,Wandsworth 006A,E01004604,1486,320,1166
2021,Wandsworth 006B,E01004605,1694,309,1385
2021,Wandsworth 006C,E01004606,1558,199,1359
2021,Wandsworth 006D,E01004607,1546,275,1271
2021,Wandsworth 006E,E01004608,1608,206,1402
2021,Wandsworth 010E,E01004609,2064,243,1821
2021,Wandsworth 033C,E01004610,1907,303,1604
2021,Wandsworth 032B,E01004611,1469,235,1234
2021,Wandsworth 032C,E01004612,1511,313,1198
2021,Wandsworth 033D,E01004613,1623,354,1269
2021,Wandsworth 034A,E01004614,1886,352,1534
2021,Wandsworth 034B,E01004615,1537,381,1156
2021,Wandsworth 034C,E01004616,1811,303,1508
2021,Wandsworth 034D,E01004617,1830,528,1302
2021,Wandsworth 032D,E01004618,1428,244,1184
2021,Wandsworth 015E,E01004619,1290,302,988
2021,Wandsworth 019C,E01004620,1560,249,1311
2021,Wandsworth 019D,E01004621,1623,306,1317
2021,Wandsworth 024D,E01004622,1786,188,1598
2021,Wandsworth 019E,E01004623,1631,280,1351
2021,Wandsworth 024E,E01004624,1467,250,1217
2021,Wandsworth 027E,E01004625,1255,301,954
2021,Wandsworth 027F,E01004626,1704,262,1442
2021,Wandsworth 019F,E01004627,1471,293,1178
2021,Wandsworth 022A,E01004628,2225,387,1838
2021,Wandsworth 020F,E01004629,1530,336,1194
2021,Wandsworth 022B,E01004630,1644,439,1205
2021,Wandsworth 022C,E01004631,1771,372,1399
2021,Wandsworth 028A,E01004632,1425,290,1135
2021,Wandsworth 022D,E01004633,1528,397,1131
2021,Wandsworth 028B,E01004634,1392,240,1152
2021,Wandsworth 028C,E01004635,1587,350,1237
2021,Wandsworth 028D,E01004636,1384,304,1080
2021,Wandsworth 028E,E01004637,1389,278,1111
2021,Wandsworth 011B,E01004638,1307,295,1012
2021,Wandsworth 011C,E01004639,1633,287,1346
2021,Wandsworth 011D,E01004640,1596,243,1353
2021,Wandsworth 011E,E01004641,1799,353,1446
2021,Wandsworth 016B,E01004642,1993,434,1559
2021,Wandsworth 016C,E01004643,2160,468,1692
2021,Wandsworth 016D,E01004644,2369,477,1892
2021,Wandsworth 016E,E01004645,1982,473,1509
2021,Westminster 002A,E01004646,1663,474,1189
2021,Westminster 001A,E01004647,1323,263,1060
2021,Westminster 002B,E01004648,2181,426,1755
2021,Westminster 001B,E01004649,1332,313,1019
2021,Westminster 002C,E01004650,1735,365,1370
2021,Westminster 003A,E01004651,1691,276,1415
2021,Westminster 017A,E01004652,1548,314,1234
2021,Westminster 014A,E01004653,1880,305,1575
2021,Westminster 014B,E01004654,2294,309,1985
2021,Westminster 014D,E01004656,1881,336,1545
2021,Westminster 012A,E01004657,1160,151,1009
2021,Westminster 012B,E01004658,1453,390,1063
2021,Westminster 008A,E01004659,1593,444,1149
2021,Westminster 008B,E01004660,1370,350,1020
2021,Westminster 012C,E01004661,1957,485,1472
2021,Westminster 012D,E01004662,1276,298,978
2021,Westminster 012E,E01004663,1372,276,1096
2021,Westminster 024A,E01004665,1384,354,1030
2021,Westminster 023D,E01004668,1356,297,1059
2021,Westminster 024B,E01004669,1647,370,1277
2021,Westminster 009A,E01004670,2618,724,1894
2021,Westminster 005A,E01004674,1818,339,1479
2021,Westminster 005B,E01004675,2261,489,1772
2021,Westminster 006A,E01004676,1418,226,1192
2021,Westminster 005C,E01004677,1615,240,1375
2021,Westminster 005D,E01004678,1861,410,1451
2021,Westminster 005E,E01004679,1893,381,1512
2021,Westminster 015A,E01004680,1203,234,969
2021,Westminster 016A,E01004681,1774,293,1481
2021,Westminster 016B,E01004682,1247,393,854
2021,Westminster 015B,E01004683,1412,277,1135
2021,Westminster 015C,E01004684,1268,491,777
2021,Westminster 015E,E01004686,1344,251,1093
2021,Westminster 019A,E01004687,1288,257,1031
2021,Westminster 019D,E01004690,1033,216,817
2021,Westminster 019E,E01004691,1103,185,918
2021,Westminster 019F,E01004692,948,204,744
2021,Westminster 017B,E01004693,1152,291,861
2021,Westminster 016C,E01004694,1429,239,1190
2021,Westminster 017C,E01004695,1040,284,756
2021,Westminster 017D,E01004696,1384,265,1119
2021,Westminster 016D,E01004697,1273,187,1086
2021,Westminster 017E,E01004698,1286,217,1069
2021,Westminster 017F,E01004699,1690,279,1411
2021,Westminster 016E,E01004700,1416,287,1129
2021,Westminster 007A,E01004701,1451,220,1231
2021,Westminster 009E,E01004702,2672,659,2013
2021,Westminster 007B,E01004703,1874,390,1484
2021,Westminster 007D,E01004705,1187,206,981
2021,Westminster 006B,E01004706,1385,184,1201
2021,Westminster 006C,E01004707,1727,311,1416
2021,Westminster 006D,E01004708,1472,230,1242
2021,Westminster 007E,E01004709,1635,376,1259
2021,Westminster 002D,E01004710,1835,400,1435
2021,Westminster 002E,E01004711,1851,416,1435
2021,Westminster 008C,E01004712,1401,320,1081
2021,Westminster 011A,E01004713,1255,210,1045
2021,Westminster 011B,E01004714,1617,324,1293
2021,Westminster 013A,E01004715,1762,572,1190
2021,Westminster 011C,E01004716,997,167,830
2021,Westminster 011D,E01004717,1232,227,1005
2021,Westminster 004A,E01004718,1791,373,1418
2021,Westminster 004B,E01004719,1722,307,1415
2021,Westminster 004C,E01004720,2118,440,1678
2021,Westminster 004D,E01004721,1752,375,1377
2021,Westminster 004E,E01004722,2578,763,1815
2021,Westminster 005F,E01004723,2115,425,1690
2021,Westminster 001C,E01004724,1842,393,1449
2021,Westminster 003B,E01004725,1244,378,866
2021,Westminster 003C,E01004726,1610,373,1237
2021,Westminster 008D,E01004727,1474,311,1163
2021,Westminster 003D,E01004728,1401,248,1153
2021,Westminster 003E,E01004729,1439,245,1194
2021,Westminster 001D,E01004730,1395,269,1126
2021,Westminster 020A,E01004731,1920,298,1622
2021,Westminster 020B,E01004732,1258,212,1046
2021,Westminster 020C,E01004733,2044,531,1513
2021,Westminster 018A,E01004734,1658,283,1375
2021,Westminster 018B,E01004735,1957,534,1423
2021,Westminster 018C,E01004736,1436,304,1132
2021,Westminster 024C,E01004737,1158,222,936
2021,Westminster 021A,E01004740,1263,209,1054
2021,Westminster 024F,E01004741,1238,190,1048
2021,Westminster 022A,E01004742,1228,154,1074
2021,Westminster 021B,E01004743,1437,289,1148
2021,Westminster 020D,E01004744,1398,266,1132
2021,Westminster 021D,E01004746,1213,225,988
2021,Westminster 021E,E01004747,2103,378,1725
2021,Westminster 020E,E01004748,1183,330,853
2021,Westminster 022B,E01004749,2128,438,1690
2021,Westminster 023E,E01004750,1528,289,1239
2021,Westminster 022C,E01004751,1666,192,1474
2021,Westminster 022D,E01004752,1318,190,1128
2021,Westminster 022E,E01004753,1711,172,1539
2021,Westminster 010A,E01004754,1793,459,1334
2021,Westminster 010B,E01004755,2356,515,1841
2021,Westminster 006E,E01004756,1464,275,1189
2021,Westminster 010C,E01004757,1578,426,1152
2021,Westminster 014E,E01004760,1625,316,1309
2021,Westminster 018D,E01004761,1164,154,1010
2021,Westminster 011E,E01004762,1493,218,1275
2021,Westminster 013B,E01004763,1985,461,1524
2021,Westminster 013D,E01004765,1819,406,1413
2021,Bolton 005A,E01004766,1552,267,1285
2021,Bolton 005B,E01004767,1788,327,1461
2021,Bolton 001A,E01004768,1524,283,1241
2021,Bolton 003A,E01004769,1445,239,1206
2021,Bolton 003B,E01004770,1448,312,1136
2021,Bolton 003C,E01004771,1586,353,1233
2021,Bolton 005C,E01004772,1725,473,1252
2021,Bolton 003D,E01004773,1845,325,1520
2021,Bolton 005D,E01004774,1661,364,1297
2021,Bolton 014A,E01004775,2171,410,1761
2021,Bolton 031A,E01004776,1735,336,1399
2021,Bolton 004A,E01004777,1636,289,1347
2021,Bolton 009A,E01004778,1154,153,1001
2021,Bolton 007A,E01004779,1535,348,1187
2021,Bolton 009B,E01004780,2161,400,1761
2021,Bolton 007B,E01004781,2028,369,1659
2021,Bolton 009C,E01004782,1274,264,1010
2021,Bolton 009D,E01004783,1411,207,1204
2021,Bolton 006A,E01004784,1152,184,968
2021,Bolton 006B,E01004785,1453,303,1150
2021,Bolton 006C,E01004786,1387,178,1209
2021,Bolton 013A,E01004787,1579,392,1187
2021,Bolton 002A,E01004788,1323,199,1124
2021,Bolton 006D,E01004789,1397,223,1174
2021,Bolton 002B,E01004790,1355,242,1113
2021,Bolton 006E,E01004791,1266,176,1090
2021,Bolton 006F,E01004792,1364,194,1170
2021,Bolton 013B,E01004793,1658,429,1229
2021,Bolton 013C,E01004794,1955,669,1286
2021,Bolton 013D,E01004795,1427,253,1174
2021,Bolton 019A,E01004796,1496,284,1212
2021,Bolton 013E,E01004797,1398,400,998
2021,Bolton 019B,E01004798,1506,359,1147
2021,Bolton 019C,E01004799,1230,170,1060
2021,Bolton 019D,E01004800,1224,209,1015
2021,Bolton 019E,E01004801,1564,457,1107
2021,Bolton 010A,E01004802,1834,517,1317
2021,Bolton 001B,E01004803,1546,258,1288
2021,Bolton 001C,E01004804,1400,249,1151
2021,Bolton 002C,E01004805,1506,260,1246
2021,Bolton 002D,E01004806,1440,244,1196
2021,Bolton 001D,E01004807,1317,250,1067
2021,Bolton 001E,E01004808,1536,261,1275
2021,Bolton 003E,E01004809,1664,277,1387
2021,Bolton 002E,E01004810,1515,319,1196
2021,Bolton 022A,E01004811,1661,438,1223
2021,Bolton 022B,E01004812,2151,645,1506
2021,Bolton 022C,E01004813,1562,452,1110
2021,Bolton 027A,E01004814,1490,387,1103
2021,Bolton 022D,E01004815,1643,536,1107
2021,Bolton 029A,E01004816,2527,859,1668
2021,Bolton 022E,E01004817,1964,461,1503
2021,Bolton 017A,E01004818,1588,355,1233
2021,Bolton 017B,E01004819,1443,278,1165
2021,Bolton 011A,E01004820,1649,528,1121
2021,Bolton 016B,E01004822,1737,537,1200
2021,Bolton 016C,E01004823,1916,497,1419
2021,Bolton 005E,E01004824,1765,525,1240
2021,Bolton 011B,E01004825,1785,484,1301
2021,Bolton 011C,E01004826,1525,487,1038
2021,Bolton 021A,E01004827,1808,581,1227
2021,Bolton 023A,E01004828,1861,641,1220
2021,Bolton 023B,E01004829,1350,393,957
2021,Bolton 026A,E01004830,1598,375,1223
2021,Bolton 026B,E01004831,1686,442,1244
2021,Bolton 023C,E01004832,1511,368,1143
2021,Bolton 026C,E01004833,1457,236,1221
2021,Bolton 018A,E01004834,1579,488,1091
2021,Bolton 020A,E01004835,1396,305,1091
2021,Bolton 020B,E01004836,1653,415,1238
2021,Bolton 020C,E01004837,1512,291,1221
2021,Bolton 018B,E01004838,1864,630,1234
2021,Bolton 026D,E01004839,2200,632,1568
2021,Bolton 012A,E01004840,1635,308,1327
2021,Bolton 012B,E01004841,1626,525,1101
2021,Bolton 012C,E01004842,1621,315,1306
2021,Bolton 018C,E01004843,1461,280,1181
2021,Bolton 020D,E01004844,1518,312,1206
2021,Bolton 018D,E01004845,1766,397,1369
2021,Bolton 025A,E01004846,1285,395,890
2021,Bolton 025B,E01004847,2112,768,1344
2021,Bolton 016D,E01004848,1969,596,1373
2021,Bolton 021B,E01004849,1668,573,1095
2021,Bolton 021C,E01004850,2059,682,1377
2021,Bolton 021D,E01004851,1585,427,1158
2021,Bolton 025C,E01004852,1607,498,1109
2021,Bolton 021E,E01004853,1459,452,1007
2021,Bolton 023D,E01004854,1526,417,1109
2021,Bolton 027B,E01004855,1368,285,1083
2021,Bolton 027C,E01004856,1406,337,1069
2021,Bolton 027D,E01004857,1754,473,1281
2021,Bolton 032A,E01004858,1488,278,1210
2021,Bolton 032B,E01004859,1414,257,1157
2021,Bolton 032C,E01004860,1358,211,1147
2021,Bolton 033A,E01004861,1786,571,1215
2021,Bolton 033B,E01004862,1342,337,1005
2021,Bolton 033C,E01004863,1462,375,1087
2021,Bolton 008A,E01004864,1391,227,1164
2021,Bolton 011D,E01004865,1470,316,1154
2021,Bolton 011E,E01004866,1889,545,1344
2021,Bolton 008B,E01004867,1419,368,1051
2021,Bolton 015A,E01004868,2001,551,1450
2021,Bolton 015B,E01004869,1861,468,1393
2021,Bolton 015C,E01004870,1875,409,1466
2021,Bolton 015D,E01004871,1663,578,1085
2021,Bolton 029B,E01004872,1602,435,1167
2021,Bolton 029C,E01004873,1889,657,1232
2021,Bolton 033D,E01004874,1654,407,1247
2021,Bolton 029D,E01004875,1547,351,1196
2021,Bolton 033E,E01004876,1831,439,1392
2021,Bolton 025D,E01004877,1902,709,1193
2021,Bolton 023E,E01004878,1568,448,1120
2021,Bolton 025E,E01004879,1534,518,1016
2021,Bolton 029E,E01004880,1387,358,1029
2021,Bolton 004B,E01004881,1421,224,1197
2021,Bolton 007C,E01004882,1287,201,1086
2021,Bolton 007D,E01004883,1673,284,1389
2021,Bolton 007E,E01004884,1428,154,1274
2021,Bolton 014B,E01004885,1371,263,1108
2021,Bolton 014C,E01004886,1329,225,1104
2021,Bolton 014D,E01004887,1279,213,1066
2021,Bolton 004C,E01004888,1229,180,1049
2021,Bolton 004D,E01004889,1375,267,1108
2021,Bolton 004E,E01004890,1324,189,1135
2021,Bolton 028A,E01004891,1463,168,1295
2021,Bolton 030A,E01004892,1513,227,1286
2021,Bolton 028B,E01004893,1450,205,1245
2021,Bolton 028C,E01004894,1811,338,1473
2021,Bolton 031B,E01004895,1267,219,1048
2021,Bolton 030B,E01004896,1269,161,1108
2021,Bolton 020E,E01004897,967,154,813
2021,Bolton 030C,E01004899,1513,351,1162
2021,Bolton 030D,E01004900,1507,343,1164
2021,Bolton 028E,E01004901,1712,264,1448
2021,Bolton 032D,E01004902,1747,334,1413
2021,Bolton 034A,E01004903,1374,252,1122
2021,Bolton 034B,E01004904,1595,293,1302
2021,Bolton 034C,E01004905,1488,305,1183
2021,Bolton 032E,E01004906,1692,236,1456
2021,Bolton 034D,E01004907,1223,286,937
2021,Bolton 034E,E01004908,1242,217,1025
2021,Bolton 034F,E01004909,1330,241,1089
2021,Bolton 034G,E01004910,1922,342,1580
2021,Bolton 024A,E01004911,1455,276,1179
2021,Bolton 024B,E01004912,1388,203,1185
2021,Bolton 024C,E01004913,1865,435,1430
2021,Bolton 024D,E01004914,1141,167,974
2021,Bolton 024E,E01004915,1234,177,1057
2021,Bolton 024F,E01004916,1394,246,1148
2021,Bolton 019F,E01004917,2160,516,1644
2021,Bolton 024G,E01004918,1179,180,999
2021,Bolton 012D,E01004919,1445,284,1161
2021,Bolton 012E,E01004920,1541,331,1210
2021,Bolton 008C,E01004921,1505,271,1234
2021,Bolton 015E,E01004922,2097,531,1566
2021,Bolton 018E,E01004923,1539,341,1198
2021,Bolton 008D,E01004924,1482,273,1209
2021,Bolton 008E,E01004925,1487,270,1217
2021,Bolton 010B,E01004926,1328,373,955
2021,Bolton 010C,E01004927,2122,528,1594
2021,Bolton 017C,E01004928,1292,224,1068
2021,Bolton 010D,E01004929,2488,571,1917
2021,Bolton 017D,E01004930,1420,257,1163
2021,Bolton 017E,E01004931,1477,273,1204
2021,Bolton 017F,E01004932,1401,234,1167
2021,Bolton 035A,E01004933,1252,192,1060
2021,Bolton 035B,E01004934,1361,291,1070
2021,Bolton 035C,E01004935,1725,356,1369
2021,Bolton 031C,E01004936,2047,294,1753
2021,Bolton 035D,E01004937,1546,287,1259
2021,Bolton 031D,E01004938,1492,379,1113
2021,Bolton 031E,E01004939,1505,252,1253
2021,Bolton 035E,E01004940,1362,220,1142
2021,Bury 021A,E01004941,1762,436,1326
2021,Bury 021B,E01004942,1572,509,1063
2021,Bury 021C,E01004943,1710,425,1285
2021,Bury 021D,E01004944,1447,243,1204
2021,Bury 017A,E01004945,1466,251,1215
2021,Bury 021E,E01004946,1562,356,1206
2021,Bury 009A,E01004947,1438,330,1108
2021,Bury 009B,E01004948,1770,322,1448
2021,Bury 010A,E01004949,1340,235,1105
2021,Bury 010B,E01004950,1433,252,1181
2021,Bury 010C,E01004951,1515,248,1267
2021,Bury 010D,E01004952,1302,176,1126
2021,Bury 010E,E01004953,1468,285,1183
2021,Bury 007A,E01004954,1380,211,1169
2021,Bury 007B,E01004955,1298,273,1025
2021,Bury 007C,E01004956,1676,372,1304
2021,Bury 007D,E01004957,1747,445,1302
2021,Bury 008A,E01004958,1390,286,1104
2021,Bury 008B,E01004959,1612,356,1256
2021,Bury 007E,E01004960,1507,455,1052
2021,Bury 005A,E01004961,1371,297,1074
2021,Bury 009C,E01004962,1865,406,1459
2021,Bury 006A,E01004963,1405,198,1207
2021,Bury 009D,E01004964,1741,315,1426
2021,Bury 005B,E01004965,1183,189,994
2021,Bury 005C,E01004966,1721,420,1301
2021,Bury 005D,E01004967,1134,195,939
2021,Bury 006B,E01004968,1408,235,1173
2021,Bury 022A,E01004969,1442,195,1247
2021,Bury 022B,E01004970,1507,303,1204
2021,Bury 022C,E01004971,1409,263,1146
2021,Bury 023A,E01004972,1423,367,1056
2021,Bury 023B,E01004973,1446,258,1188
2021,Bury 024A,E01004974,1340,248,1092
2021,Bury 023C,E01004975,1411,203,1208
2021,Bury 004A,E01004976,1459,312,1147
2021,Bury 004B,E01004977,1629,238,1391
2021,Bury 004C,E01004978,1746,439,1307
2021,Bury 008C,E01004979,1668,421,1247
2021,Bury 008D,E01004980,1340,276,1064
2021,Bury 004D,E01004981,1408,235,1173
2021,Bury 004E,E01004982,1428,223,1205
2021,Bury 020A,E01004983,1278,227,1051
2021,Bury 019A,E01004984,1327,280,1047
2021,Bury 019B,E01004985,1389,255,1134
2021,Bury 020B,E01004986,1539,224,1315
2021,Bury 020C,E01004987,1263,253,1010
2021,Bury 020D,E01004988,1319,235,1084
2021,Bury 019C,E01004989,1352,228,1124
2021,Bury 016A,E01004990,1493,344,1149
2021,Bury 015A,E01004991,1302,274,1028
2021,Bury 015B,E01004992,1330,284,1046
2021,Bury 015C,E01004993,1834,393,1441
2021,Bury 015D,E01004994,1268,227,1041
2021,Bury 018A,E01004995,1443,229,1214
2021,Bury 016B,E01004996,1431,286,1145
2021,Bury 014A,E01004997,1451,279,1172
2021,Bury 014B,E01004998,1578,275,1303
2021,Bury 014C,E01004999,1398,259,1139
2021,Bury 012A,E01005000,1415,233,1182
2021,Bury 012B,E01005001,1224,238,986
2021,Bury 014D,E01005002,1442,248,1194
2021,Bury 014E,E01005003,1386,291,1095
2021,Bury 016C,E01005004,1492,254,1238
2021,Bury 012C,E01005005,1353,233,1120
2021,Bury 012D,E01005006,1899,365,1534
2021,Bury 019D,E01005007,1446,184,1262
2021,Bury 016D,E01005008,2011,472,1539
2021,Bury 016E,E01005009,1648,325,1323
2021,Bury 018B,E01005010,1518,285,1233
2021,Bury 019E,E01005011,1354,242,1112
2021,Bury 018C,E01005012,1647,367,1280
2021,Bury 018D,E01005013,2426,660,1766
2021,Bury 001A,E01005014,1408,190,1218
2021,Bury 001B,E01005015,1428,272,1156
2021,Bury 001C,E01005016,1425,222,1203
2021,Bury 001D,E01005017,1745,347,1398
2021,Bury 001E,E01005018,1444,290,1154
2021,Bury 002A,E01005019,1446,270,1176
2021,Bury 003A,E01005020,1309,255,1054
2021,Bury 001F,E01005021,1179,381,798
2021,Bury 003B,E01005022,1419,258,1161
2021,Bury 002B,E01005023,1240,215,1025
2021,Bury 008E,E01005024,2447,619,1828
2021,Bury 011A,E01005025,1589,289,1300
2021,Bury 008F,E01005026,1990,616,1374
2021,Bury 011B,E01005027,1744,395,1349
2021,Bury 011C,E01005028,2067,555,1512
2021,Bury 011D,E01005029,1838,514,1324
2021,Bury 013A,E01005030,1665,430,1235
2021,Bury 025A,E01005031,1444,310,1134
2021,Bury 025B,E01005032,1245,236,1009
2021,Bury 024B,E01005033,1525,440,1085
2021,Bury 022D,E01005034,1678,269,1409
2021,Bury 025C,E01005035,1354,207,1147
2021,Bury 024C,E01005036,1907,266,1641
2021,Bury 024D,E01005037,1401,236,1165
2021,Bury 025D,E01005038,1276,241,1035
2021,Bury 023D,E01005039,1483,271,1212
2021,Bury 026A,E01005040,1709,375,1334
2021,Bury 026B,E01005041,1729,554,1175
2021,Bury 026C,E01005042,1774,559,1215
2021,Bury 026D,E01005043,1738,684,1054
2021,Bury 026E,E01005044,1749,756,993
2021,Bury 023E,E01005045,1547,246,1301
2021,Bury 002C,E01005046,1438,224,1214
2021,Bury 003C,E01005047,1418,199,1219
2021,Bury 002D,E01005048,1598,298,1300
2021,Bury 003D,E01005049,1577,255,1322
2021,Bury 006C,E01005050,2024,478,1546
2021,Bury 003E,E01005051,1467,231,1236
2021,Bury 006D,E01005052,1366,241,1125
2021,Bury 006E,E01005053,1465,285,1180
2021,Bury 013B,E01005054,1513,283,1230
2021,Bury 017B,E01005055,1375,254,1121
2021,Bury 017C,E01005056,1229,192,1037
2021,Bury 017D,E01005057,1549,315,1234
2021,Bury 017E,E01005058,1283,270,1013
2021,Bury 013C,E01005059,1672,369,1303
2021,Bury 013D,E01005060,1646,321,1325
2021,Manchester 018A,E01005061,1657,547,1110
2021,Manchester 018C,E01005063,1955,685,1270
2021,Manchester 018D,E01005065,2020,731,1289
2021,Manchester 018E,E01005066,990,324,666
2021,Manchester 020A,E01005067,1871,583,1288
2021,Manchester 051A,E01005068,1572,335,1237
2021,Manchester 047A,E01005069,1354,232,1122
2021,Manchester 051B,E01005070,1729,375,1354
2021,Manchester 048A,E01005071,1610,337,1273
2021,Manchester 048B,E01005072,1660,322,1338
2021,Manchester 048C,E01005073,1470,271,1199
2021,Manchester 051C,E01005074,1524,365,1159
2021,Manchester 051D,E01005075,1456,316,1140
2021,Manchester 039A,E01005076,1315,213,1102
2021,Manchester 042A,E01005077,1592,507,1085
2021,Manchester 042B,E01005078,1513,143,1370
2021,Manchester 042C,E01005079,1554,330,1224
2021,Manchester 039C,E01005081,1671,406,1265
2021,Manchester 037A,E01005082,1696,368,1328
2021,Manchester 039D,E01005083,1775,285,1490
2021,Manchester 042D,E01005084,1901,394,1507
2021,Manchester 049A,E01005085,1523,467,1056
2021,Manchester 049B,E01005086,1748,511,1237
2021,Manchester 050A,E01005087,2101,640,1461
2021,Manchester 050B,E01005088,1777,525,1252
2021,Manchester 049C,E01005089,1812,512,1300
2021,Manchester 050C,E01005090,1738,426,1312
2021,Manchester 050D,E01005091,2159,676,1483
2021,Manchester 015A,E01005092,1759,530,1229
2021,Manchester 012A,E01005093,1715,544,1171
2021,Manchester 012B,E01005094,1560,503,1057
2021,Manchester 012C,E01005097,1821,689,1132
2021,Manchester 001A,E01005098,1530,328,1202
2021,Manchester 001B,E01005099,1808,619,1189
2021,Manchester 001C,E01005100,1555,382,1173
2021,Manchester 002A,E01005101,1764,469,1295
2021,Manchester 001D,E01005102,1276,231,1045
2021,Manchester 001E,E01005103,1708,381,1327
2021,Manchester 004A,E01005104,1822,497,1325
2021,Manchester 015C,E01005105,2706,805,1901
2021,Manchester 015D,E01005106,2138,618,1520
2021,Manchester 015E,E01005107,1882,609,1273
2021,Manchester 047B,E01005111,1341,287,1054
2021,Manchester 048D,E01005112,1614,434,1180
2021,Manchester 047C,E01005113,1552,298,1254
2021,Manchester 047D,E01005114,1671,246,1425
2021,Manchester 044A,E01005115,1767,398,1369
2021,Manchester 047E,E01005116,1945,335,1610
2021,Manchester 048E,E01005117,2218,657,1561
2021,Manchester 034A,E01005118,1407,368,1039
2021,Manchester 041A,E01005119,1623,445,1178
2021,Manchester 034B,E01005120,1762,479,1283
2021,Manchester 041B,E01005121,1587,439,1148
2021,Manchester 041C,E01005122,1771,535,1236
2021,Manchester 041D,E01005123,1652,517,1135
2021,Manchester 041E,E01005124,1736,508,1228
2021,Manchester 040A,E01005125,1466,366,1100
2021,Manchester 045A,E01005126,1895,418,1477
2021,Manchester 055A,E01005128,2020,1435,585
2021,Manchester 061A,E01005129,1753,442,1311
2021,Manchester 054A,E01005130,1361,261,1100
2021,Manchester 061B,E01005132,1967,498,1469
2021,Manchester 002B,E01005135,1743,508,1235
2021,Manchester 002C,E01005136,1439,289,1150
2021,Manchester 002D,E01005138,2263,624,1639
2021,Manchester 003B,E01005139,1804,399,1405
2021,Manchester 003C,E01005141,1841,598,1243
2021,Manchester 058A,E01005142,2080,716,1364
2021,Manchester 056A,E01005143,2785,956,1829
2021,Manchester 008A,E01005145,2744,1035,1709
2021,Manchester 058B,E01005147,2545,857,1688
2021,Manchester 008C,E01005149,1963,680,1283
2021,Manchester 029A,E01005150,1636,188,1448
2021,Manchester 029B,E01005151,1412,230,1182
2021,Manchester 029C,E01005152,1324,230,1094
2021,Manchester 037B,E01005153,1477,213,1264
2021,Manchester 033A,E01005154,1375,242,1133
2021,Manchester 037C,E01005155,1339,219,1120
2021,Manchester 033B,E01005156,1382,233,1149
2021,Manchester 037D,E01005157,1450,318,1132
2021,Manchester 033C,E01005158,1402,227,1175
2021,Manchester 029D,E01005159,1542,263,1279
2021,Manchester 004B,E01005160,1808,489,1319
2021,Manchester 004C,E01005161,1678,464,1214
2021,Manchester 004D,E01005162,1746,435,1311
2021,Manchester 004E,E01005163,1626,444,1182
2021,Manchester 006A,E01005164,2104,624,1480
2021,Manchester 008D,E01005165,2120,614,1506
2021,Manchester 008E,E01005166,1976,609,1367
2021,Manchester 008F,E01005167,2142,732,1410
2021,Manchester 045B,E01005168,1316,283,1033
2021,Manchester 045C,E01005169,1294,229,1065
2021,Manchester 045D,E01005170,1422,291,1131
2021,Manchester 045E,E01005171,1623,292,1331
2021,Manchester 043A,E01005172,1488,240,1248
2021,Manchester 043B,E01005173,1531,293,1238
2021,Manchester 043C,E01005174,1460,334,1126
2021,Manchester 043D,E01005175,1491,288,1203
2021,Manchester 043E,E01005176,1614,192,1422
2021,Manchester 043F,E01005177,1226,193,1033
2021,Manchester 030A,E01005178,1894,560,1334
2021,Manchester 030B,E01005179,2119,524,1595
2021,Manchester 030C,E01005180,1769,518,1251
2021,Manchester 030D,E01005181,2074,520,1554
2021,Manchester 030E,E01005182,1529,491,1038
2021,Manchester 030F,E01005183,1715,485,1230
2021,Manchester 032A,E01005184,2187,1135,1052
2021,Manchester 032B,E01005185,3234,2823,411
2021,Manchester 020B,E01005186,2641,693,1948
2021,Manchester 021A,E01005187,2014,646,1368
2021,Manchester 021B,E01005188,1789,481,1308
2021,Manchester 017D,E01005189,1564,383,1181
2021,Manchester 017E,E01005190,2258,685,1573
2021,Manchester 021C,E01005191,1653,436,1217
2021,Manchester 021D,E01005192,1609,361,1248
2021,Manchester 021E,E01005193,1620,337,1283
2021,Manchester 023A,E01005195,2241,733,1508
2021,Manchester 023C,E01005197,1614,423,1191
2021,Manchester 023D,E01005198,1913,608,1305
2021,Manchester 064C,E01005199,2309,717,1592
2021,Manchester 064A,E01005200,2255,637,1618
2021,Manchester 023E,E01005201,1889,617,1272
2021,Manchester 009A,E01005202,2161,748,1413
2021,Manchester 009B,E01005203,1850,522,1328
2021,Manchester 006B,E01005205,2018,658,1360
2021,Manchester 006C,E01005206,1732,449,1283
2021,Manchester 006D,E01005207,1857,586,1271
2021,Manchester 019A,E01005208,2639,1103,1536
2021,Manchester 019C,E01005210,2596,2003,593
2021,Manchester 057A,E01005212,3034,2048,986
2021,Manchester 059A,E01005213,2228,604,1624
2021,Manchester 019D,E01005214,2240,732,1508
2021,Manchester 034C,E01005215,1889,472,1417
2021,Manchester 034D,E01005216,1433,312,1121
2021,Manchester 034E,E01005217,1935,519,1416
2021,Manchester 034F,E01005218,1598,489,1109
2021,Manchester 031A,E01005219,2132,496,1636
2021,Manchester 031B,E01005220,1885,523,1362
2021,Manchester 031C,E01005221,2386,676,1710
2021,Manchester 031D,E01005222,2031,548,1483
2021,Manchester 007A,E01005223,1501,423,1078
2021,Manchester 007B,E01005224,1939,674,1265
2021,Manchester 007C,E01005225,1951,535,1416
2021,Manchester 007D,E01005226,1755,630,1125
2021,Manchester 009D,E01005227,1844,592,1252
2021,Manchester 009E,E01005228,2035,636,1399
2021,Manchester 007E,E01005229,1434,280,1154
2021,Manchester 022B,E01005230,1982,740,1242
2021,Manchester 022C,E01005231,2451,1600,851
2021,Manchester 020C,E01005232,1767,508,1259
2021,Manchester 063B,E01005233,2624,936,1688
2021,Manchester 063A,E01005234,2140,812,1328
2021,Manchester 020D,E01005235,1880,599,1281
2021,Manchester 022D,E01005236,2090,898,1192
2021,Manchester 022E,E01005237,1886,603,1283
2021,Manchester 063D,E01005238,2146,741,1405
2021,Manchester 020E,E01005239,1693,576,1117
2021,Manchester 024B,E01005243,2705,841,1864
2021,Manchester 025C,E01005244,2886,1713,1173
2021,Manchester 024C,E01005245,2591,951,1640
2021,Manchester 024D,E01005246,2362,1046,1316
2021,Manchester 005A,E01005247,1339,219,1120
2021,Manchester 005B,E01005248,1275,196,1079
2021,Manchester 005C,E01005249,2059,453,1606
2021,Manchester 005D,E01005250,2080,689,1391
2021,Manchester 003D,E01005251,1564,409,1155
2021,Manchester 003E,E01005252,1823,417,1406
2021,Manchester 005E,E01005253,1615,488,1127
2021,Manchester 005F,E01005254,1518,285,1233
2021,Manchester 012D,E01005255,1550,387,1163
2021,Manchester 011A,E01005256,2441,692,1749
2021,Manchester 011B,E01005257,1841,546,1295
2021,Manchester 011C,E01005258,1676,366,1310
2021,Manchester 011D,E01005259,1627,486,1141
2021,Manchester 011E,E01005260,1389,262,1127
2021,Manchester 012E,E01005261,1646,511,1135
2021,Manchester 044B,E01005262,1654,310,1344
2021,Manchester 046A,E01005263,1595,315,1280
2021,Manchester 044C,E01005264,1561,394,1167
2021,Manchester 044D,E01005265,1604,418,1186
2021,Manchester 044E,E01005266,1886,466,1420
2021,Manchester 046B,E01005267,1439,233,1206
2021,Manchester 046C,E01005268,2046,260,1786
2021,Manchester 046D,E01005269,1463,249,1214
2021,Manchester 035A,E01005270,1670,445,1225
2021,Manchester 032C,E01005271,1945,1293,652
2021,Manchester 035B,E01005272,1859,448,1411
2021,Manchester 035C,E01005273,1627,892,735
2021,Manchester 038A,E01005274,1671,482,1189
2021,Manchester 038B,E01005275,1712,445,1267
2021,Manchester 038C,E01005276,1421,360,1061
2021,Manchester 038D,E01005277,1603,274,1329
2021,Manchester 035D,E01005278,1787,830,957
2021,Manchester 035E,E01005279,2054,569,1485
2021,Manchester 026A,E01005280,2060,730,1330
2021,Manchester 026B,E01005281,2555,1910,645
2021,Manchester 026C,E01005284,2536,1564,972
2021,Manchester 025D,E01005285,1420,558,862
2021,Manchester 026D,E01005286,2221,1149,1072
2021,Manchester 026E,E01005287,2205,809,1396
2021,Manchester 025E,E01005288,1714,771,943
2021,Manchester 049D,E01005289,1565,325,1240
2021,Manchester 052A,E01005290,1549,340,1209
2021,Manchester 050E,E01005291,1381,310,1071
2021,Manchester 052B,E01005292,1422,333,1089
2021,Manchester 052C,E01005293,1114,176,938
2021,Manchester 052D,E01005294,1533,297,1236
2021,Manchester 049E,E01005295,2445,429,2016
2021,Manchester 029E,E01005296,1479,267,1212
2021,Manchester 028A,E01005297,2330,485,1845
2021,Manchester 028B,E01005298,1667,443,1224
2021,Manchester 029F,E01005299,1504,337,1167
2021,Manchester 033D,E01005300,1435,339,1096
2021,Manchester 033E,E01005301,1416,285,1131
2021,Manchester 028C,E01005302,1957,343,1614
2021,Manchester 040B,E01005304,1898,927,971
2021,Manchester 036A,E01005305,1606,503,1103
2021,Manchester 040C,E01005306,1498,257,1241
2021,Manchester 040D,E01005307,1733,551,1182
2021,Manchester 040E,E01005308,1599,451,1148
2021,Manchester 036B,E01005309,2192,1169,1023
2021,Manchester 036C,E01005310,1911,1208,703
2021,Manchester 036D,E01005311,1741,690,1051
2021,Manchester 036E,E01005312,1966,1361,605
2021,Manchester 053A,E01005313,1416,328,1088
2021,Manchester 053B,E01005314,1565,400,1165
2021,Manchester 053C,E01005315,1608,308,1300
2021,Manchester 053D,E01005316,1524,323,1201
2021,Manchester 052E,E01005317,1922,387,1535
2021,Manchester 053E,E01005318,1859,416,1443
2021,Manchester 051E,E01005319,2149,519,1630
2021,Oldham 024A,E01005320,2428,929,1499
2021,Oldham 022A,E01005321,2090,648,1442
2021,Oldham 029A,E01005322,1362,383,979
2021,Oldham 029B,E01005323,1437,326,1111
2021,Oldham 029C,E01005324,1501,350,1151
2021,Oldham 029D,E01005325,1361,471,890
2021,Oldham 022B,E01005326,2811,904,1907
2021,Oldham 017A,E01005327,1857,387,1470
2021,Oldham 017B,E01005328,1670,460,1210
2021,Oldham 015A,E01005329,1441,238,1203
2021,Oldham 015B,E01005330,1651,297,1354
2021,Oldham 017C,E01005331,1606,402,1204
2021,Oldham 028A,E01005332,2183,513,1670
2021,Oldham 015C,E01005333,1185,200,985
2021,Oldham 017D,E01005334,1359,277,1082
2021,Oldham 010A,E01005335,1225,217,1008
2021,Oldham 015D,E01005336,1474,266,1208
2021,Oldham 010B,E01005337,2308,824,1484
2021,Oldham 017E,E01005338,1815,484,1331
2021,Oldham 010C,E01005339,1414,238,1176
2021,Oldham 010D,E01005340,1495,422,1073
2021,Oldham 028B,E01005341,1314,239,1075
2021,Oldham 027A,E01005342,1526,345,1181
2021,Oldham 027B,E01005343,1311,310,1001
2021,Oldham 027C,E01005344,1726,426,1300
2021,Oldham 028C,E01005345,1425,260,1165
2021,Oldham 028D,E01005346,1322,180,1142
2021,Oldham 028E,E01005347,1239,270,969
2021,Oldham 014A,E01005348,2225,858,1367
2021,Oldham 016A,E01005349,2297,872,1425
2021,Oldham 014B,E01005350,2248,647,1601
2021,Oldham 016B,E01005351,1920,753,1167
2021,Oldham 016C,E01005352,1420,455,965
2021,Oldham 016D,E01005353,1396,474,922
2021,Oldham 016E,E01005354,1663,501,1162
2021,Oldham 005A,E01005355,1369,277,1092
2021,Oldham 005B,E01005356,1186,213,973
2021,Oldham 001A,E01005357,1374,232,1142
2021,Oldham 001B,E01005358,1487,313,1174
2021,Oldham 001C,E01005359,1526,202,1324
2021,Oldham 001D,E01005360,1322,211,1111
2021,Oldham 003A,E01005361,1600,246,1354
2021,Oldham 031A,E01005362,1292,226,1066
2021,Oldham 032A,E01005363,1680,301,1379
2021,Oldham 031B,E01005364,1524,242,1282
2021,Oldham 033A,E01005365,1327,188,1139
2021,Oldham 033B,E01005366,1496,218,1278
2021,Oldham 033C,E01005367,1372,241,1131
2021,Oldham 031C,E01005368,1409,242,1167
2021,Oldham 032B,E01005369,1840,386,1454
2021,Oldham 032C,E01005370,1479,261,1218
2021,Oldham 032D,E01005371,1359,279,1080
2021,Oldham 034A,E01005372,1184,256,928
2021,Oldham 034B,E01005373,1146,209,937
2021,Oldham 034C,E01005374,1410,297,1113
2021,Oldham 034D,E01005375,1422,235,1187
2021,Oldham 031D,E01005376,1349,366,983
2021,Oldham 030A,E01005377,1592,470,1122
2021,Oldham 031E,E01005378,1447,304,1143
2021,Oldham 030B,E01005379,1194,398,796
2021,Oldham 030C,E01005380,1409,401,1008
2021,Oldham 027D,E01005381,1814,529,1285
2021,Oldham 030D,E01005382,1508,352,1156
2021,Oldham 026A,E01005383,2005,652,1353
2021,Oldham 026D,E01005386,1407,337,1070
2021,Oldham 018A,E01005387,1363,236,1127
2021,Oldham 018B,E01005388,1272,214,1058
2021,Oldham 018C,E01005389,1619,324,1295
2021,Oldham 004A,E01005390,1300,207,1093
2021,Oldham 008A,E01005391,1495,287,1208
2021,Oldham 008B,E01005392,1492,268,1224
2021,Oldham 008C,E01005393,1173,178,995
2021,Oldham 004B,E01005394,1391,231,1160
2021,Oldham 004C,E01005395,1359,232,1127
2021,Oldham 004D,E01005396,1371,263,1108
2021,Oldham 009A,E01005397,1269,184,1085
2021,Oldham 009B,E01005398,1467,244,1223
2021,Oldham 005C,E01005399,1509,250,1259
2021,Oldham 009C,E01005400,1452,234,1218
2021,Oldham 008D,E01005401,1527,247,1280
2021,Oldham 009D,E01005402,1514,322,1192
2021,Oldham 005D,E01005403,1644,378,1266
2021,Oldham 021A,E01005406,1344,225,1119
2021,Oldham 013A,E01005407,1656,259,1397
2021,Oldham 020C,E01005408,1929,365,1564
2021,Oldham 020D,E01005409,1517,271,1246
2021,Oldham 006A,E01005410,1447,253,1194
2021,Oldham 006B,E01005411,1508,256,1252
2021,Oldham 013B,E01005412,1616,246,1370
2021,Oldham 021B,E01005413,1521,273,1248
2021,Oldham 006C,E01005414,1283,221,1062
2021,Oldham 006D,E01005415,1060,171,889
2021,Oldham 013C,E01005416,1461,265,1196
2021,Oldham 013D,E01005417,1448,207,1241
2021,Oldham 018D,E01005418,1360,247,1113
2021,Oldham 021C,E01005419,1390,253,1137
2021,Oldham 021D,E01005420,1536,238,1298
2021,Oldham 011A,E01005421,1670,368,1302
2021,Oldham 011B,E01005422,1401,481,920
2021,Oldham 022C,E01005427,1994,669,1325
2021,Oldham 019A,E01005428,2072,762,1310
2021,Oldham 022D,E01005429,1763,621,1142
2021,Oldham 022E,E01005430,2564,866,1698
2021,Oldham 019B,E01005431,1686,439,1247
2021,Oldham 014C,E01005432,1689,517,1172
2021,Oldham 014D,E01005433,2258,798,1460
2021,Oldham 024B,E01005434,1968,615,1353
2021,Oldham 037B,E01005435,1840,677,1163
2021,Oldham 037D,E01005436,1705,518,1187
2021,Oldham 024C,E01005437,1900,666,1234
2021,Oldham 029E,E01005438,2694,736,1958
2021,Oldham 030E,E01005439,1498,266,1232
2021,Oldham 033D,E01005440,1366,251,1115
2021,Oldham 002A,E01005441,1442,242,1200
2021,Oldham 002B,E01005442,1273,188,1085
2021,Oldham 003B,E01005443,1260,202,1058
2021,Oldham 002C,E01005444,1319,225,1094
2021,Oldham 002D,E01005445,1333,250,1083
2021,Oldham 003C,E01005446,1327,251,1076
2021,Oldham 003D,E01005447,1558,314,1244
2021,Oldham 012A,E01005448,1497,381,1116
2021,Oldham 012B,E01005449,1462,301,1161
2021,Oldham 019C,E01005450,1932,719,1213
2021,Oldham 019D,E01005451,1442,419,1023
2021,Oldham 007C,E01005452,1225,177,1048
2021,Oldham 007D,E01005453,1458,255,1203
2021,Oldham 012C,E01005454,1303,238,1065
2021,Oldham 012D,E01005455,1384,237,1147
2021,Oldham 012E,E01005456,1526,331,1195
2021,Oldham 024D,E01005459,1583,554,1029
2021,Oldham 036C,E01005460,2476,886,1590
2021,Oldham 037A,E01005461,2219,705,1514
2021,Oldham 037C,E01005462,2038,621,1417
2021,Oldham 036D,E01005463,1528,543,985
2021,Rochdale 016A,E01005464,1830,600,1230
2021,Rochdale 016B,E01005465,1689,309,1380
2021,Rochdale 016C,E01005466,2249,617,1632
2021,Rochdale 016D,E01005467,1815,485,1330
2021,Rochdale 016E,E01005468,2016,398,1618
2021,Rochdale 012A,E01005469,1690,396,1294
2021,Rochdale 015A,E01005470,1882,642,1240
2021,Rochdale 015B,E01005471,1540,458,1082
2021,Rochdale 010A,E01005472,1527,396,1131
2021,Rochdale 010B,E01005473,1551,485,1066
2021,Rochdale 011A,E01005474,1258,295,963
2021,Rochdale 015C,E01005475,1654,469,1185
2021,Rochdale 017A,E01005476,1696,411,1285
2021,Rochdale 017B,E01005477,1604,293,1311
2021,Rochdale 017C,E01005478,1476,268,1208
2021,Rochdale 017D,E01005479,1862,366,1496
2021,Rochdale 017E,E01005480,1547,258,1289
2021,Rochdale 017F,E01005481,1590,329,1261
2021,Rochdale 010C,E01005482,1561,330,1231
2021,Rochdale 010D,E01005483,1401,397,1004
2021,Rochdale 010E,E01005484,1863,534,1329
2021,Rochdale 015D,E01005485,2236,610,1626
2021,Rochdale 010F,E01005486,1521,434,1087
2021,Rochdale 010G,E01005487,1663,462,1201
2021,Rochdale 006A,E01005488,1430,297,1133
2021,Rochdale 005A,E01005489,1180,232,948
2021,Rochdale 005B,E01005490,1495,296,1199
2021,Rochdale 005C,E01005491,1346,221,1125
2021,Rochdale 006B,E01005492,1453,253,1200
2021,Rochdale 005D,E01005493,1673,320,1353
2021,Rochdale 005E,E01005494,1656,374,1282
2021,Rochdale 005F,E01005495,1668,313,1355
2021,Rochdale 009A,E01005496,1187,322,865
2021,Rochdale 018A,E01005497,1717,445,1272
2021,Rochdale 020A,E01005498,1256,246,1010
2021,Rochdale 006C,E01005499,1439,218,1221
2021,Rochdale 020B,E01005500,1505,271,1234
2021,Rochdale 018B,E01005501,1681,254,1427
2021,Rochdale 018C,E01005502,1308,223,1085
2021,Rochdale 020C,E01005503,1270,220,1050
2021,Rochdale 018D,E01005504,1524,316,1208
2021,Rochdale 018E,E01005505,2010,379,1631
2021,Rochdale 020D,E01005506,1471,282,1189
2021,Rochdale 020E,E01005507,2083,431,1652
2021,Rochdale 020F,E01005508,1904,386,1518
2021,Rochdale 018F,E01005509,1356,268,1088
2021,Rochdale 019A,E01005510,1043,168,875
2021,Rochdale 019B,E01005511,1188,205,983
2021,Rochdale 019C,E01005512,1357,248,1109
2021,Rochdale 019D,E01005513,1412,386,1026
2021,Rochdale 019E,E01005514,1691,354,1337
2021,Rochdale 019F,E01005515,1615,491,1124
2021,Rochdale 003A,E01005516,1221,222,999
2021,Rochdale 003B,E01005517,1377,197,1180
2021,Rochdale 001A,E01005518,1484,263,1221
2021,Rochdale 002A,E01005519,1483,318,1165
2021,Rochdale 001B,E01005520,1644,281,1363
2021,Rochdale 003C,E01005521,1405,186,1219
2021,Rochdale 001C,E01005522,1393,216,1177
2021,Rochdale 001D,E01005523,1758,337,1421
2021,Rochdale 021A,E01005524,1385,237,1148
2021,Rochdale 021B,E01005525,1707,400,1307
2021,Rochdale 021C,E01005526,1763,375,1388
2021,Rochdale 022A,E01005527,1912,502,1410
2021,Rochdale 021D,E01005528,1465,289,1176
2021,Rochdale 022B,E01005529,1555,379,1176
2021,Rochdale 025A,E01005530,1383,205,1178
2021,Rochdale 025B,E01005531,1102,212,890
2021,Rochdale 025C,E01005532,1453,389,1064
2021,Rochdale 024A,E01005533,1521,235,1286
2021,Rochdale 023A,E01005534,1337,247,1090
2021,Rochdale 023B,E01005535,1375,246,1129
2021,Rochdale 021E,E01005536,1606,420,1186
2021,Rochdale 023C,E01005537,1222,179,1043
2021,Rochdale 023D,E01005538,1380,364,1016
2021,Rochdale 024B,E01005539,1232,216,1016
2021,Rochdale 023E,E01005540,1256,224,1032
2021,Rochdale 023F,E01005541,1427,266,1161
2021,Rochdale 023G,E01005542,1494,350,1144
2021,Rochdale 021F,E01005543,1191,212,979
2021,Rochdale 025D,E01005544,1391,272,1119
2021,Rochdale 025E,E01005545,1198,228,970
2021,Rochdale 024C,E01005546,1183,185,998
2021,Rochdale 024D,E01005547,1620,326,1294
2021,Rochdale 024E,E01005548,1212,225,987
2021,Rochdale 025F,E01005549,1464,263,1201
2021,Rochdale 025G,E01005550,1410,250,1160
2021,Rochdale 022C,E01005551,1865,516,1349
2021,Rochdale 022D,E01005552,2139,640,1499
2021,Rochdale 022E,E01005553,1872,454,1418
2021,Rochdale 022F,E01005554,1981,389,1592
2021,Rochdale 014A,E01005555,1313,253,1060
2021,Rochdale 013A,E01005556,1456,240,1216
2021,Rochdale 014B,E01005557,1097,183,914
2021,Rochdale 014C,E01005558,1498,305,1193
2021,Rochdale 013B,E01005559,1393,311,1082
2021,Rochdale 013C,E01005560,1414,192,1222
2021,Rochdale 014D,E01005561,1352,230,1122
2021,Rochdale 014E,E01005562,1442,279,1163
2021,Rochdale 012B,E01005563,1963,588,1375
2021,Rochdale 015E,E01005564,2181,676,1505
2021,Rochdale 012C,E01005565,1484,432,1052
2021,Rochdale 012D,E01005566,2160,698,1462
2021,Rochdale 013D,E01005567,1746,334,1412
2021,Rochdale 012E,E01005568,1765,524,1241
2021,Rochdale 012F,E01005569,1689,497,1192
2021,Rochdale 007A,E01005570,1243,166,1077
2021,Rochdale 006D,E01005571,1579,244,1335
2021,Rochdale 007B,E01005572,1414,258,1156
2021,Rochdale 007C,E01005573,1384,268,1116
2021,Rochdale 007D,E01005574,1655,317,1338
2021,Rochdale 011B,E01005575,1645,261,1384
2021,Rochdale 011C,E01005576,1444,250,1194
2021,Rochdale 011D,E01005577,1389,213,1176
2021,Rochdale 004A,E01005578,1411,389,1022
2021,Rochdale 004B,E01005579,1720,674,1046
2021,Rochdale 008A,E01005580,1510,451,1059
2021,Rochdale 008B,E01005581,1762,517,1245
2021,Rochdale 008D,E01005583,1621,458,1163
2021,Rochdale 008F,E01005585,1426,432,994
2021,Rochdale 004C,E01005586,1494,446,1048
2021,Rochdale 007E,E01005587,1289,262,1027
2021,Rochdale 007F,E01005588,1260,172,1088
2021,Rochdale 009B,E01005589,1564,344,1220
2021,Rochdale 009C,E01005590,1757,524,1233
2021,Rochdale 009D,E01005591,1497,323,1174
2021,Rochdale 009E,E01005592,1531,398,1133
2021,Rochdale 004D,E01005593,1901,517,1384
2021,Rochdale 002B,E01005594,1430,307,1123
2021,Rochdale 004E,E01005595,1231,173,1058
2021,Rochdale 003D,E01005596,2022,414,1608
2021,Rochdale 002C,E01005597,1859,388,1471
2021,Rochdale 002D,E01005598,1494,248,1246
2021,Salford 026A,E01005599,1777,375,1402
2021,Salford 026B,E01005600,1878,352,1526
2021,Salford 026C,E01005601,1582,341,1241
2021,Salford 026D,E01005602,1527,271,1256
2021,Salford 027A,E01005603,1643,351,1292
2021,Salford 027B,E01005604,1540,256,1284
2021,Salford 027C,E01005605,1528,294,1234
2021,Salford 034C,E01005610,2848,1970,878
2021,Salford 032C,E01005611,2348,728,1620
2021,Salford 031B,E01005612,2266,694,1572
2021,Salford 031A,E01005613,2447,717,1730
2021,Salford 031C,E01005614,2552,1328,1224
2021,Salford 032D,E01005615,2056,676,1380
2021,Salford 030A,E01005616,1361,286,1075
2021,Salford 030B,E01005617,1394,270,1124
2021,Salford 030C,E01005618,1910,387,1523
2021,Salford 030D,E01005619,1164,210,954
2021,Salford 030E,E01005620,2376,509,1867
2021,Salford 030F,E01005621,1641,329,1312
2021,Salford 018A,E01005622,1500,292,1208
2021,Salford 018B,E01005623,1195,235,960
2021,Salford 017A,E01005624,1715,439,1276
2021,Salford 015A,E01005625,1302,199,1103
2021,Salford 018C,E01005626,1222,193,1029
2021,Salford 015B,E01005627,1110,186,924
2021,Salford 018D,E01005628,1513,295,1218
2021,Salford 021A,E01005629,1392,210,1182
2021,Salford 021B,E01005630,1447,286,1161
2021,Salford 020A,E01005631,1523,145,1378
2021,Salford 020B,E01005632,2301,438,1863
2021,Salford 020C,E01005633,1447,301,1146
2021,Salford 020D,E01005634,1490,261,1229
2021,Salford 020E,E01005635,1475,199,1276
2021,Salford 020F,E01005636,1544,237,1307
2021,Salford 020G,E01005637,1378,255,1123
2021,Salford 027D,E01005638,2050,314,1736
2021,Salford 029A,E01005639,1388,477,911
2021,Salford 029B,E01005640,1267,280,987
2021,Salford 029C,E01005641,1298,213,1085
2021,Salford 029D,E01005642,1140,206,934
2021,Salford 029E,E01005643,1323,168,1155
2021,Salford 029F,E01005644,1437,277,1160
2021,Salford 029G,E01005645,1314,184,1130
2021,Salford 010A,E01005646,2006,677,1329
2021,Salford 011A,E01005647,1388,383,1005
2021,Salford 011B,E01005648,2173,459,1714
2021,Salford 010B,E01005649,1547,422,1125
2021,Salford 010C,E01005650,1733,647,1086
2021,Salford 010D,E01005651,2068,823,1245
2021,Salford 011C,E01005652,1439,372,1067
2021,Salford 011D,E01005653,1446,394,1052
2021,Salford 023A,E01005654,1846,417,1429
2021,Salford 023B,E01005656,1595,457,1138
2021,Salford 023C,E01005657,1698,415,1283
2021,Salford 001A,E01005659,1444,311,1133
2021,Salford 001B,E01005660,1684,503,1181
2021,Salford 004A,E01005661,1744,455,1289
2021,Salford 004B,E01005662,1500,459,1041
2021,Salford 001C,E01005663,1429,311,1118
2021,Salford 001D,E01005664,1551,544,1007
2021,Salford 001E,E01005665,1927,636,1291
2021,Salford 035C,E01005667,2157,453,1704
2021,Salford 005A,E01005670,1646,341,1305
2021,Salford 012A,E01005671,1461,239,1222
2021,Salford 005B,E01005672,1213,185,1028
2021,Salford 008A,E01005673,1404,258,1146
2021,Salford 012B,E01005674,1472,283,1189
2021,Salford 005C,E01005676,1176,136,1040
2021,Salford 005D,E01005677,1521,296,1225
2021,Salford 008C,E01005678,1445,372,1073
2021,Salford 008D,E01005679,1413,371,1042
2021,Salford 017B,E01005680,1622,389,1233
2021,Salford 024C,E01005681,1418,656,762
2021,Salford 024D,E01005682,1564,290,1274
2021,Salford 017C,E01005683,1981,649,1332
2021,Salford 006A,E01005686,1400,284,1116
2021,Salford 009A,E01005687,1691,323,1368
2021,Salford 006B,E01005688,1469,304,1165
2021,Salford 009B,E01005689,1274,375,899
2021,Salford 009C,E01005690,1498,225,1273
2021,Salford 006C,E01005691,1360,150,1210
2021,Salford 006D,E01005692,1281,212,1069
2021,Salford 009D,E01005693,1350,250,1100
2021,Salford 012C,E01005694,1608,305,1303
2021,Salford 014A,E01005695,1485,312,1173
2021,Salford 012D,E01005696,1647,345,1302
2021,Salford 014B,E01005697,1446,274,1172
2021,Salford 012E,E01005698,1603,366,1237
2021,Salford 015C,E01005699,1691,313,1378
2021,Salford 012F,E01005700,1428,276,1152
2021,Salford 015D,E01005701,1736,302,1434
2021,Salford 003A,E01005702,2456,509,1947
2021,Salford 002A,E01005703,1620,427,1193
2021,Salford 002B,E01005704,1261,230,1031
2021,Salford 002C,E01005706,1433,327,1106
2021,Salford 003C,E01005707,1621,386,1235
2021,Salford 002D,E01005708,1339,206,1133
2021,Salford 004C,E01005709,1453,388,1065
2021,Salford 004D,E01005710,1976,352,1624
2021,Salford 007A,E01005711,1329,206,1123
2021,Salford 007B,E01005712,1720,305,1415
2021,Salford 007C,E01005713,1522,217,1305
2021,Salford 007D,E01005714,1598,344,1254
2021,Salford 007E,E01005715,1626,255,1371
2021,Salford 013A,E01005716,1558,259,1299
2021,Salford 013B,E01005717,1475,355,1120
2021,Salford 007F,E01005718,1499,204,1295
2021,Salford 021C,E01005719,1924,309,1615
2021,Salford 023D,E01005721,1493,260,1233
2021,Salford 021E,E01005722,1913,455,1458
2021,Salford 021F,E01005723,1577,402,1175
2021,Salford 021G,E01005724,1361,211,1150
2021,Salford 019A,E01005725,1372,373,999
2021,Salford 019B,E01005726,1350,244,1106
2021,Salford 019C,E01005727,1298,237,1061
2021,Salford 019D,E01005728,1666,298,1368
2021,Salford 025A,E01005729,1404,290,1114
2021,Salford 025B,E01005730,1576,320,1256
2021,Salford 025C,E01005731,1472,411,1061
2021,Salford 025D,E01005732,1145,209,936
2021,Salford 019E,E01005733,1374,340,1034
2021,Salford 013C,E01005734,1330,208,1122
2021,Salford 013D,E01005735,1345,228,1117
2021,Salford 013E,E01005736,1290,195,1095
2021,Salford 013F,E01005737,1446,263,1183
2021,Salford 014C,E01005738,1814,253,1561
2021,Salford 013G,E01005739,1847,372,1475
2021,Salford 014D,E01005740,1511,297,1214
2021,Salford 014E,E01005741,1577,306,1271
2021,Salford 014F,E01005742,1459,277,1182
2021,Stockport 009A,E01005743,1203,155,1048
2021,Stockport 009B,E01005744,1441,253,1188
2021,Stockport 005A,E01005745,1313,202,1111
2021,Stockport 005B,E01005746,1382,162,1220
2021,Stockport 005C,E01005747,1333,237,1096
2021,Stockport 005D,E01005748,1445,196,1249
2021,Stockport 009C,E01005749,1545,240,1305
2021,Stockport 009D,E01005750,1560,269,1291
2021,Stockport 009E,E01005751,1313,219,1094
2021,Stockport 012A,E01005752,1318,252,1066
2021,Stockport 004A,E01005753,1725,437,1288
2021,Stockport 004B,E01005754,1834,356,1478
2021,Stockport 004C,E01005755,1628,392,1236
2021,Stockport 004D,E01005756,2135,489,1646
2021,Stockport 014A,E01005757,1507,284,1223
2021,Stockport 023A,E01005759,1563,292,1271
2021,Stockport 023B,E01005760,1804,367,1437
2021,Stockport 026A,E01005761,1324,328,996
2021,Stockport 026B,E01005762,1820,405,1415
2021,Stockport 026C,E01005763,1625,410,1215
2021,Stockport 016A,E01005764,1503,237,1266
2021,Stockport 018A,E01005765,1291,213,1078
2021,Stockport 014C,E01005766,1673,369,1304
2021,Stockport 028A,E01005767,1575,288,1287
2021,Stockport 025A,E01005768,1907,402,1505
2021,Stockport 022A,E01005769,1477,174,1303
2021,Stockport 025B,E01005770,1388,272,1116
2021,Stockport 025C,E01005771,1361,279,1082
2021,Stockport 028B,E01005772,1473,327,1146
2021,Stockport 028C,E01005773,1485,273,1212
2021,Stockport 028D,E01005774,1476,278,1198
2021,Stockport 025D,E01005775,1560,322,1238
2021,Stockport 028E,E01005776,1624,379,1245
2021,Stockport 034A,E01005777,1483,279,1204
2021,Stockport 022B,E01005778,1317,202,1115
2021,Stockport 022C,E01005779,1380,277,1103
2021,Stockport 022D,E01005780,1376,301,1075
2021,Stockport 022E,E01005781,1574,286,1288
2021,Stockport 030A,E01005782,1219,180,1039
2021,Stockport 030B,E01005783,1475,236,1239
2021,Stockport 030C,E01005784,1420,346,1074
2021,Stockport 030D,E01005785,1589,381,1208
2021,Stockport 030E,E01005786,1758,347,1411
2021,Stockport 034B,E01005787,1267,249,1018
2021,Stockport 034C,E01005788,1481,309,1172
2021,Stockport 039A,E01005789,1611,326,1285
2021,Stockport 034D,E01005790,1158,254,904
2021,Stockport 039B,E01005791,1489,303,1186
2021,Stockport 041A,E01005792,1460,322,1138
2021,Stockport 039C,E01005793,1452,297,1155
2021,Stockport 041B,E01005794,1196,231,965
2021,Stockport 039D,E01005795,1296,268,1028
2021,Stockport 039E,E01005796,1196,236,960
2021,Stockport 023C,E01005797,1299,225,1074
2021,Stockport 027A,E01005798,1580,225,1355
2021,Stockport 026D,E01005799,1740,519,1221
2021,Stockport 023D,E01005800,1524,266,1258
2021,Stockport 027B,E01005801,2031,421,1610
2021,Stockport 027C,E01005802,1393,269,1124
2021,Stockport 027D,E01005803,1327,227,1100
2021,Stockport 023E,E01005804,1072,217,855
2021,Stockport 035A,E01005805,1481,290,1191
2021,Stockport 033A,E01005806,1128,185,943
2021,Stockport 035B,E01005807,1490,273,1217
2021,Stockport 037A,E01005808,1307,269,1038
2021,Stockport 037B,E01005809,1152,203,949
2021,Stockport 037C,E01005810,1481,270,1211
2021,Stockport 037D,E01005811,1254,162,1092
2021,Stockport 037E,E01005812,1162,212,950
2021,Stockport 033B,E01005813,1301,212,1089
2021,Stockport 033C,E01005814,1245,208,1037
2021,Stockport 033D,E01005815,1359,231,1128
2021,Stockport 016B,E01005816,1454,266,1188
2021,Stockport 016C,E01005817,1298,192,1106
2021,Stockport 018B,E01005818,1310,305,1005
2021,Stockport 018C,E01005819,1498,251,1247
2021,Stockport 018D,E01005820,1408,247,1161
2021,Stockport 018E,E01005821,1344,227,1117
2021,Stockport 016D,E01005822,1767,278,1489
2021,Stockport 018F,E01005823,1518,314,1204
2021,Stockport 024A,E01005824,1428,281,1147
2021,Stockport 019A,E01005825,1556,283,1273
2021,Stockport 024B,E01005826,1515,399,1116
2021,Stockport 024C,E01005827,1669,277,1392
2021,Stockport 024D,E01005828,1286,391,895
2021,Stockport 024E,E01005829,1117,243,874
2021,Stockport 027E,E01005830,1459,257,1202
2021,Stockport 027F,E01005831,1554,307,1247
2021,Stockport 021A,E01005832,1355,208,1147
2021,Stockport 021B,E01005833,1002,173,829
2021,Stockport 031A,E01005834,1443,317,1126
2021,Stockport 021C,E01005835,1332,205,1127
2021,Stockport 031B,E01005836,1756,265,1491
2021,Stockport 021D,E01005837,1440,258,1182
2021,Stockport 031C,E01005838,1659,250,1409
2021,Stockport 035C,E01005839,1245,200,1045
2021,Stockport 031D,E01005840,1507,259,1248
2021,Stockport 035D,E01005841,1408,221,1187
2021,Stockport 038A,E01005842,1539,276,1263
2021,Stockport 021E,E01005843,1375,245,1130
2021,Stockport 036A,E01005844,1481,312,1169
2021,Stockport 036B,E01005845,1573,335,1238
2021,Stockport 040A,E01005846,1613,371,1242
2021,Stockport 040B,E01005847,1476,286,1190
2021,Stockport 040C,E01005848,1948,427,1521
2021,Stockport 036C,E01005849,1559,284,1275
2021,Stockport 040D,E01005850,1676,321,1355
2021,Stockport 036D,E01005851,1539,299,1240
2021,Stockport 013A,E01005852,1421,217,1204
2021,Stockport 011A,E01005853,1520,323,1197
2021,Stockport 013B,E01005854,1604,317,1287
2021,Stockport 013C,E01005855,1417,291,1126
2021,Stockport 011B,E01005856,1515,320,1195
2021,Stockport 013D,E01005857,1513,342,1171
2021,Stockport 013E,E01005858,1494,208,1286
2021,Stockport 008A,E01005859,1353,258,1095
2021,Stockport 011C,E01005860,1436,326,1110
2021,Stockport 011D,E01005861,1466,271,1195
2021,Stockport 003A,E01005862,1394,250,1144
2021,Stockport 006A,E01005863,1628,253,1375
2021,Stockport 006B,E01005864,1504,284,1220
2021,Stockport 008B,E01005865,1830,397,1433
2021,Stockport 006C,E01005866,1580,248,1332
2021,Stockport 008C,E01005867,1414,270,1144
2021,Stockport 008D,E01005868,1446,285,1161
2021,Stockport 006D,E01005869,1509,283,1226
2021,Stockport 015A,E01005870,1285,238,1047
2021,Stockport 015B,E01005871,1301,250,1051
2021,Stockport 019B,E01005872,1561,232,1329
2021,Stockport 015C,E01005873,1386,266,1120
2021,Stockport 019C,E01005874,1768,264,1504
2021,Stockport 015D,E01005875,1464,267,1197
2021,Stockport 019D,E01005876,1402,248,1154
2021,Stockport 019E,E01005877,1571,272,1299
2021,Stockport 020A,E01005878,1639,368,1271
2021,Stockport 020B,E01005879,1223,215,1008
2021,Stockport 017A,E01005880,1409,222,1187
2021,Stockport 017B,E01005881,1156,181,975
2021,Stockport 020C,E01005882,1221,202,1019
2021,Stockport 017C,E01005883,1453,230,1223
2021,Stockport 020D,E01005884,1384,215,1169
2021,Stockport 020E,E01005885,1421,223,1198
2021,Stockport 001A,E01005886,1382,265,1117
2021,Stockport 002A,E01005887,1598,431,1167
2021,Stockport 001B,E01005888,1426,309,1117
2021,Stockport 001C,E01005889,1334,213,1121
2021,Stockport 002B,E01005890,1422,349,1073
2021,Stockport 001D,E01005891,1184,157,1027
2021,Stockport 003B,E01005892,1193,219,974
2021,Stockport 002C,E01005893,2050,311,1739
2021,Stockport 001E,E01005894,1285,235,1050
2021,Stockport 003C,E01005895,1104,215,889
2021,Stockport 002D,E01005896,1561,271,1290
2021,Stockport 010A,E01005897,1453,295,1158
2021,Stockport 010B,E01005898,1612,258,1354
2021,Stockport 012B,E01005899,1545,223,1322
2021,Stockport 010C,E01005900,1517,230,1287
2021,Stockport 012C,E01005901,1326,160,1166
2021,Stockport 012D,E01005902,1536,305,1231
2021,Stockport 010D,E01005903,1426,191,1235
2021,Stockport 010E,E01005904,1446,260,1186
2021,Stockport 012E,E01005905,1381,346,1035
2021,Stockport 038B,E01005906,1398,157,1241
2021,Stockport 038C,E01005907,1312,174,1138
2021,Stockport 017D,E01005908,1558,303,1255
2021,Stockport 029A,E01005909,1469,258,1211
2021,Stockport 029B,E01005910,1528,251,1277
2021,Stockport 029C,E01005911,1279,178,1101
2021,Stockport 029D,E01005912,1431,260,1171
2021,Stockport 038D,E01005913,1373,185,1188
2021,Stockport 007A,E01005914,1341,191,1150
2021,Stockport 007B,E01005915,1445,252,1193
2021,Stockport 007C,E01005916,1512,238,1274
2021,Stockport 007D,E01005917,1719,328,1391
2021,Stockport 014D,E01005918,1486,305,1181
2021,Stockport 002E,E01005919,1440,334,1106
2021,Stockport 003D,E01005920,1504,278,1226
2021,Stockport 003E,E01005921,1382,241,1141
2021,Stockport 003F,E01005922,1244,139,1105
2021,Stockport 041C,E01005923,1416,270,1146
2021,Stockport 042A,E01005924,1243,234,1009
2021,Stockport 042B,E01005925,1382,267,1115
2021,Stockport 042C,E01005926,2077,364,1713
2021,Stockport 032A,E01005927,1218,240,978
2021,Stockport 032B,E01005928,1511,318,1193
2021,Stockport 032C,E01005929,1372,252,1120
2021,Stockport 032D,E01005930,1623,346,1277
2021,Stockport 041D,E01005931,1322,189,1133
2021,Stockport 042D,E01005932,1207,169,1038
2021,Tameside 006A,E01005933,1470,433,1037
2021,Tameside 006B,E01005934,1429,304,1125
2021,Tameside 006C,E01005935,1354,333,1021
2021,Tameside 004A,E01005936,1459,240,1219
2021,Tameside 004B,E01005937,1582,353,1229
2021,Tameside 002A,E01005938,1482,294,1188
2021,Tameside 002B,E01005939,1225,215,1010
2021,Tameside 002C,E01005940,1345,216,1129
2021,Tameside 007A,E01005941,1729,356,1373
2021,Tameside 007B,E01005942,1566,265,1301
2021,Tameside 007C,E01005943,1663,254,1409
2021,Tameside 007D,E01005944,1721,338,1383
2021,Tameside 004C,E01005945,1905,535,1370
2021,Tameside 004D,E01005946,1466,282,1184
2021,Tameside 004E,E01005947,1655,369,1286
2021,Tameside 013A,E01005948,2166,447,1719
2021,Tameside 006D,E01005949,1534,288,1246
2021,Tameside 013B,E01005950,1999,693,1306
2021,Tameside 013C,E01005951,1652,410,1242
2021,Tameside 013E,E01005953,2121,548,1573
2021,Tameside 005A,E01005954,1424,204,1220
2021,Tameside 002D,E01005955,1545,271,1274
2021,Tameside 005B,E01005956,1330,173,1157
2021,Tameside 005C,E01005957,1479,343,1136
2021,Tameside 005D,E01005958,1494,361,1133
2021,Tameside 005E,E01005959,1823,495,1328
2021,Tameside 006E,E01005960,1619,349,1270
2021,Tameside 014A,E01005961,2717,601,2116
2021,Tameside 014B,E01005962,1355,269,1086
2021,Tameside 019A,E01005963,1101,198,903
2021,Tameside 019B,E01005964,1440,265,1175
2021,Tameside 019C,E01005965,1629,285,1344
2021,Tameside 019D,E01005966,1477,345,1132
2021,Tameside 019E,E01005967,1351,233,1118
2021,Tameside 014C,E01005968,1317,181,1136
2021,Tameside 014D,E01005969,1246,195,1051
2021,Tameside 021A,E01005970,1366,192,1174
2021,Tameside 025A,E01005971,1288,194,1094
2021,Tameside 021B,E01005972,1597,328,1269
2021,Tameside 026A,E01005973,1315,216,1099
2021,Tameside 021C,E01005974,1601,283,1318
2021,Tameside 021D,E01005975,1442,294,1148
2021,Tameside 026B,E01005976,1377,270,1107
2021,Tameside 026C,E01005977,1378,200,1178
2021,Tameside 026D,E01005978,1245,229,1016
2021,Tameside 029A,E01005979,1521,227,1294
2021,Tameside 029B,E01005980,1350,249,1101
2021,Tameside 029C,E01005981,1563,295,1268
2021,Tameside 029D,E01005982,1270,232,1038
2021,Tameside 029E,E01005983,1442,213,1229
2021,Tameside 029F,E01005984,1509,291,1218
2021,Tameside 024A,E01005985,1475,217,1258
2021,Tameside 025B,E01005986,1185,235,950
2021,Tameside 024B,E01005987,1461,188,1273
2021,Tameside 024C,E01005988,1525,307,1218
2021,Tameside 025C,E01005989,1168,208,960
2021,Tameside 024D,E01005990,1309,213,1096
2021,Tameside 024E,E01005991,1430,300,1130
2021,Tameside 025D,E01005992,1150,206,944
2021,Tameside 010A,E01005993,1283,217,1066
2021,Tameside 011A,E01005994,1408,297,1111
2021,Tameside 010B,E01005995,1318,236,1082
2021,Tameside 010C,E01005996,1833,392,1441
2021,Tameside 010D,E01005997,1467,293,1174
2021,Tameside 012A,E01005998,1764,394,1370
2021,Tameside 011B,E01005999,2064,433,1631
2021,Tameside 010E,E01006000,1695,247,1448
2021,Tameside 012B,E01006001,1465,278,1187
2021,Tameside 011C,E01006002,1303,224,1079
2021,Tameside 012C,E01006003,1456,314,1142
2021,Tameside 011D,E01006004,1452,289,1163
2021,Tameside 011E,E01006005,1285,293,992
2021,Tameside 012D,E01006006,1361,203,1158
2021,Tameside 011F,E01006007,1468,290,1178
2021,Tameside 017A,E01006008,1304,215,1089
2021,Tameside 016A,E01006009,1266,242,1024
2021,Tameside 017B,E01006010,1303,260,1043
2021,Tameside 018A,E01006011,1622,410,1212
2021,Tameside 017C,E01006012,1827,344,1483
2021,Tameside 018B,E01006013,1235,212,1023
2021,Tameside 018C,E01006014,1196,285,911
2021,Tameside 017D,E01006015,1288,234,1054
2021,Tameside 017E,E01006016,1817,309,1508
2021,Tameside 016B,E01006017,1329,247,1082
2021,Tameside 016C,E01006018,1287,183,1104
2021,Tameside 018D,E01006019,1442,192,1250
2021,Tameside 018E,E01006020,1558,326,1232
2021,Tameside 016D,E01006021,1300,223,1077
2021,Tameside 015A,E01006022,1845,221,1624
2021,Tameside 015B,E01006023,1493,266,1227
2021,Tameside 022A,E01006024,1698,297,1401
2021,Tameside 027A,E01006025,1731,371,1360
2021,Tameside 022B,E01006026,1455,236,1219
2021,Tameside 027B,E01006027,2150,520,1630
2021,Tameside 028A,E01006028,1652,279,1373
2021,Tameside 028B,E01006029,1795,528,1267
2021,Tameside 028C,E01006030,1749,344,1405
2021,Tameside 020A,E01006031,2058,461,1597
2021,Tameside 020B,E01006032,1398,308,1090
2021,Tameside 020C,E01006033,1627,295,1332
2021,Tameside 020D,E01006034,1999,471,1528
2021,Tameside 020E,E01006035,2025,365,1660
2021,Tameside 020F,E01006036,2025,463,1562
2021,Tameside 022C,E01006037,1522,248,1274
2021,Tameside 022D,E01006038,1513,229,1284
2021,Tameside 028D,E01006039,1278,331,947
2021,Tameside 028E,E01006040,1756,468,1288
2021,Tameside 028F,E01006041,1582,363,1219
2021,Tameside 030A,E01006042,1610,271,1339
2021,Tameside 030B,E01006043,1366,283,1083
2021,Tameside 030C,E01006044,1446,257,1189
2021,Tameside 030D,E01006045,1199,178,1021
2021,Tameside 030E,E01006046,1459,243,1216
2021,Tameside 023A,E01006047,1250,232,1018
2021,Tameside 023B,E01006048,1505,203,1302
2021,Tameside 023C,E01006049,1471,193,1278
2021,Tameside 027C,E01006050,1690,426,1264
2021,Tameside 023D,E01006051,1563,259,1304
2021,Tameside 027D,E01006052,1461,322,1139
2021,Tameside 001A,E01006053,1857,344,1513
2021,Tameside 001B,E01006054,1682,342,1340
2021,Tameside 001C,E01006055,1397,234,1163
2021,Tameside 003A,E01006056,1146,305,841
2021,Tameside 001D,E01006057,1443,250,1193
2021,Tameside 001E,E01006058,1974,313,1661
2021,Tameside 001F,E01006059,1381,276,1105
2021,Tameside 008A,E01006060,1398,280,1118
2021,Tameside 003B,E01006061,2303,545,1758
2021,Tameside 003C,E01006062,1909,372,1537
2021,Tameside 003D,E01006063,1329,215,1114
2021,Tameside 008B,E01006064,1586,334,1252
2021,Tameside 008C,E01006065,1337,407,930
2021,Tameside 008D,E01006066,1320,216,1104
2021,Tameside 009A,E01006067,1783,396,1387
2021,Tameside 009B,E01006068,1478,212,1266
2021,Tameside 009C,E01006069,1637,395,1242
2021,Tameside 015C,E01006070,1320,224,1096
2021,Tameside 015D,E01006071,1643,273,1370
2021,Tameside 015E,E01006072,1549,263,1286
2021,Tameside 009D,E01006073,1924,457,1467
2021,Trafford 025A,E01006074,1541,362,1179
2021,Trafford 025B,E01006075,2072,365,1707
2021,Trafford 025C,E01006076,1619,249,1370
2021,Trafford 027A,E01006077,1551,272,1279
2021,Trafford 024A,E01006078,1992,376,1616
2021,Trafford 025D,E01006079,2419,527,1892
2021,Trafford 024B,E01006080,1843,364,1479
2021,Trafford 027B,E01006081,1330,303,1027
2021,Trafford 027C,E01006082,1463,287,1176
2021,Trafford 026A,E01006083,1234,255,979
2021,Trafford 026B,E01006084,1642,424,1218
2021,Trafford 027D,E01006085,1488,325,1163
2021,Trafford 027E,E01006086,1628,382,1246
2021,Trafford 025E,E01006087,1385,272,1113
2021,Trafford 026C,E01006088,1505,344,1161
2021,Trafford 024C,E01006089,1860,401,1459
2021,Trafford 020A,E01006090,2167,391,1776
2021,Trafford 019A,E01006091,2790,736,2054
2021,Trafford 019B,E01006092,1223,314,909
2021,Trafford 023A,E01006093,1451,329,1122
2021,Trafford 020B,E01006094,1499,373,1126
2021,Trafford 019C,E01006095,1576,338,1238
2021,Trafford 020C,E01006096,1522,391,1131
2021,Trafford 015A,E01006097,1700,299,1401
2021,Trafford 014A,E01006098,1275,301,974
2021,Trafford 014B,E01006099,1239,237,1002
2021,Trafford 020D,E01006100,1422,308,1114
2021,Trafford 021A,E01006101,1407,317,1090
2021,Trafford 018A,E01006102,1306,288,1018
2021,Trafford 020E,E01006103,1585,386,1199
2021,Trafford 017A,E01006104,1598,244,1354
2021,Trafford 017B,E01006105,1635,509,1126
2021,Trafford 017C,E01006106,1367,286,1081
2021,Trafford 017D,E01006107,1510,303,1207
2021,Trafford 017E,E01006108,1531,475,1056
2021,Trafford 001A,E01006109,1076,255,821
2021,Trafford 001B,E01006110,1736,467,1269
2021,Trafford 001C,E01006111,1653,544,1109
2021,Trafford 001D,E01006112,1897,542,1355
2021,Trafford 004A,E01006113,1503,357,1146
2021,Trafford 004B,E01006114,1594,391,1203
2021,Trafford 004C,E01006115,1444,290,1154
2021,Trafford 002A,E01006116,1242,265,977
2021,Trafford 002B,E01006117,1596,317,1279
2021,Trafford 002C,E01006118,1390,227,1163
2021,Trafford 002D,E01006119,1541,292,1249
2021,Trafford 010A,E01006120,1342,240,1102
2021,Trafford 002E,E01006121,1377,248,1129
2021,Trafford 005A,E01006122,1688,289,1399
2021,Trafford 005B,E01006123,1600,303,1297
2021,Trafford 005C,E01006124,1412,246,1166
2021,Trafford 007A,E01006125,1427,262,1165
2021,Trafford 007B,E01006126,1722,376,1346
2021,Trafford 007C,E01006127,1472,272,1200
2021,Trafford 005D,E01006128,1813,324,1489
2021,Trafford 010B,E01006129,1311,201,1110
2021,Trafford 007D,E01006130,1658,313,1345
2021,Trafford 005E,E01006131,1450,270,1180
2021,Trafford 007E,E01006132,1453,257,1196
2021,Trafford 010C,E01006133,1358,195,1163
2021,Trafford 028A,E01006134,1434,336,1098
2021,Trafford 028B,E01006135,1678,371,1307
2021,Trafford 028C,E01006136,1608,399,1209
2021,Trafford 028D,E01006137,1351,323,1028
2021,Trafford 028E,E01006138,1777,420,1357
2021,Trafford 026D,E01006139,1672,376,1296
2021,Trafford 026E,E01006140,1586,407,1179
2021,Trafford 003A,E01006141,1668,405,1263
2021,Trafford 011A,E01006142,1632,357,1275
2021,Trafford 011B,E01006143,1580,325,1255
2021,Trafford 011C,E01006144,1329,265,1064
2021,Trafford 004D,E01006145,1934,488,1446
2021,Trafford 004E,E01006146,1670,392,1278
2021,Trafford 012A,E01006147,1335,301,1034
2021,Trafford 016A,E01006148,1627,321,1306
2021,Trafford 012B,E01006149,1475,304,1171
2021,Trafford 012C,E01006150,1823,319,1504
2021,Trafford 016B,E01006151,1509,348,1161
2021,Trafford 016C,E01006152,1581,338,1243
2021,Trafford 016D,E01006153,1527,311,1216
2021,Trafford 012D,E01006154,1480,318,1162
2021,Trafford 006A,E01006155,1642,315,1327
2021,Trafford 008A,E01006156,1590,348,1242
2021,Trafford 006B,E01006157,1589,353,1236
2021,Trafford 008B,E01006158,1618,329,1289
2021,Trafford 006C,E01006159,1741,469,1272
2021,Trafford 015B,E01006160,2006,372,1634
2021,Trafford 015C,E01006161,2033,415,1618
2021,Trafford 015D,E01006162,1536,343,1193
2021,Trafford 015E,E01006163,1700,330,1370
2021,Trafford 014C,E01006164,1655,315,1340
2021,Trafford 012E,E01006165,1842,314,1528
2021,Trafford 013A,E01006166,1555,338,1217
2021,Trafford 019D,E01006167,1489,315,1174
2021,Trafford 019E,E01006168,1677,432,1245
2021,Trafford 013B,E01006169,1553,309,1244
2021,Trafford 013C,E01006170,1515,317,1198
2021,Trafford 013D,E01006171,1645,369,1276
2021,Trafford 016E,E01006172,1475,275,1200
2021,Trafford 018B,E01006173,1445,284,1161
2021,Trafford 014D,E01006174,1683,302,1381
2021,Trafford 018C,E01006175,1645,409,1236
2021,Trafford 018D,E01006176,1634,302,1332
2021,Trafford 018E,E01006177,1552,414,1138
2021,Trafford 014E,E01006178,1696,332,1364
2021,Trafford 008C,E01006179,1694,307,1387
2021,Trafford 011D,E01006180,1719,349,1370
2021,Trafford 011E,E01006181,1652,384,1268
2021,Trafford 006D,E01006182,1516,342,1174
2021,Trafford 006E,E01006183,1636,354,1282
2021,Trafford 008D,E01006184,1590,280,1310
2021,Trafford 003B,E01006186,2039,492,1547
2021,Trafford 003C,E01006187,2414,469,1945
2021,Trafford 001F,E01006188,1863,466,1397
2021,Trafford 003D,E01006189,2203,538,1665
2021,Trafford 021B,E01006190,1596,351,1245
2021,Trafford 023B,E01006191,1611,352,1259
2021,Trafford 023C,E01006192,1447,297,1150
2021,Trafford 024D,E01006193,1473,340,1133
2021,Trafford 024E,E01006194,2260,570,1690
2021,Trafford 021C,E01006195,1696,353,1343
2021,Trafford 021D,E01006196,1618,345,1273
2021,Trafford 010D,E01006197,1391,283,1108
2021,Trafford 009A,E01006198,1396,214,1182
2021,Trafford 009B,E01006199,1452,244,1208
2021,Trafford 009C,E01006200,1420,196,1224
2021,Trafford 009D,E01006201,1361,235,1126
2021,Trafford 009E,E01006202,1235,208,1027
2021,Trafford 010E,E01006203,1277,231,1046
2021,Trafford 022A,E01006204,1564,306,1258
2021,Trafford 023D,E01006205,1284,237,1047
2021,Trafford 022B,E01006206,1766,460,1306
2021,Trafford 022C,E01006207,1650,347,1303
2021,Trafford 022D,E01006208,1485,366,1119
2021,Trafford 023E,E01006209,1566,335,1231
2021,Trafford 021E,E01006210,1525,319,1206
2021,Trafford 022E,E01006211,1531,351,1180
2021,Wigan 026A,E01006212,1333,240,1093
2021,Wigan 024A,E01006213,1412,303,1109
2021,Wigan 026B,E01006214,1293,267,1026
2021,Wigan 024B,E01006215,1622,311,1311
2021,Wigan 026C,E01006216,2050,426,1624
2021,Wigan 024C,E01006217,2231,496,1735
2021,Wigan 024D,E01006218,2215,488,1727
2021,Wigan 024E,E01006219,1137,192,945
2021,Wigan 035A,E01006220,1648,277,1371
2021,Wigan 035B,E01006221,1491,270,1221
2021,Wigan 035C,E01006222,1504,256,1248
2021,Wigan 036A,E01006223,1511,215,1296
2021,Wigan 035D,E01006224,1365,306,1059
2021,Wigan 036B,E01006225,1446,226,1220
2021,Wigan 035E,E01006226,1628,287,1341
2021,Wigan 038A,E01006227,1518,306,1212
2021,Wigan 038B,E01006228,1528,285,1243
2021,Wigan 002A,E01006229,1330,164,1166
2021,Wigan 002B,E01006230,1987,364,1623
2021,Wigan 004A,E01006231,1401,222,1179
2021,Wigan 004B,E01006232,1898,346,1552
2021,Wigan 002C,E01006233,1358,220,1138
2021,Wigan 004C,E01006234,1112,157,955
2021,Wigan 004D,E01006235,1451,278,1173
2021,Wigan 007A,E01006236,1515,227,1288
2021,Wigan 002D,E01006237,1823,335,1488
2021,Wigan 002E,E01006238,1435,238,1197
2021,Wigan 017A,E01006239,1977,412,1565
2021,Wigan 017B,E01006240,1451,417,1034
2021,Wigan 017C,E01006241,2323,549,1774
2021,Wigan 023A,E01006242,1843,315,1528
2021,Wigan 023B,E01006243,2011,381,1630
2021,Wigan 023C,E01006244,1609,217,1392
2021,Wigan 023D,E01006245,2452,449,2003
2021,Wigan 034A,E01006246,1449,253,1196
2021,Wigan 034B,E01006247,1235,189,1046
2021,Wigan 031A,E01006248,2061,412,1649
2021,Wigan 031B,E01006249,1555,372,1183
2021,Wigan 029A,E01006250,1993,344,1649
2021,Wigan 029B,E01006251,1474,232,1242
2021,Wigan 034C,E01006252,1343,209,1134
2021,Wigan 005A,E01006253,1438,264,1174
2021,Wigan 005B,E01006254,1470,377,1093
2021,Wigan 005C,E01006255,1430,205,1225
2021,Wigan 005D,E01006256,1612,289,1323
2021,Wigan 008A,E01006257,1150,189,961
2021,Wigan 008B,E01006258,1519,236,1283
2021,Wigan 003A,E01006259,1250,231,1019
2021,Wigan 005E,E01006260,1436,282,1154
2021,Wigan 036C,E01006261,1436,243,1193
2021,Wigan 032A,E01006262,1619,336,1283
2021,Wigan 032B,E01006263,1446,234,1212
2021,Wigan 036D,E01006264,1179,174,1005
2021,Wigan 036E,E01006265,1342,238,1104
2021,Wigan 032C,E01006266,1327,174,1153
2021,Wigan 032D,E01006267,1525,308,1217
2021,Wigan 032E,E01006268,1570,310,1260
2021,Wigan 013A,E01006269,1655,288,1367
2021,Wigan 016A,E01006270,1380,220,1160
2021,Wigan 013B,E01006271,1593,203,1390
2021,Wigan 013C,E01006272,1555,275,1280
2021,Wigan 013D,E01006273,1402,257,1145
2021,Wigan 016B,E01006274,1434,335,1099
2021,Wigan 016C,E01006275,1465,325,1140
2021,Wigan 013E,E01006276,2054,412,1642
2021,Wigan 016D,E01006277,1773,410,1363
2021,Wigan 019A,E01006278,1549,250,1299
2021,Wigan 019B,E01006279,1491,262,1229
2021,Wigan 019C,E01006280,1399,240,1159
2021,Wigan 019D,E01006281,1824,319,1505
2021,Wigan 027A,E01006282,1753,364,1389
2021,Wigan 027B,E01006283,1470,294,1176
2021,Wigan 027C,E01006284,1489,319,1170
2021,Wigan 019E,E01006285,1833,258,1575
2021,Wigan 016E,E01006286,1490,189,1301
2021,Wigan 017D,E01006287,1105,157,948
2021,Wigan 025A,E01006288,1695,401,1294
2021,Wigan 017E,E01006289,1573,303,1270
2021,Wigan 022A,E01006290,1332,209,1123
2021,Wigan 022B,E01006291,1381,230,1151
2021,Wigan 022C,E01006292,1453,207,1246
2021,Wigan 022D,E01006293,1530,267,1263
2021,Wigan 025B,E01006294,1820,327,1493
2021,Wigan 025C,E01006295,1497,217,1280
2021,Wigan 037A,E01006296,1410,271,1139
2021,Wigan 034D,E01006297,1483,316,1167
2021,Wigan 037B,E01006298,1352,274,1078
2021,Wigan 037C,E01006299,1855,334,1521
2021,Wigan 037D,E01006300,1308,183,1125
2021,Wigan 037E,E01006301,1422,253,1169
2021,Wigan 040A,E01006302,1755,335,1420
2021,Wigan 040B,E01006303,1535,236,1299
2021,Wigan 040C,E01006304,1450,258,1192
2021,Wigan 012A,E01006305,1612,394,1218
2021,Wigan 009A,E01006306,1408,191,1217
2021,Wigan 009B,E01006307,1305,230,1075
2021,Wigan 012B,E01006308,1517,275,1242
2021,Wigan 012C,E01006309,1559,369,1190
2021,Wigan 012D,E01006310,1505,341,1164
2021,Wigan 012E,E01006311,1432,303,1129
2021,Wigan 003B,E01006312,1327,201,1126
2021,Wigan 003C,E01006313,1344,294,1050
2021,Wigan 003D,E01006314,1660,231,1429
2021,Wigan 001A,E01006315,1408,204,1204
2021,Wigan 001B,E01006316,1870,312,1558
2021,Wigan 001C,E01006317,1489,212,1277
2021,Wigan 003E,E01006318,1371,203,1168
2021,Wigan 001D,E01006319,1475,326,1149
2021,Wigan 003F,E01006320,1221,177,1044
2021,Wigan 003G,E01006321,1519,266,1253
2021,Wigan 026D,E01006322,1920,396,1524
2021,Wigan 033A,E01006323,1437,267,1170
2021,Wigan 033B,E01006324,1242,187,1055
2021,Wigan 033C,E01006325,1434,244,1190
2021,Wigan 033D,E01006326,1333,189,1144
2021,Wigan 033E,E01006327,2320,455,1865
2021,Wigan 030A,E01006328,1421,259,1162
2021,Wigan 026E,E01006329,1557,188,1369
2021,Wigan 031C,E01006330,1497,224,1273
2021,Wigan 031D,E01006331,1467,227,1240
2021,Wigan 031E,E01006332,1934,254,1680
2021,Wigan 030B,E01006333,1964,357,1607
2021,Wigan 030C,E01006334,1929,366,1563
2021,Wigan 034E,E01006335,1485,223,1262
2021,Wigan 027D,E01006336,1552,391,1161
2021,Wigan 027E,E01006337,1429,242,1187
2021,Wigan 030D,E01006338,1544,277,1267
2021,Wigan 039A,E01006339,1228,166,1062
2021,Wigan 039B,E01006340,1785,308,1477
2021,Wigan 040D,E01006341,1562,309,1253
2021,Wigan 038C,E01006342,1471,283,1188
2021,Wigan 039C,E01006343,1543,283,1260
2021,Wigan 038D,E01006344,1372,293,1079
2021,Wigan 039D,E01006345,1496,246,1250
2021,Wigan 038E,E01006346,1955,358,1597
2021,Wigan 040E,E01006347,1471,264,1207
2021,Wigan 039E,E01006348,2482,441,2041
2021,Wigan 015A,E01006349,1908,273,1635
2021,Wigan 010A,E01006350,1719,415,1304
2021,Wigan 010B,E01006351,1826,409,1417
2021,Wigan 015B,E01006352,1891,348,1543
2021,Wigan 014A,E01006353,1392,196,1196
2021,Wigan 014B,E01006354,1370,257,1113
2021,Wigan 014C,E01006355,1393,202,1191
2021,Wigan 011A,E01006356,1348,275,1073
2021,Wigan 010C,E01006357,1688,519,1169
2021,Wigan 014D,E01006358,2001,384,1617
2021,Wigan 014E,E01006359,1314,267,1047
2021,Wigan 010D,E01006360,1553,367,1186
2021,Wigan 010E,E01006361,1544,419,1125
2021,Wigan 018A,E01006362,1567,267,1300
2021,Wigan 018B,E01006363,1470,178,1292
2021,Wigan 018C,E01006364,1747,359,1388
2021,Wigan 018D,E01006365,2157,492,1665
2021,Wigan 018E,E01006366,1741,250,1491
2021,Wigan 018F,E01006367,1693,317,1376
2021,Wigan 018G,E01006368,1790,310,1480
2021,Wigan 008C,E01006369,1874,325,1549
2021,Wigan 006A,E01006370,1792,298,1494
2021,Wigan 008D,E01006371,1398,234,1164
2021,Wigan 006B,E01006372,1550,232,1318
2021,Wigan 006C,E01006373,1378,216,1162
2021,Wigan 006D,E01006374,1398,213,1185
2021,Wigan 008E,E01006375,1606,288,1318
2021,Wigan 028A,E01006376,1658,413,1245
2021,Wigan 025D,E01006377,1492,226,1266
2021,Wigan 025E,E01006378,1248,166,1082
2021,Wigan 029C,E01006379,1495,258,1237
2021,Wigan 029D,E01006380,2508,463,2045
2021,Wigan 028B,E01006381,1927,447,1480
2021,Wigan 028C,E01006382,1197,205,992
2021,Wigan 028D,E01006383,1518,316,1202
2021,Wigan 028E,E01006384,1257,192,1065
2021,Wigan 029E,E01006385,1397,237,1160
2021,Wigan 009C,E01006386,1527,202,1325
2021,Wigan 009D,E01006387,1236,235,1001
2021,Wigan 007B,E01006388,1712,280,1432
2021,Wigan 007C,E01006389,1241,251,990
2021,Wigan 006E,E01006390,1512,233,1279
2021,Wigan 007D,E01006391,1487,241,1246
2021,Wigan 009E,E01006392,1366,348,1018
2021,Wigan 021A,E01006393,1322,189,1133
2021,Wigan 021B,E01006394,1477,251,1226
2021,Wigan 021C,E01006395,2500,599,1901
2021,Wigan 011B,E01006396,1419,253,1166
2021,Wigan 011C,E01006397,1034,170,864
2021,Wigan 011D,E01006398,955,158,797
2021,Wigan 011E,E01006399,1507,284,1223
2021,Wigan 021D,E01006400,1843,417,1426
2021,Wigan 021E,E01006401,1290,221,1069
2021,Wigan 021F,E01006402,1083,156,927
2021,Wigan 021G,E01006403,1566,238,1328
2021,Wigan 015C,E01006404,1661,354,1307
2021,Wigan 015D,E01006405,1633,278,1355
2021,Wigan 020A,E01006406,1326,170,1156
2021,Wigan 020B,E01006407,1391,226,1165
2021,Wigan 020C,E01006408,1623,361,1262
2021,Wigan 020D,E01006409,1257,158,1099
2021,Wigan 020E,E01006410,1235,187,1048
2021,Wigan 015E,E01006411,1351,328,1023
2021,Knowsley 006A,E01006412,1481,367,1114
2021,Knowsley 006B,E01006413,1330,195,1135
2021,Knowsley 006C,E01006414,1277,278,999
2021,Knowsley 003A,E01006415,1857,378,1479
2021,Knowsley 005A,E01006416,1405,288,1117
2021,Knowsley 003B,E01006417,1159,208,951
2021,Knowsley 005B,E01006418,1243,248,995
2021,Knowsley 019A,E01006419,1325,207,1118
2021,Knowsley 017A,E01006420,2276,470,1806
2021,Knowsley 018A,E01006421,1068,187,881
2021,Knowsley 019B,E01006422,1195,172,1023
2021,Knowsley 019C,E01006423,1246,205,1041
2021,Knowsley 017B,E01006424,1853,262,1591
2021,Knowsley 018B,E01006425,1217,212,1005
2021,Knowsley 020A,E01006426,1281,233,1048
2021,Knowsley 019D,E01006427,1358,212,1146
2021,Knowsley 020B,E01006428,1457,351,1106
2021,Knowsley 020C,E01006429,1051,213,838
2021,Knowsley 018C,E01006430,1442,239,1203
2021,Knowsley 020D,E01006431,1725,293,1432
2021,Knowsley 020E,E01006432,1472,302,1170
2021,Knowsley 018D,E01006433,1490,236,1254
2021,Knowsley 005C,E01006434,1446,322,1124
2021,Knowsley 005D,E01006435,1421,280,1141
2021,Knowsley 003C,E01006436,1368,275,1093
2021,Knowsley 003D,E01006437,1287,245,1042
2021,Knowsley 005E,E01006438,1106,166,940
2021,Knowsley 005F,E01006439,1557,271,1286
2021,Knowsley 010A,E01006440,1294,282,1012
2021,Knowsley 010B,E01006442,1353,238,1115
2021,Knowsley 010C,E01006443,1351,252,1099
2021,Knowsley 010D,E01006444,1267,309,958
2021,Knowsley 010E,E01006445,1173,254,919
2021,Knowsley 005G,E01006446,1355,287,1068
2021,Knowsley 003E,E01006447,1316,216,1100
2021,Knowsley 001A,E01006448,1978,527,1451
2021,Knowsley 012A,E01006449,1504,281,1223
2021,Knowsley 012B,E01006450,1572,283,1289
2021,Knowsley 012C,E01006451,1333,262,1071
2021,Knowsley 012D,E01006452,1308,244,1064
2021,Knowsley 008A,E01006453,1099,253,846
2021,Knowsley 002A,E01006454,1438,191,1247
2021,Knowsley 004A,E01006455,1610,333,1277
2021,Knowsley 002B,E01006456,1447,194,1253
2021,Knowsley 002C,E01006457,1189,132,1057
2021,Knowsley 002D,E01006458,1436,266,1170
2021,Knowsley 009A,E01006459,1544,262,1282
2021,Knowsley 007A,E01006460,1409,322,1087
2021,Knowsley 007B,E01006461,1349,318,1031
2021,Knowsley 009B,E01006462,1588,294,1294
2021,Knowsley 007D,E01006464,2472,353,2119
2021,Knowsley 011A,E01006465,1512,276,1236
2021,Knowsley 007E,E01006466,1419,208,1211
2021,Knowsley 008B,E01006467,1202,271,931
2021,Knowsley 008E,E01006470,1338,268,1070
2021,Knowsley 016A,E01006471,1388,222,1166
2021,Knowsley 014A,E01006472,1430,242,1188
2021,Knowsley 016B,E01006473,1507,252,1255
2021,Knowsley 016C,E01006474,1811,279,1532
2021,Knowsley 016D,E01006475,1396,167,1229
2021,Knowsley 016E,E01006476,1344,185,1159
2021,Knowsley 015A,E01006477,1363,262,1101
2021,Knowsley 015B,E01006478,1710,335,1375
2021,Knowsley 015C,E01006479,1349,277,1072
2021,Knowsley 015D,E01006480,1314,264,1050
2021,Knowsley 015E,E01006481,1297,216,1081
2021,Knowsley 011B,E01006482,1420,305,1115
2021,Knowsley 011C,E01006483,1371,271,1100
2021,Knowsley 011D,E01006484,1219,222,997
2021,Knowsley 014B,E01006485,1702,324,1378
2021,Knowsley 014C,E01006486,1075,166,909
2021,Knowsley 014D,E01006487,1363,217,1146
2021,Knowsley 014E,E01006488,2297,428,1869
2021,Knowsley 014F,E01006489,1247,180,1067
2021,Knowsley 002E,E01006490,2473,559,1914
2021,Knowsley 002F,E01006491,1890,419,1471
2021,Knowsley 001B,E01006492,1224,220,1004
2021,Knowsley 001C,E01006493,1663,410,1253
2021,Knowsley 001D,E01006494,1620,451,1169
2021,Knowsley 001E,E01006495,2148,537,1611
2021,Knowsley 009C,E01006496,1337,238,1099
2021,Knowsley 013A,E01006497,1050,180,870
2021,Knowsley 009D,E01006498,1522,282,1240
2021,Knowsley 009E,E01006499,1792,328,1464
2021,Knowsley 013B,E01006500,999,184,815
2021,Knowsley 013C,E01006501,1302,317,985
2021,Knowsley 017C,E01006502,1570,219,1351
2021,Knowsley 017D,E01006503,1186,174,1012
2021,Knowsley 013D,E01006504,1095,256,839
2021,Knowsley 013E,E01006505,1576,356,1220
2021,Knowsley 004B,E01006506,1222,215,1007
2021,Knowsley 004C,E01006507,1447,308,1139
2021,Knowsley 004D,E01006508,1304,244,1060
2021,Knowsley 004E,E01006509,1646,340,1306
2021,Knowsley 004F,E01006510,1255,218,1037
2021,Liverpool 031A,E01006512,2224,1600,624
2021,Liverpool 037A,E01006514,2518,1506,1012
2021,Liverpool 044A,E01006518,1741,363,1378
2021,Liverpool 056A,E01006519,1260,244,1016
2021,Liverpool 043A,E01006520,1518,153,1365
2021,Liverpool 052A,E01006521,1509,163,1346
2021,Liverpool 048A,E01006522,1665,185,1480
2021,Liverpool 052B,E01006523,1417,206,1211
2021,Liverpool 048B,E01006524,1244,187,1057
2021,Liverpool 049A,E01006525,1120,215,905
2021,Liverpool 048C,E01006526,1298,178,1120
2021,Liverpool 053A,E01006527,1312,193,1119
2021,Liverpool 052C,E01006528,1287,259,1028
2021,Liverpool 048D,E01006529,1271,252,1019
2021,Liverpool 055A,E01006530,1325,221,1104
2021,Liverpool 055B,E01006531,1357,196,1161
2021,Liverpool 047A,E01006532,1481,255,1226
2021,Liverpool 055C,E01006533,1284,230,1054
2021,Liverpool 054A,E01006534,1756,358,1398
2021,Liverpool 054B,E01006535,1563,244,1319
2021,Liverpool 054C,E01006536,1709,284,1425
2021,Liverpool 055D,E01006537,2345,443,1902
2021,Liverpool 055E,E01006538,1203,195,1008
2021,Liverpool 047B,E01006539,1323,224,1099
2021,Liverpool 024A,E01006540,1632,363,1269
2021,Liverpool 015A,E01006541,1394,210,1184
2021,Liverpool 018A,E01006542,1457,296,1161
2021,Liverpool 015B,E01006543,1083,135,948
2021,Liverpool 015C,E01006544,1518,344,1174
2021,Liverpool 019A,E01006545,1280,275,1005
2021,Liverpool 019B,E01006546,1253,237,1016
2021,Liverpool 019C,E01006547,1540,378,1162
2021,Liverpool 019D,E01006548,1654,338,1316
2021,Liverpool 043B,E01006549,1403,331,1072
2021,Liverpool 038A,E01006550,1753,1151,602
2021,Liverpool 048E,E01006551,1206,137,1069
2021,Liverpool 039A,E01006552,1689,545,1144
2021,Liverpool 042A,E01006553,1410,549,861
2021,Liverpool 048F,E01006554,1646,759,887
2021,Liverpool 039B,E01006556,1918,740,1178
2021,Liverpool 038B,E01006557,1850,1178,672
2021,Liverpool 018B,E01006558,1187,251,936
2021,Liverpool 023A,E01006560,1775,342,1433
2021,Liverpool 018E,E01006562,1372,294,1078
2021,Liverpool 024B,E01006563,1628,409,1219
2021,Liverpool 023B,E01006564,1538,252,1286
2021,Liverpool 029A,E01006565,1439,282,1157
2021,Liverpool 032A,E01006566,1316,217,1099
2021,Liverpool 026A,E01006567,1607,276,1331
2021,Liverpool 026B,E01006568,1462,246,1216
2021,Liverpool 029B,E01006569,1343,274,1069
2021,Liverpool 026C,E01006570,1355,235,1120
2021,Liverpool 026D,E01006571,1334,236,1098
2021,Liverpool 025A,E01006572,1178,301,877
2021,Liverpool 029C,E01006573,1385,295,1090
2021,Liverpool 025B,E01006574,1438,246,1192
2021,Liverpool 034A,E01006575,1213,232,981
2021,Liverpool 034B,E01006576,1639,298,1341
2021,Liverpool 034C,E01006577,1432,272,1160
2021,Liverpool 036A,E01006578,1248,212,1036
2021,Liverpool 034D,E01006579,1491,283,1208
2021,Liverpool 036B,E01006580,1228,259,969
2021,Liverpool 036C,E01006581,1464,284,1180
2021,Liverpool 041A,E01006582,1635,394,1241
2021,Liverpool 047C,E01006583,1568,639,929
2021,Liverpool 034E,E01006584,1340,208,1132
2021,Liverpool 032B,E01006585,1279,251,1028
2021,Liverpool 032C,E01006586,1643,279,1364
2021,Liverpool 032D,E01006587,1453,252,1201
2021,Liverpool 042C,E01006588,1480,318,1162
2021,Liverpool 041B,E01006589,1393,251,1142
2021,Liverpool 042D,E01006590,1499,350,1149
2021,Liverpool 041C,E01006591,1409,318,1091
2021,Liverpool 041D,E01006592,1467,330,1137
2021,Liverpool 042E,E01006593,1351,313,1038
2021,Liverpool 047D,E01006594,1271,215,1056
2021,Liverpool 049B,E01006595,1639,269,1370
2021,Liverpool 049C,E01006596,1342,252,1090
2021,Liverpool 041E,E01006597,1606,319,1287
2021,Liverpool 010A,E01006598,1554,443,1111
2021,Liverpool 010B,E01006599,1671,480,1191
2021,Liverpool 011A,E01006600,1364,283,1081
2021,Liverpool 011B,E01006603,1376,242,1134
2021,Liverpool 016A,E01006604,1467,323,1144
2021,Liverpool 016B,E01006605,1538,351,1187
2021,Liverpool 020A,E01006606,1434,252,1182
2021,Liverpool 008A,E01006607,1455,298,1157
2021,Liverpool 009A,E01006608,1070,193,877
2021,Liverpool 009B,E01006609,1133,230,903
2021,Liverpool 009C,E01006610,1369,280,1089
2021,Liverpool 012A,E01006611,1225,250,975
2021,Liverpool 008B,E01006612,1354,260,1094
2021,Liverpool 009D,E01006613,1215,212,1003
2021,Liverpool 012B,E01006614,1036,167,869
2021,Liverpool 012C,E01006615,1324,265,1059
2021,Liverpool 015D,E01006616,1239,192,1047
2021,Liverpool 021A,E01006617,1423,216,1207
2021,Liverpool 016C,E01006618,1530,303,1227
2021,Liverpool 021B,E01006619,1653,280,1373
2021,Liverpool 021C,E01006620,1344,233,1111
2021,Liverpool 021D,E01006621,1553,289,1264
2021,Liverpool 021E,E01006622,1454,286,1168
2021,Liverpool 013A,E01006623,1270,194,1076
2021,Liverpool 013B,E01006624,1467,269,1198
2021,Liverpool 016D,E01006625,1308,199,1109
2021,Liverpool 016E,E01006626,1356,225,1131
2021,Liverpool 013C,E01006627,1299,238,1061
2021,Liverpool 052D,E01006628,1693,549,1144
2021,Liverpool 052E,E01006629,1240,176,1064
2021,Liverpool 044B,E01006630,2027,431,1596
2021,Liverpool 044C,E01006632,1665,350,1315
2021,Liverpool 050B,E01006633,1307,252,1055
2021,Liverpool 017A,E01006637,1404,359,1045
2021,Liverpool 017B,E01006638,1193,293,900
2021,Liverpool 017C,E01006639,1502,336,1166
2021,Liverpool 021F,E01006640,1809,405,1404
2021,Liverpool 025C,E01006641,1571,356,1215
2021,Liverpool 025D,E01006642,1291,317,974
2021,Liverpool 025E,E01006643,1655,423,1232
2021,Liverpool 017D,E01006644,1850,347,1503
2021,Liverpool 017E,E01006645,1421,320,1101
2021,Liverpool 023C,E01006646,2048,572,1476
2021,Liverpool 024C,E01006647,1968,564,1404
2021,Liverpool 023D,E01006648,2270,646,1624
2021,Liverpool 001A,E01006651,1534,310,1224
2021,Liverpool 002A,E01006652,1367,243,1124
2021,Liverpool 001B,E01006653,1699,345,1354
2021,Liverpool 005A,E01006654,1308,227,1081
2021,Liverpool 001C,E01006655,1723,361,1362
2021,Liverpool 002B,E01006656,1327,248,1079
2021,Liverpool 002C,E01006657,1088,200,888
2021,Liverpool 001D,E01006658,1264,242,1022
2021,Liverpool 005B,E01006659,1758,213,1545
2021,Liverpool 001E,E01006660,1314,230,1084
2021,Liverpool 004A,E01006661,1553,325,1228
2021,Liverpool 004B,E01006662,1811,353,1458
2021,Liverpool 004C,E01006663,1034,208,826
2021,Liverpool 004D,E01006664,1796,439,1357
2021,Liverpool 007A,E01006665,1400,245,1155
2021,Liverpool 007B,E01006666,1300,263,1037
2021,Liverpool 007C,E01006667,1364,263,1101
2021,Liverpool 007D,E01006668,1406,318,1088
2021,Liverpool 004E,E01006669,1395,307,1088
2021,Liverpool 007E,E01006670,1398,226,1172
2021,Liverpool 013D,E01006671,1230,219,1011
2021,Liverpool 010E,E01006672,1734,415,1319
2021,Liverpool 037D,E01006673,2082,700,1382
2021,Liverpool 039C,E01006674,2213,709,1504
2021,Liverpool 043C,E01006675,1909,309,1600
2021,Liverpool 044D,E01006676,1789,551,1238
2021,Liverpool 043D,E01006677,1408,351,1057
2021,Liverpool 044E,E01006678,1848,439,1409
2021,Liverpool 039D,E01006679,2544,921,1623
2021,Liverpool 053B,E01006680,1418,268,1150
2021,Liverpool 054D,E01006681,1434,247,1187
2021,Liverpool 053C,E01006682,1189,219,970
2021,Liverpool 053D,E01006683,1423,302,1121
2021,Liverpool 056B,E01006684,2095,348,1747
2021,Liverpool 056C,E01006685,1413,260,1153
2021,Liverpool 053E,E01006686,1270,219,1051
2021,Liverpool 056D,E01006687,2313,521,1792
2021,Liverpool 056E,E01006688,1498,288,1210
2021,Liverpool 049D,E01006689,1495,295,1200
2021,Liverpool 028A,E01006690,1697,517,1180
2021,Liverpool 030A,E01006691,1690,750,940
2021,Liverpool 028B,E01006692,2341,544,1797
2021,Liverpool 024D,E01006693,1424,237,1187
2021,Liverpool 030B,E01006694,1836,626,1210
2021,Liverpool 028C,E01006695,1714,383,1331
2021,Liverpool 030C,E01006696,1865,589,1276
2021,Liverpool 030D,E01006697,1794,706,1088
2021,Liverpool 012D,E01006698,1465,324,1141
2021,Liverpool 014A,E01006699,1585,360,1225
2021,Liverpool 012E,E01006700,1478,327,1151
2021,Liverpool 014B,E01006701,1494,283,1211
2021,Liverpool 014C,E01006702,1539,311,1228
2021,Liverpool 014D,E01006703,1558,343,1215
2021,Liverpool 009E,E01006705,1184,225,959
2021,Liverpool 045A,E01006706,1235,257,978
2021,Liverpool 045B,E01006707,1317,290,1027
2021,Liverpool 045C,E01006708,1745,386,1359
2021,Liverpool 040A,E01006709,1412,302,1110
2021,Liverpool 045D,E01006710,1317,243,1074
2021,Liverpool 027A,E01006711,1470,317,1153
2021,Liverpool 029D,E01006712,1141,210,931
2021,Liverpool 029E,E01006713,1225,244,981
2021,Liverpool 032E,E01006716,1300,227,1073
2021,Liverpool 027D,E01006717,1331,239,1092
2021,Liverpool 027E,E01006718,1478,304,1174
2021,Liverpool 027F,E01006719,1310,264,1046
2021,Liverpool 038C,E01006721,1474,404,1070
2021,Liverpool 038D,E01006722,1948,1272,676
2021,Liverpool 038E,E01006723,1907,1085,822
2021,Liverpool 038F,E01006724,1528,865,663
2021,Liverpool 035B,E01006725,1394,271,1123
2021,Liverpool 035C,E01006726,1635,759,876
2021,Liverpool 035D,E01006727,1181,237,944
2021,Liverpool 035E,E01006728,1457,418,1039
2021,Liverpool 008C,E01006729,1351,380,971
2021,Liverpool 011C,E01006730,1312,301,1011
2021,Liverpool 011D,E01006731,1145,277,868
2021,Liverpool 011E,E01006732,1597,542,1055
2021,Liverpool 005C,E01006734,1304,302,1002
2021,Liverpool 005D,E01006735,1347,310,1037
2021,Liverpool 005E,E01006736,1413,354,1059
2021,Liverpool 005F,E01006737,1319,282,1037
2021,Liverpool 058A,E01006738,1314,288,1026
2021,Liverpool 058B,E01006739,2364,603,1761
2021,Liverpool 057A,E01006740,1465,344,1121
2021,Liverpool 058C,E01006741,1769,310,1459
2021,Liverpool 057B,E01006742,1511,332,1179
2021,Liverpool 058D,E01006743,1890,332,1558
2021,Liverpool 057C,E01006744,1376,237,1139
2021,Liverpool 057D,E01006745,1667,314,1353
2021,Liverpool 030E,E01006746,1584,645,939
2021,Liverpool 031B,E01006747,2697,1792,905
2021,Liverpool 031C,E01006748,2154,1483,671
2021,Liverpool 031F,E01006751,2627,1532,1095
2021,Liverpool 059A,E01006753,1719,391,1328
2021,Liverpool 059B,E01006754,1636,366,1270
2021,Liverpool 059C,E01006755,1469,337,1132
2021,Liverpool 059D,E01006756,1610,386,1224
2021,Liverpool 059E,E01006757,1347,333,1014
2021,Liverpool 059F,E01006758,1355,290,1065
2021,Liverpool 028D,E01006759,989,204,785
2021,Liverpool 028E,E01006760,1371,225,1146
2021,Liverpool 020B,E01006761,1372,240,1132
2021,Liverpool 015E,E01006762,1631,374,1257
2021,Liverpool 020C,E01006763,1336,289,1047
2021,Liverpool 020D,E01006764,1440,294,1146
2021,Liverpool 020E,E01006765,1413,257,1156
2021,Liverpool 019E,E01006766,1178,239,939
2021,Liverpool 019F,E01006767,1709,402,1307
2021,Liverpool 020F,E01006768,1273,227,1046
2021,Liverpool 040B,E01006769,1279,221,1058
2021,Liverpool 040C,E01006770,1075,217,858
2021,Liverpool 040D,E01006771,1519,237,1282
2021,Liverpool 040E,E01006772,1057,166,891
2021,Liverpool 036D,E01006773,1226,196,1030
2021,Liverpool 036E,E01006774,1333,250,1083
2021,Liverpool 040F,E01006775,1402,251,1151
2021,Liverpool 022B,E01006776,1762,285,1477
2021,Liverpool 014E,E01006778,2044,411,1633
2021,Liverpool 022D,E01006779,1920,430,1490
2021,Liverpool 002D,E01006780,1290,238,1052
2021,Liverpool 003A,E01006781,1281,198,1083
2021,Liverpool 003B,E01006782,1394,277,1117
2021,Liverpool 002E,E01006783,1264,231,1033
2021,Liverpool 003C,E01006784,1165,206,959
2021,Liverpool 003D,E01006785,1626,310,1316
2021,Liverpool 003E,E01006786,2245,312,1933
2021,Liverpool 006A,E01006787,1254,273,981
2021,Liverpool 006B,E01006788,1579,330,1249
2021,Liverpool 006C,E01006790,1671,353,1318
2021,Liverpool 006D,E01006791,1536,274,1262
2021,Liverpool 046A,E01006792,1303,243,1060
2021,Liverpool 051A,E01006793,1303,194,1109
2021,Liverpool 046B,E01006794,1524,238,1286
2021,Liverpool 051B,E01006795,1365,204,1161
2021,Liverpool 047E,E01006796,1539,314,1225
2021,Liverpool 051C,E01006797,1287,236,1051
2021,Liverpool 051D,E01006798,1238,167,1071
2021,Liverpool 051E,E01006799,1632,144,1488
2021,Liverpool 046C,E01006800,1378,188,1190
2021,Liverpool 046D,E01006801,1777,278,1499
2021,St. Helens 002A,E01006802,1544,228,1316
2021,St. Helens 003A,E01006803,1352,179,1173
2021,St. Helens 002B,E01006804,1469,204,1265
2021,St. Helens 003B,E01006805,1455,308,1147
2021,St. Helens 002C,E01006806,1373,202,1171
2021,St. Helens 002D,E01006807,1271,174,1097
2021,St. Helens 003C,E01006808,1134,137,997
2021,St. Helens 003D,E01006809,1287,169,1118
2021,St. Helens 008A,E01006810,1119,149,970
2021,St. Helens 008B,E01006811,1263,168,1095
2021,St. Helens 008C,E01006812,1362,319,1043
2021,St. Helens 008D,E01006813,1367,241,1126
2021,St. Helens 008E,E01006814,1372,190,1182
2021,St. Helens 008F,E01006815,1188,207,981
2021,St. Helens 017A,E01006816,1628,384,1244
2021,St. Helens 017B,E01006817,1353,298,1055
2021,St. Helens 008G,E01006818,1175,169,1006
2021,St. Helens 011A,E01006819,1639,329,1310
2021,St. Helens 011B,E01006820,1364,307,1057
2021,St. Helens 011C,E01006821,1387,288,1099
2021,St. Helens 009A,E01006822,1441,270,1171
2021,St. Helens 009B,E01006823,1260,195,1065
2021,St. Helens 009C,E01006824,1183,220,963
2021,St. Helens 009D,E01006825,1420,241,1179
2021,St. Helens 018A,E01006826,1143,184,959
2021,St. Helens 018B,E01006827,1484,264,1220
2021,St. Helens 018C,E01006828,2031,305,1726
2021,St. Helens 018D,E01006829,1621,258,1363
2021,St. Helens 025A,E01006830,1498,374,1124
2021,St. Helens 016A,E01006831,1288,197,1091
2021,St. Helens 012A,E01006832,1605,302,1303
2021,St. Helens 016B,E01006833,1951,330,1621
2021,St. Helens 012B,E01006834,1193,167,1026
2021,St. Helens 016C,E01006835,1273,177,1096
2021,St. Helens 005A,E01006836,1355,246,1109
2021,St. Helens 006A,E01006837,1488,249,1239
2021,St. Helens 006B,E01006838,1367,202,1165
2021,St. Helens 005B,E01006839,1207,186,1021
2021,St. Helens 005C,E01006840,1364,203,1161
2021,St. Helens 006C,E01006841,1515,242,1273
2021,St. Helens 005D,E01006842,1529,354,1175
2021,St. Helens 006D,E01006843,1155,174,981
2021,St. Helens 020A,E01006844,1501,236,1265
2021,St. Helens 014A,E01006845,1658,250,1408
2021,St. Helens 020B,E01006846,1367,205,1162
2021,St. Helens 020C,E01006847,1853,493,1360
2021,St. Helens 020D,E01006848,1234,157,1077
2021,St. Helens 004A,E01006849,1391,299,1092
2021,St. Helens 004B,E01006850,1510,267,1243
2021,St. Helens 004C,E01006851,1275,176,1099
2021,St. Helens 004D,E01006852,1200,169,1031
2021,St. Helens 004E,E01006853,1600,245,1355
2021,St. Helens 004F,E01006854,1345,240,1105
2021,St. Helens 004G,E01006855,1425,263,1162
2021,St. Helens 015A,E01006856,1434,252,1182
2021,St. Helens 015B,E01006857,1351,185,1166
2021,St. Helens 015C,E01006858,1419,286,1133
2021,St. Helens 015D,E01006859,1634,271,1363
2021,St. Helens 015E,E01006860,1451,273,1178
2021,St. Helens 015F,E01006861,1786,485,1301
2021,St. Helens 015G,E01006862,2027,293,1734
2021,St. Helens 013A,E01006863,1561,224,1337
2021,St. Helens 013B,E01006864,1815,270,1545
2021,St. Helens 010A,E01006866,1642,410,1232
2021,St. Helens 010B,E01006867,1995,424,1571
2021,St. Helens 010C,E01006868,1425,317,1108
2021,St. Helens 010D,E01006869,1501,247,1254
2021,St. Helens 014B,E01006870,1330,223,1107
2021,St. Helens 011D,E01006871,1591,295,1296
2021,St. Helens 014C,E01006872,1512,191,1321
2021,St. Helens 014D,E01006873,1379,308,1071
2021,St. Helens 014E,E01006874,1247,262,985
2021,St. Helens 017C,E01006875,1230,243,987
2021,St. Helens 016D,E01006876,1317,209,1108
2021,St. Helens 012C,E01006877,1507,194,1313
2021,St. Helens 016E,E01006878,1237,167,1070
2021,St. Helens 016F,E01006879,1367,261,1106
2021,St. Helens 012D,E01006880,1292,209,1083
2021,St. Helens 012E,E01006881,1363,229,1134
2021,St. Helens 001A,E01006882,1149,191,958
2021,St. Helens 001B,E01006883,1333,210,1123
2021,St. Helens 001C,E01006884,1336,211,1125
2021,St. Helens 001D,E01006885,1258,181,1077
2021,St. Helens 001E,E01006886,1206,166,1040
2021,St. Helens 001F,E01006887,1293,215,1078
2021,St. Helens 023A,E01006888,1149,184,965
2021,St. Helens 023B,E01006889,1337,232,1105
2021,St. Helens 021A,E01006890,1336,224,1112
2021,St. Helens 023C,E01006891,1513,250,1263
2021,St. Helens 021B,E01006892,1302,219,1083
2021,St. Helens 021C,E01006893,1256,211,1045
2021,St. Helens 021D,E01006894,1295,188,1107
2021,St. Helens 023D,E01006895,1362,161,1201
2021,St. Helens 020E,E01006896,1392,173,1219
2021,St. Helens 020F,E01006897,1412,192,1220
2021,St. Helens 022A,E01006898,1659,274,1385
2021,St. Helens 017D,E01006899,2031,388,1643
2021,St. Helens 020G,E01006901,1387,199,1188
2021,St. Helens 024A,E01006903,1376,216,1160
2021,St. Helens 016G,E01006904,1551,293,1258
2021,St. Helens 024B,E01006905,1256,229,1027
2021,St. Helens 025B,E01006906,1439,233,1206
2021,St. Helens 024C,E01006907,1472,236,1236
2021,St. Helens 022C,E01006908,1240,252,988
2021,St. Helens 022D,E01006909,1210,344,866
2021,St. Helens 022E,E01006910,1769,351,1418
2021,St. Helens 022F,E01006911,1414,206,1208
2021,St. Helens 024E,E01006912,1592,372,1220
2021,St. Helens 024D,E01006913,1342,296,1046
2021,St. Helens 007A,E01006914,1236,222,1014
2021,St. Helens 007B,E01006915,1415,240,1175
2021,St. Helens 007C,E01006916,1449,267,1182
2021,St. Helens 007D,E01006917,1627,303,1324
2021,St. Helens 007E,E01006918,1218,227,991
2021,St. Helens 007F,E01006919,1646,382,1264
2021,Sefton 011A,E01006920,1526,253,1273
2021,Sefton 012A,E01006921,1278,168,1110
2021,Sefton 012B,E01006922,1402,229,1173
2021,Sefton 012C,E01006923,1476,192,1284
2021,Sefton 011B,E01006924,1392,316,1076
2021,Sefton 011C,E01006925,1742,412,1330
2021,Sefton 012D,E01006926,1690,275,1415
2021,Sefton 011D,E01006927,1636,264,1372
2021,Sefton 009A,E01006928,1377,232,1145
2021,Sefton 010A,E01006929,1402,299,1103
2021,Sefton 010B,E01006930,1357,277,1080
2021,Sefton 010C,E01006931,1448,261,1187
2021,Sefton 010D,E01006932,1348,224,1124
2021,Sefton 010E,E01006933,1309,280,1029
2021,Sefton 007A,E01006934,1395,239,1156
2021,Sefton 009B,E01006935,1587,322,1265
2021,Sefton 022A,E01006936,1405,130,1275
2021,Sefton 022B,E01006937,1295,304,991
2021,Sefton 022C,E01006938,1331,196,1135
2021,Sefton 022D,E01006939,1416,226,1190
2021,Sefton 022E,E01006940,1388,239,1149
2021,Sefton 028A,E01006941,1479,182,1297
2021,Sefton 028B,E01006942,1367,232,1135
2021,Sefton 022F,E01006943,1230,230,1000
2021,Sefton 003A,E01006944,1706,107,1599
2021,Sefton 004A,E01006945,1780,200,1580
2021,Sefton 001A,E01006946,1341,164,1177
2021,Sefton 002A,E01006947,1321,172,1149
2021,Sefton 003B,E01006948,1337,214,1123
2021,Sefton 003C,E01006949,1456,184,1272
2021,Sefton 004B,E01006950,1624,136,1488
2021,Sefton 003D,E01006951,1517,133,1384
2021,Sefton 032A,E01006952,1255,238,1017
2021,Sefton 032B,E01006953,1385,243,1142
2021,Sefton 028C,E01006954,1476,212,1264
2021,Sefton 030A,E01006955,1512,313,1199
2021,Sefton 030B,E01006956,1506,240,1266
2021,Sefton 032C,E01006957,1523,251,1272
2021,Sefton 030C,E01006958,1438,196,1242
2021,Sefton 032D,E01006959,1421,198,1223
2021,Sefton 038A,E01006960,1104,196,908
2021,Sefton 038B,E01006961,1487,246,1241
2021,Sefton 038C,E01006962,1327,218,1109
2021,Sefton 038D,E01006963,1595,402,1193
2021,Sefton 036A,E01006964,1526,312,1214
2021,Sefton 038E,E01006965,1424,312,1112
2021,Sefton 038F,E01006966,1541,321,1220
2021,Sefton 037A,E01006967,1665,236,1429
2021,Sefton 004D,E01006969,1411,233,1178
2021,Sefton 007B,E01006970,2087,316,1771
2021,Sefton 009C,E01006971,1546,150,1396
2021,Sefton 009D,E01006972,1501,103,1398
2021,Sefton 009E,E01006973,1531,172,1359
2021,Sefton 009F,E01006974,1470,190,1280
2021,Sefton 033A,E01006976,1318,236,1082
2021,Sefton 032E,E01006977,1973,332,1641
2021,Sefton 031A,E01006978,1253,184,1069
2021,Sefton 024A,E01006979,1240,268,972
2021,Sefton 024B,E01006980,1214,205,1009
2021,Sefton 031B,E01006981,1323,287,1036
2021,Sefton 031C,E01006982,1222,209,1013
2021,Sefton 031D,E01006983,1513,273,1240
2021,Sefton 031E,E01006984,1180,322,858
2021,Sefton 013A,E01006985,1335,218,1117
2021,Sefton 013B,E01006986,1301,208,1093
2021,Sefton 013C,E01006987,1162,179,983
2021,Sefton 014A,E01006988,1438,257,1181
2021,Sefton 013D,E01006989,1221,190,1031
2021,Sefton 013E,E01006990,1130,203,927
2021,Sefton 015A,E01006991,1404,249,1155
2021,Sefton 015B,E01006992,1203,225,978
2021,Sefton 015C,E01006993,1373,231,1142
2021,Sefton 007C,E01006994,1676,398,1278
2021,Sefton 008A,E01006995,1298,235,1063
2021,Sefton 007D,E01006996,1735,341,1394
2021,Sefton 008B,E01006997,1431,313,1118
2021,Sefton 007E,E01006998,1474,315,1159
2021,Sefton 008C,E01006999,1506,291,1215
2021,Sefton 008D,E01007000,1418,319,1099
2021,Sefton 008E,E01007001,1586,370,1216
2021,Sefton 008F,E01007002,1925,330,1595
2021,Sefton 036B,E01007003,1113,165,948
2021,Sefton 034A,E01007004,1268,249,1019
2021,Sefton 034B,E01007005,1293,237,1056
2021,Sefton 036C,E01007006,1329,319,1010
2021,Sefton 037B,E01007007,1208,216,992
2021,Sefton 037C,E01007008,1191,195,996
2021,Sefton 037D,E01007009,1705,260,1445
2021,Sefton 037E,E01007010,1480,279,1201
2021,Sefton 034C,E01007011,1400,276,1124
2021,Sefton 036D,E01007012,1271,252,1019
2021,Sefton 036E,E01007013,1339,303,1036
2021,Sefton 033B,E01007014,1421,217,1204
2021,Sefton 034D,E01007016,1691,355,1336
2021,Sefton 034E,E01007017,1445,283,1162
2021,Sefton 035A,E01007019,1341,307,1034
2021,Sefton 021A,E01007020,1298,248,1050
2021,Sefton 025A,E01007021,1192,199,993
2021,Sefton 021B,E01007022,1294,243,1051
2021,Sefton 021C,E01007023,1305,224,1081
2021,Sefton 024C,E01007024,993,146,847
2021,Sefton 025B,E01007025,1242,198,1044
2021,Sefton 024D,E01007026,1126,218,908
2021,Sefton 021D,E01007027,1944,237,1707
2021,Sefton 001B,E01007028,1345,238,1107
2021,Sefton 001C,E01007029,1130,94,1036
2021,Sefton 001D,E01007030,1456,300,1156
2021,Sefton 002B,E01007031,1319,238,1081
2021,Sefton 002C,E01007032,1310,242,1068
2021,Sefton 002D,E01007033,1298,203,1095
2021,Sefton 003E,E01007034,1237,170,1067
2021,Sefton 002E,E01007035,1348,200,1148
2021,Sefton 001E,E01007036,1127,147,980
2021,Sefton 021E,E01007037,1510,208,1302
2021,Sefton 021F,E01007038,1521,257,1264
2021,Sefton 026A,E01007039,1216,254,962
2021,Sefton 026B,E01007040,1966,360,1606
2021,Sefton 027A,E01007041,1316,208,1108
2021,Sefton 026C,E01007042,1240,256,984
2021,Sefton 027B,E01007043,1298,192,1106
2021,Sefton 026D,E01007044,1376,222,1154
2021,Sefton 026E,E01007045,1135,174,961
2021,Sefton 027C,E01007046,1674,293,1381
2021,Sefton 033E,E01007047,1474,269,1205
2021,Sefton 029A,E01007048,1560,417,1143
2021,Sefton 035B,E01007049,2040,420,1620
2021,Sefton 035C,E01007050,1179,212,967
2021,Sefton 035D,E01007051,1211,258,953
2021,Sefton 035E,E01007052,1234,271,963
2021,Sefton 027D,E01007053,1263,239,1024
2021,Sefton 029B,E01007054,1241,185,1056
2021,Sefton 005A,E01007055,1293,317,976
2021,Sefton 005B,E01007056,1537,360,1177
2021,Sefton 005C,E01007057,1391,285,1106
2021,Sefton 006A,E01007058,1425,276,1149
2021,Sefton 006B,E01007059,1482,317,1165
2021,Sefton 006C,E01007060,1414,300,1114
2021,Sefton 006D,E01007061,1399,287,1112
2021,Sefton 005D,E01007062,1357,232,1125
2021,Sefton 005E,E01007063,1431,276,1155
2021,Sefton 006E,E01007064,1263,260,1003
2021,Sefton 020A,E01007065,1208,231,977
2021,Sefton 020B,E01007066,1363,242,1121
2021,Sefton 017A,E01007067,1372,182,1190
2021,Sefton 017B,E01007068,1095,174,921
2021,Sefton 017C,E01007069,1390,233,1157
2021,Sefton 017D,E01007070,1360,211,1149
2021,Sefton 020C,E01007071,1349,201,1148
2021,Sefton 020D,E01007072,1338,162,1176
2021,Sefton 020E,E01007073,1196,215,981
2021,Sefton 019A,E01007074,1355,226,1129
2021,Sefton 016A,E01007075,1258,188,1070
2021,Sefton 016B,E01007076,1481,272,1209
2021,Sefton 016C,E01007077,1373,274,1099
2021,Sefton 015D,E01007078,1463,246,1217
2021,Sefton 014B,E01007079,1476,231,1245
2021,Sefton 014C,E01007080,1370,240,1130
2021,Sefton 014D,E01007081,1531,227,1304
2021,Sefton 016D,E01007082,1245,195,1050
2021,Sefton 023A,E01007083,1071,182,889
2021,Sefton 027E,E01007084,1193,186,1007
2021,Sefton 023B,E01007085,1255,288,967
2021,Sefton 023C,E01007086,1120,216,904
2021,Sefton 029C,E01007087,1257,216,1041
2021,Sefton 029D,E01007088,1178,154,1024
2021,Sefton 024E,E01007089,1366,260,1106
2021,Sefton 029E,E01007090,1187,262,925
2021,Sefton 023D,E01007091,1137,174,963
2021,Sefton 023E,E01007092,1063,233,830
2021,Sefton 018C,E01007095,1492,225,1267
2021,Sefton 018D,E01007096,1220,190,1030
2021,Sefton 019B,E01007097,1420,226,1194
2021,Sefton 019C,E01007098,1561,247,1314
2021,Sefton 019D,E01007099,1487,185,1302
2021,Sefton 018E,E01007100,1272,199,1073
2021,Sefton 017E,E01007101,1353,225,1128
2021,Sefton 030D,E01007102,1401,278,1123
2021,Sefton 030E,E01007103,1390,239,1151
2021,Sefton 028D,E01007104,1311,267,1044
2021,Sefton 025C,E01007105,1509,246,1263
2021,Sefton 025D,E01007106,1657,314,1343
2021,Sefton 025E,E01007107,1277,233,1044
2021,Sefton 025F,E01007108,1459,294,1165
2021,Sefton 028E,E01007109,1403,253,1150
2021,Wirral 035A,E01007110,1530,244,1286
2021,Wirral 032A,E01007111,1422,265,1157
2021,Wirral 032B,E01007112,1442,265,1177
2021,Wirral 032C,E01007113,1255,226,1029
2021,Wirral 032D,E01007114,1401,351,1050
2021,Wirral 031A,E01007115,1479,310,1169
2021,Wirral 032E,E01007116,1392,257,1135
2021,Wirral 035B,E01007117,1533,331,1202
2021,Wirral 035C,E01007118,1415,306,1109
2021,Wirral 019A,E01007119,1486,364,1122
2021,Wirral 011A,E01007120,1290,334,956
2021,Wirral 011B,E01007121,1365,315,1050
2021,Wirral 011C,E01007122,1411,321,1090
2021,Wirral 011D,E01007123,1456,338,1118
2021,Wirral 011E,E01007124,1546,441,1105
2021,Wirral 015A,E01007125,1509,313,1196
2021,Wirral 016B,E01007127,1488,365,1123
2021,Wirral 016C,E01007128,1608,303,1305
2021,Wirral 016D,E01007129,1381,256,1125
2021,Wirral 021A,E01007130,1646,452,1194
2021,Wirral 021B,E01007131,1563,375,1188
2021,Wirral 016E,E01007133,1143,173,970
2021,Wirral 039A,E01007135,1500,241,1259
2021,Wirral 039B,E01007136,1529,322,1207
2021,Wirral 039C,E01007137,1576,309,1267
2021,Wirral 031B,E01007138,1622,330,1292
2021,Wirral 031C,E01007139,1503,291,1212
2021,Wirral 031D,E01007141,1557,243,1314
2021,Wirral 036B,E01007142,1830,242,1588
2021,Wirral 036C,E01007143,1843,398,1445
2021,Wirral 038A,E01007144,1246,176,1070
2021,Wirral 038B,E01007145,1144,159,985
2021,Wirral 038C,E01007146,1379,190,1189
2021,Wirral 038D,E01007147,1341,210,1131
2021,Wirral 038E,E01007148,1589,261,1328
2021,Wirral 041A,E01007149,1408,247,1161
2021,Wirral 041B,E01007150,1278,209,1069
2021,Wirral 035D,E01007151,1458,233,1225
2021,Wirral 036D,E01007152,1526,250,1276
2021,Wirral 036E,E01007153,1422,254,1168
2021,Wirral 035E,E01007154,1423,274,1149
2021,Wirral 020A,E01007155,1645,192,1453
2021,Wirral 015B,E01007156,1468,225,1243
2021,Wirral 015C,E01007157,1425,292,1133
2021,Wirral 015D,E01007158,1462,231,1231
2021,Wirral 015E,E01007159,1872,330,1542
2021,Wirral 020B,E01007160,1555,210,1345
2021,Wirral 019B,E01007161,1471,288,1183
2021,Wirral 019C,E01007162,1352,377,975
2021,Wirral 024A,E01007163,2166,436,1730
2021,Wirral 042A,E01007164,1739,338,1401
2021,Wirral 041C,E01007165,1154,160,994
2021,Wirral 042B,E01007166,1322,199,1123
2021,Wirral 042C,E01007167,1460,312,1148
2021,Wirral 042D,E01007168,1557,334,1223
2021,Wirral 042E,E01007169,1607,303,1304
2021,Wirral 039D,E01007170,1550,239,1311
2021,Wirral 041D,E01007171,1467,284,1183
2021,Wirral 041E,E01007172,1387,228,1159
2021,Wirral 029A,E01007173,1458,325,1133
2021,Wirral 029B,E01007174,1595,288,1307
2021,Wirral 027A,E01007175,1864,382,1482
2021,Wirral 029C,E01007176,1572,344,1228
2021,Wirral 029D,E01007177,1442,287,1155
2021,Wirral 029E,E01007178,1509,275,1234
2021,Wirral 021C,E01007179,1215,236,979
2021,Wirral 022A,E01007180,1425,256,1169
2021,Wirral 022B,E01007181,1428,285,1143
2021,Wirral 037A,E01007182,1479,251,1228
2021,Wirral 034A,E01007183,1192,204,988
2021,Wirral 037B,E01007184,1400,216,1184
2021,Wirral 037C,E01007185,1519,273,1246
2021,Wirral 040A,E01007186,1425,238,1187
2021,Wirral 040B,E01007187,1402,183,1219
2021,Wirral 040C,E01007188,1425,247,1178
2021,Wirral 040D,E01007189,1510,215,1295
2021,Wirral 040E,E01007190,1466,245,1221
2021,Wirral 040F,E01007191,1298,235,1063
2021,Wirral 037D,E01007192,1289,196,1093
2021,Wirral 014A,E01007193,1604,234,1370
2021,Wirral 014B,E01007194,1434,257,1177
2021,Wirral 013A,E01007195,1515,258,1257
2021,Wirral 026A,E01007196,1527,209,1318
2021,Wirral 026B,E01007197,1575,336,1239
2021,Wirral 026C,E01007198,1523,268,1255
2021,Wirral 013B,E01007199,1447,255,1192
2021,Wirral 014C,E01007200,1554,280,1274
2021,Wirral 014D,E01007201,1406,255,1151
2021,Wirral 014E,E01007202,1314,197,1117
2021,Wirral 006A,E01007203,1843,323,1520
2021,Wirral 009A,E01007204,1587,506,1081
2021,Wirral 006B,E01007205,1541,406,1135
2021,Wirral 009B,E01007206,1749,380,1369
2021,Wirral 009C,E01007207,1323,286,1037
2021,Wirral 012A,E01007208,1598,308,1290
2021,Wirral 009D,E01007209,1351,238,1113
2021,Wirral 006C,E01007210,1853,402,1451
2021,Wirral 004A,E01007211,1107,178,929
2021,Wirral 007A,E01007212,1377,227,1150
2021,Wirral 007B,E01007213,1423,216,1207
2021,Wirral 007C,E01007214,1432,286,1146
2021,Wirral 005A,E01007215,1411,277,1134
2021,Wirral 005B,E01007216,1457,288,1169
2021,Wirral 007D,E01007217,1580,277,1303
2021,Wirral 002A,E01007218,1424,293,1131
2021,Wirral 005C,E01007219,1427,300,1127
2021,Wirral 005D,E01007220,1307,373,934
2021,Wirral 012B,E01007221,1394,230,1164
2021,Wirral 013C,E01007222,1459,232,1227
2021,Wirral 013D,E01007223,1316,236,1080
2021,Wirral 017A,E01007224,1369,229,1140
2021,Wirral 012C,E01007225,2012,314,1698
2021,Wirral 017B,E01007226,1527,198,1329
2021,Wirral 012D,E01007227,1454,293,1161
2021,Wirral 012E,E01007228,1330,246,1084
2021,Wirral 001A,E01007229,1568,279,1289
2021,Wirral 001B,E01007230,1186,200,986
2021,Wirral 001C,E01007231,1502,209,1293
2021,Wirral 002B,E01007232,1501,222,1279
2021,Wirral 002C,E01007233,1616,302,1314
2021,Wirral 002D,E01007234,1433,244,1189
2021,Wirral 004B,E01007235,1428,310,1118
2021,Wirral 002E,E01007236,1254,216,1038
2021,Wirral 001D,E01007237,1551,139,1412
2021,Wirral 001E,E01007238,1488,168,1320
2021,Wirral 022C,E01007239,1575,316,1259
2021,Wirral 020C,E01007240,1564,184,1380
2021,Wirral 020D,E01007241,1330,144,1186
2021,Wirral 020E,E01007242,1619,211,1408
2021,Wirral 022D,E01007243,1490,177,1313
2021,Wirral 022E,E01007244,2001,498,1503
2021,Wirral 024B,E01007245,1364,221,1143
2021,Wirral 024C,E01007246,1334,220,1114
2021,Wirral 024D,E01007247,1566,288,1278
2021,Wirral 030A,E01007248,1439,267,1172
2021,Wirral 025A,E01007249,1224,262,962
2021,Wirral 030B,E01007250,1312,248,1064
2021,Wirral 025B,E01007251,1038,155,883
2021,Wirral 024E,E01007252,1408,225,1183
2021,Wirral 030C,E01007253,1490,288,1202
2021,Wirral 030D,E01007254,1561,266,1295
2021,Wirral 034B,E01007255,1445,240,1205
2021,Wirral 034C,E01007256,1486,171,1315
2021,Wirral 025C,E01007257,1211,273,938
2021,Wirral 028A,E01007258,1332,244,1088
2021,Wirral 023A,E01007259,1131,201,930
2021,Wirral 028B,E01007260,1496,287,1209
2021,Wirral 023B,E01007261,1277,153,1124
2021,Wirral 028C,E01007262,1439,227,1212
2021,Wirral 026D,E01007263,1354,268,1086
2021,Wirral 023C,E01007264,1304,161,1143
2021,Wirral 017C,E01007265,1275,258,1017
2021,Wirral 023D,E01007266,1443,301,1142
2021,Wirral 023E,E01007267,1355,215,1140
2021,Wirral 023F,E01007268,1250,161,1089
2021,Wirral 010C,E01007269,1606,356,1250
2021,Wirral 010D,E01007270,1605,338,1267
2021,Wirral 010E,E01007271,1482,300,1182
2021,Wirral 008A,E01007272,1311,362,949
2021,Wirral 008B,E01007273,1194,253,941
2021,Wirral 008C,E01007274,1269,298,971
2021,Wirral 005E,E01007275,1336,299,1037
2021,Wirral 007E,E01007276,1386,307,1079
2021,Wirral 008D,E01007277,1316,294,1022
2021,Wirral 008E,E01007278,1360,359,1001
2021,Wirral 034D,E01007279,1488,275,1213
2021,Wirral 033A,E01007280,1630,302,1328
2021,Wirral 028D,E01007281,1291,239,1052
2021,Wirral 026E,E01007282,1270,228,1042
2021,Wirral 028E,E01007283,1192,195,997
2021,Wirral 033B,E01007284,1560,275,1285
2021,Wirral 033C,E01007285,1379,227,1152
2021,Wirral 034E,E01007286,1376,252,1124
2021,Wirral 033D,E01007287,1772,237,1535
2021,Wirral 037E,E01007288,1554,255,1299
2021,Wirral 031E,E01007289,1492,416,1076
2021,Wirral 027B,E01007290,1862,370,1492
2021,Wirral 021D,E01007291,1494,263,1231
2021,Wirral 021E,E01007292,1435,310,1125
2021,Wirral 027C,E01007293,1515,402,1113
2021,Wirral 021F,E01007294,1325,280,1045
2021,Wirral 027D,E01007295,1551,364,1187
2021,Wirral 027E,E01007296,1549,324,1225
2021,Wirral 018A,E01007297,1386,285,1101
2021,Wirral 018B,E01007298,1468,233,1235
2021,Wirral 017D,E01007299,1215,190,1025
2021,Wirral 019D,E01007300,2093,476,1617
2021,Wirral 018C,E01007301,1507,248,1259
2021,Wirral 018D,E01007302,1791,310,1481
2021,Wirral 025D,E01007303,1406,297,1109
2021,Wirral 025E,E01007304,1466,352,1114
2021,Wirral 018E,E01007305,1507,219,1288
2021,Wirral 017E,E01007306,1481,204,1277
2021,Wirral 003A,E01007307,1623,278,1345
2021,Wirral 003B,E01007308,1369,159,1210
2021,Wirral 006D,E01007309,1418,233,1185
2021,Wirral 004C,E01007310,1263,243,1020
2021,Wirral 004D,E01007311,1334,196,1138
2021,Wirral 003C,E01007312,1407,266,1141
2021,Wirral 003D,E01007313,1503,246,1257
2021,Wirral 004E,E01007314,1348,274,1074
2021,Wirral 003E,E01007315,1408,267,1141
2021,Wirral 004F,E01007316,1421,269,1152
2021,Barnsley 018A,E01007317,1440,308,1132
2021,Barnsley 018B,E01007318,1492,343,1149
2021,Barnsley 015A,E01007319,1360,194,1166
2021,Barnsley 018C,E01007320,1604,358,1246
2021,Barnsley 015B,E01007321,1376,151,1225
2021,Barnsley 015C,E01007322,1999,386,1613
2021,Barnsley 007A,E01007323,1430,296,1134
2021,Barnsley 007B,E01007324,1546,288,1258
2021,Barnsley 007C,E01007325,1491,416,1075
2021,Barnsley 007D,E01007326,1578,325,1253
2021,Barnsley 007E,E01007327,1599,266,1333
2021,Barnsley 006A,E01007328,1946,363,1583
2021,Barnsley 003A,E01007329,1517,275,1242
2021,Barnsley 006B,E01007330,1658,278,1380
2021,Barnsley 003B,E01007331,1722,277,1445
2021,Barnsley 006C,E01007332,2223,418,1805
2021,Barnsley 006D,E01007333,1387,308,1079
2021,Barnsley 009A,E01007334,1234,195,1039
2021,Barnsley 009B,E01007335,1346,165,1181
2021,Barnsley 013A,E01007336,1431,180,1251
2021,Barnsley 015D,E01007337,1693,244,1449
2021,Barnsley 017A,E01007338,1526,162,1364
2021,Barnsley 017B,E01007339,1372,220,1152
2021,Barnsley 013B,E01007340,1754,278,1476
2021,Barnsley 008A,E01007341,1206,288,918
2021,Barnsley 003C,E01007342,1208,183,1025
2021,Barnsley 003D,E01007343,1370,220,1150
2021,Barnsley 011A,E01007344,2444,510,1934
2021,Barnsley 008B,E01007345,1498,285,1213
2021,Barnsley 008C,E01007346,1497,305,1192
2021,Barnsley 008D,E01007347,1707,285,1422
2021,Barnsley 020A,E01007348,1414,253,1161
2021,Barnsley 020B,E01007349,1491,261,1230
2021,Barnsley 020C,E01007350,1075,128,947
2021,Barnsley 020D,E01007351,1605,268,1337
2021,Barnsley 020E,E01007352,1371,294,1077
2021,Barnsley 020F,E01007353,1587,290,1297
2021,Barnsley 020G,E01007354,1572,250,1322
2021,Barnsley 005A,E01007355,1387,257,1130
2021,Barnsley 004A,E01007356,1390,173,1217
2021,Barnsley 004B,E01007357,1338,227,1111
2021,Barnsley 005B,E01007358,1337,231,1106
2021,Barnsley 005C,E01007359,1374,226,1148
2021,Barnsley 005D,E01007360,1434,228,1206
2021,Barnsley 004C,E01007361,1796,292,1504
2021,Barnsley 004D,E01007362,1996,346,1650
2021,Barnsley 004E,E01007363,1546,232,1314
2021,Barnsley 025A,E01007364,1331,262,1069
2021,Barnsley 025B,E01007365,1132,217,915
2021,Barnsley 025C,E01007366,2130,373,1757
2021,Barnsley 025D,E01007367,1076,218,858
2021,Barnsley 025E,E01007368,1628,311,1317
2021,Barnsley 022A,E01007369,1877,374,1503
2021,Barnsley 022B,E01007370,1641,306,1335
2021,Barnsley 022C,E01007371,1787,333,1454
2021,Barnsley 014A,E01007372,1571,329,1242
2021,Barnsley 014B,E01007373,1579,348,1231
2021,Barnsley 014C,E01007374,1268,146,1122
2021,Barnsley 014D,E01007375,1651,250,1401
2021,Barnsley 022D,E01007376,1370,218,1152
2021,Barnsley 014E,E01007377,1288,272,1016
2021,Barnsley 014F,E01007378,1505,302,1203
2021,Barnsley 012A,E01007379,1410,204,1206
2021,Barnsley 012B,E01007380,1753,299,1454
2021,Barnsley 012C,E01007381,1958,323,1635
2021,Barnsley 019A,E01007382,1523,223,1300
2021,Barnsley 019B,E01007383,1251,235,1016
2021,Barnsley 019C,E01007384,1614,266,1348
2021,Barnsley 019D,E01007385,1336,203,1133
2021,Barnsley 005E,E01007386,1722,228,1494
2021,Barnsley 012D,E01007387,1330,226,1104
2021,Barnsley 029A,E01007388,1641,285,1356
2021,Barnsley 030A,E01007389,1301,120,1181
2021,Barnsley 030B,E01007390,1413,206,1207
2021,Barnsley 030C,E01007391,1450,254,1196
2021,Barnsley 030D,E01007392,1398,299,1099
2021,Barnsley 029B,E01007393,1724,259,1465
2021,Barnsley 029C,E01007394,1290,236,1054
2021,Barnsley 030E,E01007395,1958,480,1478
2021,Barnsley 028A,E01007396,1473,222,1251
2021,Barnsley 028B,E01007397,1476,212,1264
2021,Barnsley 028C,E01007398,1582,227,1355
2021,Barnsley 028D,E01007399,1892,260,1632
2021,Barnsley 009C,E01007400,2178,443,1735
2021,Barnsley 011B,E01007402,1800,429,1371
2021,Barnsley 011C,E01007403,1359,251,1108
2021,Barnsley 009D,E01007404,1272,144,1128
2021,Barnsley 011D,E01007405,1816,271,1545
2021,Barnsley 009E,E01007406,1590,274,1316
2021,Barnsley 010C,E01007408,1370,211,1159
2021,Barnsley 010D,E01007409,1416,211,1205
2021,Barnsley 010E,E01007410,1670,241,1429
2021,Barnsley 007F,E01007411,1385,367,1018
2021,Barnsley 017C,E01007413,1370,300,1070
2021,Barnsley 017D,E01007414,2124,417,1707
2021,Barnsley 013C,E01007415,1421,214,1207
2021,Barnsley 018D,E01007416,1276,286,990
2021,Barnsley 013D,E01007417,1732,324,1408
2021,Barnsley 016A,E01007418,1257,174,1083
2021,Barnsley 016B,E01007419,1525,234,1291
2021,Barnsley 016C,E01007420,1343,191,1152
2021,Barnsley 027A,E01007421,1341,187,1154
2021,Barnsley 027B,E01007422,1477,286,1191
2021,Barnsley 027C,E01007423,1582,262,1320
2021,Barnsley 028E,E01007424,1813,318,1495
2021,Barnsley 016D,E01007425,1765,316,1449
2021,Barnsley 027D,E01007426,1845,314,1531
2021,Barnsley 024A,E01007427,1606,308,1298
2021,Barnsley 024B,E01007428,1437,231,1206
2021,Barnsley 024C,E01007429,1385,216,1169
2021,Barnsley 024D,E01007430,2660,622,2038
2021,Barnsley 024E,E01007431,1318,253,1065
2021,Barnsley 024F,E01007432,1593,311,1282
2021,Barnsley 002A,E01007433,1557,290,1267
2021,Barnsley 001A,E01007434,2298,472,1826
2021,Barnsley 001B,E01007435,1535,308,1227
2021,Barnsley 002B,E01007436,1316,236,1080
2021,Barnsley 002C,E01007437,1329,212,1117
2021,Barnsley 001C,E01007438,1372,205,1167
2021,Barnsley 001D,E01007439,1380,217,1163
2021,Barnsley 002D,E01007440,1390,267,1123
2021,Barnsley 013E,E01007441,1432,229,1203
2021,Barnsley 012E,E01007442,1411,191,1220
2021,Barnsley 013F,E01007443,2137,347,1790
2021,Barnsley 012F,E01007444,2047,342,1705
2021,Barnsley 013G,E01007445,1487,274,1213
2021,Barnsley 012G,E01007446,1226,166,1060
2021,Barnsley 023A,E01007447,1619,286,1333
2021,Barnsley 023B,E01007448,2065,295,1770
2021,Barnsley 023C,E01007449,1646,207,1439
2021,Barnsley 023D,E01007450,1906,321,1585
2021,Barnsley 026A,E01007451,1735,336,1399
2021,Barnsley 026B,E01007452,1539,291,1248
2021,Barnsley 026C,E01007453,1575,328,1247
2021,Barnsley 026E,E01007455,1348,166,1182
2021,Barnsley 029D,E01007456,1669,259,1410
2021,Barnsley 029E,E01007457,1659,353,1306
2021,Barnsley 021A,E01007458,1384,223,1161
2021,Barnsley 021B,E01007459,1457,161,1296
2021,Barnsley 021C,E01007460,1375,189,1186
2021,Barnsley 021D,E01007461,1619,288,1331
2021,Barnsley 021E,E01007462,1474,353,1121
2021,Barnsley 021F,E01007463,1653,351,1302
2021,Doncaster 009A,E01007464,1380,293,1087
2021,Doncaster 009B,E01007465,1755,340,1415
2021,Doncaster 009C,E01007466,1821,435,1386
2021,Doncaster 009D,E01007467,1430,257,1173
2021,Doncaster 005A,E01007468,1174,102,1072
2021,Doncaster 005B,E01007469,1187,217,970
2021,Doncaster 005C,E01007470,1258,264,994
2021,Doncaster 009E,E01007471,1321,184,1137
2021,Doncaster 005D,E01007472,1292,298,994
2021,Doncaster 005E,E01007473,1325,268,1057
2021,Doncaster 005F,E01007474,1136,171,965
2021,Doncaster 011A,E01007475,1376,227,1149
2021,Doncaster 011B,E01007476,1714,369,1345
2021,Doncaster 011C,E01007477,1333,211,1122
2021,Doncaster 011D,E01007478,1537,262,1275
2021,Doncaster 014A,E01007479,1434,242,1192
2021,Doncaster 014B,E01007480,1396,308,1088
2021,Doncaster 014D,E01007482,1301,199,1102
2021,Doncaster 017A,E01007483,1243,154,1089
2021,Doncaster 017B,E01007484,1266,169,1097
2021,Doncaster 017C,E01007485,1325,196,1129
2021,Doncaster 017D,E01007486,1189,119,1070
2021,Doncaster 002A,E01007487,1502,305,1197
2021,Doncaster 002B,E01007488,1577,246,1331
2021,Doncaster 002C,E01007489,1945,320,1625
2021,Doncaster 002D,E01007490,1624,293,1331
2021,Doncaster 002E,E01007491,1561,364,1197
2021,Doncaster 002F,E01007492,1486,336,1150
2021,Doncaster 002G,E01007493,1651,287,1364
2021,Doncaster 023A,E01007494,1428,247,1181
2021,Doncaster 028A,E01007495,1615,319,1296
2021,Doncaster 029A,E01007496,1485,404,1081
2021,Doncaster 029B,E01007497,1256,293,963
2021,Doncaster 029C,E01007498,1423,278,1145
2021,Doncaster 029D,E01007499,1304,269,1035
2021,Doncaster 028B,E01007500,1186,228,958
2021,Doncaster 029E,E01007501,1257,146,1111
2021,Doncaster 029F,E01007503,1442,221,1221
2021,Doncaster 009F,E01007504,1311,258,1053
2021,Doncaster 013A,E01007505,1514,221,1293
2021,Doncaster 010A,E01007506,1622,310,1312
2021,Doncaster 009G,E01007507,1192,339,853
2021,Doncaster 010B,E01007508,1404,306,1098
2021,Doncaster 010C,E01007509,1536,280,1256
2021,Doncaster 010D,E01007510,1393,219,1174
2021,Doncaster 010E,E01007511,1406,314,1092
2021,Doncaster 012A,E01007512,1964,420,1544
2021,Doncaster 012B,E01007513,1386,241,1145
2021,Doncaster 013B,E01007514,1407,293,1114
2021,Doncaster 012C,E01007515,1395,253,1142
2021,Doncaster 013C,E01007516,1330,217,1113
2021,Doncaster 013D,E01007517,1332,211,1121
2021,Doncaster 012D,E01007518,1376,214,1162
2021,Doncaster 012E,E01007519,1212,253,959
2021,Doncaster 027A,E01007520,1273,175,1098
2021,Doncaster 025A,E01007521,1398,255,1143
2021,Doncaster 024A,E01007522,1455,270,1185
2021,Doncaster 025B,E01007523,1408,212,1196
2021,Doncaster 025C,E01007524,1508,233,1275
2021,Doncaster 024B,E01007525,1437,264,1173
2021,Doncaster 025D,E01007526,1945,318,1627
2021,Doncaster 024C,E01007528,1343,317,1026
2021,Doncaster 022A,E01007529,2191,310,1881
2021,Doncaster 022B,E01007530,1401,288,1113
2021,Doncaster 022C,E01007531,1535,274,1261
2021,Doncaster 023B,E01007532,1654,323,1331
2021,Doncaster 023C,E01007533,1402,266,1136
2021,Doncaster 028D,E01007534,1817,306,1511
2021,Doncaster 023D,E01007535,1364,251,1113
2021,Doncaster 032A,E01007536,1731,279,1452
2021,Doncaster 035A,E01007537,1535,269,1266
2021,Doncaster 035B,E01007538,1447,271,1176
2021,Doncaster 035C,E01007539,1338,303,1035
2021,Doncaster 035D,E01007540,1518,311,1207
2021,Doncaster 035E,E01007541,1386,254,1132
2021,Doncaster 032B,E01007542,1928,372,1556
2021,Doncaster 032C,E01007543,1365,225,1140
2021,Doncaster 032D,E01007544,1562,338,1224
2021,Doncaster 034A,E01007545,1274,174,1100
2021,Doncaster 033A,E01007546,1239,205,1034
2021,Doncaster 034B,E01007547,1383,283,1100
2021,Doncaster 034C,E01007548,1685,379,1306
2021,Doncaster 034D,E01007549,1361,186,1175
2021,Doncaster 034E,E01007550,1593,318,1275
2021,Doncaster 033B,E01007551,1549,251,1298
2021,Doncaster 033C,E01007552,1284,198,1086
2021,Doncaster 008A,E01007553,1535,227,1308
2021,Doncaster 006A,E01007554,1449,246,1203
2021,Doncaster 006B,E01007555,1253,241,1012
2021,Doncaster 006C,E01007556,1241,310,931
2021,Doncaster 008B,E01007557,2900,180,2720
2021,Doncaster 008C,E01007558,1384,215,1169
2021,Doncaster 008D,E01007559,1151,113,1038
2021,Doncaster 008E,E01007560,1580,243,1337
2021,Doncaster 006D,E01007561,1301,190,1111
2021,Doncaster 006E,E01007562,1280,214,1066
2021,Doncaster 006F,E01007563,1351,396,955
2021,Doncaster 018A,E01007564,1446,336,1110
2021,Doncaster 018B,E01007565,1428,240,1188
2021,Doncaster 018C,E01007566,1531,300,1231
2021,Doncaster 018D,E01007567,1260,236,1024
2021,Doncaster 018E,E01007568,1447,375,1072
2021,Doncaster 018F,E01007569,1504,333,1171
2021,Doncaster 015A,E01007570,1379,205,1174
2021,Doncaster 031A,E01007571,1553,298,1255
2021,Doncaster 031B,E01007572,1253,220,1033
2021,Doncaster 031C,E01007573,1330,286,1044
2021,Doncaster 031D,E01007574,1349,251,1098
2021,Doncaster 030A,E01007575,1161,236,925
2021,Doncaster 031E,E01007576,1339,207,1132
2021,Doncaster 031F,E01007577,1284,183,1101
2021,Doncaster 030B,E01007578,1453,277,1176
2021,Doncaster 030C,E01007579,2528,454,2074
2021,Doncaster 030D,E01007580,1214,143,1071
2021,Doncaster 016A,E01007581,1337,205,1132
2021,Doncaster 016B,E01007582,1328,214,1114
2021,Doncaster 020A,E01007583,1310,157,1153
2021,Doncaster 021A,E01007584,1454,204,1250
2021,Doncaster 021B,E01007585,1452,247,1205
2021,Doncaster 020B,E01007586,1384,188,1196
2021,Doncaster 020C,E01007587,1531,218,1313
2021,Doncaster 016C,E01007588,1544,304,1240
2021,Doncaster 016D,E01007589,1552,249,1303
2021,Doncaster 037A,E01007590,1142,231,911
2021,Doncaster 036A,E01007591,1342,244,1098
2021,Doncaster 037B,E01007592,1591,372,1219
2021,Doncaster 037C,E01007593,1794,358,1436
2021,Doncaster 036B,E01007594,1863,364,1499
2021,Doncaster 037D,E01007595,1378,205,1173
2021,Doncaster 036C,E01007596,1141,146,995
2021,Doncaster 037E,E01007597,1446,324,1122
2021,Doncaster 036D,E01007598,1400,187,1213
2021,Doncaster 026A,E01007599,1684,304,1380
2021,Doncaster 026B,E01007600,1293,173,1120
2021,Doncaster 026C,E01007601,1474,218,1256
2021,Doncaster 026D,E01007602,1897,389,1508
2021,Doncaster 026E,E01007603,1497,227,1270
2021,Doncaster 024D,E01007604,1275,172,1103
2021,Doncaster 027C,E01007605,1417,172,1245
2021,Doncaster 027D,E01007606,2084,364,1720
2021,Doncaster 025E,E01007607,1437,303,1134
2021,Doncaster 038B,E01007609,2126,337,1789
2021,Doncaster 038C,E01007610,1688,228,1460
2021,Doncaster 039A,E01007611,1224,148,1076
2021,Doncaster 039B,E01007612,1310,176,1134
2021,Doncaster 033D,E01007613,1570,238,1332
2021,Doncaster 039C,E01007614,1333,198,1135
2021,Doncaster 039D,E01007615,1223,152,1071
2021,Doncaster 039E,E01007616,1120,121,999
2021,Doncaster 021C,E01007617,1415,215,1200
2021,Doncaster 021D,E01007618,1136,186,950
2021,Doncaster 021E,E01007619,1751,339,1412
2021,Doncaster 020D,E01007620,1541,213,1328
2021,Doncaster 007A,E01007621,1323,245,1078
2021,Doncaster 007B,E01007622,1355,220,1135
2021,Doncaster 007C,E01007623,1166,168,998
2021,Doncaster 007D,E01007624,1830,333,1497
2021,Doncaster 004A,E01007625,1364,198,1166
2021,Doncaster 004B,E01007626,1445,254,1191
2021,Doncaster 004C,E01007627,1495,309,1186
2021,Doncaster 004D,E01007628,1270,294,976
2021,Doncaster 004E,E01007629,1407,351,1056
2021,Doncaster 007E,E01007630,1281,172,1109
2021,Doncaster 007F,E01007631,1130,131,999
2021,Doncaster 001A,E01007632,1500,292,1208
2021,Doncaster 001B,E01007633,1322,319,1003
2021,Doncaster 001C,E01007634,1606,396,1210
2021,Doncaster 001D,E01007635,1841,380,1461
2021,Doncaster 003A,E01007636,1474,297,1177
2021,Doncaster 003B,E01007637,1488,209,1279
2021,Doncaster 003C,E01007638,1447,216,1231
2021,Doncaster 003D,E01007639,2049,285,1764
2021,Doncaster 003E,E01007640,1519,190,1329
2021,Doncaster 003F,E01007641,1347,207,1140
2021,Doncaster 003G,E01007642,1512,341,1171
2021,Doncaster 022D,E01007643,1533,428,1105
2021,Doncaster 019A,E01007644,1666,335,1331
2021,Doncaster 019B,E01007646,1535,219,1316
2021,Doncaster 019C,E01007647,1475,215,1260
2021,Doncaster 019E,E01007649,1401,297,1104
2021,Doncaster 015B,E01007650,1574,193,1381
2021,Doncaster 015C,E01007651,1689,398,1291
2021,Doncaster 015D,E01007652,1908,457,1451
2021,Doncaster 015E,E01007653,1476,287,1189
2021,Doncaster 019F,E01007654,1443,275,1168
2021,Doncaster 022F,E01007655,1880,323,1557
2021,Doncaster 015F,E01007656,1529,309,1220
2021,Rotherham 029A,E01007657,1317,211,1106
2021,Rotherham 032A,E01007658,1396,260,1136
2021,Rotherham 029B,E01007659,1034,160,874
2021,Rotherham 032B,E01007660,1151,158,993
2021,Rotherham 032C,E01007661,1399,243,1156
2021,Rotherham 032D,E01007662,1041,230,811
2021,Rotherham 032E,E01007663,1402,200,1202
2021,Rotherham 032F,E01007664,1780,257,1523
2021,Rotherham 026A,E01007666,1218,150,1068
2021,Rotherham 030A,E01007667,1457,312,1145
2021,Rotherham 030B,E01007668,1468,325,1143
2021,Rotherham 030C,E01007669,1388,222,1166
2021,Rotherham 030D,E01007670,1361,207,1154
2021,Rotherham 031A,E01007671,1927,381,1546
2021,Rotherham 030E,E01007672,1309,208,1101
2021,Rotherham 030F,E01007673,1446,303,1143
2021,Rotherham 031B,E01007674,1990,364,1626
2021,Rotherham 023A,E01007675,1836,464,1372
2021,Rotherham 025A,E01007676,1514,227,1287
2021,Rotherham 017A,E01007677,1813,494,1319
2021,Rotherham 023B,E01007678,1525,259,1266
2021,Rotherham 023C,E01007679,1873,448,1425
2021,Rotherham 023D,E01007680,1799,416,1383
2021,Rotherham 012A,E01007681,1217,190,1027
2021,Rotherham 019A,E01007682,1236,238,998
2021,Rotherham 019B,E01007683,1272,198,1074
2021,Rotherham 034A,E01007684,1700,325,1375
2021,Rotherham 018A,E01007685,1277,164,1113
2021,Rotherham 019C,E01007686,1389,155,1234
2021,Rotherham 034C,E01007687,1510,238,1272
2021,Rotherham 019D,E01007688,1428,250,1178
2021,Rotherham 034B,E01007689,1496,283,1213
2021,Rotherham 034E,E01007690,1659,258,1401
2021,Rotherham 012B,E01007691,1932,300,1632
2021,Rotherham 012C,E01007692,1456,212,1244
2021,Rotherham 001B,E01007694,1783,397,1386
2021,Rotherham 001C,E01007695,2612,576,2036
2021,Rotherham 007A,E01007696,1365,176,1189
2021,Rotherham 001D,E01007697,1573,308,1265
2021,Rotherham 001E,E01007698,1375,198,1177
2021,Rotherham 027B,E01007699,2514,504,2010
2021,Rotherham 027C,E01007700,1860,401,1459
2021,Rotherham 027D,E01007701,1524,284,1240
2021,Rotherham 025B,E01007702,1589,339,1250
2021,Rotherham 025C,E01007703,1157,203,954
2021,Rotherham 025D,E01007704,1460,206,1254
2021,Rotherham 025E,E01007705,1406,247,1159
2021,Rotherham 027E,E01007706,1273,202,1071
2021,Rotherham 025F,E01007707,1407,186,1221
2021,Rotherham 021A,E01007708,1599,334,1265
2021,Rotherham 021B,E01007709,1394,249,1145
2021,Rotherham 021C,E01007710,1486,248,1238
2021,Rotherham 021D,E01007711,1672,290,1382
2021,Rotherham 023E,E01007712,1895,410,1485
2021,Rotherham 023F,E01007713,1572,291,1281
2021,Rotherham 017B,E01007714,2130,380,1750
2021,Rotherham 016A,E01007715,1748,506,1242
2021,Rotherham 016B,E01007716,1814,462,1352
2021,Rotherham 016C,E01007717,1696,286,1410
2021,Rotherham 016D,E01007718,1445,302,1143
2021,Rotherham 010A,E01007719,1167,217,950
2021,Rotherham 010B,E01007720,1440,194,1246
2021,Rotherham 010C,E01007721,1540,286,1254
2021,Rotherham 013A,E01007723,1322,271,1051
2021,Rotherham 021E,E01007724,1334,232,1102
2021,Rotherham 019E,E01007725,1163,198,965
2021,Rotherham 019F,E01007726,1452,307,1145
2021,Rotherham 010D,E01007727,1335,192,1143
2021,Rotherham 009A,E01007728,1109,171,938
2021,Rotherham 009B,E01007729,1488,188,1300
2021,Rotherham 009C,E01007730,1314,202,1112
2021,Rotherham 009D,E01007731,1103,112,991
2021,Rotherham 009E,E01007732,1245,148,1097
2021,Rotherham 009F,E01007733,1174,171,1003
2021,Rotherham 021F,E01007734,1633,353,1280
2021,Rotherham 013B,E01007735,1326,342,984
2021,Rotherham 014A,E01007736,1503,369,1134
2021,Rotherham 013C,E01007737,1504,413,1091
2021,Rotherham 013D,E01007738,1396,349,1047
2021,Rotherham 013E,E01007739,1436,336,1100
2021,Rotherham 011A,E01007740,1450,296,1154
2021,Rotherham 015A,E01007741,1412,167,1245
2021,Rotherham 015B,E01007742,1356,247,1109
2021,Rotherham 015C,E01007743,1138,164,974
2021,Rotherham 015D,E01007744,1367,169,1198
2021,Rotherham 015E,E01007745,1496,317,1179
2021,Rotherham 015F,E01007746,1371,269,1102
2021,Rotherham 031C,E01007747,1241,244,997
2021,Rotherham 033A,E01007748,1368,173,1195
2021,Rotherham 033B,E01007749,1780,354,1426
2021,Rotherham 031D,E01007750,1535,240,1295
2021,Rotherham 033C,E01007751,2170,454,1716
2021,Rotherham 033D,E01007752,1417,216,1201
2021,Rotherham 033E,E01007753,1529,236,1293
2021,Rotherham 018B,E01007754,1255,216,1039
2021,Rotherham 018C,E01007755,1235,183,1052
2021,Rotherham 018D,E01007756,1319,205,1114
2021,Rotherham 020A,E01007757,1520,238,1282
2021,Rotherham 020B,E01007758,1414,293,1121
2021,Rotherham 020C,E01007759,1367,231,1136
2021,Rotherham 020D,E01007760,1491,320,1171
2021,Rotherham 018E,E01007761,1480,257,1223
2021,Rotherham 018F,E01007762,1341,181,1160
2021,Rotherham 020E,E01007763,1431,258,1173
2021,Rotherham 020F,E01007764,1654,407,1247
2021,Rotherham 014B,E01007765,1295,215,1080
2021,Rotherham 014C,E01007766,1364,390,974
2021,Rotherham 017C,E01007767,1407,244,1163
2021,Rotherham 014D,E01007768,1864,450,1414
2021,Rotherham 017D,E01007769,1535,435,1100
2021,Rotherham 014E,E01007770,1664,412,1252
2021,Rotherham 006A,E01007771,1276,203,1073
2021,Rotherham 006B,E01007772,1293,289,1004
2021,Rotherham 006C,E01007773,1322,262,1060
2021,Rotherham 006D,E01007774,1348,267,1081
2021,Rotherham 008A,E01007775,1220,306,914
2021,Rotherham 008B,E01007776,1459,307,1152
2021,Rotherham 004A,E01007777,2021,435,1586
2021,Rotherham 005A,E01007778,1344,185,1159
2021,Rotherham 005B,E01007779,1820,340,1480
2021,Rotherham 005C,E01007780,1341,236,1105
2021,Rotherham 005D,E01007781,1415,286,1129
2021,Rotherham 005E,E01007782,1391,298,1093
2021,Rotherham 008C,E01007783,1602,222,1380
2021,Rotherham 008D,E01007784,1626,256,1370
2021,Rotherham 029C,E01007785,1295,246,1049
2021,Rotherham 029D,E01007786,1131,178,953
2021,Rotherham 028B,E01007788,1430,204,1226
2021,Rotherham 028C,E01007789,1488,235,1253
2021,Rotherham 029E,E01007790,1554,352,1202
2021,Rotherham 029F,E01007791,1288,282,1006
2021,Rotherham 028D,E01007792,1193,183,1010
2021,Rotherham 004B,E01007793,1338,214,1124
2021,Rotherham 004C,E01007794,1236,262,974
2021,Rotherham 004D,E01007795,1293,138,1155
2021,Rotherham 003A,E01007796,1072,194,878
2021,Rotherham 003B,E01007797,1164,174,990
2021,Rotherham 003C,E01007798,1465,164,1301
2021,Rotherham 003D,E01007799,1401,266,1135
2021,Rotherham 003E,E01007800,1471,210,1261
2021,Rotherham 007B,E01007801,1387,224,1163
2021,Rotherham 007C,E01007802,1189,146,1043
2021,Rotherham 007D,E01007803,1211,218,993
2021,Rotherham 011B,E01007804,1322,263,1059
2021,Rotherham 011C,E01007805,1386,278,1108
2021,Rotherham 011D,E01007806,1282,314,968
2021,Rotherham 011E,E01007807,1348,267,1081
2021,Rotherham 007E,E01007808,1282,183,1099
2021,Rotherham 026B,E01007809,1524,308,1216
2021,Rotherham 026C,E01007810,2718,540,2178
2021,Rotherham 034D,E01007811,1242,209,1033
2021,Rotherham 034F,E01007812,1182,221,961
2021,Rotherham 026D,E01007815,1529,266,1263
2021,Rotherham 002A,E01007816,1620,323,1297
2021,Rotherham 002B,E01007817,1391,253,1138
2021,Rotherham 003F,E01007818,1528,271,1257
2021,Rotherham 002C,E01007819,1496,274,1222
2021,Rotherham 002D,E01007820,1625,319,1306
2021,Rotherham 002E,E01007821,1515,235,1280
2021,Rotherham 002F,E01007822,1813,421,1392
2021,Sheffield 069A,E01007823,1600,265,1335
2021,Sheffield 066A,E01007824,1265,219,1046
2021,Sheffield 066B,E01007825,1369,219,1150
2021,Sheffield 066C,E01007826,1423,266,1157
2021,Sheffield 064A,E01007827,1740,267,1473
2021,Sheffield 059A,E01007828,1641,325,1316
2021,Sheffield 059B,E01007829,1507,200,1307
2021,Sheffield 064B,E01007830,1401,190,1211
2021,Sheffield 059C,E01007831,1504,286,1218
2021,Sheffield 059D,E01007832,1434,234,1200
2021,Sheffield 064C,E01007833,1599,253,1346
2021,Sheffield 066D,E01007834,1559,245,1314
2021,Sheffield 062A,E01007835,1280,220,1060
2021,Sheffield 062B,E01007836,1515,212,1303
2021,Sheffield 076A,E01007838,1368,195,1173
2021,Sheffield 076B,E01007839,1520,238,1282
2021,Sheffield 076C,E01007841,1420,194,1226
2021,Sheffield 076D,E01007842,1475,268,1207
2021,Sheffield 062C,E01007843,1593,339,1254
2021,Sheffield 062D,E01007846,1320,195,1125
2021,Sheffield 014A,E01007847,1224,194,1030
2021,Sheffield 013A,E01007848,1698,407,1291
2021,Sheffield 010A,E01007849,1998,521,1477
2021,Sheffield 014B,E01007850,1318,184,1134
2021,Sheffield 013B,E01007851,1401,407,994
2021,Sheffield 014C,E01007852,1418,266,1152
2021,Sheffield 014D,E01007853,1659,267,1392
2021,Sheffield 014E,E01007854,1353,324,1029
2021,Sheffield 014F,E01007855,1827,457,1370
2021,Sheffield 007A,E01007856,1213,262,951
2021,Sheffield 010B,E01007857,1580,402,1178
2021,Sheffield 038A,E01007858,1316,223,1093
2021,Sheffield 038B,E01007861,1520,295,1225
2021,Sheffield 038C,E01007862,3507,2745,762
2021,Sheffield 036C,E01007863,1567,600,967
2021,Sheffield 036D,E01007864,1590,1109,481
2021,Sheffield 038D,E01007865,1669,355,1314
2021,Sheffield 030A,E01007866,1688,974,714
2021,Sheffield 030B,E01007867,1878,1228,650
2021,Sheffield 030C,E01007868,1257,299,958
2021,Sheffield 020A,E01007869,1474,448,1026
2021,Sheffield 019A,E01007870,1657,367,1290
2021,Sheffield 019B,E01007871,1666,383,1283
2021,Sheffield 020B,E01007872,1694,413,1281
2021,Sheffield 020C,E01007873,2005,565,1440
2021,Sheffield 022A,E01007874,1748,558,1190
2021,Sheffield 022B,E01007875,1653,528,1125
2021,Sheffield 075A,E01007878,1201,292,909
2021,Sheffield 075B,E01007879,1447,318,1129
2021,Sheffield 075C,E01007881,1457,261,1196
2021,Sheffield 075D,E01007882,1388,239,1149
2021,Sheffield 027A,E01007883,1769,588,1181
2021,Sheffield 075E,E01007885,1770,521,1249
2021,Sheffield 075F,E01007886,1431,352,1079
2021,Sheffield 004A,E01007887,1339,235,1104
2021,Sheffield 003A,E01007888,1281,209,1072
2021,Sheffield 004B,E01007889,2616,520,2096
2021,Sheffield 004C,E01007890,1306,198,1108
2021,Sheffield 004D,E01007891,1434,198,1236
2021,Sheffield 003B,E01007892,1363,268,1095
2021,Sheffield 003C,E01007893,1369,188,1181
2021,Sheffield 004E,E01007894,1332,191,1141
2021,Sheffield 004F,E01007895,1363,167,1196
2021,Sheffield 004G,E01007896,1191,154,1037
2021,Sheffield 005A,E01007897,1294,156,1138
2021,Sheffield 003D,E01007898,1380,208,1172
2021,Sheffield 003E,E01007899,1376,190,1186
2021,Sheffield 003F,E01007900,1588,308,1280
2021,Sheffield 003G,E01007901,1330,269,1061
2021,Sheffield 027B,E01007902,1569,388,1181
2021,Sheffield 018A,E01007903,1524,385,1139
2021,Sheffield 018B,E01007904,1592,450,1142
2021,Sheffield 027C,E01007905,1876,665,1211
2021,Sheffield 027D,E01007906,2626,907,1719
2021,Sheffield 032A,E01007907,1584,397,1187
2021,Sheffield 032B,E01007908,1301,211,1090
2021,Sheffield 032C,E01007909,2372,396,1976
2021,Sheffield 037A,E01007910,1692,372,1320
2021,Sheffield 032D,E01007911,1307,204,1103
2021,Sheffield 037B,E01007912,1377,175,1202
2021,Sheffield 018C,E01007913,1456,446,1010
2021,Sheffield 018D,E01007914,1439,467,972
2021,Sheffield 071A,E01007915,1384,263,1121
2021,Sheffield 069B,E01007916,1416,353,1063
2021,Sheffield 071B,E01007917,1380,228,1152
2021,Sheffield 071C,E01007918,1624,317,1307
2021,Sheffield 069C,E01007919,1500,368,1132
2021,Sheffield 068A,E01007920,1631,301,1330
2021,Sheffield 068B,E01007921,1652,307,1345
2021,Sheffield 071D,E01007922,1315,229,1086
2021,Sheffield 068C,E01007923,1780,356,1424
2021,Sheffield 071E,E01007924,1541,327,1214
2021,Sheffield 068D,E01007925,1679,352,1327
2021,Sheffield 068E,E01007926,1644,272,1372
2021,Sheffield 055A,E01007927,1507,307,1200
2021,Sheffield 055B,E01007928,1667,358,1309
2021,Sheffield 055C,E01007929,1865,393,1472
2021,Sheffield 055D,E01007930,1370,308,1062
2021,Sheffield 047A,E01007931,1482,320,1162
2021,Sheffield 055E,E01007932,1403,272,1131
2021,Sheffield 068F,E01007933,1599,318,1281
2021,Sheffield 047B,E01007934,1410,330,1080
2021,Sheffield 047C,E01007935,1314,316,998
2021,Sheffield 047D,E01007936,1543,389,1154
2021,Sheffield 047E,E01007937,1383,296,1087
2021,Sheffield 047F,E01007938,1420,313,1107
2021,Sheffield 055F,E01007939,1543,313,1230
2021,Sheffield 022E,E01007940,1638,535,1103
2021,Sheffield 015A,E01007941,1612,352,1260
2021,Sheffield 020D,E01007942,1768,580,1188
2021,Sheffield 019C,E01007943,1635,421,1214
2021,Sheffield 015B,E01007945,1588,350,1238
2021,Sheffield 015C,E01007946,1425,374,1051
2021,Sheffield 013C,E01007947,1444,301,1143
2021,Sheffield 013D,E01007948,1541,481,1060
2021,Sheffield 020E,E01007949,1606,540,1066
2021,Sheffield 015D,E01007950,1443,395,1048
2021,Sheffield 029A,E01007951,1535,357,1178
2021,Sheffield 033A,E01007952,1483,299,1184
2021,Sheffield 033B,E01007953,1465,202,1263
2021,Sheffield 033C,E01007954,1544,334,1210
2021,Sheffield 041A,E01007955,1351,299,1052
2021,Sheffield 041B,E01007956,2044,406,1638
2021,Sheffield 041C,E01007957,1547,372,1175
2021,Sheffield 041D,E01007958,1371,249,1122
2021,Sheffield 041E,E01007959,1387,294,1093
2021,Sheffield 029B,E01007960,1475,339,1136
2021,Sheffield 033D,E01007961,1432,341,1091
2021,Sheffield 029C,E01007962,1255,381,874
2021,Sheffield 045A,E01007963,1363,193,1170
2021,Sheffield 049A,E01007964,1422,229,1193
2021,Sheffield 044A,E01007965,1769,436,1333
2021,Sheffield 049B,E01007966,1383,221,1162
2021,Sheffield 045B,E01007967,1641,345,1296
2021,Sheffield 049C,E01007968,1362,303,1059
2021,Sheffield 044B,E01007969,1566,209,1357
2021,Sheffield 049D,E01007970,1355,144,1211
2021,Sheffield 037C,E01007971,1379,302,1077
2021,Sheffield 044C,E01007972,1334,190,1144
2021,Sheffield 037D,E01007973,1437,241,1196
2021,Sheffield 044D,E01007974,1320,227,1093
2021,Sheffield 051A,E01007975,1452,248,1204
2021,Sheffield 051B,E01007976,1308,248,1060
2021,Sheffield 051C,E01007977,1375,221,1154
2021,Sheffield 053A,E01007978,1478,243,1235
2021,Sheffield 051D,E01007979,1622,500,1122
2021,Sheffield 053B,E01007980,1352,252,1100
2021,Sheffield 053C,E01007981,1399,304,1095
2021,Sheffield 054A,E01007982,1712,423,1289
2021,Sheffield 053D,E01007983,1310,224,1086
2021,Sheffield 064D,E01007984,1322,211,1111
2021,Sheffield 053E,E01007985,1400,238,1162
2021,Sheffield 059E,E01007986,1286,210,1076
2021,Sheffield 016A,E01007987,1344,239,1105
2021,Sheffield 016B,E01007988,1406,211,1195
2021,Sheffield 016C,E01007989,1332,236,1096
2021,Sheffield 021A,E01007990,1366,230,1136
2021,Sheffield 016D,E01007991,1444,301,1143
2021,Sheffield 021B,E01007992,1444,227,1217
2021,Sheffield 021C,E01007993,1535,310,1225
2021,Sheffield 021D,E01007994,1261,207,1054
2021,Sheffield 017A,E01007995,1411,202,1209
2021,Sheffield 021E,E01007996,1583,280,1303
2021,Sheffield 025A,E01007997,1492,263,1229
2021,Sheffield 025B,E01007998,1448,215,1233
2021,Sheffield 045C,E01007999,1171,139,1032
2021,Sheffield 052A,E01008000,1374,173,1201
2021,Sheffield 052B,E01008001,1438,255,1183
2021,Sheffield 054B,E01008002,1483,203,1280
2021,Sheffield 054C,E01008003,1286,183,1103
2021,Sheffield 052C,E01008004,1477,244,1233
2021,Sheffield 052D,E01008005,1466,204,1262
2021,Sheffield 054D,E01008006,1390,180,1210
2021,Sheffield 060A,E01008007,1565,296,1269
2021,Sheffield 045D,E01008008,1547,286,1261
2021,Sheffield 045E,E01008009,1410,383,1027
2021,Sheffield 052E,E01008010,1308,254,1054
2021,Sheffield 039A,E01008011,1745,492,1253
2021,Sheffield 039B,E01008012,2116,524,1592
2021,Sheffield 039C,E01008013,1888,482,1406
2021,Sheffield 032E,E01008014,1715,437,1278
2021,Sheffield 039D,E01008015,1459,280,1179
2021,Sheffield 032F,E01008016,1415,286,1129
2021,Sheffield 039E,E01008017,1546,397,1149
2021,Sheffield 039F,E01008018,1466,349,1117
2021,Sheffield 065A,E01008019,1673,318,1355
2021,Sheffield 065B,E01008020,1186,137,1049
2021,Sheffield 072A,E01008021,1318,220,1098
2021,Sheffield 065C,E01008022,1348,253,1095
2021,Sheffield 072B,E01008023,2294,412,1882
2021,Sheffield 072C,E01008024,2048,410,1638
2021,Sheffield 072D,E01008025,1871,302,1569
2021,Sheffield 065D,E01008027,1378,250,1128
2021,Sheffield 056A,E01008028,1445,277,1168
2021,Sheffield 056B,E01008029,1410,302,1108
2021,Sheffield 063A,E01008030,1332,236,1096
2021,Sheffield 061A,E01008031,1315,198,1117
2021,Sheffield 056C,E01008032,1288,205,1083
2021,Sheffield 061B,E01008033,1176,107,1069
2021,Sheffield 056D,E01008034,1474,239,1235
2021,Sheffield 063B,E01008035,1108,180,928
2021,Sheffield 063C,E01008036,1271,202,1069
2021,Sheffield 065E,E01008037,1283,128,1155
2021,Sheffield 061C,E01008038,1404,126,1278
2021,Sheffield 065F,E01008039,1147,107,1040
2021,Sheffield 061D,E01008040,1527,268,1259
2021,Sheffield 063D,E01008041,1236,206,1030
2021,Sheffield 050A,E01008042,1715,372,1343
2021,Sheffield 046A,E01008043,1647,370,1277
2021,Sheffield 046B,E01008044,1562,369,1193
2021,Sheffield 050B,E01008045,1255,270,985
2021,Sheffield 050C,E01008046,1510,318,1192
2021,Sheffield 046C,E01008047,1280,400,880
2021,Sheffield 046D,E01008048,1500,409,1091
2021,Sheffield 050D,E01008049,1580,280,1300
2021,Sheffield 046E,E01008050,1392,292,1100
2021,Sheffield 050E,E01008051,1634,383,1251
2021,Sheffield 050F,E01008052,1614,298,1316
2021,Sheffield 006A,E01008053,1246,244,1002
2021,Sheffield 007B,E01008054,1276,329,947
2021,Sheffield 007C,E01008055,1437,379,1058
2021,Sheffield 006B,E01008056,1354,274,1080
2021,Sheffield 007D,E01008057,1521,437,1084
2021,Sheffield 006C,E01008058,1660,306,1354
2021,Sheffield 010C,E01008059,1550,417,1133
2021,Sheffield 010D,E01008060,1416,360,1056
2021,Sheffield 011A,E01008061,1549,404,1145
2021,Sheffield 013E,E01008062,1592,533,1059
2021,Sheffield 011B,E01008063,1339,223,1116
2021,Sheffield 028A,E01008064,1451,565,886
2021,Sheffield 026A,E01008065,1954,575,1379
2021,Sheffield 028B,E01008066,1402,910,492
2021,Sheffield 030D,E01008067,1749,1316,433
2021,Sheffield 026B,E01008068,2166,1232,934
2021,Sheffield 028C,E01008069,1422,753,669
2021,Sheffield 026C,E01008072,1573,395,1178
2021,Sheffield 030E,E01008073,1506,564,942
2021,Sheffield 028D,E01008074,1241,383,858
2021,Sheffield 060B,E01008075,1303,349,954
2021,Sheffield 060C,E01008076,1296,347,949
2021,Sheffield 060D,E01008077,1434,261,1173
2021,Sheffield 064E,E01008078,1410,212,1198
2021,Sheffield 064F,E01008079,1155,238,917
2021,Sheffield 069D,E01008080,1363,236,1127
2021,Sheffield 070A,E01008081,1404,235,1169
2021,Sheffield 070B,E01008082,1467,283,1184
2021,Sheffield 070C,E01008083,1414,331,1083
2021,Sheffield 070D,E01008084,1510,386,1124
2021,Sheffield 009A,E01008085,1236,249,987
2021,Sheffield 009B,E01008086,1341,324,1017
2021,Sheffield 012A,E01008087,1409,202,1207
2021,Sheffield 012B,E01008088,1305,180,1125
2021,Sheffield 017B,E01008089,1603,405,1198
2021,Sheffield 012C,E01008090,1509,389,1120
2021,Sheffield 017C,E01008091,1313,188,1125
2021,Sheffield 012D,E01008092,1374,225,1149
2021,Sheffield 017D,E01008093,1368,185,1183
2021,Sheffield 019D,E01008094,1127,277,850
2021,Sheffield 043A,E01008095,1737,470,1267
2021,Sheffield 043B,E01008096,2178,520,1658
2021,Sheffield 043C,E01008097,1336,278,1058
2021,Sheffield 048A,E01008098,1368,302,1066
2021,Sheffield 051E,E01008099,1397,234,1163
2021,Sheffield 048B,E01008100,1213,329,884
2021,Sheffield 043D,E01008101,1681,332,1349
2021,Sheffield 048C,E01008102,1250,300,950
2021,Sheffield 048D,E01008103,1068,289,779
2021,Sheffield 036E,E01008104,1356,649,707
2021,Sheffield 040A,E01008105,2785,1761,1024
2021,Sheffield 040C,E01008107,1435,489,946
2021,Sheffield 042A,E01008108,1770,664,1106
2021,Sheffield 042B,E01008109,2825,1729,1096
2021,Sheffield 040D,E01008111,1570,706,864
2021,Sheffield 042D,E01008112,1642,495,1147
2021,Sheffield 042E,E01008113,1566,411,1155
2021,Sheffield 074A,E01008114,2598,1705,893
2021,Sheffield 074B,E01008115,1467,910,557
2021,Sheffield 009C,E01008116,1212,256,956
2021,Sheffield 009D,E01008117,1687,377,1310
2021,Sheffield 009E,E01008118,1300,271,1029
2021,Sheffield 009F,E01008119,1270,321,949
2021,Sheffield 012E,E01008122,1507,396,1111
2021,Sheffield 015E,E01008123,1270,306,964
2021,Sheffield 012F,E01008124,1324,349,975
2021,Sheffield 009G,E01008125,1452,303,1149
2021,Sheffield 008A,E01008126,1487,256,1231
2021,Sheffield 008C,E01008128,1735,328,1407
2021,Sheffield 023A,E01008129,1557,299,1258
2021,Sheffield 023B,E01008130,1468,246,1222
2021,Sheffield 023C,E01008131,1518,254,1264
2021,Sheffield 023D,E01008132,1264,200,1064
2021,Sheffield 023E,E01008133,1443,176,1267
2021,Sheffield 005B,E01008134,1237,173,1064
2021,Sheffield 005C,E01008135,1594,216,1378
2021,Sheffield 008D,E01008136,1321,297,1024
2021,Sheffield 005D,E01008137,1305,157,1148
2021,Sheffield 006D,E01008138,1206,168,1038
2021,Sheffield 006E,E01008139,1451,240,1211
2021,Sheffield 008E,E01008140,1793,343,1450
2021,Sheffield 005E,E01008141,1470,213,1257
2021,Sheffield 002A,E01008142,1380,271,1109
2021,Sheffield 002B,E01008143,1499,236,1263
2021,Sheffield 001A,E01008144,1829,294,1535
2021,Sheffield 001B,E01008145,1317,209,1108
2021,Sheffield 002C,E01008146,1176,189,987
2021,Sheffield 002D,E01008147,1325,167,1158
2021,Sheffield 001C,E01008148,1436,301,1135
2021,Sheffield 001D,E01008149,1358,204,1154
2021,Sheffield 001E,E01008150,1351,200,1151
2021,Sheffield 024A,E01008151,1432,335,1097
2021,Sheffield 025C,E01008152,1349,232,1117
2021,Sheffield 024B,E01008153,1535,218,1317
2021,Sheffield 024C,E01008154,1554,258,1296
2021,Sheffield 024D,E01008155,1349,244,1105
2021,Sheffield 024E,E01008156,1375,171,1204
2021,Sheffield 026D,E01008157,1550,259,1291
2021,Sheffield 025D,E01008158,1443,276,1167
2021,Sheffield 029D,E01008159,1443,309,1134
2021,Sheffield 024F,E01008160,1275,183,1092
2021,Sheffield 026E,E01008161,1592,210,1382
2021,Gateshead 027A,E01008162,2143,353,1790
2021,Gateshead 028A,E01008163,1885,618,1267
2021,Gateshead 027B,E01008164,1420,262,1158
2021,Gateshead 011A,E01008165,1397,343,1054
2021,Gateshead 027C,E01008166,1608,774,834
2021,Gateshead 008A,E01008167,1445,256,1189
2021,Gateshead 008C,E01008170,1670,260,1410
2021,Gateshead 026A,E01008172,1662,238,1424
2021,Gateshead 026B,E01008173,1427,277,1150
2021,Gateshead 026C,E01008174,2043,376,1667
2021,Gateshead 026D,E01008175,1367,185,1182
2021,Gateshead 026E,E01008176,1417,240,1177
2021,Gateshead 005A,E01008177,1224,154,1070
2021,Gateshead 004A,E01008178,1477,300,1177
2021,Gateshead 005B,E01008179,1096,183,913
2021,Gateshead 004B,E01008180,1272,276,996
2021,Gateshead 005C,E01008181,1477,266,1211
2021,Gateshead 004C,E01008182,1609,326,1283
2021,Gateshead 029B,E01008183,1368,260,1108
2021,Gateshead 022A,E01008184,1296,166,1130
2021,Gateshead 022B,E01008185,1326,291,1035
2021,Gateshead 029C,E01008186,1673,241,1432
2021,Gateshead 022C,E01008188,1285,196,1089
2021,Gateshead 023A,E01008189,1161,220,941
2021,Gateshead 023B,E01008190,1299,183,1116
2021,Gateshead 023C,E01008191,1320,230,1090
2021,Gateshead 023D,E01008192,1316,240,1076
2021,Gateshead 020A,E01008193,1235,205,1030
2021,Gateshead 020B,E01008194,1308,205,1103
2021,Gateshead 002A,E01008195,1892,315,1577
2021,Gateshead 029A,E01008196,2024,316,1708
2021,Gateshead 002B,E01008197,1600,209,1391
2021,Gateshead 002C,E01008198,1533,271,1262
2021,Gateshead 002D,E01008199,1260,150,1110
2021,Gateshead 002E,E01008200,1306,183,1123
2021,Gateshead 011B,E01008201,1511,430,1081
2021,Gateshead 011C,E01008202,1595,314,1281
2021,Gateshead 028B,E01008203,1500,263,1237
2021,Gateshead 011D,E01008204,1402,278,1124
2021,Gateshead 028C,E01008205,1401,214,1187
2021,Gateshead 013A,E01008206,1550,265,1285
2021,Gateshead 013B,E01008207,1267,160,1107
2021,Gateshead 013C,E01008208,1526,278,1248
2021,Gateshead 007A,E01008209,1816,326,1490
2021,Gateshead 007B,E01008210,1314,239,1075
2021,Gateshead 013D,E01008211,1565,248,1317
2021,Gateshead 012A,E01008212,1193,215,978
2021,Gateshead 012B,E01008213,1421,240,1181
2021,Gateshead 003A,E01008214,1615,421,1194
2021,Gateshead 003B,E01008215,1454,261,1193
2021,Gateshead 012C,E01008216,1317,231,1086
2021,Gateshead 023E,E01008217,1382,211,1171
2021,Gateshead 021A,E01008218,1469,249,1220
2021,Gateshead 016A,E01008219,1560,255,1305
2021,Gateshead 021B,E01008220,1153,304,849
2021,Gateshead 021C,E01008221,1733,405,1328
2021,Gateshead 025A,E01008222,1525,312,1213
2021,Gateshead 025B,E01008223,1709,408,1301
2021,Gateshead 025C,E01008224,2499,408,2091
2021,Gateshead 021D,E01008225,1490,205,1285
2021,Gateshead 025D,E01008226,1689,323,1366
2021,Gateshead 021E,E01008227,1574,461,1113
2021,Gateshead 012D,E01008228,1068,181,887
2021,Gateshead 018A,E01008229,1199,121,1078
2021,Gateshead 018B,E01008230,1295,255,1040
2021,Gateshead 015A,E01008231,1395,270,1125
2021,Gateshead 018C,E01008232,1269,273,996
2021,Gateshead 018D,E01008233,1171,130,1041
2021,Gateshead 020C,E01008234,1978,292,1686
2021,Gateshead 016B,E01008235,1289,160,1129
2021,Gateshead 016C,E01008236,1370,185,1185
2021,Gateshead 016D,E01008237,1468,311,1157
2021,Gateshead 016E,E01008238,1366,236,1130
2021,Gateshead 020D,E01008239,1457,275,1182
2021,Gateshead 015B,E01008240,1417,282,1135
2021,Gateshead 015C,E01008241,1502,262,1240
2021,Gateshead 015D,E01008242,1532,312,1220
2021,Gateshead 003C,E01008243,1450,215,1235
2021,Gateshead 003D,E01008244,1751,283,1468
2021,Gateshead 002F,E01008245,1281,189,1092
2021,Gateshead 001A,E01008246,1311,244,1067
2021,Gateshead 001B,E01008247,1474,249,1225
2021,Gateshead 001C,E01008248,2497,482,2015
2021,Gateshead 001D,E01008249,1449,149,1300
2021,Gateshead 001E,E01008250,1361,263,1098
2021,Gateshead 010A,E01008251,1633,256,1377
2021,Gateshead 010B,E01008252,1536,458,1078
2021,Gateshead 010C,E01008253,1356,297,1059
2021,Gateshead 010D,E01008254,1389,286,1103
2021,Gateshead 010E,E01008255,1989,363,1626
2021,Gateshead 019A,E01008256,1557,251,1306
2021,Gateshead 008E,E01008257,1391,217,1174
2021,Gateshead 007C,E01008258,2181,368,1813
2021,Gateshead 007D,E01008259,1901,365,1536
2021,Gateshead 019B,E01008260,1436,254,1182
2021,Gateshead 019C,E01008261,1296,251,1045
2021,Gateshead 009A,E01008262,1490,222,1268
2021,Gateshead 009B,E01008263,1313,267,1046
2021,Gateshead 009C,E01008264,1368,245,1123
2021,Gateshead 009D,E01008265,1262,213,1049
2021,Gateshead 009E,E01008266,1254,141,1113
2021,Gateshead 017A,E01008267,1456,191,1265
2021,Gateshead 019D,E01008268,1325,233,1092
2021,Gateshead 017B,E01008269,1393,239,1154
2021,Gateshead 017C,E01008270,1234,151,1083
2021,Gateshead 017D,E01008271,1270,202,1068
2021,Gateshead 019E,E01008272,1509,244,1265
2021,Gateshead 019F,E01008273,1334,264,1070
2021,Gateshead 019G,E01008274,1273,262,1011
2021,Gateshead 017E,E01008275,1346,195,1151
2021,Gateshead 005D,E01008276,1343,201,1142
2021,Gateshead 004D,E01008277,1464,257,1207
2021,Gateshead 022D,E01008278,1448,223,1225
2021,Gateshead 005E,E01008279,1324,154,1170
2021,Gateshead 004E,E01008280,1761,319,1442
2021,Gateshead 015E,E01008281,1488,271,1217
2021,Gateshead 015F,E01008282,1305,265,1040
2021,Gateshead 014A,E01008283,1181,139,1042
2021,Gateshead 014B,E01008284,1285,217,1068
2021,Gateshead 018E,E01008285,1304,267,1037
2021,Gateshead 014C,E01008286,1284,173,1111
2021,Gateshead 014D,E01008287,1807,377,1430
2021,Newcastle upon Tyne 027A,E01008288,1281,242,1039
2021,Newcastle upon Tyne 027B,E01008289,1624,423,1201
2021,Newcastle upon Tyne 027C,E01008290,1556,359,1197
2021,Newcastle upon Tyne 027D,E01008291,1916,610,1306
2021,Newcastle upon Tyne 027E,E01008292,1244,201,1043
2021,Newcastle upon Tyne 004A,E01008293,1310,184,1126
2021,Newcastle upon Tyne 033D,E01008294,1317,220,1097
2021,Newcastle upon Tyne 008A,E01008295,1687,493,1194
2021,Newcastle upon Tyne 011A,E01008296,1270,166,1104
2021,Newcastle upon Tyne 011B,E01008297,1810,351,1459
2021,Newcastle upon Tyne 011C,E01008298,1756,319,1437
2021,Newcastle upon Tyne 011D,E01008299,1311,331,980
2021,Newcastle upon Tyne 016A,E01008300,1905,456,1449
2021,Newcastle upon Tyne 040D,E01008301,1553,236,1317
2021,Newcastle upon Tyne 035D,E01008302,1526,318,1208
2021,Newcastle upon Tyne 018A,E01008303,1692,355,1337
2021,Newcastle upon Tyne 040C,E01008305,2258,643,1615
2021,Newcastle upon Tyne 032A,E01008306,2229,340,1889
2021,Newcastle upon Tyne 032B,E01008307,1276,172,1104
2021,Newcastle upon Tyne 002A,E01008309,1697,305,1392
2021,Newcastle upon Tyne 033A,E01008311,2108,505,1603
2021,Newcastle upon Tyne 033B,E01008312,1093,215,878
2021,Newcastle upon Tyne 033C,E01008313,1146,237,909
2021,Newcastle upon Tyne 012A,E01008314,1025,162,863
2021,Newcastle upon Tyne 012B,E01008315,1434,282,1152
2021,Newcastle upon Tyne 012C,E01008316,1437,232,1205
2021,Newcastle upon Tyne 007A,E01008317,1329,287,1042
2021,Newcastle upon Tyne 012D,E01008318,1253,274,979
2021,Newcastle upon Tyne 007B,E01008319,1722,365,1357
2021,Newcastle upon Tyne 007C,E01008320,1511,295,1216
2021,Newcastle upon Tyne 007D,E01008321,1625,286,1339
2021,Newcastle upon Tyne 007E,E01008322,1436,304,1132
2021,Newcastle upon Tyne 007F,E01008323,1550,269,1281
2021,Newcastle upon Tyne 015A,E01008324,1189,284,905
2021,Newcastle upon Tyne 015B,E01008325,1398,352,1046
2021,Newcastle upon Tyne 015C,E01008326,1311,226,1085
2021,Newcastle upon Tyne 015D,E01008327,1167,288,879
2021,Newcastle upon Tyne 015E,E01008328,1161,153,1008
2021,Newcastle upon Tyne 015F,E01008329,1372,251,1121
2021,Newcastle upon Tyne 015G,E01008330,1308,256,1052
2021,Newcastle upon Tyne 041A,E01008331,1742,592,1150
2021,Newcastle upon Tyne 038E,E01008333,1814,572,1242
2021,Newcastle upon Tyne 038A,E01008334,2082,612,1470
2021,Newcastle upon Tyne 038D,E01008335,1982,653,1329
2021,Newcastle upon Tyne 003A,E01008336,1272,245,1027
2021,Newcastle upon Tyne 003B,E01008337,1248,315,933
2021,Newcastle upon Tyne 003C,E01008338,1077,224,853
2021,Newcastle upon Tyne 003D,E01008339,1738,431,1307
2021,Newcastle upon Tyne 003E,E01008340,1649,420,1229
2021,Newcastle upon Tyne 003F,E01008341,1338,251,1087
2021,Newcastle upon Tyne 003G,E01008342,1289,175,1114
2021,Newcastle upon Tyne 019A,E01008343,1554,378,1176
2021,Newcastle upon Tyne 019B,E01008344,1425,252,1173
2021,Newcastle upon Tyne 019C,E01008345,1467,240,1227
2021,Newcastle upon Tyne 019D,E01008346,984,219,765
2021,Newcastle upon Tyne 019E,E01008347,1409,317,1092
2021,Newcastle upon Tyne 019F,E01008348,1114,308,806
2021,Newcastle upon Tyne 019G,E01008349,1603,545,1058
2021,Newcastle upon Tyne 019H,E01008350,1535,290,1245
2021,Newcastle upon Tyne 005A,E01008351,1313,207,1106
2021,Newcastle upon Tyne 002C,E01008352,1379,292,1087
2021,Newcastle upon Tyne 006A,E01008353,1437,285,1152
2021,Newcastle upon Tyne 005B,E01008354,1536,314,1222
2021,Newcastle upon Tyne 006B,E01008355,1454,262,1192
2021,Newcastle upon Tyne 006C,E01008356,1257,209,1048
2021,Newcastle upon Tyne 002D,E01008357,1462,228,1234
2021,Newcastle upon Tyne 002E,E01008358,1639,247,1392
2021,Newcastle upon Tyne 018B,E01008359,1363,462,901
2021,Newcastle upon Tyne 018C,E01008360,1469,252,1217
2021,Newcastle upon Tyne 018D,E01008361,1435,340,1095
2021,Newcastle upon Tyne 018E,E01008362,1495,484,1011
2021,Newcastle upon Tyne 012E,E01008363,1538,205,1333
2021,Newcastle upon Tyne 018F,E01008364,1423,330,1093
2021,Newcastle upon Tyne 012F,E01008365,1518,378,1140
2021,Newcastle upon Tyne 013A,E01008366,2082,1410,672
2021,Newcastle upon Tyne 017A,E01008367,2122,1250,872
2021,Newcastle upon Tyne 017B,E01008368,1711,1172,539
2021,Newcastle upon Tyne 013B,E01008369,1978,1259,719
2021,Newcastle upon Tyne 017C,E01008370,1832,684,1148
2021,Newcastle upon Tyne 013C,E01008371,1372,253,1119
2021,Newcastle upon Tyne 013D,E01008372,1788,1150,638
2021,Newcastle upon Tyne 013E,E01008373,2152,1698,454
2021,Newcastle upon Tyne 008B,E01008374,1424,285,1139
2021,Newcastle upon Tyne 008C,E01008375,1391,277,1114
2021,Newcastle upon Tyne 008D,E01008376,1094,212,882
2021,Newcastle upon Tyne 008E,E01008377,2151,627,1524
2021,Newcastle upon Tyne 006D,E01008378,1330,319,1011
2021,Newcastle upon Tyne 008F,E01008379,1605,352,1253
2021,Newcastle upon Tyne 008G,E01008380,1720,516,1204
2021,Newcastle upon Tyne 021A,E01008381,1384,223,1161
2021,Newcastle upon Tyne 021B,E01008382,1215,323,892
2021,Newcastle upon Tyne 021C,E01008383,1368,304,1064
2021,Newcastle upon Tyne 021D,E01008384,1285,246,1039
2021,Newcastle upon Tyne 021E,E01008385,1292,237,1055
2021,Newcastle upon Tyne 021F,E01008386,1222,213,1009
2021,Newcastle upon Tyne 021G,E01008387,1196,157,1039
2021,Newcastle upon Tyne 028A,E01008388,1672,404,1268
2021,Newcastle upon Tyne 028B,E01008389,1562,373,1189
2021,Newcastle upon Tyne 030A,E01008390,1774,465,1309
2021,Newcastle upon Tyne 035C,E01008391,1500,445,1055
2021,Newcastle upon Tyne 035A,E01008392,1715,262,1453
2021,Newcastle upon Tyne 022B,E01008396,2164,1154,1010
2021,Newcastle upon Tyne 036B,E01008397,2786,2283,503
2021,Newcastle upon Tyne 022C,E01008398,1668,501,1167
2021,Newcastle upon Tyne 039A,E01008399,1916,586,1330
2021,Newcastle upon Tyne 014A,E01008400,1643,302,1341
2021,Newcastle upon Tyne 014B,E01008401,1435,317,1118
2021,Newcastle upon Tyne 014C,E01008402,1362,257,1105
2021,Newcastle upon Tyne 014D,E01008403,1504,216,1288
2021,Newcastle upon Tyne 014E,E01008404,1478,220,1258
2021,Newcastle upon Tyne 014F,E01008405,1392,261,1131
2021,Newcastle upon Tyne 037A,E01008406,3920,2963,957
2021,Newcastle upon Tyne 034D,E01008407,3229,2384,845
2021,Newcastle upon Tyne 017D,E01008409,1485,556,929
2021,Newcastle upon Tyne 034B,E01008410,2483,1584,899
2021,Newcastle upon Tyne 017E,E01008411,1682,924,758
2021,Newcastle upon Tyne 034A,E01008412,1465,540,925
2021,Newcastle upon Tyne 034C,E01008413,1324,517,807
2021,Newcastle upon Tyne 025B,E01008415,1206,286,920
2021,Newcastle upon Tyne 025C,E01008416,1634,298,1336
2021,Newcastle upon Tyne 005C,E01008418,1859,340,1519
2021,Newcastle upon Tyne 006E,E01008419,1370,286,1084
2021,Newcastle upon Tyne 005D,E01008420,1238,248,990
2021,Newcastle upon Tyne 006F,E01008421,1427,320,1107
2021,Newcastle upon Tyne 005E,E01008422,1463,379,1084
2021,Newcastle upon Tyne 006G,E01008423,1250,253,997
2021,Newcastle upon Tyne 005F,E01008424,1418,353,1065
2021,Newcastle upon Tyne 030B,E01008425,1328,184,1144
2021,Newcastle upon Tyne 028C,E01008426,1497,389,1108
2021,Newcastle upon Tyne 030C,E01008427,1239,264,975
2021,Newcastle upon Tyne 030D,E01008428,1395,270,1125
2021,Newcastle upon Tyne 028D,E01008429,1463,334,1129
2021,Newcastle upon Tyne 020A,E01008430,1209,202,1007
2021,Newcastle upon Tyne 020B,E01008431,1443,224,1219
2021,Newcastle upon Tyne 035B,E01008432,1367,201,1166
2021,Newcastle upon Tyne 020C,E01008433,1320,180,1140
2021,Newcastle upon Tyne 020D,E01008434,1367,218,1149
2021,Newcastle upon Tyne 020E,E01008435,1465,310,1155
2021,Newcastle upon Tyne 020F,E01008436,1485,263,1222
2021,Newcastle upon Tyne 041C,E01008437,1597,504,1093
2021,Newcastle upon Tyne 041B,E01008438,1818,347,1471
2021,Newcastle upon Tyne 039D,E01008439,1639,405,1234
2021,Newcastle upon Tyne 031A,E01008441,1685,268,1417
2021,Newcastle upon Tyne 031B,E01008442,1259,185,1074
2021,Newcastle upon Tyne 014G,E01008443,1339,198,1141
2021,Newcastle upon Tyne 031C,E01008444,1520,217,1303
2021,Newcastle upon Tyne 031D,E01008445,1996,373,1623
2021,Newcastle upon Tyne 031E,E01008446,1308,157,1151
2021,Newcastle upon Tyne 031F,E01008447,1255,165,1090
2021,Newcastle upon Tyne 031G,E01008448,1328,170,1158
2021,Newcastle upon Tyne 022D,E01008449,1714,653,1061
2021,Newcastle upon Tyne 016B,E01008450,1639,509,1130
2021,Newcastle upon Tyne 016C,E01008451,1744,389,1355
2021,Newcastle upon Tyne 016D,E01008452,1390,312,1078
2021,Newcastle upon Tyne 022E,E01008453,1743,436,1307
2021,Newcastle upon Tyne 022G,E01008455,1613,577,1036
2021,Newcastle upon Tyne 004B,E01008456,1430,311,1119
2021,Newcastle upon Tyne 004C,E01008457,1486,259,1227
2021,Newcastle upon Tyne 004D,E01008458,2023,311,1712
2021,Newcastle upon Tyne 004E,E01008459,1715,457,1258
2021,Newcastle upon Tyne 004F,E01008460,1317,263,1054
2021,North Tyneside 021A,E01008461,1330,313,1017
2021,North Tyneside 024A,E01008462,1468,285,1183
2021,North Tyneside 024B,E01008463,1226,224,1002
2021,North Tyneside 024C,E01008464,1249,166,1083
2021,North Tyneside 024D,E01008465,1325,170,1155
2021,North Tyneside 021B,E01008466,1321,188,1133
2021,North Tyneside 021C,E01008467,1284,196,1088
2021,North Tyneside 021D,E01008468,1379,242,1137
2021,North Tyneside 018A,E01008469,1746,231,1515
2021,North Tyneside 014A,E01008470,1366,196,1170
2021,North Tyneside 019A,E01008471,1474,324,1150
2021,North Tyneside 018B,E01008472,1374,201,1173
2021,North Tyneside 018C,E01008473,1212,187,1025
2021,North Tyneside 019B,E01008474,1446,335,1111
2021,North Tyneside 008A,E01008475,1529,287,1242
2021,North Tyneside 008B,E01008476,1675,327,1348
2021,North Tyneside 008C,E01008477,1679,385,1294
2021,North Tyneside 002A,E01008478,1399,198,1201
2021,North Tyneside 008D,E01008479,1457,218,1239
2021,North Tyneside 002B,E01008480,1427,202,1225
2021,North Tyneside 023A,E01008481,1340,262,1078
2021,North Tyneside 023B,E01008482,1567,298,1269
2021,North Tyneside 022A,E01008483,1383,231,1152
2021,North Tyneside 023C,E01008484,1329,279,1050
2021,North Tyneside 023D,E01008485,1354,414,940
2021,North Tyneside 020A,E01008486,1295,208,1087
2021,North Tyneside 020B,E01008487,1395,233,1162
2021,North Tyneside 015A,E01008488,1367,291,1076
2021,North Tyneside 015B,E01008489,1748,457,1291
2021,North Tyneside 015C,E01008490,1476,212,1264
2021,North Tyneside 015D,E01008491,1452,389,1063
2021,North Tyneside 023E,E01008492,1615,368,1247
2021,North Tyneside 013A,E01008493,1421,269,1152
2021,North Tyneside 013B,E01008494,1526,253,1273
2021,North Tyneside 010A,E01008495,1666,301,1365
2021,North Tyneside 010B,E01008496,1425,211,1214
2021,North Tyneside 010C,E01008497,1387,181,1206
2021,North Tyneside 010D,E01008498,1461,183,1278
2021,North Tyneside 014B,E01008499,1575,296,1279
2021,North Tyneside 012A,E01008500,1458,196,1262
2021,North Tyneside 014C,E01008502,1465,275,1190
2021,North Tyneside 018E,E01008503,1868,327,1541
2021,North Tyneside 002C,E01008504,1456,180,1276
2021,North Tyneside 012B,E01008505,1693,276,1417
2021,North Tyneside 012C,E01008506,1300,285,1015
2021,North Tyneside 012D,E01008507,1602,253,1349
2021,North Tyneside 026A,E01008508,1489,330,1159
2021,North Tyneside 026B,E01008509,1590,295,1295
2021,North Tyneside 026C,E01008510,1448,206,1242
2021,North Tyneside 028A,E01008511,1559,316,1243
2021,North Tyneside 026D,E01008512,1533,216,1317
2021,North Tyneside 019C,E01008513,2080,309,1771
2021,North Tyneside 019D,E01008514,1708,305,1403
2021,North Tyneside 014D,E01008516,1877,320,1557
2021,North Tyneside 005A,E01008517,1501,340,1161
2021,North Tyneside 007A,E01008518,1498,211,1287
2021,North Tyneside 005B,E01008519,1175,149,1026
2021,North Tyneside 003A,E01008520,1337,280,1057
2021,North Tyneside 005C,E01008521,1388,177,1211
2021,North Tyneside 005D,E01008522,1469,252,1217
2021,North Tyneside 003B,E01008523,1255,306,949
2021,North Tyneside 022B,E01008524,1780,151,1629
2021,North Tyneside 017A,E01008525,1449,196,1253
2021,North Tyneside 020C,E01008526,1385,207,1178
2021,North Tyneside 017B,E01008527,1331,176,1155
2021,North Tyneside 022C,E01008528,1269,174,1095
2021,North Tyneside 022D,E01008529,1436,198,1238
2021,North Tyneside 020D,E01008530,1480,185,1295
2021,North Tyneside 025A,E01008531,1270,166,1104
2021,North Tyneside 025B,E01008532,1549,275,1274
2021,North Tyneside 030A,E01008533,1413,280,1133
2021,North Tyneside 025C,E01008534,1191,130,1061
2021,North Tyneside 030B,E01008535,1411,177,1234
2021,North Tyneside 030C,E01008536,1364,257,1107
2021,North Tyneside 030D,E01008537,1105,172,933
2021,North Tyneside 025D,E01008538,2316,439,1877
2021,North Tyneside 027A,E01008539,1496,186,1310
2021,North Tyneside 027B,E01008540,1598,405,1193
2021,North Tyneside 027C,E01008541,1416,224,1192
2021,North Tyneside 028B,E01008542,1546,372,1174
2021,North Tyneside 028C,E01008543,2362,512,1850
2021,North Tyneside 027D,E01008544,1456,192,1264
2021,North Tyneside 027E,E01008545,1188,200,988
2021,North Tyneside 003C,E01008546,1521,362,1159
2021,North Tyneside 001A,E01008547,1355,254,1101
2021,North Tyneside 001B,E01008548,1713,319,1394
2021,North Tyneside 001C,E01008549,1469,279,1190
2021,North Tyneside 003D,E01008550,1515,339,1176
2021,North Tyneside 001D,E01008551,1375,241,1134
2021,North Tyneside 009A,E01008552,1509,204,1305
2021,North Tyneside 009B,E01008553,1664,270,1394
2021,North Tyneside 009C,E01008554,1587,355,1232
2021,North Tyneside 009D,E01008555,1609,402,1207
2021,North Tyneside 013C,E01008556,1938,339,1599
2021,North Tyneside 013D,E01008557,1566,260,1306
2021,North Tyneside 016A,E01008558,1398,175,1223
2021,North Tyneside 017C,E01008559,1415,228,1187
2021,North Tyneside 016B,E01008560,1544,228,1316
2021,North Tyneside 016C,E01008561,1570,216,1354
2021,North Tyneside 016D,E01008562,1400,274,1126
2021,North Tyneside 017D,E01008563,1348,242,1106
2021,North Tyneside 007B,E01008564,1376,211,1165
2021,North Tyneside 007D,E01008567,1403,303,1100
2021,North Tyneside 011B,E01008568,1417,214,1203
2021,North Tyneside 011C,E01008569,1391,266,1125
2021,North Tyneside 011D,E01008570,1216,218,998
2021,North Tyneside 028D,E01008571,1694,265,1429
2021,North Tyneside 029A,E01008572,1502,212,1290
2021,North Tyneside 029B,E01008573,1520,254,1266
2021,North Tyneside 029C,E01008574,1839,322,1517
2021,North Tyneside 030E,E01008575,1261,205,1056
2021,North Tyneside 029D,E01008576,1938,481,1457
2021,North Tyneside 004A,E01008577,1778,298,1480
2021,North Tyneside 002D,E01008578,1270,205,1065
2021,North Tyneside 004B,E01008579,1338,165,1173
2021,North Tyneside 004C,E01008580,1231,195,1036
2021,North Tyneside 004D,E01008581,1726,227,1499
2021,North Tyneside 004E,E01008582,1277,221,1056
2021,North Tyneside 002E,E01008583,1364,247,1117
2021,North Tyneside 006A,E01008584,1528,259,1269
2021,North Tyneside 006B,E01008585,1446,298,1148
2021,North Tyneside 009E,E01008586,1432,315,1117
2021,North Tyneside 006C,E01008587,1330,216,1114
2021,North Tyneside 006D,E01008588,1513,320,1193
2021,North Tyneside 006E,E01008589,1372,255,1117
2021,South Tyneside 011A,E01008590,1337,205,1132
2021,South Tyneside 011B,E01008591,1160,150,1010
2021,South Tyneside 011C,E01008592,1141,171,970
2021,South Tyneside 016A,E01008593,1243,285,958
2021,South Tyneside 011D,E01008594,1688,326,1362
2021,South Tyneside 001A,E01008595,1343,177,1166
2021,South Tyneside 001B,E01008596,1338,396,942
2021,South Tyneside 001C,E01008597,2254,386,1868
2021,South Tyneside 001D,E01008598,1398,300,1098
2021,South Tyneside 001E,E01008599,1380,262,1118
2021,South Tyneside 007A,E01008600,1145,226,919
2021,South Tyneside 012A,E01008601,1455,310,1145
2021,South Tyneside 014A,E01008602,1333,315,1018
2021,South Tyneside 014B,E01008603,1263,233,1030
2021,South Tyneside 007B,E01008604,1513,275,1238
2021,South Tyneside 016B,E01008605,1051,174,877
2021,South Tyneside 016C,E01008606,1590,331,1259
2021,South Tyneside 016D,E01008607,1312,341,971
2021,South Tyneside 014C,E01008608,1044,211,833
2021,South Tyneside 016E,E01008609,1381,326,1055
2021,South Tyneside 021A,E01008610,1387,289,1098
2021,South Tyneside 021B,E01008611,1283,189,1094
2021,South Tyneside 021C,E01008612,1386,190,1196
2021,South Tyneside 021D,E01008613,1391,238,1153
2021,South Tyneside 023A,E01008614,1590,368,1222
2021,South Tyneside 023B,E01008615,1327,185,1142
2021,South Tyneside 022A,E01008616,1405,251,1154
2021,South Tyneside 023C,E01008617,1339,210,1129
2021,South Tyneside 022B,E01008618,1250,224,1026
2021,South Tyneside 022C,E01008619,1528,233,1295
2021,South Tyneside 023D,E01008620,1381,274,1107
2021,South Tyneside 022D,E01008621,1372,226,1146
2021,South Tyneside 013A,E01008622,1611,218,1393
2021,South Tyneside 018A,E01008624,1253,244,1009
2021,South Tyneside 013C,E01008625,1290,240,1050
2021,South Tyneside 020A,E01008627,1158,155,1003
2021,South Tyneside 020B,E01008628,1321,290,1031
2021,South Tyneside 020C,E01008629,1307,200,1107
2021,South Tyneside 020D,E01008630,1350,330,1020
2021,South Tyneside 017A,E01008631,1273,264,1009
2021,South Tyneside 017B,E01008632,1164,237,927
2021,South Tyneside 008A,E01008633,1343,350,993
2021,South Tyneside 008B,E01008634,1167,234,933
2021,South Tyneside 006A,E01008635,1289,200,1089
2021,South Tyneside 008C,E01008636,1320,249,1071
2021,South Tyneside 008D,E01008637,1341,255,1086
2021,South Tyneside 010A,E01008638,1191,155,1036
2021,South Tyneside 009A,E01008639,2232,476,1756
2021,South Tyneside 010B,E01008640,2478,438,2040
2021,South Tyneside 010C,E01008641,993,162,831
2021,South Tyneside 010D,E01008642,1731,273,1458
2021,South Tyneside 015A,E01008643,1619,285,1334
2021,South Tyneside 015B,E01008644,1468,281,1187
2021,South Tyneside 015C,E01008645,2457,515,1942
2021,South Tyneside 015D,E01008646,1260,195,1065
2021,South Tyneside 004A,E01008647,1388,186,1202
2021,South Tyneside 004B,E01008648,1286,156,1130
2021,South Tyneside 004C,E01008649,1471,349,1122
2021,South Tyneside 006B,E01008650,1251,185,1066
2021,South Tyneside 004D,E01008651,1709,455,1254
2021,South Tyneside 009B,E01008652,1152,201,951
2021,South Tyneside 009C,E01008653,1152,266,886
2021,South Tyneside 009D,E01008654,1056,152,904
2021,South Tyneside 009E,E01008655,1704,313,1391
2021,South Tyneside 015E,E01008656,1353,224,1129
2021,South Tyneside 009F,E01008657,1215,193,1022
2021,South Tyneside 015F,E01008658,1373,349,1024
2021,South Tyneside 017C,E01008659,1393,271,1122
2021,South Tyneside 007C,E01008660,1283,180,1103
2021,South Tyneside 007D,E01008661,1034,202,832
2021,South Tyneside 017D,E01008662,1130,226,904
2021,South Tyneside 017E,E01008663,1300,225,1075
2021,South Tyneside 002A,E01008664,1143,210,933
2021,South Tyneside 002B,E01008665,1185,159,1026
2021,South Tyneside 002C,E01008666,1694,315,1379
2021,South Tyneside 002D,E01008667,1628,221,1407
2021,South Tyneside 002E,E01008668,1331,250,1081
2021,South Tyneside 012B,E01008669,1363,257,1106
2021,South Tyneside 014D,E01008670,1385,258,1127
2021,South Tyneside 012C,E01008671,995,117,878
2021,South Tyneside 012D,E01008672,1264,213,1051
2021,South Tyneside 003A,E01008673,1078,163,915
2021,South Tyneside 006C,E01008674,1150,186,964
2021,South Tyneside 003B,E01008675,1191,143,1048
2021,South Tyneside 003C,E01008676,1118,185,933
2021,South Tyneside 003D,E01008677,1267,220,1047
2021,South Tyneside 003E,E01008678,1061,144,917
2021,South Tyneside 005A,E01008679,1165,187,978
2021,South Tyneside 005B,E01008680,1373,211,1162
2021,South Tyneside 006D,E01008681,1356,214,1142
2021,South Tyneside 005C,E01008682,1091,250,841
2021,South Tyneside 005D,E01008683,1165,137,1028
2021,South Tyneside 018B,E01008684,993,142,851
2021,South Tyneside 018C,E01008685,1707,284,1423
2021,South Tyneside 018D,E01008686,1579,331,1248
2021,South Tyneside 018E,E01008687,1749,236,1513
2021,South Tyneside 019A,E01008688,1254,248,1006
2021,South Tyneside 019B,E01008689,1352,210,1142
2021,South Tyneside 019C,E01008690,1284,256,1028
2021,South Tyneside 019D,E01008691,1095,150,945
2021,South Tyneside 019E,E01008692,1272,221,1051
2021,Sunderland 008A,E01008693,1333,247,1086
2021,Sunderland 008B,E01008694,1302,246,1056
2021,Sunderland 008C,E01008695,1327,288,1039
2021,Sunderland 008D,E01008696,1175,202,973
2021,Sunderland 008E,E01008697,1336,223,1113
2021,Sunderland 003A,E01008698,1349,227,1122
2021,Sunderland 008F,E01008699,1298,259,1039
2021,Sunderland 013A,E01008700,1841,714,1127
2021,Sunderland 011A,E01008701,1537,549,988
2021,Sunderland 016A,E01008702,1108,200,908
2021,Sunderland 013B,E01008703,2147,866,1281
2021,Sunderland 011B,E01008704,1433,411,1022
2021,Sunderland 013C,E01008705,1003,226,777
2021,Sunderland 011C,E01008706,1378,283,1095
2021,Sunderland 011D,E01008707,1161,304,857
2021,Sunderland 005A,E01008708,1351,220,1131
2021,Sunderland 005B,E01008709,1115,171,944
2021,Sunderland 005D,E01008711,1383,231,1152
2021,Sunderland 004A,E01008712,1719,312,1407
2021,Sunderland 001A,E01008713,1456,224,1232
2021,Sunderland 034A,E01008714,1417,358,1059
2021,Sunderland 034B,E01008715,1278,254,1024
2021,Sunderland 034C,E01008716,1405,196,1209
2021,Sunderland 034D,E01008717,1475,284,1191
2021,Sunderland 035A,E01008718,1638,239,1399
2021,Sunderland 035B,E01008719,1132,150,982
2021,Sunderland 032A,E01008720,1265,193,1072
2021,Sunderland 032B,E01008721,1494,294,1200
2021,Sunderland 001B,E01008722,1344,182,1162
2021,Sunderland 002A,E01008723,1368,212,1156
2021,Sunderland 001C,E01008724,1082,160,922
2021,Sunderland 002B,E01008725,1306,172,1134
2021,Sunderland 001D,E01008726,1354,161,1193
2021,Sunderland 002C,E01008727,1407,188,1219
2021,Sunderland 002D,E01008728,1288,196,1092
2021,Sunderland 021B,E01008730,1536,399,1137
2021,Sunderland 021D,E01008732,1837,334,1503
2021,Sunderland 021E,E01008733,1505,254,1251
2021,Sunderland 021F,E01008734,1270,123,1147
2021,Sunderland 016B,E01008735,1805,381,1424
2021,Sunderland 016C,E01008736,965,190,775
2021,Sunderland 016D,E01008737,1169,271,898
2021,Sunderland 016E,E01008738,995,183,812
2021,Sunderland 024A,E01008739,1415,316,1099
2021,Sunderland 022A,E01008740,1371,197,1174
2021,Sunderland 024B,E01008741,1355,233,1122
2021,Sunderland 035C,E01008742,1446,223,1223
2021,Sunderland 036A,E01008743,1470,340,1130
2021,Sunderland 036B,E01008744,1923,382,1541
2021,Sunderland 036C,E01008745,1548,239,1309
2021,Sunderland 036D,E01008746,1961,422,1539
2021,Sunderland 035D,E01008747,1646,266,1380
2021,Sunderland 035E,E01008748,1419,169,1250
2021,Sunderland 034E,E01008749,1231,133,1098
2021,Sunderland 033A,E01008750,1919,312,1607
2021,Sunderland 033B,E01008751,1355,249,1106
2021,Sunderland 033C,E01008752,1834,400,1434
2021,Sunderland 033D,E01008753,1223,213,1010
2021,Sunderland 034F,E01008754,1303,226,1077
2021,Sunderland 033E,E01008755,1206,195,1011
2021,Sunderland 012A,E01008756,1423,288,1135
2021,Sunderland 015A,E01008757,1250,193,1057
2021,Sunderland 015B,E01008758,1312,211,1101
2021,Sunderland 015C,E01008759,1353,177,1176
2021,Sunderland 018A,E01008760,1350,237,1113
2021,Sunderland 015D,E01008761,1326,171,1155
2021,Sunderland 012B,E01008762,1564,326,1238
2021,Sunderland 028A,E01008763,1360,305,1055
2021,Sunderland 028B,E01008764,1408,230,1178
2021,Sunderland 031A,E01008765,1467,256,1211
2021,Sunderland 028C,E01008766,2760,628,2132
2021,Sunderland 031B,E01008767,1287,185,1102
2021,Sunderland 028D,E01008768,1880,378,1502
2021,Sunderland 028E,E01008769,1571,307,1264
2021,Sunderland 031C,E01008770,1202,187,1015
2021,Sunderland 031D,E01008771,1410,264,1146
2021,Sunderland 029A,E01008772,1335,214,1121
2021,Sunderland 026A,E01008773,1203,227,976
2021,Sunderland 029B,E01008774,1237,187,1050
2021,Sunderland 029C,E01008775,1323,182,1141
2021,Sunderland 026B,E01008776,1172,287,885
2021,Sunderland 026C,E01008777,1363,82,1281
2021,Sunderland 026D,E01008778,1244,212,1032
2021,Sunderland 024C,E01008779,1280,220,1060
2021,Sunderland 024D,E01008780,1844,352,1492
2021,Sunderland 022B,E01008781,1395,216,1179
2021,Sunderland 022C,E01008782,1319,189,1130
2021,Sunderland 022D,E01008783,1334,216,1118
2021,Sunderland 022E,E01008784,1441,261,1180
2021,Sunderland 022F,E01008785,1288,144,1144
2021,Sunderland 006A,E01008786,1359,229,1130
2021,Sunderland 006B,E01008787,1369,276,1093
2021,Sunderland 006C,E01008788,1375,206,1169
2021,Sunderland 006D,E01008789,1251,156,1095
2021,Sunderland 006E,E01008790,1341,212,1129
2021,Sunderland 006F,E01008791,1533,299,1234
2021,Sunderland 002E,E01008792,1222,137,1085
2021,Sunderland 030A,E01008793,1503,308,1195
2021,Sunderland 030B,E01008795,1648,295,1353
2021,Sunderland 032D,E01008796,1778,295,1483
2021,Sunderland 025A,E01008799,1564,272,1292
2021,Sunderland 030D,E01008800,1435,340,1095
2021,Sunderland 030E,E01008801,1469,203,1266
2021,Sunderland 029D,E01008802,1313,145,1168
2021,Sunderland 027A,E01008803,1380,261,1119
2021,Sunderland 027B,E01008804,1532,255,1277
2021,Sunderland 027C,E01008805,1238,235,1003
2021,Sunderland 029E,E01008808,1432,200,1232
2021,Sunderland 026E,E01008809,1502,230,1272
2021,Sunderland 014A,E01008810,1499,354,1145
2021,Sunderland 014B,E01008811,1489,242,1247
2021,Sunderland 012C,E01008812,1578,360,1218
2021,Sunderland 014C,E01008813,1507,218,1289
2021,Sunderland 014D,E01008814,1406,227,1179
2021,Sunderland 004B,E01008817,1133,282,851
2021,Sunderland 004C,E01008819,1309,243,1066
2021,Sunderland 004D,E01008821,1394,331,1063
2021,Sunderland 004E,E01008822,1434,266,1168
2021,Sunderland 023A,E01008823,1333,312,1021
2021,Sunderland 023B,E01008824,1305,297,1008
2021,Sunderland 023C,E01008825,1431,271,1160
2021,Sunderland 023D,E01008826,1302,239,1063
2021,Sunderland 023E,E01008827,1101,249,852
2021,Sunderland 023F,E01008828,1410,357,1053
2021,Sunderland 023G,E01008829,1211,246,965
2021,Sunderland 018B,E01008830,1273,378,895
2021,Sunderland 013D,E01008831,1771,583,1188
2021,Sunderland 018C,E01008832,1352,347,1005
2021,Sunderland 018D,E01008833,1275,249,1026
2021,Sunderland 013E,E01008834,1413,242,1171
2021,Sunderland 022G,E01008835,1466,324,1142
2021,Sunderland 016F,E01008836,1244,245,999
2021,Sunderland 003B,E01008837,1169,236,933
2021,Sunderland 003C,E01008838,1390,308,1082
2021,Sunderland 003D,E01008839,1260,229,1031
2021,Sunderland 003E,E01008840,1299,297,1002
2021,Sunderland 003F,E01008841,1288,288,1000
2021,Sunderland 004F,E01008842,1322,223,1099
2021,Sunderland 019A,E01008843,1171,176,995
2021,Sunderland 019B,E01008844,1382,201,1181
2021,Sunderland 017A,E01008845,1345,170,1175
2021,Sunderland 017B,E01008846,1134,293,841
2021,Sunderland 017C,E01008847,1277,344,933
2021,Sunderland 019C,E01008848,1259,149,1110
2021,Sunderland 019D,E01008849,1309,353,956
2021,Sunderland 017E,E01008851,1470,253,1217
2021,Sunderland 019E,E01008852,1082,156,926
2021,Sunderland 009A,E01008853,1292,254,1038
2021,Sunderland 009B,E01008854,1168,176,992
2021,Sunderland 007A,E01008855,1331,276,1055
2021,Sunderland 007B,E01008856,1222,130,1092
2021,Sunderland 009C,E01008857,1268,265,1003
2021,Sunderland 009D,E01008858,1132,217,915
2021,Sunderland 009E,E01008859,1277,380,897
2021,Sunderland 009F,E01008860,1218,222,996
2021,Sunderland 025B,E01008861,1388,266,1122
2021,Sunderland 025C,E01008862,1251,177,1074
2021,Sunderland 025D,E01008863,1491,239,1252
2021,Sunderland 025E,E01008864,1177,148,1029
2021,Sunderland 025F,E01008865,1279,198,1081
2021,Sunderland 025G,E01008866,1306,292,1014
2021,Sunderland 020A,E01008867,1445,336,1109
2021,Sunderland 020B,E01008868,1053,123,930
2021,Sunderland 020C,E01008869,1174,196,978
2021,Sunderland 020D,E01008870,1286,191,1095
2021,Sunderland 020E,E01008871,1317,277,1040
2021,Sunderland 020F,E01008872,1592,216,1376
2021,Sunderland 010A,E01008873,1162,184,978
2021,Sunderland 010B,E01008874,1642,427,1215
2021,Sunderland 010C,E01008875,1378,247,1131
2021,Sunderland 007C,E01008876,1589,292,1297
2021,Sunderland 007D,E01008877,1506,236,1270
2021,Sunderland 009G,E01008878,1406,271,1135
2021,Sunderland 010D,E01008879,1215,175,1040
2021,Sunderland 010E,E01008880,1039,161,878
2021,Birmingham 067A,E01008881,1625,466,1159
2021,Birmingham 066A,E01008882,1875,606,1269
2021,Birmingham 078A,E01008883,1855,557,1298
2021,Birmingham 078B,E01008884,1993,670,1323
2021,Birmingham 076A,E01008885,1259,274,985
2021,Birmingham 076B,E01008886,1473,333,1140
2021,Birmingham 078C,E01008887,1572,447,1125
2021,Birmingham 076C,E01008888,1539,325,1214
2021,Birmingham 078D,E01008889,1676,378,1298
2021,Birmingham 089A,E01008890,1695,372,1323
2021,Birmingham 089B,E01008891,1488,275,1213
2021,Birmingham 089C,E01008892,1389,397,992
2021,Birmingham 089D,E01008893,1617,312,1305
2021,Birmingham 089E,E01008894,1515,235,1280
2021,Birmingham 089F,E01008895,1771,394,1377
2021,Birmingham 066B,E01008896,1736,634,1102
2021,Birmingham 067B,E01008897,1834,586,1248
2021,Birmingham 066C,E01008898,1627,514,1113
2021,Birmingham 037A,E01008899,1203,422,781
2021,Birmingham 037C,E01008901,1700,509,1191
2021,Birmingham 040A,E01008905,1814,621,1193
2021,Birmingham 049A,E01008906,1822,693,1129
2021,Birmingham 040B,E01008907,1669,546,1123
2021,Birmingham 041D,E01008909,1957,801,1156
2021,Birmingham 050A,E01008910,1599,599,1000
2021,Birmingham 049B,E01008911,1725,717,1008
2021,Birmingham 050B,E01008913,2027,618,1409
2021,Birmingham 030A,E01008915,1576,545,1031
2021,Birmingham 037E,E01008916,1586,565,1021
2021,Birmingham 102A,E01008917,1180,241,939
2021,Birmingham 094A,E01008918,1598,419,1179
2021,Birmingham 095A,E01008919,1541,380,1161
2021,Birmingham 094B,E01008920,1243,246,997
2021,Birmingham 094C,E01008921,1360,303,1057
2021,Birmingham 102B,E01008923,1409,353,1056
2021,Birmingham 101A,E01008924,1417,258,1159
2021,Birmingham 102C,E01008925,1124,167,957
2021,Birmingham 102D,E01008927,1206,264,942
2021,Birmingham 102E,E01008928,1476,346,1130
2021,Birmingham 106C,E01008929,1492,404,1088
2021,Birmingham 106D,E01008930,1826,470,1356
2021,Birmingham 094D,E01008931,1347,355,992
2021,Birmingham 111A,E01008932,1501,380,1121
2021,Birmingham 105A,E01008933,1516,400,1116
2021,Birmingham 105B,E01008934,1410,309,1101
2021,Birmingham 111B,E01008935,1661,474,1187
2021,Birmingham 111C,E01008936,1542,332,1210
2021,Birmingham 115A,E01008937,1473,373,1100
2021,Birmingham 111D,E01008938,1558,485,1073
2021,Birmingham 111E,E01008939,1534,336,1198
2021,Birmingham 115B,E01008940,1505,417,1088
2021,Birmingham 115C,E01008941,1482,403,1079
2021,Birmingham 117A,E01008942,1503,356,1147
2021,Birmingham 117B,E01008943,1369,305,1064
2021,Birmingham 115D,E01008944,1599,377,1222
2021,Birmingham 122A,E01008945,1710,389,1321
2021,Birmingham 122B,E01008946,1450,274,1176
2021,Birmingham 122C,E01008947,1261,253,1008
2021,Birmingham 122D,E01008948,1361,236,1125
2021,Birmingham 122E,E01008949,1124,163,961
2021,Birmingham 113A,E01008950,1375,215,1160
2021,Birmingham 112A,E01008951,1337,298,1039
2021,Birmingham 112B,E01008952,1675,253,1422
2021,Birmingham 107A,E01008953,1459,338,1121
2021,Birmingham 113B,E01008954,1370,273,1097
2021,Birmingham 112C,E01008955,1575,284,1291
2021,Birmingham 112D,E01008956,1353,295,1058
2021,Birmingham 112E,E01008957,1496,310,1186
2021,Birmingham 113C,E01008958,1472,280,1192
2021,Birmingham 116A,E01008959,1657,319,1338
2021,Birmingham 116B,E01008960,1463,281,1182
2021,Birmingham 116C,E01008961,1348,189,1159
2021,Birmingham 116D,E01008962,1920,550,1370
2021,Birmingham 107B,E01008963,1389,332,1057
2021,Birmingham 107C,E01008964,1379,292,1087
2021,Birmingham 107D,E01008965,1354,250,1104
2021,Birmingham 107E,E01008966,1627,450,1177
2021,Birmingham 110A,E01008967,1494,278,1216
2021,Birmingham 110B,E01008968,1716,389,1327
2021,Birmingham 117C,E01008969,1567,310,1257
2021,Birmingham 110C,E01008970,1363,324,1039
2021,Birmingham 117D,E01008971,1638,321,1317
2021,Birmingham 118A,E01008972,1773,415,1358
2021,Birmingham 118B,E01008973,1809,329,1480
2021,Birmingham 118C,E01008974,2642,592,2050
2021,Birmingham 118D,E01008975,1396,233,1163
2021,Birmingham 121A,E01008976,1425,334,1091
2021,Birmingham 123A,E01008977,1455,309,1146
2021,Birmingham 121B,E01008978,1261,323,938
2021,Birmingham 121C,E01008979,1468,347,1121
2021,Birmingham 121D,E01008980,1586,436,1150
2021,Birmingham 110D,E01008981,1462,287,1175
2021,Birmingham 079A,E01008982,1595,534,1061
2021,Birmingham 074A,E01008984,1609,433,1176
2021,Birmingham 064A,E01008986,1490,306,1184
2021,Birmingham 064B,E01008987,1544,666,878
2021,Birmingham 064C,E01008988,1981,400,1581
2021,Birmingham 064D,E01008989,1624,313,1311
2021,Birmingham 064E,E01008990,1128,246,882
2021,Birmingham 064F,E01008991,1748,463,1285
2021,Birmingham 079C,E01008992,1637,798,839
2021,Birmingham 074B,E01008994,1515,465,1050
2021,Birmingham 134A,E01008995,2225,807,1418
2021,Birmingham 074C,E01008996,1707,516,1191
2021,Birmingham 074D,E01008997,1471,362,1109
2021,Birmingham 031A,E01008998,1776,533,1243
2021,Birmingham 031B,E01008999,1490,382,1108
2021,Birmingham 031C,E01009000,1651,269,1382
2021,Birmingham 018A,E01009001,1561,276,1285
2021,Birmingham 023A,E01009002,1809,579,1230
2021,Birmingham 018B,E01009003,1679,217,1462
2021,Birmingham 025A,E01009005,1645,374,1271
2021,Birmingham 023C,E01009006,1457,237,1220
2021,Birmingham 023D,E01009007,1720,330,1390
2021,Birmingham 141A,E01009008,1369,225,1144
2021,Birmingham 025B,E01009009,1411,263,1148
2021,Birmingham 141B,E01009011,1657,297,1360
2021,Birmingham 141C,E01009012,1416,261,1155
2021,Birmingham 031D,E01009013,1902,358,1544
2021,Birmingham 090A,E01009014,2413,838,1575
2021,Birmingham 089G,E01009015,1721,375,1346
2021,Birmingham 098A,E01009016,1552,329,1223
2021,Birmingham 097A,E01009017,1683,544,1139
2021,Birmingham 090B,E01009018,1765,354,1411
2021,Birmingham 103A,E01009019,1676,520,1156
2021,Birmingham 103B,E01009020,1492,418,1074
2021,Birmingham 103C,E01009021,1574,431,1143
2021,Birmingham 098B,E01009022,1712,495,1217
2021,Birmingham 098C,E01009023,1587,430,1157
2021,Birmingham 103D,E01009024,1675,502,1173
2021,Birmingham 103E,E01009025,1475,421,1054
2021,Birmingham 090C,E01009026,1788,530,1258
2021,Birmingham 090D,E01009028,1703,552,1151
2021,Birmingham 090E,E01009029,1440,428,1012
2021,Birmingham 098D,E01009030,1734,437,1297
2021,Birmingham 105C,E01009031,1705,374,1331
2021,Birmingham 108A,E01009032,1792,486,1306
2021,Birmingham 103F,E01009033,1743,516,1227
2021,Birmingham 108B,E01009034,1649,375,1274
2021,Birmingham 108C,E01009035,1754,497,1257
2021,Birmingham 108D,E01009036,1507,371,1136
2021,Birmingham 105D,E01009037,1796,352,1444
2021,Birmingham 132A,E01009039,1680,420,1260
2021,Birmingham 132B,E01009040,1717,418,1299
2021,Birmingham 132C,E01009041,1606,366,1240
2021,Birmingham 132D,E01009042,1267,306,961
2021,Birmingham 097B,E01009043,1877,509,1368
2021,Birmingham 097C,E01009044,1625,552,1073
2021,Birmingham 097D,E01009045,1916,505,1411
2021,Birmingham 097E,E01009046,1728,411,1317
2021,Birmingham 040C,E01009047,1691,470,1221
2021,Birmingham 040D,E01009048,1904,464,1440
2021,Birmingham 032A,E01009049,1558,376,1182
2021,Birmingham 035A,E01009050,2056,642,1414
2021,Birmingham 033A,E01009051,1696,526,1170
2021,Birmingham 033B,E01009053,1454,488,966
2021,Birmingham 033C,E01009054,1544,451,1093
2021,Birmingham 032B,E01009056,2097,632,1465
2021,Birmingham 035D,E01009057,1850,635,1215
2021,Birmingham 033D,E01009058,1805,637,1168
2021,Birmingham 035E,E01009059,1680,506,1174
2021,Birmingham 035F,E01009060,1598,475,1123
2021,Birmingham 033E,E01009061,1757,597,1160
2021,Birmingham 040E,E01009062,1726,526,1200
2021,Birmingham 095B,E01009064,1406,359,1047
2021,Birmingham 075A,E01009065,1545,320,1225
2021,Birmingham 073A,E01009066,1864,349,1515
2021,Birmingham 075B,E01009067,1414,259,1155
2021,Birmingham 075C,E01009068,1489,350,1139
2021,Birmingham 075D,E01009069,1553,302,1251
2021,Birmingham 073B,E01009070,1504,283,1221
2021,Birmingham 087B,E01009071,1616,375,1241
2021,Birmingham 075E,E01009072,1674,314,1360
2021,Birmingham 085A,E01009073,1603,618,985
2021,Birmingham 085B,E01009074,1641,531,1110
2021,Birmingham 087C,E01009075,1563,461,1102
2021,Birmingham 095C,E01009077,1493,321,1172
2021,Birmingham 087E,E01009078,1452,567,885
2021,Birmingham 141G,E01009079,1286,415,871
2021,Birmingham 141F,E01009080,1229,499,730
2021,Birmingham 141H,E01009081,1252,361,891
2021,Birmingham 044A,E01009082,1391,449,942
2021,Birmingham 141I,E01009083,1490,514,976
2021,Birmingham 042A,E01009084,1810,566,1244
2021,Birmingham 042B,E01009085,1980,624,1356
2021,Birmingham 044B,E01009086,2057,618,1439
2021,Birmingham 042C,E01009087,1624,489,1135
2021,Birmingham 045A,E01009088,1492,284,1208
2021,Birmingham 042D,E01009089,1655,548,1107
2021,Birmingham 042E,E01009090,1973,617,1356
2021,Birmingham 045B,E01009091,1558,367,1191
2021,Birmingham 054A,E01009092,1607,508,1099
2021,Birmingham 054B,E01009093,1547,451,1096
2021,Birmingham 054C,E01009094,1473,429,1044
2021,Birmingham 056A,E01009095,1685,448,1237
2021,Birmingham 029A,E01009096,1581,323,1258
2021,Birmingham 029B,E01009097,1908,490,1418
2021,Birmingham 025C,E01009098,1985,434,1551
2021,Birmingham 029C,E01009099,1629,415,1214
2021,Birmingham 025D,E01009100,1838,366,1472
2021,Birmingham 029D,E01009101,1427,303,1124
2021,Birmingham 141E,E01009102,1492,367,1125
2021,Birmingham 029E,E01009103,1472,364,1108
2021,Birmingham 141D,E01009104,1541,389,1152
2021,Birmingham 025E,E01009105,1668,357,1311
2021,Birmingham 029F,E01009106,1267,194,1073
2021,Birmingham 128A,E01009107,1531,463,1068
2021,Birmingham 127A,E01009108,972,169,803
2021,Birmingham 123B,E01009109,1283,403,880
2021,Birmingham 128B,E01009110,1291,280,1011
2021,Birmingham 127B,E01009111,1443,324,1119
2021,Birmingham 127C,E01009112,1527,288,1239
2021,Birmingham 128C,E01009113,1561,474,1087
2021,Birmingham 128D,E01009114,1350,290,1060
2021,Birmingham 128E,E01009115,1346,323,1023
2021,Birmingham 127D,E01009116,1321,243,1078
2021,Birmingham 126A,E01009117,1917,671,1246
2021,Birmingham 127E,E01009118,1472,302,1170
2021,Birmingham 123C,E01009119,1364,245,1119
2021,Birmingham 123D,E01009120,1595,281,1314
2021,Birmingham 014B,E01009122,1531,376,1155
2021,Birmingham 022A,E01009123,1513,426,1087
2021,Birmingham 022B,E01009124,1890,774,1116
2021,Birmingham 022C,E01009125,1912,527,1385
2021,Birmingham 026A,E01009126,1385,324,1061
2021,Birmingham 011A,E01009127,1438,389,1049
2021,Birmingham 011B,E01009128,1283,354,929
2021,Birmingham 014C,E01009129,1503,426,1077
2021,Birmingham 011C,E01009130,1391,336,1055
2021,Birmingham 011D,E01009131,1368,365,1003
2021,Birmingham 014D,E01009132,1426,354,1072
2021,Birmingham 011E,E01009133,1403,390,1013
2021,Birmingham 011F,E01009134,1557,390,1167
2021,Birmingham 010A,E01009135,1340,243,1097
2021,Birmingham 014E,E01009136,1653,334,1319
2021,Birmingham 011G,E01009137,1514,432,1082
2021,Birmingham 060A,E01009138,2055,575,1480
2021,Birmingham 060B,E01009139,1513,403,1110
2021,Birmingham 060C,E01009140,2093,513,1580
2021,Birmingham 137A,E01009141,1755,519,1236
2021,Birmingham 136A,E01009143,1687,548,1139
2021,Birmingham 060D,E01009145,1878,454,1424
2021,Birmingham 136B,E01009146,2213,919,1294
2021,Birmingham 060E,E01009147,1848,372,1476
2021,Birmingham 053A,E01009151,1968,672,1296
2021,Birmingham 053B,E01009152,1847,518,1329
2021,Birmingham 053C,E01009153,1968,519,1449
2021,Birmingham 125B,E01009155,1267,230,1037
2021,Birmingham 125D,E01009157,1370,343,1027
2021,Birmingham 129A,E01009158,2098,517,1581
2021,Birmingham 130A,E01009159,2143,450,1693
2021,Birmingham 125E,E01009160,1472,397,1075
2021,Birmingham 125F,E01009161,1349,287,1062
2021,Birmingham 124A,E01009162,1498,321,1177
2021,Birmingham 130B,E01009164,1339,261,1078
2021,Birmingham 129C,E01009165,1294,297,997
2021,Birmingham 131A,E01009166,1235,301,934
2021,Birmingham 130C,E01009167,1393,302,1091
2021,Birmingham 131B,E01009168,1372,205,1167
2021,Birmingham 129D,E01009169,1561,293,1268
2021,Birmingham 131C,E01009170,1398,257,1141
2021,Birmingham 130D,E01009171,1553,322,1231
2021,Birmingham 119A,E01009172,1370,357,1013
2021,Birmingham 119B,E01009173,1596,444,1152
2021,Birmingham 119C,E01009174,1151,285,866
2021,Birmingham 104A,E01009175,1358,290,1068
2021,Birmingham 105E,E01009176,1630,363,1267
2021,Birmingham 104B,E01009177,1449,330,1119
2021,Birmingham 104C,E01009178,1556,287,1269
2021,Birmingham 104D,E01009179,1585,329,1256
2021,Birmingham 092A,E01009182,1525,337,1188
2021,Birmingham 088C,E01009183,1566,355,1211
2021,Birmingham 092B,E01009184,1467,243,1224
2021,Birmingham 093A,E01009185,1658,286,1372
2021,Birmingham 088D,E01009186,1679,322,1357
2021,Birmingham 092C,E01009187,1425,263,1162
2021,Birmingham 092D,E01009188,1408,304,1104
2021,Birmingham 104E,E01009189,1357,286,1071
2021,Birmingham 052B,E01009192,2572,819,1753
2021,Birmingham 058A,E01009195,2521,892,1629
2021,Birmingham 058C,E01009197,1755,625,1130
2021,Birmingham 052D,E01009199,1302,424,878
2021,Birmingham 139A,E01009200,1646,594,1052
2021,Birmingham 043A,E01009201,1823,640,1183
2021,Birmingham 043B,E01009202,1598,581,1017
2021,Birmingham 052E,E01009204,1987,853,1134
2021,Birmingham 120A,E01009205,1457,302,1155
2021,Birmingham 120B,E01009206,1454,241,1213
2021,Birmingham 124B,E01009207,1525,270,1255
2021,Birmingham 124C,E01009208,1597,313,1284
2021,Birmingham 124D,E01009209,1933,337,1596
2021,Birmingham 126B,E01009210,1693,342,1351
2021,Birmingham 120C,E01009211,1368,199,1169
2021,Birmingham 126C,E01009212,1640,421,1219
2021,Birmingham 124E,E01009213,1509,261,1248
2021,Birmingham 126D,E01009214,1545,336,1209
2021,Birmingham 126E,E01009215,1668,314,1354
2021,Birmingham 131D,E01009216,1937,454,1483
2021,Birmingham 131E,E01009217,1466,238,1228
2021,Birmingham 120D,E01009218,1550,353,1197
2021,Birmingham 120E,E01009219,1394,314,1080
2021,Birmingham 008A,E01009220,1466,366,1100
2021,Birmingham 007A,E01009221,1430,305,1125
2021,Birmingham 008B,E01009222,1428,404,1024
2021,Birmingham 013A,E01009223,1488,259,1229
2021,Birmingham 008C,E01009224,1317,226,1091
2021,Birmingham 013B,E01009225,1529,330,1199
2021,Birmingham 017A,E01009226,1358,232,1126
2021,Birmingham 013C,E01009227,1569,297,1272
2021,Birmingham 013D,E01009228,1458,302,1156
2021,Birmingham 017B,E01009229,1479,312,1167
2021,Birmingham 017C,E01009230,1520,278,1242
2021,Birmingham 017D,E01009231,1827,397,1430
2021,Birmingham 022D,E01009232,1471,309,1162
2021,Birmingham 008D,E01009233,1508,432,1076
2021,Birmingham 019A,E01009234,1364,278,1086
2021,Birmingham 016A,E01009235,1542,333,1209
2021,Birmingham 019B,E01009236,1450,363,1087
2021,Birmingham 024A,E01009237,1350,334,1016
2021,Birmingham 024B,E01009238,1652,371,1281
2021,Birmingham 033F,E01009239,1360,302,1058
2021,Birmingham 024C,E01009240,1420,346,1074
2021,Birmingham 024D,E01009241,1645,466,1179
2021,Birmingham 024E,E01009242,1941,593,1348
2021,Birmingham 016B,E01009243,1678,382,1296
2021,Birmingham 019C,E01009244,1714,372,1342
2021,Birmingham 016C,E01009245,1388,292,1096
2021,Birmingham 016D,E01009246,1463,272,1191
2021,Birmingham 016E,E01009247,1477,334,1143
2021,Birmingham 019D,E01009248,1651,342,1309
2021,Birmingham 080A,E01009249,1516,335,1181
2021,Birmingham 080B,E01009250,1631,316,1315
2021,Birmingham 080C,E01009251,1407,255,1152
2021,Birmingham 073C,E01009252,1516,297,1219
2021,Birmingham 080D,E01009253,1522,301,1221
2021,Birmingham 085C,E01009254,1839,436,1403
2021,Birmingham 080E,E01009255,1428,352,1076
2021,Birmingham 085D,E01009256,1556,407,1149
2021,Birmingham 080F,E01009257,1517,406,1111
2021,Birmingham 085E,E01009258,1407,364,1043
2021,Birmingham 094E,E01009259,1583,388,1195
2021,Birmingham 073D,E01009260,1500,263,1237
2021,Birmingham 073E,E01009261,1656,345,1311
2021,Birmingham 133A,E01009262,1674,359,1315
2021,Birmingham 032C,E01009263,1540,380,1160
2021,Birmingham 032D,E01009264,1716,785,931
2021,Birmingham 032E,E01009265,1681,372,1309
2021,Birmingham 034A,E01009266,1656,470,1186
2021,Birmingham 133B,E01009267,1717,364,1353
2021,Birmingham 036A,E01009268,1416,382,1034
2021,Birmingham 034B,E01009269,1383,434,949
2021,Birmingham 034C,E01009270,1882,628,1254
2021,Birmingham 034D,E01009271,1492,443,1049
2021,Birmingham 036B,E01009272,1328,392,936
2021,Birmingham 034E,E01009273,1493,398,1095
2021,Birmingham 036C,E01009274,1946,488,1458
2021,Birmingham 039A,E01009275,1659,587,1072
2021,Birmingham 133C,E01009276,1582,377,1205
2021,Birmingham 133D,E01009278,1630,373,1257
2021,Birmingham 133E,E01009279,1501,364,1137
2021,Birmingham 100A,E01009280,1632,402,1230
2021,Birmingham 099A,E01009281,1475,302,1173
2021,Birmingham 100B,E01009282,1628,420,1208
2021,Birmingham 079E,E01009283,1671,586,1085
2021,Birmingham 096A,E01009284,4241,3064,1177
2021,Birmingham 096C,E01009286,2373,2038,335
2021,Birmingham 100C,E01009288,1310,340,970
2021,Birmingham 096E,E01009289,2503,2104,399
2021,Birmingham 096F,E01009290,2422,2113,309
2021,Birmingham 095D,E01009291,1378,350,1028
2021,Birmingham 099B,E01009292,1476,356,1120
2021,Birmingham 100D,E01009293,1466,463,1003
2021,Birmingham 099C,E01009294,1799,431,1368
2021,Birmingham 099D,E01009295,1643,611,1032
2021,Birmingham 100E,E01009296,1406,419,987
2021,Birmingham 057A,E01009297,1684,342,1342
2021,Birmingham 054D,E01009298,1500,466,1034
2021,Birmingham 057B,E01009299,1473,385,1088
2021,Birmingham 057C,E01009300,1773,513,1260
2021,Birmingham 057D,E01009301,1521,359,1162
2021,Birmingham 069A,E01009302,1390,212,1178
2021,Birmingham 057E,E01009303,1411,295,1116
2021,Birmingham 046A,E01009304,1716,359,1357
2021,Birmingham 045C,E01009305,1535,413,1122
2021,Birmingham 046B,E01009306,1579,328,1251
2021,Birmingham 045D,E01009307,1437,290,1147
2021,Birmingham 046C,E01009308,1730,443,1287
2021,Birmingham 045E,E01009309,1703,421,1282
2021,Birmingham 046D,E01009310,1843,457,1386
2021,Birmingham 054E,E01009311,1507,463,1044
2021,Birmingham 072A,E01009312,1500,307,1193
2021,Birmingham 076D,E01009313,1564,371,1193
2021,Birmingham 069B,E01009314,1842,487,1355
2021,Birmingham 081A,E01009315,1641,294,1347
2021,Birmingham 081B,E01009316,1804,379,1425
2021,Birmingham 081C,E01009317,1876,391,1485
2021,Birmingham 081D,E01009318,1447,247,1200
2021,Birmingham 081E,E01009319,1481,267,1214
2021,Birmingham 081F,E01009320,1542,295,1247
2021,Birmingham 069C,E01009321,1824,481,1343
2021,Birmingham 069D,E01009322,1648,414,1234
2021,Birmingham 069E,E01009323,1689,479,1210
2021,Birmingham 072B,E01009324,1628,297,1331
2021,Birmingham 063A,E01009325,1844,672,1172
2021,Birmingham 066D,E01009326,1953,762,1191
2021,Birmingham 139B,E01009327,1526,546,980
2021,Birmingham 139C,E01009328,2276,757,1519
2021,Birmingham 070A,E01009329,2444,803,1641
2021,Birmingham 139D,E01009331,2270,837,1433
2021,Birmingham 139E,E01009332,1772,613,1159
2021,Birmingham 139F,E01009333,1466,562,904
2021,Birmingham 070B,E01009334,1712,499,1213
2021,Birmingham 139G,E01009335,1840,626,1214
2021,Birmingham 070C,E01009337,1799,689,1110
2021,Birmingham 070D,E01009338,1638,561,1077
2021,Birmingham 142A,E01009339,1509,491,1018
2021,Birmingham 066E,E01009341,1491,505,986
2021,Birmingham 063D,E01009342,1740,536,1204
2021,Birmingham 063E,E01009343,1712,620,1092
2021,Birmingham 139H,E01009344,1667,646,1021
2021,Birmingham 053D,E01009345,1968,492,1476
2021,Birmingham 053E,E01009346,1548,512,1036
2021,Birmingham 049D,E01009347,1460,467,993
2021,Birmingham 047A,E01009348,1937,575,1362
2021,Birmingham 036D,E01009349,1520,507,1013
2021,Birmingham 039B,E01009350,1525,513,1012
2021,Birmingham 036E,E01009351,1583,524,1059
2021,Birmingham 039C,E01009352,1726,481,1245
2021,Birmingham 039D,E01009353,1593,499,1094
2021,Birmingham 036F,E01009354,1450,373,1077
2021,Birmingham 039E,E01009355,1342,364,978
2021,Birmingham 047B,E01009358,2097,616,1481
2021,Birmingham 047C,E01009359,1894,610,1284
2021,Birmingham 047D,E01009360,2559,823,1736
2021,Birmingham 047E,E01009361,1993,698,1295
2021,Birmingham 071A,E01009362,1295,457,838
2021,Birmingham 071B,E01009363,1638,504,1134
2021,Birmingham 071C,E01009364,1476,544,932
2021,Birmingham 071D,E01009365,1734,590,1144
2021,Birmingham 084A,E01009366,1562,498,1064
2021,Birmingham 083A,E01009367,1635,500,1135
2021,Birmingham 077A,E01009368,1399,447,952
2021,Birmingham 077D,E01009371,1782,618,1164
2021,Birmingham 082A,E01009372,1603,550,1053
2021,Birmingham 082B,E01009373,1619,522,1097
2021,Birmingham 084B,E01009374,1142,386,756
2021,Birmingham 083B,E01009375,1817,596,1221
2021,Birmingham 084C,E01009376,1482,444,1038
2021,Birmingham 083C,E01009377,1321,462,859
2021,Birmingham 071E,E01009379,1770,579,1191
2021,Birmingham 070E,E01009380,1695,625,1070
2021,Birmingham 142D,E01009382,1864,590,1274
2021,Birmingham 083D,E01009383,1304,307,997
2021,Birmingham 092E,E01009384,1298,231,1067
2021,Birmingham 092F,E01009385,1135,182,953
2021,Birmingham 093B,E01009389,1791,464,1327
2021,Birmingham 093C,E01009390,1492,342,1150
2021,Birmingham 143C,E01009391,1744,691,1053
2021,Birmingham 142E,E01009392,1595,485,1110
2021,Birmingham 143D,E01009393,1650,576,1074
2021,Birmingham 093D,E01009394,1651,319,1332
2021,Birmingham 097F,E01009395,1590,405,1185
2021,Birmingham 082D,E01009396,1983,585,1398
2021,Birmingham 077E,E01009397,1639,558,1081
2021,Birmingham 083E,E01009399,1526,605,921
2021,Birmingham 031E,E01009400,1565,379,1186
2021,Birmingham 031F,E01009401,1728,455,1273
2021,Birmingham 020A,E01009403,1450,367,1083
2021,Birmingham 020B,E01009404,1487,369,1118
2021,Birmingham 020C,E01009405,1388,309,1079
2021,Birmingham 020D,E01009406,1620,345,1275
2021,Birmingham 020E,E01009407,1618,368,1250
2021,Birmingham 026B,E01009408,1652,423,1229
2021,Birmingham 026C,E01009409,1724,331,1393
2021,Birmingham 026D,E01009410,1807,387,1420
2021,Birmingham 030B,E01009411,1765,354,1411
2021,Birmingham 030C,E01009412,1675,387,1288
2021,Birmingham 030D,E01009413,1716,428,1288
2021,Birmingham 030E,E01009414,2178,581,1597
2021,Birmingham 002A,E01009415,1664,358,1306
2021,Birmingham 003A,E01009416,2613,633,1980
2021,Birmingham 001A,E01009417,1531,340,1191
2021,Birmingham 001B,E01009418,1515,371,1144
2021,Birmingham 001C,E01009419,1397,288,1109
2021,Birmingham 003B,E01009420,1584,382,1202
2021,Birmingham 004A,E01009421,1651,287,1364
2021,Birmingham 002B,E01009422,1912,372,1540
2021,Birmingham 002C,E01009423,1574,296,1278
2021,Birmingham 004B,E01009424,1496,245,1251
2021,Birmingham 002D,E01009425,1645,258,1387
2021,Birmingham 003C,E01009426,1414,251,1163
2021,Birmingham 004C,E01009427,1444,255,1189
2021,Birmingham 004D,E01009428,1613,322,1291
2021,Birmingham 003D,E01009429,1428,310,1118
2021,Birmingham 004E,E01009430,1663,321,1342
2021,Birmingham 003E,E01009431,1604,347,1257
2021,Birmingham 006A,E01009432,1406,270,1136
2021,Birmingham 001D,E01009433,1718,309,1409
2021,Birmingham 012A,E01009434,1569,281,1288
2021,Birmingham 006B,E01009435,1643,309,1334
2021,Birmingham 012B,E01009436,1341,239,1102
2021,Birmingham 006C,E01009437,1717,280,1437
2021,Birmingham 012C,E01009438,1284,195,1089
2021,Birmingham 021A,E01009439,1385,267,1118
2021,Birmingham 012D,E01009440,1501,214,1287
2021,Birmingham 021B,E01009441,1403,255,1148
2021,Birmingham 021C,E01009442,1386,233,1153
2021,Birmingham 021D,E01009443,1142,205,937
2021,Birmingham 006D,E01009444,1421,254,1167
2021,Birmingham 005A,E01009445,1720,429,1291
2021,Birmingham 005B,E01009446,2330,470,1860
2021,Birmingham 005C,E01009447,1550,376,1174
2021,Birmingham 005D,E01009448,1547,322,1225
2021,Birmingham 009A,E01009449,2063,299,1764
2021,Birmingham 012E,E01009450,1515,261,1254
2021,Birmingham 009B,E01009451,1364,321,1043
2021,Birmingham 005E,E01009452,1616,345,1271
2021,Birmingham 009C,E01009453,1292,260,1032
2021,Birmingham 006E,E01009454,1362,214,1148
2021,Birmingham 005F,E01009455,1214,187,1027
2021,Birmingham 018C,E01009456,1631,305,1326
2021,Birmingham 015A,E01009457,1453,252,1201
2021,Birmingham 018D,E01009458,1340,172,1168
2021,Birmingham 015B,E01009459,1523,279,1244
2021,Birmingham 018E,E01009460,1518,226,1292
2021,Birmingham 015C,E01009461,1249,227,1022
2021,Birmingham 018F,E01009462,1491,210,1281
2021,Birmingham 015D,E01009463,1494,230,1264
2021,Birmingham 007B,E01009464,1341,231,1110
2021,Birmingham 007C,E01009465,1362,298,1064
2021,Birmingham 009D,E01009466,1601,297,1304
2021,Birmingham 007D,E01009467,1477,255,1222
2021,Birmingham 004F,E01009468,1443,242,1201
2021,Birmingham 010B,E01009469,1382,272,1110
2021,Birmingham 010C,E01009470,1358,242,1116
2021,Birmingham 009E,E01009471,1760,322,1438
2021,Birmingham 010D,E01009472,1555,297,1258
2021,Birmingham 010E,E01009473,1487,285,1202
2021,Birmingham 010F,E01009474,1479,276,1203
2021,Birmingham 055A,E01009475,2132,756,1376
2021,Birmingham 055B,E01009476,1931,675,1256
2021,Birmingham 055C,E01009477,1739,635,1104
2021,Birmingham 048A,E01009478,1904,706,1198
2021,Birmingham 048B,E01009479,2079,684,1395
2021,Birmingham 044C,E01009480,1911,666,1245
2021,Birmingham 044D,E01009481,2528,909,1619
2021,Birmingham 048C,E01009482,1591,538,1053
2021,Birmingham 051B,E01009483,1887,652,1235
2021,Birmingham 048D,E01009484,1678,572,1106
2021,Birmingham 048E,E01009485,1870,655,1215
2021,Birmingham 044E,E01009486,2037,729,1308
2021,Birmingham 044F,E01009487,2022,715,1307
2021,Birmingham 051C,E01009488,2359,855,1504
2021,Birmingham 051D,E01009489,1948,687,1261
2021,Birmingham 055D,E01009490,1990,684,1306
2021,Birmingham 051E,E01009491,2031,765,1266
2021,Birmingham 055E,E01009492,1838,656,1182
2021,Birmingham 113D,E01009493,1732,298,1434
2021,Birmingham 109A,E01009494,1596,534,1062
2021,Birmingham 106E,E01009495,1210,329,881
2021,Birmingham 109B,E01009496,1394,230,1164
2021,Birmingham 109C,E01009497,1708,379,1329
2021,Birmingham 119D,E01009498,1589,450,1139
2021,Birmingham 119E,E01009499,1644,398,1246
2021,Birmingham 095E,E01009500,1416,387,1029
2021,Birmingham 101B,E01009501,1424,431,993
2021,Birmingham 101C,E01009502,1352,377,975
2021,Birmingham 101D,E01009503,1472,392,1080
2021,Birmingham 109D,E01009504,1540,338,1202
2021,Birmingham 101E,E01009505,1545,431,1114
2021,Birmingham 109E,E01009506,1412,286,1126
2021,Birmingham 056B,E01009507,1481,398,1083
2021,Birmingham 056C,E01009508,1529,385,1144
2021,Birmingham 056D,E01009509,1898,555,1343
2021,Birmingham 056E,E01009510,1574,387,1187
2021,Birmingham 054F,E01009511,1549,510,1039
2021,Birmingham 062A,E01009512,1843,550,1293
2021,Birmingham 066F,E01009513,1884,674,1210
2021,Birmingham 062B,E01009514,1618,477,1141
2021,Birmingham 067C,E01009515,1609,336,1273
2021,Birmingham 062C,E01009516,1346,350,996
2021,Birmingham 062D,E01009517,1854,507,1347
2021,Birmingham 067D,E01009518,1637,317,1320
2021,Birmingham 072C,E01009519,1369,246,1123
2021,Birmingham 072D,E01009520,1666,326,1340
2021,Birmingham 067E,E01009521,1564,331,1233
2021,Coventry 014A,E01009522,1778,482,1296
2021,Coventry 010A,E01009523,1595,238,1357
2021,Coventry 006A,E01009524,1472,228,1244
2021,Coventry 006B,E01009525,1457,279,1178
2021,Coventry 010B,E01009526,1477,276,1201
2021,Coventry 006C,E01009527,1540,367,1173
2021,Coventry 010C,E01009528,2035,406,1629
2021,Coventry 014B,E01009529,1459,294,1165
2021,Coventry 014C,E01009530,1321,280,1041
2021,Coventry 010D,E01009531,1511,239,1272
2021,Coventry 033A,E01009532,1268,224,1044
2021,Coventry 033B,E01009535,1304,218,1086
2021,Coventry 033C,E01009536,1401,247,1154
2021,Coventry 035C,E01009537,1425,309,1116
2021,Coventry 035D,E01009538,1452,326,1126
2021,Coventry 039A,E01009539,1893,469,1424
2021,Coventry 039B,E01009540,1854,613,1241
2021,Coventry 039C,E01009541,1560,285,1275
2021,Coventry 039D,E01009542,1751,440,1311
2021,Coventry 033D,E01009543,1705,339,1366
2021,Coventry 038A,E01009544,1476,235,1241
2021,Coventry 031A,E01009548,2660,1226,1434
2021,Coventry 037B,E01009549,1536,315,1221
2021,Coventry 037C,E01009550,1609,329,1280
2021,Coventry 037E,E01009552,1494,333,1161
2021,Coventry 031B,E01009553,1874,831,1043
2021,Coventry 034A,E01009554,1292,350,942
2021,Coventry 034B,E01009555,1413,317,1096
2021,Coventry 034C,E01009556,1450,321,1129
2021,Coventry 034D,E01009557,1337,252,1085
2021,Coventry 034E,E01009558,1349,274,1075
2021,Coventry 034F,E01009559,1316,251,1065
2021,Coventry 040A,E01009560,1413,268,1145
2021,Coventry 040B,E01009561,1514,265,1249
2021,Coventry 040C,E01009562,1515,244,1271
2021,Coventry 040D,E01009563,1626,351,1275
2021,Coventry 005A,E01009564,1912,568,1344
2021,Coventry 009A,E01009565,1649,527,1122
2021,Coventry 009B,E01009566,1831,617,1214
2021,Coventry 009C,E01009567,1575,478,1097
2021,Coventry 009D,E01009568,1751,529,1222
2021,Coventry 015A,E01009569,1235,348,887
2021,Coventry 015B,E01009570,2112,698,1414
2021,Coventry 015C,E01009571,1498,444,1054
2021,Coventry 015E,E01009573,1355,393,962
2021,Coventry 015F,E01009574,1460,480,980
2021,Coventry 005B,E01009575,1230,341,889
2021,Coventry 008A,E01009576,1518,295,1223
2021,Coventry 007A,E01009577,1568,453,1115
2021,Coventry 008B,E01009578,1324,227,1097
2021,Coventry 007B,E01009579,2052,654,1398
2021,Coventry 019A,E01009580,1276,235,1041
2021,Coventry 007C,E01009581,1660,427,1233
2021,Coventry 008C,E01009582,1603,303,1300
2021,Coventry 008D,E01009583,1492,315,1177
2021,Coventry 007D,E01009584,1940,412,1528
2021,Coventry 007E,E01009585,1696,615,1081
2021,Coventry 008E,E01009586,1714,349,1365
2021,Coventry 011A,E01009587,2145,672,1473
2021,Coventry 043A,E01009588,1513,347,1166
2021,Coventry 001A,E01009589,1566,353,1213
2021,Coventry 002A,E01009590,1449,262,1187
2021,Coventry 002B,E01009591,1477,350,1127
2021,Coventry 043B,E01009592,1590,464,1126
2021,Coventry 002C,E01009593,1565,355,1210
2021,Coventry 006D,E01009594,1411,273,1138
2021,Coventry 043C,E01009596,1909,522,1387
2021,Coventry 043D,E01009597,1764,450,1314
2021,Coventry 002D,E01009598,2007,453,1554
2021,Coventry 013A,E01009599,1034,154,880
2021,Coventry 004A,E01009604,1361,313,1048
2021,Coventry 004B,E01009605,1621,406,1215
2021,Coventry 005C,E01009606,2051,492,1559
2021,Coventry 004C,E01009607,1493,338,1155
2021,Coventry 004D,E01009608,1519,417,1102
2021,Coventry 005D,E01009609,1454,363,1091
2021,Coventry 004E,E01009610,1411,340,1071
2021,Coventry 035F,E01009612,1435,476,959
2021,Coventry 018A,E01009613,1232,279,953
2021,Coventry 021A,E01009614,1380,287,1093
2021,Coventry 027A,E01009615,1626,448,1178
2021,Coventry 027B,E01009616,1471,281,1190
2021,Coventry 027C,E01009617,1171,250,921
2021,Coventry 027D,E01009618,1579,313,1266
2021,Coventry 027E,E01009620,2575,639,1936
2021,Coventry 027F,E01009621,1359,399,960
2021,Coventry 012A,E01009622,1726,392,1334
2021,Coventry 012B,E01009623,1479,319,1160
2021,Coventry 011B,E01009624,1457,350,1107
2021,Coventry 011C,E01009625,2275,585,1690
2021,Coventry 011D,E01009626,1586,382,1204
2021,Coventry 012C,E01009627,1665,403,1262
2021,Coventry 012D,E01009628,1473,343,1130
2021,Coventry 020B,E01009630,1682,437,1245
2021,Coventry 020C,E01009631,1464,361,1103
2021,Coventry 020D,E01009632,1698,438,1260
2021,Coventry 028A,E01009633,1975,1097,878
2021,Coventry 028B,E01009634,2033,1091,942
2021,Coventry 024A,E01009636,2335,874,1461
2021,Coventry 024B,E01009637,1567,473,1094
2021,Coventry 024C,E01009638,1690,625,1065
2021,Coventry 024D,E01009639,1607,514,1093
2021,Coventry 024E,E01009640,1917,713,1204
2021,Coventry 024F,E01009641,3200,2200,1000
2021,Coventry 017A,E01009643,1329,252,1077
2021,Coventry 017B,E01009644,1522,291,1231
2021,Coventry 014D,E01009645,1362,277,1085
2021,Coventry 022A,E01009646,1413,300,1113
2021,Coventry 017C,E01009647,1784,368,1416
2021,Coventry 017D,E01009648,1441,292,1149
2021,Coventry 026A,E01009649,1343,299,1044
2021,Coventry 020E,E01009650,1468,396,1072
2021,Coventry 031D,E01009651,1437,444,993
2021,Coventry 017E,E01009652,1403,264,1139
2021,Coventry 017F,E01009653,1489,322,1167
2021,Coventry 021B,E01009654,1693,350,1343
2021,Coventry 016A,E01009655,1926,528,1398
2021,Coventry 016B,E01009656,1527,327,1200
2021,Coventry 018B,E01009657,1535,333,1202
2021,Coventry 021C,E01009658,1584,363,1221
2021,Coventry 016C,E01009659,1699,513,1186
2021,Coventry 021D,E01009660,1633,369,1264
2021,Coventry 028D,E01009661,1923,709,1214
2021,Coventry 016D,E01009662,1332,277,1055
2021,Coventry 013B,E01009663,1367,228,1139
2021,Coventry 016E,E01009664,1480,354,1126
2021,Coventry 042A,E01009665,1234,340,894
2021,Coventry 041A,E01009666,1323,302,1021
2021,Coventry 041B,E01009667,1276,207,1069
2021,Coventry 041C,E01009668,1561,371,1190
2021,Coventry 042B,E01009669,1236,313,923
2021,Coventry 041D,E01009670,1594,346,1248
2021,Coventry 042C,E01009671,4081,3076,1005
2021,Coventry 040E,E01009672,2051,412,1639
2021,Coventry 029A,E01009674,1595,365,1230
2021,Coventry 032A,E01009676,1546,361,1185
2021,Coventry 036C,E01009679,2147,1160,987
2021,Coventry 032B,E01009681,1242,247,995
2021,Coventry 032C,E01009682,1363,244,1119
2021,Coventry 032D,E01009683,1758,674,1084
2021,Coventry 026B,E01009684,1404,276,1128
2021,Coventry 026C,E01009685,1535,265,1270
2021,Coventry 026D,E01009686,1597,333,1264
2021,Coventry 026E,E01009687,1312,260,1052
2021,Coventry 030A,E01009688,1426,427,999
2021,Coventry 030B,E01009689,1598,382,1216
2021,Coventry 030C,E01009690,1398,532,866
2021,Coventry 030D,E01009691,1242,409,833
2021,Coventry 022B,E01009692,1136,170,966
2021,Coventry 022C,E01009693,1407,239,1168
2021,Coventry 022D,E01009694,1366,243,1123
2021,Coventry 023A,E01009695,1519,212,1307
2021,Coventry 023B,E01009696,1370,198,1172
2021,Coventry 025A,E01009697,1906,339,1567
2021,Coventry 025B,E01009698,1424,237,1187
2021,Coventry 029B,E01009699,1361,246,1115
2021,Coventry 029C,E01009700,1573,331,1242
2021,Coventry 029D,E01009701,1417,260,1157
2021,Coventry 029E,E01009702,1523,334,1189
2021,Coventry 023C,E01009704,1337,186,1151
2021,Coventry 023D,E01009705,1290,209,1081
2021,Coventry 025D,E01009706,1399,246,1153
2021,Coventry 033E,E01009707,1742,397,1345
2021,Coventry 033F,E01009708,1359,220,1139
2021,Coventry 007F,E01009709,1149,442,707
2021,Coventry 013C,E01009710,1222,212,1010
2021,Coventry 013D,E01009711,1769,362,1407
2021,Coventry 018C,E01009712,1448,336,1112
2021,Coventry 019B,E01009713,1383,320,1063
2021,Coventry 018D,E01009714,1410,358,1052
2021,Coventry 019C,E01009715,1342,307,1035
2021,Coventry 018E,E01009716,1598,373,1225
2021,Coventry 019D,E01009717,1403,300,1103
2021,Coventry 019E,E01009718,1731,405,1326
2021,Dudley 027A,E01009719,1318,236,1082
2021,Dudley 028A,E01009720,1240,190,1050
2021,Dudley 031A,E01009721,2254,401,1853
2021,Dudley 027B,E01009722,1249,164,1085
2021,Dudley 028B,E01009723,1133,184,949
2021,Dudley 028C,E01009724,1388,217,1171
2021,Dudley 031B,E01009725,1355,321,1034
2021,Dudley 031C,E01009726,1215,217,998
2021,Dudley 027C,E01009727,1263,209,1054
2021,Dudley 027D,E01009728,1173,201,972
2021,Dudley 027E,E01009729,1473,269,1204
2021,Dudley 028D,E01009730,1410,227,1183
2021,Dudley 023A,E01009731,1498,239,1259
2021,Dudley 039A,E01009732,1761,382,1379
2021,Dudley 039B,E01009733,1695,339,1356
2021,Dudley 034A,E01009734,1500,318,1182
2021,Dudley 034B,E01009735,1570,259,1311
2021,Dudley 034C,E01009736,1319,204,1115
2021,Dudley 034D,E01009737,1455,227,1228
2021,Dudley 034E,E01009738,1583,394,1189
2021,Dudley 039C,E01009739,1465,321,1144
2021,Dudley 023B,E01009740,1945,419,1526
2021,Dudley 022A,E01009741,1904,336,1568
2021,Dudley 023C,E01009742,1437,303,1134
2021,Dudley 023D,E01009743,1704,430,1274
2021,Dudley 022B,E01009744,2025,352,1673
2021,Dudley 023E,E01009745,1611,237,1374
2021,Dudley 022C,E01009746,1841,370,1471
2021,Dudley 022D,E01009747,1440,266,1174
2021,Dudley 013A,E01009748,1534,337,1197
2021,Dudley 016A,E01009749,2185,390,1795
2021,Dudley 016B,E01009750,1413,277,1136
2021,Dudley 017A,E01009751,1427,262,1165
2021,Dudley 017B,E01009752,1519,365,1154
2021,Dudley 017C,E01009753,1475,350,1125
2021,Dudley 017D,E01009754,1594,349,1245
2021,Dudley 006B,E01009756,1446,386,1060
2021,Dudley 006C,E01009757,2009,420,1589
2021,Dudley 005A,E01009758,1672,410,1262
2021,Dudley 006D,E01009759,1217,186,1031
2021,Dudley 005B,E01009760,1246,246,1000
2021,Dudley 006F,E01009762,1368,459,909
2021,Dudley 001A,E01009763,2040,542,1498
2021,Dudley 001B,E01009764,1420,202,1218
2021,Dudley 004A,E01009765,1521,265,1256
2021,Dudley 004B,E01009766,1478,257,1221
2021,Dudley 001C,E01009767,1422,230,1192
2021,Dudley 004C,E01009768,1294,217,1077
2021,Dudley 001D,E01009769,1697,360,1337
2021,Dudley 001E,E01009770,1369,207,1162
2021,Dudley 004D,E01009771,1363,162,1201
2021,Dudley 005C,E01009772,1222,273,949
2021,Dudley 002A,E01009773,1475,303,1172
2021,Dudley 005D,E01009774,1542,258,1284
2021,Dudley 004E,E01009775,1418,253,1165
2021,Dudley 004F,E01009776,1479,286,1193
2021,Dudley 002B,E01009777,1504,263,1241
2021,Dudley 002C,E01009778,1509,281,1228
2021,Dudley 008A,E01009779,1324,168,1156
2021,Dudley 009A,E01009780,2042,394,1648
2021,Dudley 007A,E01009781,1823,345,1478
2021,Dudley 008B,E01009782,1746,370,1376
2021,Dudley 008C,E01009783,1376,295,1081
2021,Dudley 009B,E01009784,1486,264,1222
2021,Dudley 008D,E01009785,1428,183,1245
2021,Dudley 007B,E01009786,1350,313,1037
2021,Dudley 009C,E01009787,1404,227,1177
2021,Dudley 005E,E01009788,1483,259,1224
2021,Dudley 007C,E01009789,1379,168,1211
2021,Dudley 007D,E01009790,1509,307,1202
2021,Dudley 026A,E01009791,1469,281,1188
2021,Dudley 026B,E01009792,1488,324,1164
2021,Dudley 030A,E01009793,1460,256,1204
2021,Dudley 030B,E01009794,1444,276,1168
2021,Dudley 026C,E01009795,1589,362,1227
2021,Dudley 026D,E01009796,1529,308,1221
2021,Dudley 030C,E01009797,1290,200,1090
2021,Dudley 026E,E01009798,2212,419,1793
2021,Dudley 039D,E01009799,1406,203,1203
2021,Dudley 036A,E01009800,1465,279,1186
2021,Dudley 030D,E01009801,1709,335,1374
2021,Dudley 036B,E01009802,1651,330,1321
2021,Dudley 036C,E01009803,1511,241,1270
2021,Dudley 036D,E01009804,1220,168,1052
2021,Dudley 039E,E01009805,1397,205,1192
2021,Dudley 039F,E01009806,1403,199,1204
2021,Dudley 043A,E01009807,1796,369,1427
2021,Dudley 043B,E01009808,1316,200,1116
2021,Dudley 033A,E01009809,1576,375,1201
2021,Dudley 043C,E01009810,1730,324,1406
2021,Dudley 043D,E01009811,1409,250,1159
2021,Dudley 043E,E01009812,1444,247,1197
2021,Dudley 033B,E01009813,1503,329,1174
2021,Dudley 014A,E01009814,1235,185,1050
2021,Dudley 014B,E01009815,1216,217,999
2021,Dudley 012A,E01009816,1572,266,1306
2021,Dudley 012B,E01009817,1212,185,1027
2021,Dudley 014C,E01009818,1180,216,964
2021,Dudley 012C,E01009819,1423,224,1199
2021,Dudley 012D,E01009820,1445,225,1220
2021,Dudley 014D,E01009821,1268,181,1087
2021,Dudley 014E,E01009822,1437,214,1223
2021,Dudley 016C,E01009823,1256,183,1073
2021,Dudley 016D,E01009824,1763,324,1439
2021,Dudley 019A,E01009825,1366,237,1129
2021,Dudley 019B,E01009826,1386,207,1179
2021,Dudley 019C,E01009827,1564,303,1261
2021,Dudley 019D,E01009828,1233,169,1064
2021,Dudley 019E,E01009829,1439,276,1163
2021,Dudley 019F,E01009830,1591,286,1305
2021,Dudley 037A,E01009831,1373,274,1099
2021,Dudley 042A,E01009832,1621,386,1235
2021,Dudley 032A,E01009833,1460,418,1042
2021,Dudley 031D,E01009834,1569,290,1279
2021,Dudley 032B,E01009835,1599,357,1242
2021,Dudley 037B,E01009836,1746,388,1358
2021,Dudley 037C,E01009837,1514,295,1219
2021,Dudley 037D,E01009838,1594,308,1286
2021,Dudley 013B,E01009839,1701,374,1327
2021,Dudley 018A,E01009840,1401,398,1003
2021,Dudley 017E,E01009841,1478,327,1151
2021,Dudley 018B,E01009842,1413,283,1130
2021,Dudley 018C,E01009843,1427,227,1200
2021,Dudley 011A,E01009844,1498,393,1105
2021,Dudley 041A,E01009845,1490,264,1226
2021,Dudley 041B,E01009846,1444,217,1227
2021,Dudley 038A,E01009847,1430,252,1178
2021,Dudley 038B,E01009848,1296,230,1066
2021,Dudley 038C,E01009849,1501,293,1208
2021,Dudley 041C,E01009850,1425,253,1172
2021,Dudley 038D,E01009851,1408,205,1203
2021,Dudley 041D,E01009852,1348,171,1177
2021,Dudley 042B,E01009853,1305,168,1137
2021,Dudley 040A,E01009854,1439,198,1241
2021,Dudley 042C,E01009855,1606,267,1339
2021,Dudley 035A,E01009856,1926,359,1567
2021,Dudley 040B,E01009857,1597,368,1229
2021,Dudley 040C,E01009858,1432,322,1110
2021,Dudley 040D,E01009859,1484,247,1237
2021,Dudley 042D,E01009860,1462,242,1220
2021,Dudley 033C,E01009861,1556,291,1265
2021,Dudley 033D,E01009862,1721,339,1382
2021,Dudley 033E,E01009863,1816,400,1416
2021,Dudley 025A,E01009864,1446,311,1135
2021,Dudley 025B,E01009865,1454,308,1146
2021,Dudley 025C,E01009866,1582,249,1333
2021,Dudley 025D,E01009867,1623,289,1334
2021,Dudley 033F,E01009868,1419,258,1161
2021,Dudley 032C,E01009869,1452,223,1229
2021,Dudley 032D,E01009870,1399,136,1263
2021,Dudley 018D,E01009871,1879,333,1546
2021,Dudley 020A,E01009872,1261,323,938
2021,Dudley 020B,E01009873,1468,254,1214
2021,Dudley 020C,E01009874,1499,356,1143
2021,Dudley 018E,E01009875,1449,256,1193
2021,Dudley 020D,E01009876,1543,305,1238
2021,Dudley 020E,E01009877,1512,370,1142
2021,Dudley 025E,E01009878,2105,361,1744
2021,Dudley 011B,E01009879,2248,496,1752
2021,Dudley 009D,E01009880,1472,270,1202
2021,Dudley 009E,E01009882,1357,253,1104
2021,Dudley 013C,E01009883,1435,293,1142
2021,Dudley 013D,E01009884,1333,266,1067
2021,Dudley 011D,E01009885,1525,319,1206
2021,Dudley 013E,E01009886,1850,304,1546
2021,Dudley 015A,E01009887,1728,437,1291
2021,Dudley 015B,E01009888,1639,354,1285
2021,Dudley 015C,E01009889,2592,635,1957
2021,Dudley 015D,E01009890,1704,466,1238
2021,Dudley 010A,E01009891,1708,454,1254
2021,Dudley 010B,E01009892,1522,403,1119
2021,Dudley 010C,E01009893,1718,523,1195
2021,Dudley 010D,E01009894,1606,352,1254
2021,Dudley 002D,E01009895,1332,212,1120
2021,Dudley 003A,E01009896,1376,241,1135
2021,Dudley 003B,E01009897,1348,198,1150
2021,Dudley 003C,E01009898,1397,175,1222
2021,Dudley 008E,E01009899,1308,148,1160
2021,Dudley 008F,E01009900,1345,176,1169
2021,Dudley 003D,E01009901,1349,162,1187
2021,Dudley 003E,E01009902,1165,160,1005
2021,Dudley 029A,E01009903,1352,199,1153
2021,Dudley 029B,E01009904,1307,179,1128
2021,Dudley 035B,E01009905,1354,199,1155
2021,Dudley 035C,E01009906,1638,284,1354
2021,Dudley 035D,E01009907,1386,211,1175
2021,Dudley 035E,E01009908,1491,264,1227
2021,Dudley 029C,E01009909,1362,174,1188
2021,Dudley 029D,E01009910,1448,255,1193
2021,Dudley 021A,E01009911,1190,121,1069
2021,Dudley 021B,E01009912,1904,327,1577
2021,Dudley 021C,E01009913,1445,267,1178
2021,Dudley 021D,E01009914,1290,181,1109
2021,Dudley 021E,E01009915,1604,231,1373
2021,Dudley 021F,E01009916,1596,295,1301
2021,Dudley 024A,E01009917,1125,158,967
2021,Dudley 024B,E01009918,1353,274,1079
2021,Dudley 024C,E01009919,1102,148,954
2021,Dudley 024D,E01009920,1511,233,1278
2021,Sandwell 034A,E01009921,1653,353,1300
2021,Sandwell 034B,E01009922,1286,307,979
2021,Sandwell 036A,E01009923,1422,287,1135
2021,Sandwell 034C,E01009924,1344,243,1101
2021,Sandwell 034D,E01009925,1393,280,1113
2021,Sandwell 034E,E01009926,1325,265,1060
2021,Sandwell 034F,E01009927,1415,265,1150
2021,Sandwell 034G,E01009928,1605,400,1205
2021,Sandwell 033A,E01009929,1645,350,1295
2021,Sandwell 033B,E01009930,1455,319,1136
2021,Sandwell 033C,E01009931,2256,408,1848
2021,Sandwell 033D,E01009932,1528,243,1285
2021,Sandwell 035A,E01009933,1342,273,1069
2021,Sandwell 027A,E01009934,1367,367,1000
2021,Sandwell 027B,E01009935,2077,511,1566
2021,Sandwell 027C,E01009936,1470,226,1244
2021,Sandwell 032A,E01009937,1542,385,1157
2021,Sandwell 031A,E01009938,1739,433,1306
2021,Sandwell 032B,E01009939,1617,330,1287
2021,Sandwell 032C,E01009940,1464,360,1104
2021,Sandwell 032D,E01009941,1516,307,1209
2021,Sandwell 032E,E01009942,1655,398,1257
2021,Sandwell 031B,E01009943,1533,428,1105
2021,Sandwell 031C,E01009944,1733,466,1267
2021,Sandwell 039A,E01009946,1729,327,1402
2021,Sandwell 017A,E01009947,2235,522,1713
2021,Sandwell 039B,E01009948,1429,230,1199
2021,Sandwell 039C,E01009949,1528,308,1220
2021,Sandwell 039D,E01009950,1644,313,1331
2021,Sandwell 039E,E01009951,2069,400,1669
2021,Sandwell 035B,E01009952,2022,506,1516
2021,Sandwell 038A,E01009953,1963,393,1570
2021,Sandwell 038B,E01009954,1740,350,1390
2021,Sandwell 035C,E01009955,2108,443,1665
2021,Sandwell 035D,E01009956,1537,303,1234
2021,Sandwell 038C,E01009957,1716,484,1232
2021,Sandwell 038D,E01009958,1519,253,1266
2021,Sandwell 035E,E01009959,1374,211,1163
2021,Sandwell 003A,E01009960,1479,330,1149
2021,Sandwell 003B,E01009961,1174,177,997
2021,Sandwell 004A,E01009962,1277,323,954
2021,Sandwell 004B,E01009963,1282,338,944
2021,Sandwell 004C,E01009964,1507,444,1063
2021,Sandwell 004D,E01009965,1272,365,907
2021,Sandwell 003C,E01009966,1157,313,844
2021,Sandwell 003D,E01009967,1774,399,1375
2021,Sandwell 006A,E01009968,1460,253,1207
2021,Sandwell 002A,E01009969,1961,496,1465
2021,Sandwell 002B,E01009970,1671,398,1273
2021,Sandwell 002C,E01009971,1587,356,1231
2021,Sandwell 006B,E01009972,1826,348,1478
2021,Sandwell 002D,E01009973,2252,559,1693
2021,Sandwell 006C,E01009974,1607,286,1321
2021,Sandwell 006D,E01009975,1610,251,1359
2021,Sandwell 016A,E01009976,2549,534,2015
2021,Sandwell 016B,E01009977,1867,426,1441
2021,Sandwell 014A,E01009978,1769,399,1370
2021,Sandwell 016C,E01009979,1923,447,1476
2021,Sandwell 016D,E01009980,2213,508,1705
2021,Sandwell 018A,E01009981,1944,518,1426
2021,Sandwell 009A,E01009982,1497,417,1080
2021,Sandwell 009B,E01009983,1486,336,1150
2021,Sandwell 018C,E01009985,1673,439,1234
2021,Sandwell 019A,E01009986,1574,460,1114
2021,Sandwell 019B,E01009987,1398,339,1059
2021,Sandwell 020A,E01009988,2636,696,1940
2021,Sandwell 019C,E01009989,1874,509,1365
2021,Sandwell 010A,E01009991,2223,522,1701
2021,Sandwell 017B,E01009992,1709,437,1272
2021,Sandwell 017C,E01009993,1850,457,1393
2021,Sandwell 010B,E01009994,1657,360,1297
2021,Sandwell 010C,E01009995,1494,346,1148
2021,Sandwell 010D,E01009996,1548,373,1175
2021,Sandwell 010E,E01009997,1668,400,1268
2021,Sandwell 010F,E01009998,2043,560,1483
2021,Sandwell 033E,E01009999,1383,337,1046
2021,Sandwell 030A,E01010000,1720,358,1362
2021,Sandwell 037A,E01010001,1814,404,1410
2021,Sandwell 030B,E01010002,2073,455,1618
2021,Sandwell 030C,E01010003,1420,254,1166
2021,Sandwell 027D,E01010004,1756,346,1410
2021,Sandwell 030D,E01010005,1550,356,1194
2021,Sandwell 030E,E01010006,1661,358,1303
2021,Sandwell 012A,E01010007,1295,303,992
2021,Sandwell 011A,E01010008,1563,351,1212
2021,Sandwell 012B,E01010009,1382,346,1036
2021,Sandwell 011B,E01010010,1380,322,1058
2021,Sandwell 011C,E01010011,1674,407,1267
2021,Sandwell 011D,E01010012,1340,247,1093
2021,Sandwell 012C,E01010013,1250,218,1032
2021,Sandwell 012D,E01010014,1573,301,1272
2021,Sandwell 021A,E01010015,1898,436,1462
2021,Sandwell 021B,E01010016,1739,465,1274
2021,Sandwell 024A,E01010017,1867,439,1428
2021,Sandwell 021C,E01010018,2232,471,1761
2021,Sandwell 024B,E01010019,1808,549,1259
2021,Sandwell 024C,E01010020,2128,623,1505
2021,Sandwell 024D,E01010021,1870,436,1434
2021,Sandwell 037B,E01010022,1500,287,1213
2021,Sandwell 037C,E01010023,1727,317,1410
2021,Sandwell 036B,E01010024,1486,288,1198
2021,Sandwell 037D,E01010025,1620,382,1238
2021,Sandwell 036C,E01010026,1750,374,1376
2021,Sandwell 036D,E01010027,1544,346,1198
2021,Sandwell 037E,E01010028,1492,402,1090
2021,Sandwell 009C,E01010029,1506,461,1045
2021,Sandwell 007A,E01010030,1560,364,1196
2021,Sandwell 014B,E01010031,1421,234,1187
2021,Sandwell 014C,E01010032,1513,578,935
2021,Sandwell 014D,E01010033,1542,297,1245
2021,Sandwell 007B,E01010034,1183,168,1015
2021,Sandwell 007C,E01010035,1280,179,1101
2021,Sandwell 007D,E01010036,1854,458,1396
2021,Sandwell 009D,E01010037,1223,325,898
2021,Sandwell 029A,E01010038,1724,433,1291
2021,Sandwell 025A,E01010039,1994,538,1456
2021,Sandwell 029B,E01010040,1361,242,1119
2021,Sandwell 029C,E01010041,1600,309,1291
2021,Sandwell 035F,E01010042,1768,331,1437
2021,Sandwell 025B,E01010043,1352,209,1143
2021,Sandwell 025C,E01010044,1443,343,1100
2021,Sandwell 029D,E01010045,1596,358,1238
2021,Sandwell 023A,E01010046,2637,883,1754
2021,Sandwell 023B,E01010047,2013,609,1404
2021,Sandwell 023C,E01010048,1743,531,1212
2021,Sandwell 023D,E01010049,1606,397,1209
2021,Sandwell 023E,E01010050,1629,440,1189
2021,Sandwell 031D,E01010051,1306,349,957
2021,Sandwell 023F,E01010052,1376,426,950
2021,Sandwell 023G,E01010053,2113,688,1425
2021,Sandwell 028A,E01010054,1952,500,1452
2021,Sandwell 028B,E01010055,1837,601,1236
2021,Sandwell 028C,E01010056,1752,469,1283
2021,Sandwell 028D,E01010057,2098,637,1461
2021,Sandwell 031E,E01010058,1595,407,1188
2021,Sandwell 041D,E01010059,2124,629,1495
2021,Sandwell 028E,E01010060,1933,542,1391
2021,Sandwell 041B,E01010061,1861,638,1223
2021,Sandwell 040A,E01010062,2086,585,1501
2021,Sandwell 040D,E01010064,1984,522,1462
2021,Sandwell 015A,E01010066,1624,405,1219
2021,Sandwell 015B,E01010067,1633,417,1216
2021,Sandwell 015C,E01010068,1766,424,1342
2021,Sandwell 016E,E01010069,2383,644,1739
2021,Sandwell 015D,E01010070,1668,298,1370
2021,Sandwell 016F,E01010071,1654,360,1294
2021,Sandwell 021D,E01010072,2184,528,1656
2021,Sandwell 021E,E01010073,1563,390,1173
2021,Sandwell 015E,E01010075,1470,351,1119
2021,Sandwell 015F,E01010076,1913,434,1479
2021,Sandwell 022A,E01010077,1495,333,1162
2021,Sandwell 025D,E01010078,1173,148,1025
2021,Sandwell 022B,E01010079,1408,237,1171
2021,Sandwell 022C,E01010080,1831,518,1313
2021,Sandwell 022D,E01010081,1484,246,1238
2021,Sandwell 022E,E01010082,2185,496,1689
2021,Sandwell 022F,E01010083,1730,439,1291
2021,Sandwell 022G,E01010084,1514,426,1088
2021,Sandwell 001A,E01010085,1716,362,1354
2021,Sandwell 001B,E01010086,1628,382,1246
2021,Sandwell 001C,E01010087,1566,369,1197
2021,Sandwell 001D,E01010088,1522,340,1182
2021,Sandwell 001E,E01010089,1753,426,1327
2021,Sandwell 005A,E01010090,1951,435,1516
2021,Sandwell 005B,E01010091,1617,296,1321
2021,Sandwell 003E,E01010092,1754,384,1370
2021,Sandwell 013A,E01010093,1510,333,1177
2021,Sandwell 013B,E01010094,1590,427,1163
2021,Sandwell 013C,E01010095,1927,561,1366
2021,Sandwell 005C,E01010096,1723,329,1394
2021,Sandwell 005D,E01010097,1815,243,1572
2021,Sandwell 013D,E01010098,1800,377,1423
2021,Sandwell 013E,E01010099,1733,429,1304
2021,Sandwell 013F,E01010100,1871,392,1479
2021,Sandwell 020B,E01010101,1934,355,1579
2021,Sandwell 020C,E01010102,1753,417,1336
2021,Sandwell 017D,E01010103,2073,481,1592
2021,Sandwell 017E,E01010104,1683,249,1434
2021,Sandwell 017F,E01010105,1554,332,1222
2021,Sandwell 019D,E01010106,1802,500,1302
2021,Sandwell 020D,E01010107,2039,548,1491
2021,Solihull 017A,E01010108,2078,393,1685
2021,Solihull 009A,E01010109,1568,286,1282
2021,Solihull 009B,E01010110,1532,252,1280
2021,Solihull 008A,E01010111,1333,317,1016
2021,Solihull 009C,E01010112,1482,269,1213
2021,Solihull 009D,E01010113,1281,251,1030
2021,Solihull 009E,E01010114,1822,334,1488
2021,Solihull 015A,E01010115,1481,258,1223
2021,Solihull 015B,E01010116,1310,226,1084
2021,Solihull 003A,E01010117,1394,239,1155
2021,Solihull 001A,E01010118,1167,178,989
2021,Solihull 003B,E01010119,1438,248,1190
2021,Solihull 001B,E01010120,1175,174,1001
2021,Solihull 001C,E01010121,1481,272,1209
2021,Solihull 001D,E01010122,1365,204,1161
2021,Solihull 003C,E01010123,1442,227,1215
2021,Solihull 003D,E01010124,1461,232,1229
2021,Solihull 006A,E01010125,1688,319,1369
2021,Solihull 008B,E01010126,1331,304,1027
2021,Solihull 008C,E01010127,1712,389,1323
2021,Solihull 008D,E01010128,1414,305,1109
2021,Solihull 006B,E01010129,1527,321,1206
2021,Solihull 008E,E01010130,1712,374,1338
2021,Solihull 008F,E01010131,1368,270,1098
2021,Solihull 011A,E01010132,1465,294,1171
2021,Solihull 011B,E01010133,1609,282,1327
2021,Solihull 011C,E01010134,1399,291,1108
2021,Solihull 011D,E01010135,1451,228,1223
2021,Solihull 012A,E01010136,1203,239,964
2021,Solihull 012B,E01010137,1300,202,1098
2021,Solihull 011E,E01010138,1318,229,1089
2021,Solihull 006C,E01010139,1043,222,821
2021,Solihull 007A,E01010140,1377,329,1048
2021,Solihull 006D,E01010141,1178,224,954
2021,Solihull 007B,E01010142,1354,334,1020
2021,Solihull 007C,E01010143,1449,346,1103
2021,Solihull 007D,E01010144,1624,318,1306
2021,Solihull 005A,E01010145,1573,321,1252
2021,Solihull 004A,E01010146,1574,402,1172
2021,Solihull 005B,E01010147,1426,389,1037
2021,Solihull 005C,E01010148,1735,520,1215
2021,Solihull 005D,E01010149,1451,232,1219
2021,Solihull 028A,E01010150,1523,304,1219
2021,Solihull 026A,E01010151,1579,279,1300
2021,Solihull 026B,E01010152,1247,269,978
2021,Solihull 026C,E01010153,1715,366,1349
2021,Solihull 026D,E01010154,1611,283,1328
2021,Solihull 026E,E01010155,1726,335,1391
2021,Solihull 026F,E01010156,1460,258,1202
2021,Solihull 010A,E01010157,1341,262,1079
2021,Solihull 012C,E01010158,1468,329,1139
2021,Solihull 010B,E01010159,1349,266,1083
2021,Solihull 012D,E01010160,1424,263,1161
2021,Solihull 012E,E01010161,1485,282,1203
2021,Solihull 010C,E01010162,1474,287,1187
2021,Solihull 010D,E01010163,1424,273,1151
2021,Solihull 017B,E01010164,1643,258,1385
2021,Solihull 017C,E01010165,1719,305,1414
2021,Solihull 025A,E01010166,1780,373,1407
2021,Solihull 017D,E01010167,1597,268,1329
2021,Solihull 025B,E01010168,1739,320,1419
2021,Solihull 025C,E01010169,1607,292,1315
2021,Solihull 025D,E01010170,1427,285,1142
2021,Solihull 025E,E01010171,1353,252,1101
2021,Solihull 014A,E01010172,1510,325,1185
2021,Solihull 014B,E01010173,1373,291,1082
2021,Solihull 013A,E01010174,1600,334,1266
2021,Solihull 013B,E01010175,1650,258,1392
2021,Solihull 014C,E01010176,1334,270,1064
2021,Solihull 013C,E01010177,1274,234,1040
2021,Solihull 013D,E01010178,1860,309,1551
2021,Solihull 014D,E01010179,1515,183,1332
2021,Solihull 029A,E01010180,1421,285,1136
2021,Solihull 029B,E01010181,2587,590,1997
2021,Solihull 029D,E01010183,1778,317,1461
2021,Solihull 028B,E01010184,1552,384,1168
2021,Solihull 028C,E01010185,1485,303,1182
2021,Solihull 028D,E01010186,1766,382,1384
2021,Solihull 028E,E01010187,1420,337,1083
2021,Solihull 028F,E01010188,1657,328,1329
2021,Solihull 029E,E01010189,1545,289,1256
2021,Solihull 024A,E01010190,1542,297,1245
2021,Solihull 022A,E01010191,1867,371,1496
2021,Solihull 019A,E01010192,1735,280,1455
2021,Solihull 024B,E01010193,1222,250,972
2021,Solihull 024C,E01010194,1510,290,1220
2021,Solihull 016A,E01010195,1534,358,1176
2021,Solihull 019B,E01010196,1678,353,1325
2021,Solihull 019C,E01010197,1620,316,1304
2021,Solihull 019D,E01010198,1608,313,1295
2021,Solihull 018A,E01010199,1842,458,1384
2021,Solihull 018B,E01010200,1382,277,1105
2021,Solihull 018C,E01010201,1667,310,1357
2021,Solihull 022B,E01010202,1526,338,1188
2021,Solihull 022C,E01010203,1633,335,1298
2021,Solihull 018D,E01010204,1276,242,1034
2021,Solihull 018E,E01010205,1434,306,1128
2021,Solihull 018F,E01010206,1662,382,1280
2021,Solihull 024D,E01010207,1379,229,1150
2021,Solihull 023A,E01010208,1477,252,1225
2021,Solihull 022D,E01010209,1630,359,1271
2021,Solihull 023B,E01010210,1477,216,1261
2021,Solihull 023C,E01010211,1376,180,1196
2021,Solihull 027A,E01010212,1202,206,996
2021,Solihull 022E,E01010213,1677,305,1372
2021,Solihull 027B,E01010214,1107,182,925
2021,Solihull 027C,E01010215,1442,229,1213
2021,Solihull 027D,E01010216,1416,287,1129
2021,Solihull 023D,E01010217,1463,247,1216
2021,Solihull 021A,E01010218,1245,172,1073
2021,Solihull 021B,E01010219,1495,254,1241
2021,Solihull 030A,E01010220,1557,331,1226
2021,Solihull 021C,E01010221,1878,324,1554
2021,Solihull 021D,E01010222,1316,200,1116
2021,Solihull 030B,E01010223,1154,264,890
2021,Solihull 030C,E01010225,1411,294,1117
2021,Solihull 016B,E01010226,1674,181,1493
2021,Solihull 015C,E01010227,1812,310,1502
2021,Solihull 015D,E01010228,1531,296,1235
2021,Solihull 016C,E01010229,1526,329,1197
2021,Solihull 016D,E01010230,1723,359,1364
2021,Solihull 016E,E01010231,1607,314,1293
2021,Solihull 015E,E01010232,2037,406,1631
2021,Solihull 016F,E01010233,1807,353,1454
2021,Solihull 004B,E01010234,1655,442,1213
2021,Solihull 002A,E01010235,1371,358,1013
2021,Solihull 002B,E01010236,1311,334,977
2021,Solihull 004C,E01010237,1744,320,1424
2021,Solihull 004D,E01010238,1249,254,995
2021,Solihull 002C,E01010239,1473,341,1132
2021,Solihull 002D,E01010240,1290,318,972
2021,Walsall 015A,E01010241,2275,279,1996
2021,Walsall 015B,E01010242,1541,264,1277
2021,Walsall 015C,E01010243,1426,205,1221
2021,Walsall 015D,E01010244,1346,287,1059
2021,Walsall 022A,E01010245,1546,287,1259
2021,Walsall 022B,E01010246,1482,237,1245
2021,Walsall 022C,E01010247,1511,260,1251
2021,Walsall 022D,E01010248,1545,274,1271
2021,Walsall 004A,E01010249,1625,291,1334
2021,Walsall 004B,E01010250,1328,222,1106
2021,Walsall 007A,E01010251,1466,272,1194
2021,Walsall 004C,E01010252,1680,353,1327
2021,Walsall 007B,E01010253,1169,217,952
2021,Walsall 004D,E01010254,1408,289,1119
2021,Walsall 007C,E01010255,1296,165,1131
2021,Walsall 007D,E01010256,1434,192,1242
2021,Walsall 007E,E01010257,1090,166,924
2021,Walsall 023A,E01010258,1551,368,1183
2021,Walsall 023B,E01010259,1514,294,1220
2021,Walsall 023C,E01010260,1773,490,1283
2021,Walsall 033A,E01010261,1749,537,1212
2021,Walsall 036A,E01010262,1646,367,1279
2021,Walsall 033B,E01010263,1519,399,1120
2021,Walsall 033C,E01010264,1894,459,1435
2021,Walsall 033D,E01010265,1851,627,1224
2021,Walsall 023D,E01010266,1243,323,920
2021,Walsall 021A,E01010267,1523,278,1245
2021,Walsall 021B,E01010268,1620,488,1132
2021,Walsall 026A,E01010269,1492,459,1033
2021,Walsall 026B,E01010270,1631,409,1222
2021,Walsall 017A,E01010271,1888,456,1432
2021,Walsall 017B,E01010272,1374,289,1085
2021,Walsall 017C,E01010273,1389,330,1059
2021,Walsall 021C,E01010274,1446,386,1060
2021,Walsall 021D,E01010275,1755,474,1281
2021,Walsall 013B,E01010277,1656,380,1276
2021,Walsall 018B,E01010279,1870,529,1341
2021,Walsall 012A,E01010282,1254,309,945
2021,Walsall 013D,E01010283,1764,534,1230
2021,Walsall 006A,E01010284,1562,327,1235
2021,Walsall 006B,E01010285,1793,322,1471
2021,Walsall 006C,E01010286,1505,343,1162
2021,Walsall 012B,E01010287,1631,286,1345
2021,Walsall 012C,E01010288,1519,366,1153
2021,Walsall 012D,E01010289,1798,531,1267
2021,Walsall 006D,E01010290,1534,239,1295
2021,Walsall 009A,E01010291,1365,378,987
2021,Walsall 008A,E01010292,1854,314,1540
2021,Walsall 009B,E01010293,1598,297,1301
2021,Walsall 008B,E01010294,1418,316,1102
2021,Walsall 017D,E01010295,1414,304,1110
2021,Walsall 008C,E01010296,1401,231,1170
2021,Walsall 008D,E01010297,1304,159,1145
2021,Walsall 009C,E01010298,1150,215,935
2021,Walsall 009D,E01010299,1427,343,1084
2021,Walsall 009E,E01010300,1378,282,1096
2021,Walsall 001A,E01010301,1369,295,1074
2021,Walsall 002A,E01010302,1458,316,1142
2021,Walsall 001B,E01010303,1504,261,1243
2021,Walsall 002B,E01010304,1594,262,1332
2021,Walsall 002C,E01010305,1308,301,1007
2021,Walsall 001C,E01010306,2119,442,1677
2021,Walsall 001D,E01010307,1649,323,1326
2021,Walsall 002D,E01010308,1704,336,1368
2021,Walsall 036B,E01010309,2056,582,1474
2021,Walsall 038A,E01010310,1999,503,1496
2021,Walsall 036C,E01010311,2501,660,1841
2021,Walsall 038B,E01010312,1671,455,1216
2021,Walsall 038C,E01010313,1419,349,1070
2021,Walsall 038D,E01010314,1543,335,1208
2021,Walsall 038E,E01010315,1717,388,1329
2021,Walsall 036D,E01010316,1586,461,1125
2021,Walsall 024A,E01010317,1556,236,1320
2021,Walsall 024B,E01010318,1528,295,1233
2021,Walsall 010A,E01010319,1259,230,1029
2021,Walsall 016A,E01010320,1252,223,1029
2021,Walsall 010B,E01010321,1516,328,1188
2021,Walsall 016B,E01010322,1569,353,1216
2021,Walsall 016C,E01010323,1416,263,1153
2021,Walsall 016D,E01010324,1825,371,1454
2021,Walsall 024C,E01010325,1808,336,1472
2021,Walsall 029A,E01010326,1576,353,1223
2021,Walsall 029B,E01010327,1552,441,1111
2021,Walsall 029C,E01010328,1468,313,1155
2021,Walsall 039A,E01010329,1584,286,1298
2021,Walsall 029D,E01010330,1403,324,1079
2021,Walsall 035A,E01010331,1568,278,1290
2021,Walsall 035B,E01010332,1906,397,1509
2021,Walsall 035C,E01010333,1549,307,1242
2021,Walsall 035D,E01010334,1518,289,1229
2021,Walsall 037A,E01010335,1533,462,1071
2021,Walsall 034A,E01010336,1404,373,1031
2021,Walsall 037B,E01010337,1305,288,1017
2021,Walsall 037C,E01010338,1760,527,1233
2021,Walsall 037D,E01010339,1451,377,1074
2021,Walsall 034B,E01010340,1578,447,1131
2021,Walsall 034C,E01010341,1559,486,1073
2021,Walsall 034D,E01010342,1681,609,1072
2021,Walsall 034E,E01010343,1458,460,998
2021,Walsall 034F,E01010344,1694,556,1138
2021,Walsall 003A,E01010345,1064,160,904
2021,Walsall 003B,E01010346,1215,197,1018
2021,Walsall 003C,E01010347,1402,296,1106
2021,Walsall 005A,E01010348,1400,226,1174
2021,Walsall 005B,E01010349,1186,176,1010
2021,Walsall 003D,E01010350,1358,260,1098
2021,Walsall 005C,E01010351,1634,252,1382
2021,Walsall 005D,E01010352,1551,228,1323
2021,Walsall 010C,E01010353,1460,227,1233
2021,Walsall 010D,E01010354,1449,243,1206
2021,Walsall 039B,E01010355,1363,252,1111
2021,Walsall 039C,E01010356,1411,253,1158
2021,Walsall 039D,E01010357,2159,412,1747
2021,Walsall 039E,E01010358,1449,300,1149
2021,Walsall 039F,E01010359,1434,284,1150
2021,Walsall 039G,E01010360,1402,271,1131
2021,Walsall 031A,E01010361,1408,260,1148
2021,Walsall 026C,E01010362,1725,485,1240
2021,Walsall 026D,E01010363,2516,659,1857
2021,Walsall 031B,E01010364,1485,481,1004
2021,Walsall 031C,E01010365,1546,437,1109
2021,Walsall 031D,E01010366,1653,478,1175
2021,Walsall 031E,E01010367,1759,499,1260
2021,Walsall 030A,E01010368,2050,390,1660
2021,Walsall 024D,E01010369,1638,307,1331
2021,Walsall 030B,E01010370,1838,405,1433
2021,Walsall 030D,E01010372,1500,357,1143
2021,Walsall 030E,E01010373,1789,643,1146
2021,Walsall 018D,E01010374,2450,689,1761
2021,Walsall 018E,E01010375,2123,707,1416
2021,Walsall 020A,E01010376,1185,175,1010
2021,Walsall 020B,E01010377,1687,339,1348
2021,Walsall 019A,E01010378,1125,195,930
2021,Walsall 019B,E01010379,1228,160,1068
2021,Walsall 020C,E01010380,1374,168,1206
2021,Walsall 020D,E01010381,1492,317,1175
2021,Walsall 019C,E01010382,1426,251,1175
2021,Walsall 019D,E01010383,1557,314,1243
2021,Walsall 032A,E01010384,1331,239,1092
2021,Walsall 028A,E01010385,1473,265,1208
2021,Walsall 028B,E01010386,1543,268,1275
2021,Walsall 028C,E01010387,1384,232,1152
2021,Walsall 022E,E01010388,1371,218,1153
2021,Walsall 032B,E01010389,1414,235,1179
2021,Walsall 032C,E01010390,1603,289,1314
2021,Walsall 032D,E01010391,1759,313,1446
2021,Walsall 028D,E01010392,1459,235,1224
2021,Walsall 014A,E01010393,1404,251,1153
2021,Walsall 014B,E01010394,1275,271,1004
2021,Walsall 011A,E01010395,1295,243,1052
2021,Walsall 014C,E01010396,1581,325,1256
2021,Walsall 011B,E01010397,1602,435,1167
2021,Walsall 011C,E01010398,1479,233,1246
2021,Walsall 011D,E01010399,1419,242,1177
2021,Walsall 014D,E01010400,1858,330,1528
2021,Walsall 025A,E01010401,1495,328,1167
2021,Walsall 027A,E01010402,1646,345,1301
2021,Walsall 025B,E01010403,1817,485,1332
2021,Walsall 025C,E01010404,1894,448,1446
2021,Walsall 027B,E01010405,1725,359,1366
2021,Walsall 027C,E01010406,2680,686,1994
2021,Walsall 025D,E01010407,1753,389,1364
2021,Walsall 025E,E01010408,1636,349,1287
2021,Walsall 027D,E01010409,1435,286,1149
2021,Wolverhampton 033A,E01010410,2222,466,1756
2021,Wolverhampton 033B,E01010411,2020,497,1523
2021,Wolverhampton 033C,E01010412,2009,502,1507
2021,Wolverhampton 033D,E01010413,1607,373,1234
2021,Wolverhampton 027A,E01010414,2053,425,1628
2021,Wolverhampton 027B,E01010415,1699,515,1184
2021,Wolverhampton 027C,E01010416,1780,437,1343
2021,Wolverhampton 023A,E01010417,1528,326,1202
2021,Wolverhampton 022A,E01010418,1422,242,1180
2021,Wolverhampton 023B,E01010419,1629,415,1214
2021,Wolverhampton 023C,E01010420,1251,281,970
2021,Wolverhampton 022B,E01010421,1537,440,1097
2021,Wolverhampton 027D,E01010422,1790,337,1453
2021,Wolverhampton 022C,E01010423,1493,341,1152
2021,Wolverhampton 022D,E01010424,1452,268,1184
2021,Wolverhampton 023D,E01010425,1246,249,997
2021,Wolverhampton 035A,E01010426,1454,306,1148
2021,Wolverhampton 030A,E01010427,1726,351,1375
2021,Wolverhampton 035B,E01010428,1485,401,1084
2021,Wolverhampton 035C,E01010429,1261,338,923
2021,Wolverhampton 035D,E01010430,1693,394,1299
2021,Wolverhampton 030B,E01010431,1484,281,1203
2021,Wolverhampton 030C,E01010432,1467,282,1185
2021,Wolverhampton 035E,E01010433,1263,318,945
2021,Wolverhampton 001A,E01010434,1658,369,1289
2021,Wolverhampton 001B,E01010436,1382,222,1160
2021,Wolverhampton 001C,E01010437,1098,144,954
2021,Wolverhampton 001D,E01010438,1338,226,1112
2021,Wolverhampton 001E,E01010439,1311,340,971
2021,Wolverhampton 001F,E01010440,1516,313,1203
2021,Wolverhampton 001G,E01010441,1272,303,969
2021,Wolverhampton 018A,E01010442,1309,300,1009
2021,Wolverhampton 018B,E01010443,1588,529,1059
2021,Wolverhampton 018C,E01010444,1210,185,1025
2021,Wolverhampton 018D,E01010445,1394,493,901
2021,Wolverhampton 023E,E01010446,1553,298,1255
2021,Wolverhampton 018E,E01010447,1785,382,1403
2021,Wolverhampton 018F,E01010448,1589,335,1254
2021,Wolverhampton 029A,E01010449,2340,618,1722
2021,Wolverhampton 029B,E01010450,2441,534,1907
2021,Wolverhampton 029C,E01010451,1880,368,1512
2021,Wolverhampton 029D,E01010452,1559,406,1153
2021,Wolverhampton 035G,E01010454,1607,415,1192
2021,Wolverhampton 029E,E01010455,2389,549,1840
2021,Wolverhampton 004A,E01010456,1366,476,890
2021,Wolverhampton 004B,E01010457,1504,299,1205
2021,Wolverhampton 008A,E01010458,1636,356,1280
2021,Wolverhampton 008B,E01010459,1468,293,1175
2021,Wolverhampton 008C,E01010460,1515,277,1238
2021,Wolverhampton 008D,E01010461,1491,277,1214
2021,Wolverhampton 004C,E01010462,1601,399,1202
2021,Wolverhampton 020A,E01010463,1706,402,1304
2021,Wolverhampton 020B,E01010464,1539,294,1245
2021,Wolverhampton 020C,E01010465,1569,423,1146
2021,Wolverhampton 020D,E01010466,1460,446,1014
2021,Wolverhampton 026A,E01010467,1544,285,1259
2021,Wolverhampton 026B,E01010468,1437,287,1150
2021,Wolverhampton 026C,E01010469,1371,237,1134
2021,Wolverhampton 020E,E01010470,1491,342,1149
2021,Wolverhampton 015A,E01010471,1675,376,1299
2021,Wolverhampton 015B,E01010472,2387,726,1661
2021,Wolverhampton 015C,E01010473,1944,516,1428
2021,Wolverhampton 012A,E01010474,1576,328,1248
2021,Wolverhampton 015D,E01010475,1587,294,1293
2021,Wolverhampton 015E,E01010476,1769,386,1383
2021,Wolverhampton 015F,E01010477,1536,398,1138
2021,Wolverhampton 011A,E01010478,1349,404,945
2021,Wolverhampton 011B,E01010479,1515,407,1108
2021,Wolverhampton 011C,E01010480,1328,403,925
2021,Wolverhampton 004D,E01010481,1424,420,1004
2021,Wolverhampton 007A,E01010482,1371,464,907
2021,Wolverhampton 007B,E01010483,1380,428,952
2021,Wolverhampton 007C,E01010484,1274,370,904
2021,Wolverhampton 007D,E01010485,1977,659,1318
2021,Wolverhampton 011D,E01010486,1580,501,1079
2021,Wolverhampton 021A,E01010487,1440,281,1159
2021,Wolverhampton 021B,E01010488,1402,250,1152
2021,Wolverhampton 028A,E01010489,1437,269,1168
2021,Wolverhampton 028B,E01010490,1650,288,1362
2021,Wolverhampton 028C,E01010491,1486,348,1138
2021,Wolverhampton 028D,E01010492,1228,206,1022
2021,Wolverhampton 021C,E01010493,1477,318,1159
2021,Wolverhampton 028E,E01010494,1503,329,1174
2021,Wolverhampton 002A,E01010495,1649,339,1310
2021,Wolverhampton 003A,E01010496,1323,265,1058
2021,Wolverhampton 002B,E01010497,1070,165,905
2021,Wolverhampton 003B,E01010498,1281,171,1110
2021,Wolverhampton 002C,E01010499,1369,297,1072
2021,Wolverhampton 002D,E01010500,1352,402,950
2021,Wolverhampton 006B,E01010501,1375,321,1054
2021,Wolverhampton 006C,E01010502,1316,275,1041
2021,Wolverhampton 006D,E01010503,1192,237,955
2021,Wolverhampton 021D,E01010504,1515,271,1244
2021,Wolverhampton 021E,E01010505,1183,212,971
2021,Wolverhampton 017A,E01010506,1476,251,1225
2021,Wolverhampton 021F,E01010507,1413,223,1190
2021,Wolverhampton 017B,E01010508,1485,228,1257
2021,Wolverhampton 019A,E01010509,1431,267,1164
2021,Wolverhampton 017C,E01010510,1474,265,1209
2021,Wolverhampton 017D,E01010511,1667,422,1245
2021,Wolverhampton 017E,E01010512,1337,266,1071
2021,Wolverhampton 031A,E01010513,1486,256,1230
2021,Wolverhampton 031B,E01010514,1554,315,1239
2021,Wolverhampton 031C,E01010515,1563,279,1284
2021,Wolverhampton 026D,E01010516,1360,260,1100
2021,Wolverhampton 031D,E01010517,1629,365,1264
2021,Wolverhampton 026E,E01010518,1564,278,1286
2021,Wolverhampton 030D,E01010519,1481,247,1234
2021,Wolverhampton 030E,E01010520,1591,283,1308
2021,Wolverhampton 013A,E01010522,1617,514,1103
2021,Wolverhampton 013B,E01010523,1598,385,1213
2021,Wolverhampton 013C,E01010524,1591,429,1162
2021,Wolverhampton 013D,E01010525,1686,494,1192
2021,Wolverhampton 016A,E01010526,1351,402,949
2021,Wolverhampton 016B,E01010527,1746,492,1254
2021,Wolverhampton 016C,E01010528,1539,800,739
2021,Wolverhampton 016D,E01010529,1608,461,1147
2021,Wolverhampton 035H,E01010530,1748,500,1248
2021,Wolverhampton 034A,E01010531,1697,358,1339
2021,Wolverhampton 034B,E01010532,1641,350,1291
2021,Wolverhampton 032A,E01010533,1678,406,1272
2021,Wolverhampton 034C,E01010534,1434,281,1153
2021,Wolverhampton 032B,E01010535,1482,385,1097
2021,Wolverhampton 032C,E01010536,1587,301,1286
2021,Wolverhampton 032D,E01010537,1396,189,1207
2021,Wolverhampton 034D,E01010538,1479,297,1182
2021,Wolverhampton 009A,E01010539,1474,319,1155
2021,Wolverhampton 009B,E01010540,1400,223,1177
2021,Wolverhampton 003C,E01010541,1320,302,1018
2021,Wolverhampton 009C,E01010542,1514,347,1167
2021,Wolverhampton 003D,E01010543,1329,362,967
2021,Wolverhampton 009D,E01010544,1429,243,1186
2021,Wolverhampton 009E,E01010545,1571,302,1269
2021,Wolverhampton 014A,E01010546,1704,299,1405
2021,Wolverhampton 014B,E01010547,1429,206,1223
2021,Wolverhampton 014C,E01010548,1370,223,1147
2021,Wolverhampton 014D,E01010549,1451,294,1157
2021,Wolverhampton 019B,E01010550,1610,275,1335
2021,Wolverhampton 019C,E01010551,1521,207,1314
2021,Wolverhampton 019D,E01010552,1772,341,1431
2021,Wolverhampton 014E,E01010553,1526,260,1266
2021,Wolverhampton 010A,E01010554,1339,208,1131
2021,Wolverhampton 005A,E01010555,1392,273,1119
2021,Wolverhampton 005B,E01010556,1325,237,1088
2021,Wolverhampton 005C,E01010557,1355,190,1165
2021,Wolverhampton 010B,E01010558,1575,250,1325
2021,Wolverhampton 005D,E01010559,1328,225,1103
2021,Wolverhampton 005E,E01010560,1600,305,1295
2021,Wolverhampton 012B,E01010561,1507,286,1221
2021,Wolverhampton 010C,E01010562,1438,252,1186
2021,Wolverhampton 010D,E01010563,1304,245,1059
2021,Wolverhampton 012C,E01010564,2327,531,1796
2021,Wolverhampton 012D,E01010565,1739,294,1445
2021,Wolverhampton 008E,E01010566,1756,403,1353
2021,Wolverhampton 010E,E01010567,1415,277,1138
2021,Bradford 016A,E01010568,1619,241,1378
2021,Bradford 016B,E01010569,1662,295,1367
2021,Bradford 018A,E01010570,1433,223,1210
2021,Bradford 016C,E01010571,1810,336,1474
2021,Bradford 016D,E01010572,1419,188,1231
2021,Bradford 013A,E01010573,1743,287,1456
2021,Bradford 013B,E01010574,1361,200,1161
2021,Bradford 013C,E01010575,1527,227,1300
2021,Bradford 016E,E01010576,1419,190,1229
2021,Bradford 013D,E01010577,1491,283,1208
2021,Bradford 015A,E01010578,1558,221,1337
2021,Bradford 010A,E01010579,1468,229,1239
2021,Bradford 010B,E01010580,2391,467,1924
2021,Bradford 015B,E01010581,1550,323,1227
2021,Bradford 015C,E01010582,1578,292,1286
2021,Bradford 018B,E01010583,1195,232,963
2021,Bradford 015D,E01010584,1686,275,1411
2021,Bradford 015E,E01010585,1930,350,1580
2021,Bradford 022A,E01010586,1540,225,1315
2021,Bradford 022B,E01010587,1963,386,1577
2021,Bradford 022C,E01010588,1512,297,1215
2021,Bradford 022D,E01010589,1312,161,1151
2021,Bradford 031A,E01010590,2071,351,1720
2021,Bradford 022E,E01010591,1491,309,1182
2021,Bradford 031B,E01010592,1591,271,1320
2021,Bradford 022F,E01010593,1638,273,1365
2021,Bradford 031C,E01010594,1603,292,1311
2021,Bradford 031D,E01010595,2011,415,1596
2021,Bradford 022G,E01010596,1473,281,1192
2021,Bradford 028A,E01010597,1447,299,1148
2021,Bradford 028B,E01010598,1575,341,1234
2021,Bradford 028C,E01010599,1281,339,942
2021,Bradford 028D,E01010600,1355,366,989
2021,Bradford 032A,E01010601,1688,405,1283
2021,Bradford 028E,E01010602,1529,359,1170
2021,Bradford 024A,E01010603,1527,303,1224
2021,Bradford 024B,E01010604,1707,264,1443
2021,Bradford 024C,E01010605,1483,357,1126
2021,Bradford 064E,E01010606,1873,563,1310
2021,Bradford 064C,E01010607,1974,613,1361
2021,Bradford 045A,E01010608,1620,545,1075
2021,Bradford 046A,E01010609,1480,338,1142
2021,Bradford 046B,E01010610,1867,494,1373
2021,Bradford 046C,E01010611,2010,495,1515
2021,Bradford 052A,E01010612,1325,438,887
2021,Bradford 045B,E01010613,1513,353,1160
2021,Bradford 046D,E01010614,1605,536,1069
2021,Bradford 053A,E01010615,1274,282,992
2021,Bradford 053B,E01010616,1793,602,1191
2021,Bradford 064B,E01010617,1548,459,1089
2021,Bradford 038A,E01010618,1654,529,1125
2021,Bradford 038B,E01010619,2019,658,1361
2021,Bradford 042A,E01010620,1864,610,1254
2021,Bradford 042B,E01010621,2175,812,1363
2021,Bradford 042C,E01010622,2384,829,1555
2021,Bradford 042D,E01010623,1573,493,1080
2021,Bradford 042E,E01010624,2037,662,1375
2021,Bradford 038C,E01010625,1692,640,1052
2021,Bradford 038D,E01010626,1954,688,1266
2021,Bradford 038E,E01010627,1514,419,1095
2021,Bradford 040A,E01010628,1721,412,1309
2021,Bradford 040B,E01010629,2171,699,1472
2021,Bradford 040C,E01010630,1747,537,1210
2021,Bradford 040D,E01010631,1492,477,1015
2021,Bradford 040E,E01010632,1373,417,956
2021,Bradford 047A,E01010633,1406,257,1149
2021,Bradford 047B,E01010634,1483,235,1248
2021,Bradford 047C,E01010635,1357,277,1080
2021,Bradford 047D,E01010636,1642,265,1377
2021,Bradford 047E,E01010637,1968,892,1076
2021,Bradford 062A,E01010638,1377,163,1214
2021,Bradford 063C,E01010639,1899,303,1596
2021,Bradford 063A,E01010640,1607,265,1342
2021,Bradford 063B,E01010641,1467,224,1243
2021,Bradford 062B,E01010642,1963,272,1691
2021,Bradford 062E,E01010643,1296,165,1131
2021,Bradford 062D,E01010644,1920,370,1550
2021,Bradford 062C,E01010645,1711,283,1428
2021,Bradford 001A,E01010646,1303,160,1143
2021,Bradford 001B,E01010647,1022,159,863
2021,Bradford 001C,E01010648,1334,180,1154
2021,Bradford 027A,E01010649,1376,250,1126
2021,Bradford 027B,E01010650,1988,693,1295
2021,Bradford 032B,E01010651,1560,363,1197
2021,Bradford 026A,E01010652,1573,240,1333
2021,Bradford 026B,E01010653,1821,483,1338
2021,Bradford 027C,E01010654,1593,466,1127
2021,Bradford 026C,E01010655,1386,398,988
2021,Bradford 026D,E01010656,1474,302,1172
2021,Bradford 026E,E01010657,1344,235,1109
2021,Bradford 041A,E01010658,1830,610,1220
2021,Bradford 049A,E01010659,1781,598,1183
2021,Bradford 049D,E01010662,1373,386,987
2021,Bradford 050A,E01010663,1626,425,1201
2021,Bradford 049E,E01010664,1504,437,1067
2021,Bradford 050B,E01010665,1747,474,1273
2021,Bradford 050C,E01010666,1573,452,1121
2021,Bradford 050D,E01010667,1678,553,1125
2021,Bradford 055A,E01010668,1368,374,994
2021,Bradford 030A,E01010669,2033,685,1348
2021,Bradford 029A,E01010670,1726,480,1246
2021,Bradford 029B,E01010671,1593,462,1131
2021,Bradford 036A,E01010672,1271,275,996
2021,Bradford 029C,E01010673,1814,560,1254
2021,Bradford 030B,E01010674,2056,779,1277
2021,Bradford 029D,E01010675,2032,514,1518
2021,Bradford 034A,E01010676,2247,675,1572
2021,Bradford 036B,E01010678,1304,298,1006
2021,Bradford 034B,E01010679,1986,592,1394
2021,Bradford 019A,E01010680,1604,338,1266
2021,Bradford 019B,E01010681,1413,226,1187
2021,Bradford 019C,E01010682,1358,256,1102
2021,Bradford 017A,E01010683,2154,296,1858
2021,Bradford 017B,E01010684,1407,247,1160
2021,Bradford 017C,E01010685,1591,262,1329
2021,Bradford 017D,E01010686,1677,267,1410
2021,Bradford 019D,E01010687,1705,329,1376
2021,Bradford 019E,E01010688,1787,320,1467
2021,Bradford 019F,E01010689,1846,296,1550
2021,Bradford 019G,E01010690,1791,297,1494
2021,Bradford 002A,E01010691,1527,312,1215
2021,Bradford 001D,E01010692,1880,275,1605
2021,Bradford 002B,E01010693,1409,254,1155
2021,Bradford 002C,E01010694,1500,286,1214
2021,Bradford 002D,E01010695,1508,201,1307
2021,Bradford 002E,E01010696,1546,340,1206
2021,Bradford 002F,E01010697,1402,224,1178
2021,Bradford 002G,E01010698,1867,306,1561
2021,Bradford 002H,E01010699,1900,418,1482
2021,Bradford 008A,E01010700,1457,424,1033
2021,Bradford 008B,E01010701,1362,446,916
2021,Bradford 008C,E01010702,1910,622,1288
2021,Bradford 008D,E01010703,1537,365,1172
2021,Bradford 008E,E01010704,1276,260,1016
2021,Bradford 008F,E01010705,1580,315,1265
2021,Bradford 006A,E01010706,1513,258,1255
2021,Bradford 006B,E01010707,1750,287,1463
2021,Bradford 006C,E01010708,1558,352,1206
2021,Bradford 006D,E01010709,2589,576,2013
2021,Bradford 008G,E01010710,1896,424,1472
2021,Bradford 011A,E01010711,1433,257,1176
2021,Bradford 009A,E01010712,1590,596,994
2021,Bradford 011B,E01010713,1475,391,1084
2021,Bradford 011C,E01010714,1297,277,1020
2021,Bradford 012A,E01010715,1003,202,801
2021,Bradford 011D,E01010716,1870,357,1513
2021,Bradford 012B,E01010717,1496,346,1150
2021,Bradford 012C,E01010718,1405,354,1051
2021,Bradford 007A,E01010719,1711,615,1096
2021,Bradford 009B,E01010720,1405,376,1029
2021,Bradford 009C,E01010721,1769,423,1346
2021,Bradford 014A,E01010722,1532,377,1155
2021,Bradford 009D,E01010723,1446,459,987
2021,Bradford 009E,E01010724,1313,310,1003
2021,Bradford 009F,E01010725,1453,289,1164
2021,Bradford 012D,E01010726,1355,206,1149
2021,Bradford 007B,E01010727,1636,258,1378
2021,Bradford 007C,E01010728,1752,547,1205
2021,Bradford 007D,E01010729,1633,408,1225
2021,Bradford 045C,E01010730,1193,209,984
2021,Bradford 048A,E01010731,1481,488,993
2021,Bradford 048B,E01010732,1504,564,940
2021,Bradford 048C,E01010733,1571,428,1143
2021,Bradford 045D,E01010734,1365,414,951
2021,Bradford 051A,E01010735,1712,633,1079
2021,Bradford 048D,E01010736,1794,656,1138
2021,Bradford 048E,E01010737,1485,417,1068
2021,Bradford 051B,E01010738,1932,720,1212
2021,Bradford 051C,E01010739,1875,742,1133
2021,Bradford 051D,E01010740,1792,590,1202
2021,Bradford 059A,E01010741,1334,232,1102
2021,Bradford 053C,E01010742,1913,709,1204
2021,Bradford 053D,E01010743,1564,439,1125
2021,Bradford 051E,E01010744,1700,569,1131
2021,Bradford 056A,E01010745,1745,569,1176
2021,Bradford 060A,E01010746,1926,387,1539
2021,Bradford 056B,E01010747,1518,357,1161
2021,Bradford 056C,E01010748,1487,359,1128
2021,Bradford 056D,E01010749,1256,269,987
2021,Bradford 060B,E01010750,1444,219,1225
2021,Bradford 060C,E01010751,1339,197,1142
2021,Bradford 058A,E01010752,1973,416,1557
2021,Bradford 058B,E01010753,1259,168,1091
2021,Bradford 058C,E01010754,1484,263,1221
2021,Bradford 055B,E01010755,1797,501,1296
2021,Bradford 058D,E01010756,1682,311,1371
2021,Bradford 058E,E01010758,1216,221,995
2021,Bradford 058F,E01010759,1444,239,1205
2021,Bradford 058G,E01010760,1817,380,1437
2021,Bradford 049G,E01010761,1629,373,1256
2021,Bradford 055C,E01010762,1466,361,1105
2021,Bradford 055D,E01010763,1538,348,1190
2021,Bradford 010C,E01010764,1566,255,1311
2021,Bradford 010D,E01010765,2166,325,1841
2021,Bradford 010E,E01010766,1172,176,996
2021,Bradford 003A,E01010767,1377,279,1098
2021,Bradford 003B,E01010768,1545,327,1218
2021,Bradford 003C,E01010769,1482,239,1243
2021,Bradford 005A,E01010770,1691,384,1307
2021,Bradford 003D,E01010771,1168,204,964
2021,Bradford 005B,E01010772,1207,232,975
2021,Bradford 005C,E01010773,1493,295,1198
2021,Bradford 005D,E01010774,1522,231,1291
2021,Bradford 024D,E01010775,1686,322,1364
2021,Bradford 021A,E01010776,1523,328,1195
2021,Bradford 021B,E01010777,1359,234,1125
2021,Bradford 024E,E01010778,1860,456,1404
2021,Bradford 021C,E01010779,1480,247,1233
2021,Bradford 021D,E01010781,1383,328,1055
2021,Bradford 020B,E01010782,2067,428,1639
2021,Bradford 021E,E01010783,1480,261,1219
2021,Bradford 018C,E01010784,1498,267,1231
2021,Bradford 018D,E01010785,1499,200,1299
2021,Bradford 018E,E01010786,1521,362,1159
2021,Bradford 020C,E01010787,1480,252,1228
2021,Bradford 020D,E01010788,1325,270,1055
2021,Bradford 025A,E01010789,1730,498,1232
2021,Bradford 018F,E01010790,1496,311,1185
2021,Bradford 025B,E01010791,1718,451,1267
2021,Bradford 025C,E01010792,1856,573,1283
2021,Bradford 025D,E01010793,1698,480,1218
2021,Bradford 043A,E01010794,1878,388,1490
2021,Bradford 043B,E01010795,1843,395,1448
2021,Bradford 043C,E01010796,1599,350,1249
2021,Bradford 043D,E01010797,1337,223,1114
2021,Bradford 043E,E01010798,1432,277,1155
2021,Bradford 036C,E01010799,1485,345,1140
2021,Bradford 036D,E01010800,1693,519,1174
2021,Bradford 036E,E01010801,1864,560,1304
2021,Bradford 036F,E01010802,1841,512,1329
2021,Bradford 037A,E01010803,1711,497,1214
2021,Bradford 033A,E01010804,2132,611,1521
2021,Bradford 030D,E01010805,1692,475,1217
2021,Bradford 033B,E01010806,1544,461,1083
2021,Bradford 033C,E01010807,2135,611,1524
2021,Bradford 033D,E01010808,2157,774,1383
2021,Bradford 033E,E01010809,1995,603,1392
2021,Bradford 037B,E01010810,2058,679,1379
2021,Bradford 037C,E01010811,2053,731,1322
2021,Bradford 041B,E01010812,1856,595,1261
2021,Bradford 037D,E01010813,1756,577,1179
2021,Bradford 057A,E01010814,1516,249,1267
2021,Bradford 057B,E01010815,2382,640,1742
2021,Bradford 057C,E01010816,1813,325,1488
2021,Bradford 057D,E01010817,2397,638,1759
2021,Bradford 057E,E01010818,1966,425,1541
2021,Bradford 052B,E01010819,1385,358,1027
2021,Bradford 052C,E01010820,1356,393,963
2021,Bradford 052D,E01010821,1749,520,1229
2021,Bradford 052E,E01010822,1174,325,849
2021,Bradford 034C,E01010824,1759,425,1334
2021,Bradford 032C,E01010825,1422,349,1073
2021,Bradford 027D,E01010826,1512,547,965
2021,Bradford 032D,E01010827,1450,417,1033
2021,Bradford 035A,E01010828,1530,360,1170
2021,Bradford 035B,E01010829,1563,460,1103
2021,Bradford 035C,E01010830,2226,888,1338
2021,Bradford 035D,E01010831,2006,639,1367
2021,Bradford 035E,E01010832,2280,853,1427
2021,Bradford 041C,E01010833,1626,537,1089
2021,Bradford 044A,E01010834,2780,1619,1161
2021,Bradford 044C,E01010836,1881,740,1141
2021,Bradford 044D,E01010837,1959,622,1337
2021,Bradford 044E,E01010838,1879,660,1219
2021,Bradford 044F,E01010839,1526,433,1093
2021,Bradford 034D,E01010840,1720,487,1233
2021,Bradford 034E,E01010841,1709,502,1207
2021,Bradford 065A,E01010842,2156,768,1388
2021,Bradford 041D,E01010843,1913,670,1243
2021,Bradford 059B,E01010845,1942,537,1405
2021,Bradford 055E,E01010846,1993,443,1550
2021,Bradford 054A,E01010847,1509,319,1190
2021,Bradford 054B,E01010848,1484,300,1184
2021,Bradford 059C,E01010849,1320,222,1098
2021,Bradford 059D,E01010850,1287,383,904
2021,Bradford 059E,E01010851,1331,234,1097
2021,Bradford 054C,E01010852,1746,457,1289
2021,Bradford 054D,E01010853,1297,335,962
2021,Bradford 023A,E01010854,1661,277,1384
2021,Bradford 023B,E01010855,1557,200,1357
2021,Bradford 023C,E01010856,1410,234,1176
2021,Bradford 023D,E01010857,1541,208,1333
2021,Bradford 023E,E01010858,1504,246,1258
2021,Bradford 012E,E01010859,1715,276,1439
2021,Bradford 014B,E01010860,1633,280,1353
2021,Bradford 023F,E01010861,1700,270,1430
2021,Bradford 014C,E01010862,1561,284,1277
2021,Bradford 014D,E01010863,1349,242,1107
2021,Bradford 059F,E01010864,1165,271,894
2021,Bradford 060D,E01010865,1515,266,1249
2021,Bradford 060E,E01010866,1252,181,1071
2021,Bradford 059G,E01010867,1625,403,1222
2021,Bradford 061A,E01010868,1533,380,1153
2021,Bradford 061B,E01010869,1652,340,1312
2021,Bradford 061C,E01010870,1353,198,1155
2021,Bradford 061D,E01010871,1644,271,1373
2021,Bradford 061E,E01010872,1721,473,1248
2021,Bradford 061F,E01010873,1133,174,959
2021,Bradford 059H,E01010874,1407,342,1065
2021,Calderdale 019A,E01010875,1640,282,1358
2021,Calderdale 019B,E01010876,1543,219,1324
2021,Calderdale 019C,E01010877,1363,188,1175
2021,Calderdale 015A,E01010878,1576,252,1324
2021,Calderdale 015B,E01010879,1725,276,1449
2021,Calderdale 019D,E01010880,1277,244,1033
2021,Calderdale 004A,E01010881,1507,305,1202
2021,Calderdale 004B,E01010882,1263,217,1046
2021,Calderdale 004C,E01010883,1512,253,1259
2021,Calderdale 022A,E01010884,1554,256,1298
2021,Calderdale 022B,E01010885,1440,221,1219
2021,Calderdale 022C,E01010886,1064,196,868
2021,Calderdale 004D,E01010887,1429,193,1236
2021,Calderdale 004E,E01010888,1399,212,1187
2021,Calderdale 025A,E01010889,1614,294,1320
2021,Calderdale 025B,E01010890,1689,314,1375
2021,Calderdale 024A,E01010891,1638,293,1345
2021,Calderdale 024B,E01010892,1805,382,1423
2021,Calderdale 025C,E01010893,1364,278,1086
2021,Calderdale 025D,E01010894,1682,395,1287
2021,Calderdale 024C,E01010895,1307,257,1050
2021,Calderdale 026A,E01010896,1497,247,1250
2021,Calderdale 026B,E01010897,1589,279,1310
2021,Calderdale 026C,E01010898,1556,249,1307
2021,Calderdale 026D,E01010899,1276,255,1021
2021,Calderdale 026E,E01010900,1524,268,1256
2021,Calderdale 025E,E01010901,1783,333,1450
2021,Calderdale 026F,E01010902,1466,346,1120
2021,Calderdale 025F,E01010903,1615,297,1318
2021,Calderdale 011A,E01010904,1516,283,1233
2021,Calderdale 015C,E01010905,1851,352,1499
2021,Calderdale 011B,E01010906,1360,236,1124
2021,Calderdale 011C,E01010907,1409,237,1172
2021,Calderdale 015D,E01010908,2055,384,1671
2021,Calderdale 011D,E01010909,1635,296,1339
2021,Calderdale 015E,E01010910,1259,272,987
2021,Calderdale 001A,E01010911,1669,304,1365
2021,Calderdale 001B,E01010912,1451,300,1151
2021,Calderdale 001C,E01010913,1236,151,1085
2021,Calderdale 002A,E01010914,1522,322,1200
2021,Calderdale 001D,E01010915,1430,264,1166
2021,Calderdale 005A,E01010916,1455,387,1068
2021,Calderdale 007A,E01010917,1694,250,1444
2021,Calderdale 007B,E01010918,1573,261,1312
2021,Calderdale 007C,E01010919,1525,282,1243
2021,Calderdale 007D,E01010920,1538,208,1330
2021,Calderdale 007E,E01010921,1554,313,1241
2021,Calderdale 020A,E01010922,1737,325,1412
2021,Calderdale 004F,E01010923,1489,248,1241
2021,Calderdale 002B,E01010924,997,213,784
2021,Calderdale 002C,E01010925,1383,328,1055
2021,Calderdale 002D,E01010926,1082,343,739
2021,Calderdale 009A,E01010927,2146,412,1734
2021,Calderdale 009B,E01010928,1347,314,1033
2021,Calderdale 010A,E01010929,2466,795,1671
2021,Calderdale 010B,E01010930,1531,350,1181
2021,Calderdale 003A,E01010931,1347,212,1135
2021,Calderdale 003B,E01010932,1488,217,1271
2021,Calderdale 003C,E01010933,1588,248,1340
2021,Calderdale 008A,E01010934,1857,266,1591
2021,Calderdale 003D,E01010935,1351,173,1178
2021,Calderdale 003E,E01010936,1928,373,1555
2021,Calderdale 003F,E01010937,1440,252,1188
2021,Calderdale 006A,E01010938,1403,393,1010
2021,Calderdale 005B,E01010939,1589,257,1332
2021,Calderdale 006B,E01010940,1341,253,1088
2021,Calderdale 005C,E01010941,1292,301,991
2021,Calderdale 005D,E01010942,1661,295,1366
2021,Calderdale 006C,E01010943,1333,344,989
2021,Calderdale 005E,E01010944,1279,284,995
2021,Calderdale 024D,E01010945,1486,276,1210
2021,Calderdale 023A,E01010946,1240,206,1034
2021,Calderdale 023B,E01010947,1426,227,1199
2021,Calderdale 024E,E01010948,1354,216,1138
2021,Calderdale 019E,E01010949,1489,229,1260
2021,Calderdale 023C,E01010950,1380,245,1135
2021,Calderdale 023D,E01010951,1427,210,1217
2021,Calderdale 027A,E01010952,1555,258,1297
2021,Calderdale 027B,E01010953,1447,274,1173
2021,Calderdale 027C,E01010954,2356,534,1822
2021,Calderdale 027D,E01010955,1346,287,1059
2021,Calderdale 020B,E01010956,1564,276,1288
2021,Calderdale 027E,E01010957,1426,237,1189
2021,Calderdale 020C,E01010958,1256,258,998
2021,Calderdale 020D,E01010959,1627,352,1275
2021,Calderdale 012A,E01010960,1471,458,1013
2021,Calderdale 006D,E01010961,1098,191,907
2021,Calderdale 012B,E01010964,1479,458,1021
2021,Calderdale 012C,E01010965,1312,335,977
2021,Calderdale 012D,E01010966,1614,518,1096
2021,Calderdale 008D,E01010967,1404,221,1183
2021,Calderdale 021A,E01010968,1683,272,1411
2021,Calderdale 016A,E01010969,1677,341,1336
2021,Calderdale 016B,E01010970,1935,373,1562
2021,Calderdale 021B,E01010971,1836,388,1448
2021,Calderdale 021C,E01010972,1542,340,1202
2021,Calderdale 021D,E01010973,1663,310,1353
2021,Calderdale 016C,E01010974,1411,309,1102
2021,Calderdale 017A,E01010975,1419,183,1236
2021,Calderdale 017B,E01010976,1785,289,1496
2021,Calderdale 016D,E01010977,1717,269,1448
2021,Calderdale 017C,E01010978,1308,246,1062
2021,Calderdale 017D,E01010979,1327,182,1145
2021,Calderdale 017E,E01010980,1380,274,1106
2021,Calderdale 017F,E01010981,1392,218,1174
2021,Calderdale 013A,E01010982,1301,226,1075
2021,Calderdale 013B,E01010983,1563,293,1270
2021,Calderdale 022D,E01010984,1290,255,1035
2021,Calderdale 013C,E01010985,1349,247,1102
2021,Calderdale 013D,E01010986,1613,358,1255
2021,Calderdale 013E,E01010987,1788,371,1417
2021,Calderdale 013F,E01010988,1346,263,1083
2021,Calderdale 018A,E01010989,1404,200,1204
2021,Calderdale 018B,E01010990,1524,264,1260
2021,Calderdale 018C,E01010991,1362,193,1169
2021,Calderdale 018D,E01010992,1613,302,1311
2021,Calderdale 018E,E01010993,1598,376,1222
2021,Calderdale 012E,E01010995,1263,341,922
2021,Calderdale 014A,E01010996,1382,410,972
2021,Calderdale 009C,E01010997,1432,249,1183
2021,Calderdale 010C,E01010998,1666,433,1233
2021,Calderdale 009D,E01010999,1436,280,1156
2021,Calderdale 010D,E01011000,2200,755,1445
2021,Calderdale 014B,E01011001,1540,507,1033
2021,Calderdale 014C,E01011002,1699,510,1189
2021,Calderdale 014D,E01011003,1355,379,976
2021,Kirklees 040A,E01011004,1235,218,1017
2021,Kirklees 044A,E01011005,1412,225,1187
2021,Kirklees 040B,E01011006,1411,248,1163
2021,Kirklees 042A,E01011007,1671,631,1040
2021,Kirklees 040C,E01011008,1350,272,1078
2021,Kirklees 044B,E01011009,1292,225,1067
2021,Kirklees 044C,E01011010,1478,387,1091
2021,Kirklees 044D,E01011011,1428,198,1230
2021,Kirklees 040D,E01011012,1436,319,1117
2021,Kirklees 007A,E01011013,1497,253,1244
2021,Kirklees 007B,E01011014,1462,325,1137
2021,Kirklees 010A,E01011015,1467,346,1121
2021,Kirklees 013A,E01011016,1345,291,1054
2021,Kirklees 013B,E01011017,1440,336,1104
2021,Kirklees 013C,E01011018,1329,373,956
2021,Kirklees 013D,E01011019,1369,283,1086
2021,Kirklees 013E,E01011020,1248,356,892
2021,Kirklees 014A,E01011021,1507,260,1247
2021,Kirklees 014B,E01011022,1340,267,1073
2021,Kirklees 007C,E01011023,1686,437,1249
2021,Kirklees 007D,E01011024,1802,484,1318
2021,Kirklees 016A,E01011025,1441,397,1044
2021,Kirklees 016B,E01011026,1463,335,1128
2021,Kirklees 006A,E01011027,1227,286,941
2021,Kirklees 006B,E01011028,1348,277,1071
2021,Kirklees 010B,E01011029,1441,322,1119
2021,Kirklees 006C,E01011030,1537,458,1079
2021,Kirklees 006D,E01011031,1886,414,1472
2021,Kirklees 010C,E01011032,2012,505,1507
2021,Kirklees 012A,E01011033,1569,356,1213
2021,Kirklees 010D,E01011034,1454,392,1062
2021,Kirklees 012B,E01011035,1510,408,1102
2021,Kirklees 012C,E01011036,1650,510,1140
2021,Kirklees 012D,E01011037,2120,552,1568
2021,Kirklees 029A,E01011038,1658,488,1170
2021,Kirklees 027A,E01011039,1685,378,1307
2021,Kirklees 031A,E01011040,1775,496,1279
2021,Kirklees 029B,E01011041,1461,297,1164
2021,Kirklees 027B,E01011042,1525,342,1183
2021,Kirklees 031B,E01011043,2516,773,1743
2021,Kirklees 031C,E01011044,1520,422,1098
2021,Kirklees 031D,E01011045,1807,502,1305
2021,Kirklees 022A,E01011046,1355,252,1103
2021,Kirklees 027C,E01011047,1436,207,1229
2021,Kirklees 002A,E01011048,1560,201,1359
2021,Kirklees 002B,E01011049,1618,308,1310
2021,Kirklees 002C,E01011050,1389,220,1169
2021,Kirklees 001A,E01011051,1582,262,1320
2021,Kirklees 002D,E01011052,1509,282,1227
2021,Kirklees 002E,E01011053,1339,230,1109
2021,Kirklees 006E,E01011054,1316,206,1110
2021,Kirklees 001B,E01011055,1219,216,1003
2021,Kirklees 001C,E01011056,1591,302,1289
2021,Kirklees 001D,E01011057,1539,280,1259
2021,Kirklees 001E,E01011058,1188,246,942
2021,Kirklees 002F,E01011059,1675,478,1197
2021,Kirklees 005A,E01011060,1517,225,1292
2021,Kirklees 005B,E01011061,1582,259,1323
2021,Kirklees 003A,E01011062,1791,324,1467
2021,Kirklees 005C,E01011063,2027,388,1639
2021,Kirklees 003B,E01011064,1564,298,1266
2021,Kirklees 005D,E01011065,1528,297,1231
2021,Kirklees 005E,E01011066,1431,223,1208
2021,Kirklees 008A,E01011067,1576,278,1298
2021,Kirklees 003C,E01011068,1499,231,1268
2021,Kirklees 003D,E01011069,1357,210,1147
2021,Kirklees 052A,E01011070,1578,262,1316
2021,Kirklees 049A,E01011071,1819,323,1496
2021,Kirklees 049B,E01011072,1516,295,1221
2021,Kirklees 049C,E01011073,1478,285,1193
2021,Kirklees 052B,E01011074,1752,302,1450
2021,Kirklees 052C,E01011075,1395,246,1149
2021,Kirklees 052D,E01011076,1348,240,1108
2021,Kirklees 045A,E01011077,1520,292,1228
2021,Kirklees 049D,E01011078,1762,342,1420
2021,Kirklees 047A,E01011079,1854,418,1436
2021,Kirklees 043A,E01011080,1916,515,1401
2021,Kirklees 043B,E01011081,1681,429,1252
2021,Kirklees 043C,E01011082,1713,578,1135
2021,Kirklees 047B,E01011083,1668,322,1346
2021,Kirklees 047C,E01011084,1794,624,1170
2021,Kirklees 047D,E01011085,1621,378,1243
2021,Kirklees 050A,E01011086,1518,247,1271
2021,Kirklees 050B,E01011087,1425,247,1178
2021,Kirklees 050C,E01011088,1257,181,1076
2021,Kirklees 032A,E01011089,1190,232,958
2021,Kirklees 037A,E01011090,1365,253,1112
2021,Kirklees 032B,E01011091,1302,234,1068
2021,Kirklees 032C,E01011092,1221,171,1050
2021,Kirklees 035A,E01011093,1349,354,995
2021,Kirklees 035B,E01011094,1486,404,1082
2021,Kirklees 037B,E01011095,1305,225,1080
2021,Kirklees 035C,E01011096,1447,295,1152
2021,Kirklees 037C,E01011097,1550,325,1225
2021,Kirklees 035D,E01011098,1520,412,1108
2021,Kirklees 037D,E01011099,1358,292,1066
2021,Kirklees 022B,E01011100,1405,283,1122
2021,Kirklees 025A,E01011101,1649,496,1153
2021,Kirklees 022C,E01011102,1280,273,1007
2021,Kirklees 025B,E01011103,1294,291,1003
2021,Kirklees 025C,E01011104,1526,321,1205
2021,Kirklees 025D,E01011105,2250,688,1562
2021,Kirklees 029C,E01011106,1495,427,1068
2021,Kirklees 029D,E01011107,2101,970,1131
2021,Kirklees 022D,E01011108,1332,213,1119
2021,Kirklees 054A,E01011109,1805,348,1457
2021,Kirklees 057A,E01011110,1401,230,1171
2021,Kirklees 057B,E01011111,1780,354,1426
2021,Kirklees 057C,E01011112,1523,293,1230
2021,Kirklees 054B,E01011113,1487,209,1278
2021,Kirklees 054C,E01011114,1626,301,1325
2021,Kirklees 057D,E01011115,1740,293,1447
2021,Kirklees 057E,E01011116,1501,225,1276
2021,Kirklees 057F,E01011117,1656,287,1369
2021,Kirklees 056A,E01011118,1450,269,1181
2021,Kirklees 054D,E01011119,1371,203,1168
2021,Kirklees 056B,E01011120,1369,278,1091
2021,Kirklees 018A,E01011121,1648,399,1249
2021,Kirklees 018B,E01011122,1276,370,906
2021,Kirklees 018C,E01011123,1548,282,1266
2021,Kirklees 018D,E01011124,1853,340,1513
2021,Kirklees 018E,E01011125,1961,448,1513
2021,Kirklees 014C,E01011126,1732,328,1404
2021,Kirklees 014D,E01011127,1290,218,1072
2021,Kirklees 017A,E01011128,1878,494,1384
2021,Kirklees 018F,E01011129,1209,243,966
2021,Kirklees 017B,E01011130,2040,430,1610
2021,Kirklees 020A,E01011132,1474,265,1209
2021,Kirklees 023A,E01011133,1551,510,1041
2021,Kirklees 023B,E01011134,1949,666,1283
2021,Kirklees 016C,E01011136,1509,394,1115
2021,Kirklees 016D,E01011137,1375,317,1058
2021,Kirklees 019A,E01011138,1773,556,1217
2021,Kirklees 019B,E01011139,1474,414,1060
2021,Kirklees 019C,E01011140,1598,571,1027
2021,Kirklees 019D,E01011141,1665,505,1160
2021,Kirklees 020B,E01011142,1489,250,1239
2021,Kirklees 023C,E01011143,1693,562,1131
2021,Kirklees 023D,E01011144,1557,453,1104
2021,Kirklees 041A,E01011145,1369,256,1113
2021,Kirklees 036A,E01011146,1483,266,1217
2021,Kirklees 041B,E01011147,1571,287,1284
2021,Kirklees 041C,E01011148,1618,377,1241
2021,Kirklees 045B,E01011149,1681,294,1387
2021,Kirklees 038A,E01011150,1560,285,1275
2021,Kirklees 036B,E01011151,1446,230,1216
2021,Kirklees 041D,E01011152,1610,249,1361
2021,Kirklees 045C,E01011153,1609,280,1329
2021,Kirklees 045D,E01011154,1500,340,1160
2021,Kirklees 038B,E01011155,2012,338,1674
2021,Kirklees 015A,E01011156,1449,254,1195
2021,Kirklees 011A,E01011157,1618,421,1197
2021,Kirklees 015B,E01011158,1831,392,1439
2021,Kirklees 015C,E01011159,1641,252,1389
2021,Kirklees 015D,E01011160,1260,251,1009
2021,Kirklees 011B,E01011161,1256,250,1006
2021,Kirklees 015E,E01011162,1404,227,1177
2021,Kirklees 011C,E01011163,1300,285,1015
2021,Kirklees 011D,E01011164,1666,351,1315
2021,Kirklees 011E,E01011165,1657,425,1232
2021,Kirklees 011F,E01011166,1580,360,1220
2021,Kirklees 011G,E01011167,1824,418,1406
2021,Kirklees 055A,E01011168,1554,280,1274
2021,Kirklees 053A,E01011169,1346,222,1124
2021,Kirklees 053B,E01011170,1790,311,1479
2021,Kirklees 053E,E01011173,1167,223,944
2021,Kirklees 055B,E01011174,1774,256,1518
2021,Kirklees 055C,E01011175,1612,412,1200
2021,Kirklees 053F,E01011176,1320,255,1065
2021,Kirklees 055D,E01011177,1917,331,1586
2021,Kirklees 055E,E01011178,1773,317,1456
2021,Kirklees 059A,E01011179,1607,249,1358
2021,Kirklees 058A,E01011180,1810,330,1480
2021,Kirklees 059B,E01011181,1683,287,1396
2021,Kirklees 058B,E01011182,1613,288,1325
2021,Kirklees 059C,E01011183,2142,429,1713
2021,Kirklees 059D,E01011184,1342,291,1051
2021,Kirklees 059E,E01011185,1533,290,1243
2021,Kirklees 058C,E01011186,1729,276,1453
2021,Kirklees 059F,E01011187,1601,335,1266
2021,Kirklees 058D,E01011188,1585,291,1294
2021,Kirklees 059G,E01011189,1773,316,1457
2021,Kirklees 051A,E01011190,1528,239,1289
2021,Kirklees 046A,E01011191,1474,239,1235
2021,Kirklees 046B,E01011192,1489,239,1250
2021,Kirklees 046C,E01011193,2151,410,1741
2021,Kirklees 046D,E01011194,1259,141,1118
2021,Kirklees 051B,E01011195,1695,786,909
2021,Kirklees 051C,E01011196,1861,409,1452
2021,Kirklees 051D,E01011197,1445,241,1204
2021,Kirklees 056C,E01011198,1499,278,1221
2021,Kirklees 056D,E01011199,1402,283,1119
2021,Kirklees 032D,E01011200,2176,497,1679
2021,Kirklees 030A,E01011201,1638,268,1370
2021,Kirklees 036C,E01011202,1483,261,1222
2021,Kirklees 030B,E01011203,1760,333,1427
2021,Kirklees 033A,E01011204,1472,308,1164
2021,Kirklees 036D,E01011205,1517,226,1291
2021,Kirklees 033B,E01011206,1575,283,1292
2021,Kirklees 038C,E01011207,1407,259,1148
2021,Kirklees 033C,E01011208,1552,322,1230
2021,Kirklees 027D,E01011210,1968,395,1573
2021,Kirklees 030D,E01011211,1857,371,1486
2021,Kirklees 026A,E01011212,1492,235,1257
2021,Kirklees 026B,E01011213,1476,242,1234
2021,Kirklees 026C,E01011214,1434,219,1215
2021,Kirklees 026D,E01011215,2184,331,1853
2021,Kirklees 021A,E01011216,1437,266,1171
2021,Kirklees 020C,E01011217,1487,213,1274
2021,Kirklees 020D,E01011218,1569,319,1250
2021,Kirklees 021B,E01011219,1496,232,1264
2021,Kirklees 021C,E01011220,1666,432,1234
2021,Kirklees 021D,E01011221,1616,285,1331
2021,Kirklees 050D,E01011222,1557,217,1340
2021,Kirklees 042B,E01011223,1763,499,1264
2021,Kirklees 048A,E01011224,1676,401,1275
2021,Kirklees 042C,E01011225,1552,485,1067
2021,Kirklees 048B,E01011226,1418,239,1179
2021,Kirklees 048C,E01011227,1419,261,1158
2021,Kirklees 048D,E01011228,1308,185,1123
2021,Kirklees 042D,E01011229,2714,1708,1006
2021,Kirklees 043D,E01011230,1880,695,1185
2021,Kirklees 034A,E01011231,1356,215,1141
2021,Kirklees 039A,E01011232,1473,336,1137
2021,Kirklees 039B,E01011233,1600,380,1220
2021,Kirklees 038D,E01011234,1447,340,1107
2021,Kirklees 039C,E01011235,1769,625,1144
2021,Kirklees 034B,E01011236,1671,533,1138
2021,Kirklees 039D,E01011237,1554,473,1081
2021,Kirklees 034C,E01011238,1667,403,1264
2021,Kirklees 034D,E01011239,1531,341,1190
2021,Kirklees 033D,E01011240,1688,366,1322
2021,Kirklees 004A,E01011241,1540,289,1251
2021,Kirklees 004B,E01011242,1537,296,1241
2021,Kirklees 004C,E01011243,1567,264,1303
2021,Kirklees 004D,E01011244,1911,439,1472
2021,Kirklees 009A,E01011245,1447,318,1129
2021,Kirklees 009B,E01011246,1431,327,1104
2021,Kirklees 008B,E01011247,1490,251,1239
2021,Kirklees 009C,E01011248,1346,211,1135
2021,Kirklees 008C,E01011249,1696,405,1291
2021,Kirklees 009D,E01011250,1660,296,1364
2021,Kirklees 008D,E01011251,1584,404,1180
2021,Kirklees 028A,E01011252,1092,137,955
2021,Kirklees 028B,E01011253,1160,252,908
2021,Kirklees 028C,E01011254,1468,208,1260
2021,Kirklees 028D,E01011255,1348,295,1053
2021,Kirklees 028E,E01011256,1215,249,966
2021,Kirklees 024A,E01011257,1903,492,1411
2021,Kirklees 024B,E01011258,1882,594,1288
2021,Kirklees 024C,E01011259,1922,557,1365
2021,Kirklees 023E,E01011260,1354,389,965
2021,Kirklees 024D,E01011261,1361,470,891
2021,Kirklees 024E,E01011262,1621,503,1118
2021,Kirklees 024F,E01011263,1678,387,1291
2021,Leeds 011A,E01011264,1241,182,1059
2021,Leeds 009A,E01011265,1849,330,1519
2021,Leeds 008A,E01011266,2488,471,2017
2021,Leeds 009B,E01011267,1595,319,1276
2021,Leeds 010A,E01011268,1312,268,1044
2021,Leeds 011B,E01011269,1502,231,1271
2021,Leeds 008B,E01011270,1649,316,1333
2021,Leeds 009C,E01011271,2079,459,1620
2021,Leeds 009D,E01011272,1398,293,1105
2021,Leeds 010B,E01011273,1397,203,1194
2021,Leeds 010C,E01011274,1287,247,1040
2021,Leeds 010D,E01011275,1311,249,1062
2021,Leeds 011C,E01011276,1640,241,1399
2021,Leeds 014A,E01011277,1499,308,1191
2021,Leeds 014B,E01011278,1545,257,1288
2021,Leeds 008C,E01011279,1256,222,1034
2021,Leeds 008D,E01011280,1945,382,1563
2021,Leeds 059A,E01011281,2028,419,1609
2021,Leeds 059B,E01011282,1287,289,998
2021,Leeds 059C,E01011283,1437,403,1034
2021,Leeds 071A,E01011284,2002,403,1599
2021,Leeds 059D,E01011286,1221,224,997
2021,Leeds 067B,E01011287,1352,224,1128
2021,Leeds 071B,E01011292,1825,445,1380
2021,Leeds 071C,E01011293,1815,437,1378
2021,Leeds 071D,E01011294,1626,268,1358
2021,Leeds 059E,E01011295,1570,345,1225
2021,Leeds 030A,E01011296,1560,196,1364
2021,Leeds 030B,E01011297,1644,320,1324
2021,Leeds 088A,E01011298,1462,276,1186
2021,Leeds 088B,E01011299,2647,576,2071
2021,Leeds 089A,E01011300,1371,260,1111
2021,Leeds 089B,E01011301,1195,166,1029
2021,Leeds 088C,E01011302,1688,209,1479
2021,Leeds 088D,E01011303,1090,176,914
2021,Leeds 089C,E01011304,1494,310,1184
2021,Leeds 089D,E01011305,1421,233,1188
2021,Leeds 089E,E01011306,1241,210,1031
2021,Leeds 103A,E01011307,1531,280,1251
2021,Leeds 103B,E01011308,1422,272,1150
2021,Leeds 030C,E01011309,1438,232,1206
2021,Leeds 030D,E01011310,1554,276,1278
2021,Leeds 022A,E01011311,1208,246,962
2021,Leeds 086A,E01011312,1837,593,1244
2021,Leeds 091A,E01011313,1602,436,1166
2021,Leeds 091B,E01011314,1477,330,1147
2021,Leeds 090A,E01011315,1520,336,1184
2021,Leeds 086B,E01011316,1834,564,1270
2021,Leeds 090B,E01011317,1641,346,1295
2021,Leeds 090C,E01011318,1408,372,1036
2021,Leeds 091C,E01011319,1468,359,1109
2021,Leeds 091D,E01011320,1669,361,1308
2021,Leeds 090D,E01011321,1501,354,1147
2021,Leeds 091E,E01011322,1562,357,1205
2021,Leeds 051A,E01011323,1233,202,1031
2021,Leeds 046A,E01011324,1706,856,850
2021,Leeds 046B,E01011325,1528,269,1259
2021,Leeds 046C,E01011326,1398,344,1054
2021,Leeds 052A,E01011327,1260,216,1044
2021,Leeds 052B,E01011328,1487,295,1192
2021,Leeds 051B,E01011329,1435,194,1241
2021,Leeds 051C,E01011330,1283,247,1036
2021,Leeds 058A,E01011331,1275,209,1066
2021,Leeds 046D,E01011332,1503,371,1132
2021,Leeds 051D,E01011333,1297,236,1061
2021,Leeds 058B,E01011334,1335,229,1106
2021,Leeds 052C,E01011335,1618,254,1364
2021,Leeds 058C,E01011336,1485,209,1276
2021,Leeds 058D,E01011337,1600,556,1044
2021,Leeds 064A,E01011338,1887,557,1330
2021,Leeds 060A,E01011339,1963,497,1466
2021,Leeds 060B,E01011340,1649,448,1201
2021,Leeds 061A,E01011341,2013,455,1558
2021,Leeds 060C,E01011342,1743,604,1139
2021,Leeds 061B,E01011343,1839,246,1593
2021,Leeds 065A,E01011344,1830,548,1282
2021,Leeds 061C,E01011345,1427,329,1098
2021,Leeds 060D,E01011346,1794,522,1272
2021,Leeds 065B,E01011347,1777,602,1175
2021,Leeds 065C,E01011348,1669,543,1126
2021,Leeds 065D,E01011349,1662,320,1342
2021,Leeds 034A,E01011350,1471,264,1207
2021,Leeds 034B,E01011351,1631,169,1462
2021,Leeds 034C,E01011352,1796,199,1597
2021,Leeds 034D,E01011353,1823,278,1545
2021,Leeds 038A,E01011354,1454,426,1028
2021,Leeds 038B,E01011355,1414,334,1080
2021,Leeds 042A,E01011356,1913,284,1629
2021,Leeds 038C,E01011357,1943,504,1439
2021,Leeds 042B,E01011358,1471,319,1152
2021,Leeds 042C,E01011359,1782,350,1432
2021,Leeds 042D,E01011360,2095,652,1443
2021,Leeds 042E,E01011361,2679,818,1861
2021,Leeds 081A,E01011362,1809,321,1488
2021,Leeds 071E,E01011363,1795,431,1364
2021,Leeds 085A,E01011364,1980,547,1433
2021,Leeds 082A,E01011366,1642,426,1216
2021,Leeds 082C,E01011368,1499,398,1101
2021,Leeds 090E,E01011369,1503,263,1240
2021,Leeds 082D,E01011370,1575,336,1239
2021,Leeds 085B,E01011371,1705,467,1238
2021,Leeds 086C,E01011372,1630,578,1052
2021,Leeds 085C,E01011373,1434,455,979
2021,Leeds 085D,E01011374,1174,270,904
2021,Leeds 086D,E01011375,1893,580,1313
2021,Leeds 013A,E01011376,1575,274,1301
2021,Leeds 013B,E01011377,1319,214,1105
2021,Leeds 013C,E01011378,1334,267,1067
2021,Leeds 017A,E01011379,1495,302,1193
2021,Leeds 016A,E01011380,1476,245,1231
2021,Leeds 016B,E01011381,1414,243,1171
2021,Leeds 013D,E01011382,1511,236,1275
2021,Leeds 019A,E01011383,1578,298,1280
2021,Leeds 017B,E01011384,1412,253,1159
2021,Leeds 016C,E01011385,1280,240,1040
2021,Leeds 016D,E01011386,1700,351,1349
2021,Leeds 019B,E01011388,1498,250,1248
2021,Leeds 087A,E01011390,1294,208,1086
2021,Leeds 087B,E01011391,1498,222,1276
2021,Leeds 087C,E01011392,1838,357,1481
2021,Leeds 103C,E01011393,2082,415,1667
2021,Leeds 103D,E01011394,1106,191,915
2021,Leeds 103E,E01011395,1141,279,862
2021,Leeds 074A,E01011396,1795,403,1392
2021,Leeds 077A,E01011397,1393,235,1158
2021,Leeds 077B,E01011398,1101,169,932
2021,Leeds 074B,E01011399,1442,270,1172
2021,Leeds 074C,E01011400,1328,226,1102
2021,Leeds 077C,E01011401,1665,320,1345
2021,Leeds 087D,E01011402,1970,315,1655
2021,Leeds 074D,E01011403,1486,195,1291
2021,Leeds 077D,E01011404,1317,265,1052
2021,Leeds 077E,E01011405,1414,198,1216
2021,Leeds 057A,E01011406,1246,180,1066
2021,Leeds 057B,E01011407,1346,207,1139
2021,Leeds 057C,E01011408,1443,148,1295
2021,Leeds 057D,E01011409,1386,230,1156
2021,Leeds 057E,E01011410,1594,229,1365
2021,Leeds 073A,E01011411,1631,268,1363
2021,Leeds 057F,E01011412,1698,263,1435
2021,Leeds 069A,E01011413,1388,232,1156
2021,Leeds 073B,E01011414,1418,213,1205
2021,Leeds 069B,E01011415,1553,300,1253
2021,Leeds 069C,E01011416,1419,277,1142
2021,Leeds 069D,E01011417,1483,200,1283
2021,Leeds 073C,E01011418,1391,203,1188
2021,Leeds 073D,E01011419,1071,137,934
2021,Leeds 069E,E01011420,1311,154,1157
2021,Leeds 040A,E01011421,1427,347,1080
2021,Leeds 048A,E01011422,1510,448,1062
2021,Leeds 047A,E01011423,1612,458,1154
2021,Leeds 047B,E01011424,1800,637,1163
2021,Leeds 040B,E01011425,1451,308,1143
2021,Leeds 048B,E01011426,1570,539,1031
2021,Leeds 047C,E01011427,1875,666,1209
2021,Leeds 048C,E01011428,1938,577,1361
2021,Leeds 048D,E01011429,1925,599,1326
2021,Leeds 053A,E01011430,1574,561,1013
2021,Leeds 047D,E01011431,1960,532,1428
2021,Leeds 053B,E01011432,1598,484,1114
2021,Leeds 053C,E01011433,1719,554,1165
2021,Leeds 053D,E01011434,1556,465,1091
2021,Leeds 044A,E01011435,1808,1102,706
2021,Leeds 044D,E01011440,1660,899,761
2021,Leeds 044E,E01011441,1920,1035,885
2021,Leeds 110A,E01011442,1859,1351,508
2021,Leeds 110B,E01011443,1844,1126,718
2021,Leeds 110C,E01011444,1970,1536,434
2021,Leeds 054A,E01011445,1769,1512,257
2021,Leeds 054B,E01011446,1725,1262,463
2021,Leeds 054C,E01011447,1405,1050,355
2021,Leeds 054D,E01011448,1640,1197,443
2021,Leeds 054E,E01011449,1440,873,567
2021,Leeds 038D,E01011450,1244,257,987
2021,Leeds 110D,E01011451,1523,786,737
2021,Leeds 027A,E01011452,1563,338,1225
2021,Leeds 028A,E01011453,1498,249,1249
2021,Leeds 027B,E01011454,1496,288,1208
2021,Leeds 021A,E01011455,1311,412,899
2021,Leeds 021B,E01011456,1959,713,1246
2021,Leeds 027C,E01011457,1552,345,1207
2021,Leeds 027D,E01011458,2421,528,1893
2021,Leeds 021C,E01011459,1614,286,1328
2021,Leeds 028B,E01011460,1433,305,1128
2021,Leeds 021D,E01011461,1471,306,1165
2021,Leeds 028C,E01011462,1632,366,1266
2021,Leeds 028D,E01011463,1581,321,1260
2021,Leeds 028E,E01011464,1708,268,1440
2021,Leeds 027E,E01011465,1624,288,1336
2021,Leeds 094A,E01011466,1453,274,1179
2021,Leeds 112A,E01011467,1865,343,1522
2021,Leeds 112B,E01011468,1885,418,1467
2021,Leeds 094B,E01011469,1342,194,1148
2021,Leeds 112C,E01011470,1199,204,995
2021,Leeds 092A,E01011471,1439,332,1107
2021,Leeds 092B,E01011472,1551,329,1222
2021,Leeds 092C,E01011473,1431,452,979
2021,Leeds 092D,E01011474,1476,363,1113
2021,Leeds 094C,E01011475,1490,370,1120
2021,Leeds 094D,E01011476,1142,303,839
2021,Leeds 045A,E01011477,1904,468,1436
2021,Leeds 056A,E01011478,1719,542,1177
2021,Leeds 056B,E01011479,1505,662,843
2021,Leeds 045B,E01011480,1564,352,1212
2021,Leeds 056C,E01011481,1738,842,896
2021,Leeds 056D,E01011482,1701,353,1348
2021,Leeds 056E,E01011483,1563,642,921
2021,Leeds 033A,E01011484,1489,368,1121
2021,Leeds 033B,E01011485,1504,300,1204
2021,Leeds 045C,E01011488,1396,243,1153
2021,Leeds 045D,E01011489,1662,347,1315
2021,Leeds 101A,E01011491,1326,345,981
2021,Leeds 101B,E01011492,1573,407,1166
2021,Leeds 101C,E01011493,1480,392,1088
2021,Leeds 101D,E01011494,1565,472,1093
2021,Leeds 100A,E01011496,1433,286,1147
2021,Leeds 101E,E01011497,1566,440,1126
2021,Leeds 105D,E01011500,1517,221,1296
2021,Leeds 099C,E01011502,1304,262,1042
2021,Leeds 032A,E01011504,1448,301,1147
2021,Leeds 025A,E01011505,1588,323,1265
2021,Leeds 025B,E01011506,1431,319,1112
2021,Leeds 025C,E01011507,1526,283,1243
2021,Leeds 024A,E01011508,1329,304,1025
2021,Leeds 023A,E01011509,1353,210,1143
2021,Leeds 025D,E01011510,1461,269,1192
2021,Leeds 023B,E01011511,1323,275,1048
2021,Leeds 023C,E01011512,1612,324,1288
2021,Leeds 031A,E01011513,2096,418,1678
2021,Leeds 025E,E01011514,1661,366,1295
2021,Leeds 023D,E01011515,1406,247,1159
2021,Leeds 023E,E01011516,1621,298,1323
2021,Leeds 024B,E01011517,1607,321,1286
2021,Leeds 093A,E01011518,2172,408,1764
2021,Leeds 095A,E01011519,1434,269,1165
2021,Leeds 096A,E01011520,1438,219,1219
2021,Leeds 096B,E01011521,2064,324,1740
2021,Leeds 095B,E01011522,1297,195,1102
2021,Leeds 096C,E01011523,1786,336,1450
2021,Leeds 093B,E01011524,1164,164,1000
2021,Leeds 095C,E01011525,1462,245,1217
2021,Leeds 093C,E01011526,1204,236,968
2021,Leeds 096D,E01011527,1671,257,1414
2021,Leeds 095D,E01011528,1515,300,1215
2021,Leeds 096E,E01011529,1288,245,1043
2021,Leeds 106A,E01011530,1317,199,1118
2021,Leeds 093D,E01011531,1591,200,1391
2021,Leeds 095E,E01011532,1507,283,1224
2021,Leeds 104A,E01011533,1300,146,1154
2021,Leeds 106B,E01011534,2140,413,1727
2021,Leeds 108A,E01011535,1641,303,1338
2021,Leeds 108B,E01011536,1576,272,1304
2021,Leeds 107A,E01011537,1948,263,1685
2021,Leeds 107B,E01011538,1489,266,1223
2021,Leeds 102B,E01011540,1851,378,1473
2021,Leeds 104B,E01011541,1965,213,1752
2021,Leeds 104C,E01011545,1283,201,1082
2021,Leeds 106C,E01011546,1626,307,1319
2021,Leeds 104D,E01011547,1885,352,1533
2021,Leeds 106D,E01011548,1413,257,1156
2021,Leeds 108C,E01011549,1360,271,1089
2021,Leeds 106E,E01011550,1302,257,1045
2021,Leeds 107C,E01011551,1633,331,1302
2021,Leeds 107D,E01011552,1427,338,1089
2021,Leeds 108D,E01011553,1308,203,1105
2021,Leeds 012A,E01011554,1362,293,1069
2021,Leeds 018A,E01011555,1302,251,1051
2021,Leeds 015A,E01011556,1566,312,1254
2021,Leeds 015B,E01011557,1360,249,1111
2021,Leeds 018B,E01011558,1602,431,1171
2021,Leeds 018C,E01011559,1358,352,1006
2021,Leeds 018D,E01011560,1752,412,1340
2021,Leeds 006A,E01011561,1128,161,967
2021,Leeds 012B,E01011562,1503,265,1238
2021,Leeds 012C,E01011563,1341,224,1117
2021,Leeds 012D,E01011564,1466,317,1149
2021,Leeds 015C,E01011565,1393,285,1108
2021,Leeds 015D,E01011566,1248,232,1016
2021,Leeds 012E,E01011567,1387,313,1074
2021,Leeds 015E,E01011568,1794,264,1530
2021,Leeds 004A,E01011569,1667,246,1421
2021,Leeds 007A,E01011570,2185,442,1743
2021,Leeds 004B,E01011571,1533,222,1311
2021,Leeds 004C,E01011572,1686,291,1395
2021,Leeds 004D,E01011573,1246,241,1005
2021,Leeds 004E,E01011574,1366,193,1173
2021,Leeds 007C,E01011576,1387,257,1130
2021,Leeds 011D,E01011578,1216,177,1039
2021,Leeds 014C,E01011579,1253,265,988
2021,Leeds 014D,E01011580,1307,225,1082
2021,Leeds 003A,E01011581,1564,264,1300
2021,Leeds 003B,E01011582,1519,287,1232
2021,Leeds 003C,E01011583,1494,284,1210
2021,Leeds 003D,E01011584,1594,284,1310
2021,Leeds 062A,E01011585,1330,262,1068
2021,Leeds 066A,E01011586,1700,376,1324
2021,Leeds 062B,E01011587,1656,335,1321
2021,Leeds 039A,E01011588,1652,340,1312
2021,Leeds 039B,E01011589,1487,276,1211
2021,Leeds 039C,E01011590,1612,332,1280
2021,Leeds 052D,E01011591,1538,161,1377
2021,Leeds 039D,E01011592,1518,206,1312
2021,Leeds 039E,E01011593,1838,316,1522
2021,Leeds 062C,E01011594,1426,289,1137
2021,Leeds 066B,E01011595,2029,420,1609
2021,Leeds 062D,E01011596,1573,242,1331
2021,Leeds 066C,E01011597,1597,397,1200
2021,Leeds 062E,E01011598,1496,208,1288
2021,Leeds 066D,E01011599,1571,281,1290
2021,Leeds 079A,E01011600,1465,229,1236
2021,Leeds 079B,E01011601,1534,359,1175
2021,Leeds 076A,E01011602,1869,323,1546
2021,Leeds 076B,E01011603,1518,279,1239
2021,Leeds 079C,E01011604,1269,203,1066
2021,Leeds 076C,E01011605,1674,330,1344
2021,Leeds 076D,E01011606,1907,430,1477
2021,Leeds 079D,E01011607,1550,324,1226
2021,Leeds 068A,E01011608,1297,261,1036
2021,Leeds 068B,E01011609,1347,288,1059
2021,Leeds 068C,E01011610,1456,240,1216
2021,Leeds 068D,E01011611,1376,298,1078
2021,Leeds 079E,E01011612,1352,155,1197
2021,Leeds 076E,E01011613,1650,401,1249
2021,Leeds 068E,E01011614,1780,270,1510
2021,Leeds 070A,E01011615,1495,315,1180
2021,Leeds 072A,E01011616,1525,356,1169
2021,Leeds 070B,E01011617,1535,370,1165
2021,Leeds 070C,E01011618,1531,415,1116
2021,Leeds 072B,E01011620,1259,346,913
2021,Leeds 070D,E01011621,1450,417,1033
2021,Leeds 072C,E01011622,1595,483,1112
2021,Leeds 075B,E01011623,1549,508,1041
2021,Leeds 072D,E01011624,1716,517,1199
2021,Leeds 075C,E01011625,1556,399,1157
2021,Leeds 075D,E01011626,2203,523,1680
2021,Leeds 098A,E01011627,1278,244,1034
2021,Leeds 098B,E01011628,1176,147,1029
2021,Leeds 098C,E01011629,1230,188,1042
2021,Leeds 100B,E01011630,1906,309,1597
2021,Leeds 098D,E01011632,1245,277,968
2021,Leeds 098E,E01011633,1403,210,1193
2021,Leeds 100C,E01011634,1500,284,1216
2021,Leeds 097B,E01011635,1724,276,1448
2021,Leeds 100D,E01011636,1766,280,1486
2021,Leeds 097C,E01011637,1605,300,1305
2021,Leeds 097D,E01011638,1337,209,1128
2021,Leeds 100E,E01011639,1432,297,1135
2021,Leeds 032B,E01011641,1526,369,1157
2021,Leeds 032C,E01011642,1291,328,963
2021,Leeds 037A,E01011643,1430,264,1166
2021,Leeds 037B,E01011644,1248,267,981
2021,Leeds 032D,E01011645,1425,313,1112
2021,Leeds 037C,E01011646,1704,393,1311
2021,Leeds 037D,E01011647,1759,498,1261
2021,Leeds 037E,E01011648,1766,461,1305
2021,Leeds 022B,E01011649,1488,277,1211
2021,Leeds 020A,E01011650,1416,295,1121
2021,Leeds 020B,E01011651,1374,280,1094
2021,Leeds 024C,E01011652,1302,219,1083
2021,Leeds 020C,E01011653,1307,227,1080
2021,Leeds 024D,E01011654,1373,332,1041
2021,Leeds 020D,E01011655,1405,225,1180
2021,Leeds 035A,E01011656,1410,349,1061
2021,Leeds 035B,E01011657,1187,233,954
2021,Leeds 040C,E01011658,1550,378,1172
2021,Leeds 035C,E01011659,1356,301,1055
2021,Leeds 040D,E01011660,1665,370,1295
2021,Leeds 035D,E01011661,1610,217,1393
2021,Leeds 040E,E01011662,1276,387,889
2021,Leeds 050A,E01011663,1528,491,1037
2021,Leeds 050B,E01011664,1236,265,971
2021,Leeds 050C,E01011665,1298,222,1076
2021,Leeds 061D,E01011666,1365,216,1149
2021,Leeds 050D,E01011667,1451,529,922
2021,Leeds 110E,E01011668,1668,1089,579
2021,Leeds 110F,E01011669,1444,827,617
2021,Leeds 055A,E01011670,2501,1420,1081
2021,Leeds 055B,E01011671,1550,556,994
2021,Leeds 064B,E01011673,1682,506,1176
2021,Leeds 064D,E01011677,1471,308,1163
2021,Leeds 063B,E01011678,4292,3516,776
2021,Leeds 063D,E01011681,1630,829,801
2021,Leeds 019C,E01011684,1471,302,1169
2021,Leeds 109A,E01011685,2120,656,1464
2021,Leeds 033E,E01011686,1455,267,1188
2021,Leeds 109B,E01011687,1429,276,1153
2021,Leeds 031B,E01011688,1429,310,1119
2021,Leeds 031C,E01011689,1535,219,1316
2021,Leeds 109C,E01011690,1322,315,1007
2021,Leeds 031D,E01011691,1427,277,1150
2021,Leeds 109D,E01011692,1428,234,1194
2021,Leeds 109E,E01011693,1455,250,1205
2021,Leeds 109F,E01011694,1783,594,1189
2021,Leeds 019D,E01011695,1594,401,1193
2021,Leeds 006B,E01011696,1476,253,1223
2021,Leeds 002A,E01011697,2199,292,1907
2021,Leeds 001A,E01011698,1400,254,1146
2021,Leeds 001B,E01011699,1226,175,1051
2021,Leeds 002B,E01011700,1425,180,1245
2021,Leeds 001C,E01011701,1300,218,1082
2021,Leeds 001D,E01011702,1548,291,1257
2021,Leeds 001E,E01011703,1198,143,1055
2021,Leeds 002C,E01011704,2116,233,1883
2021,Leeds 002D,E01011705,1300,199,1101
2021,Leeds 006C,E01011706,1470,300,1170
2021,Leeds 005A,E01011707,1254,234,1020
2021,Leeds 006D,E01011708,1394,227,1167
2021,Leeds 005B,E01011709,1915,398,1517
2021,Leeds 005C,E01011710,1333,239,1094
2021,Leeds 005D,E01011711,1349,206,1143
2021,Leeds 005E,E01011712,1353,232,1121
2021,Leeds 006E,E01011713,1674,316,1358
2021,Leeds 029A,E01011714,1783,347,1436
2021,Leeds 022C,E01011715,1285,193,1092
2021,Leeds 029B,E01011716,1489,296,1193
2021,Leeds 029C,E01011717,1524,277,1247
2021,Leeds 029D,E01011718,1820,371,1449
2021,Leeds 022D,E01011719,1373,211,1162
2021,Leeds 029E,E01011720,1422,260,1162
2021,Leeds 041A,E01011721,1431,332,1099
2021,Leeds 041B,E01011722,1951,436,1515
2021,Leeds 041C,E01011723,1577,387,1190
2021,Leeds 041D,E01011724,1736,341,1395
2021,Leeds 078A,E01011725,1394,381,1013
2021,Leeds 080A,E01011726,1427,310,1117
2021,Leeds 080B,E01011727,1468,274,1194
2021,Leeds 080C,E01011728,1336,202,1134
2021,Leeds 078B,E01011729,1586,283,1303
2021,Leeds 078C,E01011730,1434,354,1080
2021,Leeds 081B,E01011731,1355,235,1120
2021,Leeds 081C,E01011732,1872,319,1553
2021,Leeds 081D,E01011733,1495,227,1268
2021,Leeds 083A,E01011734,2618,496,2122
2021,Leeds 078D,E01011735,1592,421,1171
2021,Leeds 083B,E01011736,1335,226,1109
2021,Leeds 083C,E01011737,1454,264,1190
2021,Leeds 083D,E01011738,1424,252,1172
2021,Leeds 080D,E01011739,1522,317,1205
2021,Wakefield 001A,E01011740,1464,302,1162
2021,Wakefield 001B,E01011741,1356,190,1166
2021,Wakefield 001C,E01011742,1554,289,1265
2021,Wakefield 003A,E01011743,1357,175,1182
2021,Wakefield 003B,E01011744,1536,236,1300
2021,Wakefield 001D,E01011745,1594,420,1174
2021,Wakefield 001E,E01011746,2306,515,1791
2021,Wakefield 003C,E01011747,1580,334,1246
2021,Wakefield 005A,E01011748,1479,215,1264
2021,Wakefield 003D,E01011750,1539,403,1136
2021,Wakefield 005C,E01011751,1237,173,1064
2021,Wakefield 002A,E01011752,1572,238,1334
2021,Wakefield 002B,E01011753,1378,190,1188
2021,Wakefield 003E,E01011754,1455,259,1196
2021,Wakefield 005D,E01011755,1487,198,1289
2021,Wakefield 002C,E01011756,1317,199,1118
2021,Wakefield 004A,E01011757,2234,463,1771
2021,Wakefield 013A,E01011758,2348,435,1913
2021,Wakefield 004B,E01011759,1884,359,1525
2021,Wakefield 004C,E01011761,2062,332,1730
2021,Wakefield 002E,E01011762,1452,221,1231
2021,Wakefield 004D,E01011763,1336,198,1138
2021,Wakefield 004E,E01011764,1647,248,1399
2021,Wakefield 032A,E01011765,1848,364,1484
2021,Wakefield 032B,E01011766,1560,285,1275
2021,Wakefield 034A,E01011767,1736,265,1471
2021,Wakefield 034B,E01011768,1269,173,1096
2021,Wakefield 034D,E01011770,1781,341,1440
2021,Wakefield 040A,E01011771,1280,254,1026
2021,Wakefield 040B,E01011772,1530,227,1303
2021,Wakefield 032C,E01011773,1364,170,1194
2021,Wakefield 032D,E01011774,1401,247,1154
2021,Wakefield 024B,E01011776,1607,345,1262
2021,Wakefield 024C,E01011777,1361,176,1185
2021,Wakefield 024D,E01011778,1478,240,1238
2021,Wakefield 027A,E01011779,1374,265,1109
2021,Wakefield 027B,E01011780,1732,326,1406
2021,Wakefield 027C,E01011781,2244,382,1862
2021,Wakefield 027D,E01011782,1493,235,1258
2021,Wakefield 027E,E01011783,1600,271,1329
2021,Wakefield 040C,E01011784,1674,283,1391
2021,Wakefield 039A,E01011785,2086,393,1693
2021,Wakefield 040D,E01011786,1462,292,1170
2021,Wakefield 042A,E01011787,1561,232,1329
2021,Wakefield 042B,E01011788,1595,193,1402
2021,Wakefield 039B,E01011789,1346,280,1066
2021,Wakefield 042C,E01011790,1507,206,1301
2021,Wakefield 039C,E01011791,1437,247,1190
2021,Wakefield 039D,E01011792,1357,305,1052
2021,Wakefield 029A,E01011793,1571,248,1323
2021,Wakefield 029B,E01011794,1290,251,1039
2021,Wakefield 029C,E01011795,1247,231,1016
2021,Wakefield 029D,E01011796,1547,293,1254
2021,Wakefield 031A,E01011797,1774,351,1423
2021,Wakefield 031B,E01011798,1292,193,1099
2021,Wakefield 029E,E01011799,1416,226,1190
2021,Wakefield 029F,E01011800,1539,255,1284
2021,Wakefield 031C,E01011801,1404,255,1149
2021,Wakefield 031D,E01011802,1399,187,1212
2021,Wakefield 011A,E01011803,1795,324,1471
2021,Wakefield 011B,E01011804,1456,254,1202
2021,Wakefield 010A,E01011805,1278,205,1073
2021,Wakefield 011C,E01011806,1346,171,1175
2021,Wakefield 010B,E01011807,1311,214,1097
2021,Wakefield 010C,E01011808,1879,322,1557
2021,Wakefield 011D,E01011809,1437,205,1232
2021,Wakefield 010D,E01011810,1317,258,1059
2021,Wakefield 011E,E01011811,1523,369,1154
2021,Wakefield 013B,E01011812,2388,446,1942
2021,Wakefield 016A,E01011813,1675,390,1285
2021,Wakefield 016B,E01011814,1687,299,1388
2021,Wakefield 016C,E01011815,1408,225,1183
2021,Wakefield 016D,E01011816,1374,255,1119
2021,Wakefield 024E,E01011817,1430,303,1127
2021,Wakefield 024F,E01011818,1285,198,1087
2021,Wakefield 016E,E01011819,1598,229,1369
2021,Wakefield 013C,E01011820,1407,217,1190
2021,Wakefield 013D,E01011821,1320,197,1123
2021,Wakefield 016F,E01011822,1377,234,1143
2021,Wakefield 021A,E01011823,1369,186,1183
2021,Wakefield 021B,E01011824,1561,386,1175
2021,Wakefield 021C,E01011825,1732,337,1395
2021,Wakefield 021D,E01011826,1412,246,1166
2021,Wakefield 021E,E01011827,1144,166,978
2021,Wakefield 021F,E01011828,1370,214,1156
2021,Wakefield 025A,E01011829,1309,233,1076
2021,Wakefield 025B,E01011830,1338,188,1150
2021,Wakefield 025C,E01011831,1614,300,1314
2021,Wakefield 025D,E01011832,1419,272,1147
2021,Wakefield 025E,E01011833,1399,244,1155
2021,Wakefield 015A,E01011834,1863,365,1498
2021,Wakefield 012A,E01011835,2047,269,1778
2021,Wakefield 012B,E01011836,1387,245,1142
2021,Wakefield 015B,E01011837,1599,273,1326
2021,Wakefield 015C,E01011838,1862,246,1616
2021,Wakefield 012C,E01011839,2330,410,1920
2021,Wakefield 018A,E01011840,1681,315,1366
2021,Wakefield 015D,E01011841,2048,302,1746
2021,Wakefield 015E,E01011842,1278,224,1054
2021,Wakefield 012D,E01011843,1623,360,1263
2021,Wakefield 012E,E01011844,1819,326,1493
2021,Wakefield 023A,E01011845,1720,260,1460
2021,Wakefield 023B,E01011846,1309,225,1084
2021,Wakefield 023C,E01011847,1365,219,1146
2021,Wakefield 023D,E01011848,1377,231,1146
2021,Wakefield 034E,E01011849,1512,183,1329
2021,Wakefield 018B,E01011850,1503,352,1151
2021,Wakefield 023E,E01011851,1391,220,1171
2021,Wakefield 018C,E01011852,1599,387,1212
2021,Wakefield 018D,E01011853,1314,261,1053
2021,Wakefield 041A,E01011854,1452,308,1144
2021,Wakefield 041B,E01011855,1404,223,1181
2021,Wakefield 041C,E01011856,1331,252,1079
2021,Wakefield 034F,E01011857,1601,208,1393
2021,Wakefield 041D,E01011858,1690,307,1383
2021,Wakefield 043A,E01011859,1314,206,1108
2021,Wakefield 044A,E01011860,1446,214,1232
2021,Wakefield 044B,E01011861,1848,335,1513
2021,Wakefield 044C,E01011862,2174,404,1770
2021,Wakefield 044D,E01011863,1479,351,1128
2021,Wakefield 045A,E01011864,1602,394,1208
2021,Wakefield 042D,E01011865,1599,310,1289
2021,Wakefield 045B,E01011866,1609,321,1288
2021,Wakefield 042E,E01011867,1508,289,1219
2021,Wakefield 045C,E01011868,2046,420,1626
2021,Wakefield 043B,E01011869,1213,169,1044
2021,Wakefield 043C,E01011870,1312,182,1130
2021,Wakefield 043D,E01011871,1380,190,1190
2021,Wakefield 045D,E01011872,1453,312,1141
2021,Wakefield 006A,E01011873,1923,358,1565
2021,Wakefield 009A,E01011874,1509,219,1290
2021,Wakefield 007A,E01011875,1358,229,1129
2021,Wakefield 007B,E01011876,2213,402,1811
2021,Wakefield 006B,E01011877,1310,197,1113
2021,Wakefield 007C,E01011878,1442,214,1228
2021,Wakefield 009B,E01011879,1369,196,1173
2021,Wakefield 007D,E01011880,1513,259,1254
2021,Wakefield 008A,E01011881,1308,195,1113
2021,Wakefield 009C,E01011882,1357,198,1159
2021,Wakefield 009D,E01011883,1428,213,1215
2021,Wakefield 017A,E01011884,2585,517,2068
2021,Wakefield 014A,E01011885,1490,205,1285
2021,Wakefield 014B,E01011886,1963,371,1592
2021,Wakefield 008B,E01011887,2355,461,1894
2021,Wakefield 014C,E01011888,1340,172,1168
2021,Wakefield 022A,E01011889,1482,267,1215
2021,Wakefield 014D,E01011890,1323,213,1110
2021,Wakefield 014E,E01011891,1453,228,1225
2021,Wakefield 022B,E01011892,1761,336,1425
2021,Wakefield 008C,E01011893,1429,210,1219
2021,Wakefield 006C,E01011894,1242,188,1054
2021,Wakefield 006D,E01011895,1350,247,1103
2021,Wakefield 008D,E01011896,1460,252,1208
2021,Wakefield 008E,E01011897,1474,269,1205
2021,Wakefield 030A,E01011898,1410,231,1179
2021,Wakefield 026A,E01011899,1514,394,1120
2021,Wakefield 026B,E01011900,1437,258,1179
2021,Wakefield 026C,E01011901,1598,484,1114
2021,Wakefield 028A,E01011902,1334,175,1159
2021,Wakefield 028B,E01011903,1177,123,1054
2021,Wakefield 026D,E01011904,1575,477,1098
2021,Wakefield 028C,E01011905,1550,215,1335
2021,Wakefield 030B,E01011906,1574,359,1215
2021,Wakefield 028D,E01011907,1768,253,1515
2021,Wakefield 030C,E01011908,2396,453,1943
2021,Wakefield 020A,E01011909,1314,224,1090
2021,Wakefield 020B,E01011910,1485,273,1212
2021,Wakefield 020C,E01011911,1528,392,1136
2021,Wakefield 017B,E01011912,1780,308,1472
2021,Wakefield 017C,E01011913,1833,498,1335
2021,Wakefield 020D,E01011914,1521,354,1167
2021,Wakefield 020E,E01011915,1574,409,1165
2021,Wakefield 030D,E01011917,1640,323,1317
2021,Wakefield 026E,E01011918,2192,500,1692
2021,Wakefield 022C,E01011919,1758,338,1420
2021,Wakefield 019A,E01011920,2726,352,2374
2021,Wakefield 022D,E01011921,1419,276,1143
2021,Wakefield 026F,E01011922,1335,265,1070
2021,Wakefield 019B,E01011923,1580,255,1325
2021,Wakefield 019C,E01011924,1620,289,1331
2021,Wakefield 019D,E01011925,1707,454,1253
2021,Wakefield 022E,E01011926,1632,466,1166
2021,Wakefield 022F,E01011927,1354,242,1112
2021,Wakefield 035A,E01011928,1292,201,1091
2021,Wakefield 036A,E01011929,2035,247,1788
2021,Wakefield 036B,E01011930,1578,235,1343
2021,Wakefield 035B,E01011931,1333,215,1118
2021,Wakefield 035C,E01011932,1338,194,1144
2021,Wakefield 036C,E01011933,1515,252,1263
2021,Wakefield 037A,E01011934,1554,241,1313
2021,Wakefield 038A,E01011935,1905,378,1527
2021,Wakefield 037B,E01011936,1476,315,1161
2021,Wakefield 036D,E01011937,1248,165,1083
2021,Wakefield 035D,E01011938,1577,231,1346
2021,Wakefield 033A,E01011939,1372,207,1165
2021,Wakefield 037C,E01011940,1547,335,1212
2021,Wakefield 038B,E01011941,1462,226,1236
2021,Wakefield 038C,E01011942,1248,180,1068
2021,Wakefield 037D,E01011943,1958,395,1563
2021,Wakefield 030E,E01011944,1343,282,1061
2021,Wakefield 033B,E01011945,1403,191,1212
2021,Wakefield 038D,E01011946,1390,194,1196
2021,Wakefield 033C,E01011947,1454,188,1266
2021,Wakefield 033D,E01011948,1538,227,1311
2021,Hartlepool 009A,E01011949,1734,400,1334
2021,Hartlepool 008A,E01011950,978,160,818
2021,Hartlepool 007A,E01011951,1146,213,933
2021,Hartlepool 002A,E01011952,1500,328,1172
2021,Hartlepool 002B,E01011953,1800,427,1373
2021,Hartlepool 001A,E01011954,2117,480,1637
2021,Hartlepool 003A,E01011955,1223,285,938
2021,Hartlepool 003C,E01011957,1167,250,917
2021,Hartlepool 014A,E01011959,2711,472,2239
2021,Hartlepool 014B,E01011960,1251,133,1118
2021,Hartlepool 012A,E01011961,1315,270,1045
2021,Hartlepool 012B,E01011962,1347,343,1004
2021,Hartlepool 014C,E01011963,1358,180,1178
2021,Hartlepool 007B,E01011964,1262,328,934
2021,Hartlepool 015G,E01011965,1555,289,1266
2021,Hartlepool 015E,E01011966,1242,209,1033
2021,Hartlepool 007C,E01011967,1408,350,1058
2021,Hartlepool 014D,E01011968,1886,230,1656
2021,Hartlepool 001B,E01011969,1283,173,1110
2021,Hartlepool 001C,E01011970,1027,123,904
2021,Hartlepool 001D,E01011971,1275,281,994
2021,Hartlepool 015B,E01011974,1462,223,1239
2021,Hartlepool 015D,E01011975,1042,184,858
2021,Hartlepool 012C,E01011977,1550,352,1198
2021,Hartlepool 012D,E01011978,1506,312,1194
2021,Hartlepool 012E,E01011979,1362,341,1021
2021,Hartlepool 009B,E01011980,1575,349,1226
2021,Hartlepool 009C,E01011981,1636,440,1196
2021,Hartlepool 014E,E01011982,1605,263,1342
2021,Hartlepool 015F,E01011983,1620,318,1302
2021,Hartlepool 009D,E01011984,1187,145,1042
2021,Hartlepool 010A,E01011985,1201,169,1032
2021,Hartlepool 008B,E01011986,1197,200,997
2021,Hartlepool 008C,E01011987,1260,257,1003
2021,Hartlepool 010B,E01011988,1720,278,1442
2021,Hartlepool 010C,E01011989,1763,390,1373
2021,Hartlepool 010D,E01011990,1705,387,1318
2021,Hartlepool 002C,E01011991,1561,259,1302
2021,Hartlepool 002D,E01011992,1737,371,1366
2021,Hartlepool 002E,E01011993,1669,308,1361
2021,Hartlepool 002F,E01011994,1350,274,1076
2021,Hartlepool 011A,E01011995,1245,172,1073
2021,Hartlepool 011B,E01011996,1329,175,1154
2021,Hartlepool 011C,E01011997,1839,331,1508
2021,Hartlepool 011D,E01011998,2029,364,1665
2021,Hartlepool 007D,E01011999,1739,414,1325
2021,Hartlepool 007E,E01012000,1209,260,949
2021,Hartlepool 008D,E01012001,2010,453,1557
2021,Hartlepool 015A,E01012002,1325,226,1099
2021,Hartlepool 014F,E01012003,1585,219,1366
2021,Hartlepool 014G,E01012005,1816,378,1438
2021,Middlesbrough 012A,E01012007,1352,216,1136
2021,Middlesbrough 012B,E01012008,1309,271,1038
2021,Middlesbrough 012C,E01012009,1835,399,1436
2021,Middlesbrough 012D,E01012010,1373,272,1101
2021,Middlesbrough 008A,E01012011,1839,497,1342
2021,Middlesbrough 008B,E01012012,1678,400,1278
2021,Middlesbrough 008C,E01012013,1352,296,1056
2021,Middlesbrough 008D,E01012014,1471,451,1020
2021,Middlesbrough 007A,E01012015,1363,266,1097
2021,Middlesbrough 007B,E01012016,1639,387,1252
2021,Middlesbrough 007C,E01012017,1448,186,1262
2021,Middlesbrough 011A,E01012018,1518,343,1175
2021,Middlesbrough 011B,E01012019,1102,276,826
2021,Middlesbrough 011C,E01012020,1415,357,1058
2021,Middlesbrough 011D,E01012021,1249,355,894
2021,Middlesbrough 015A,E01012022,2616,508,2108
2021,Middlesbrough 015B,E01012023,1401,127,1274
2021,Middlesbrough 015C,E01012024,1482,261,1221
2021,Middlesbrough 015D,E01012025,1173,199,974
2021,Middlesbrough 006A,E01012026,1969,482,1487
2021,Middlesbrough 006B,E01012027,1831,382,1449
2021,Middlesbrough 019A,E01012030,1346,232,1114
2021,Middlesbrough 019B,E01012031,1406,253,1153
2021,Middlesbrough 019C,E01012032,1612,379,1233
2021,Middlesbrough 019D,E01012033,1175,161,1014
2021,Middlesbrough 019E,E01012034,1322,296,1026
2021,Middlesbrough 019F,E01012035,1153,177,976
2021,Middlesbrough 003A,E01012036,1418,515,903
2021,Middlesbrough 003B,E01012037,1360,418,942
2021,Middlesbrough 003C,E01012038,1342,399,943
2021,Middlesbrough 003D,E01012039,1420,695,725
2021,Middlesbrough 003E,E01012040,1294,423,871
2021,Middlesbrough 003F,E01012041,1057,172,885
2021,Middlesbrough 018A,E01012042,1279,188,1091
2021,Middlesbrough 018B,E01012043,1252,180,1072
2021,Middlesbrough 018C,E01012044,1417,405,1012
2021,Middlesbrough 018D,E01012045,1349,384,965
2021,Middlesbrough 013A,E01012046,1917,277,1640
2021,Middlesbrough 013B,E01012047,1519,382,1137
2021,Middlesbrough 013C,E01012048,1701,291,1410
2021,Middlesbrough 014A,E01012049,1209,157,1052
2021,Middlesbrough 014B,E01012050,1299,339,960
2021,Middlesbrough 014C,E01012051,1149,272,877
2021,Middlesbrough 014D,E01012052,1177,188,989
2021,Middlesbrough 009A,E01012053,1653,387,1266
2021,Middlesbrough 009B,E01012054,1635,391,1244
2021,Middlesbrough 009C,E01012055,1844,391,1453
2021,Middlesbrough 009D,E01012056,2187,595,1592
2021,Middlesbrough 009E,E01012057,1833,390,1443
2021,Middlesbrough 002A,E01012058,1537,402,1135
2021,Middlesbrough 002B,E01012059,1505,304,1201
2021,Middlesbrough 002C,E01012060,1495,436,1059
2021,Middlesbrough 002D,E01012061,1141,325,816
2021,Middlesbrough 020A,E01012062,1699,284,1415
2021,Middlesbrough 020B,E01012063,1330,225,1105
2021,Middlesbrough 017A,E01012065,1822,301,1521
2021,Middlesbrough 017B,E01012066,1769,347,1422
2021,Middlesbrough 017C,E01012067,1511,227,1284
2021,Middlesbrough 001A,E01012068,1759,1062,697
2021,Middlesbrough 020D,E01012071,1321,219,1102
2021,Middlesbrough 020E,E01012073,1334,258,1076
2021,Middlesbrough 004A,E01012074,1395,345,1050
2021,Middlesbrough 004B,E01012075,1428,397,1031
2021,Middlesbrough 004C,E01012076,1240,401,839
2021,Middlesbrough 004D,E01012077,1391,319,1072
2021,Middlesbrough 005A,E01012078,1392,399,993
2021,Middlesbrough 005B,E01012079,1361,308,1053
2021,Middlesbrough 005C,E01012080,1134,253,881
2021,Middlesbrough 005D,E01012081,1650,398,1252
2021,Middlesbrough 010A,E01012082,1405,326,1079
2021,Middlesbrough 010B,E01012083,1485,430,1055
2021,Middlesbrough 010C,E01012084,1525,378,1147
2021,Middlesbrough 010D,E01012085,1449,387,1062
2021,Middlesbrough 004E,E01012088,1601,412,1189
2021,Middlesbrough 007D,E01012089,1441,386,1055
2021,Middlesbrough 007E,E01012090,1435,346,1089
2021,Middlesbrough 007F,E01012091,1785,552,1233
2021,Middlesbrough 001D,E01012092,1838,970,868
2021,Middlesbrough 001E,E01012093,1882,809,1073
2021,Redcar and Cleveland 010A,E01012095,1185,164,1021
2021,Redcar and Cleveland 013A,E01012096,1359,250,1109
2021,Redcar and Cleveland 010B,E01012097,1078,159,919
2021,Redcar and Cleveland 010C,E01012098,1509,309,1200
2021,Redcar and Cleveland 010D,E01012099,1383,313,1070
2021,Redcar and Cleveland 001A,E01012100,1399,175,1224
2021,Redcar and Cleveland 001B,E01012101,1496,203,1293
2021,Redcar and Cleveland 001C,E01012102,1941,376,1565
2021,Redcar and Cleveland 002A,E01012105,1299,245,1054
2021,Redcar and Cleveland 003C,E01012106,1286,239,1047
2021,Redcar and Cleveland 003D,E01012107,1269,245,1024
2021,Redcar and Cleveland 011A,E01012108,1310,276,1034
2021,Redcar and Cleveland 011B,E01012109,1259,161,1098
2021,Redcar and Cleveland 011C,E01012110,1243,202,1041
2021,Redcar and Cleveland 011D,E01012111,1241,210,1031
2021,Redcar and Cleveland 015A,E01012112,1289,295,994
2021,Redcar and Cleveland 009A,E01012113,1307,399,908
2021,Redcar and Cleveland 009B,E01012114,1273,317,956
2021,Redcar and Cleveland 018A,E01012117,1934,281,1653
2021,Redcar and Cleveland 018B,E01012118,1274,203,1071
2021,Redcar and Cleveland 018C,E01012119,1958,388,1570
2021,Redcar and Cleveland 020A,E01012120,1223,132,1091
2021,Redcar and Cleveland 018D,E01012121,1215,232,983
2021,Redcar and Cleveland 020B,E01012124,1501,226,1275
2021,Redcar and Cleveland 005A,E01012127,1032,231,801
2021,Redcar and Cleveland 005B,E01012128,1272,287,985
2021,Redcar and Cleveland 005C,E01012129,2314,466,1848
2021,Redcar and Cleveland 005D,E01012130,1162,155,1007
2021,Redcar and Cleveland 005E,E01012131,1284,278,1006
2021,Redcar and Cleveland 016A,E01012132,1774,253,1521
2021,Redcar and Cleveland 016B,E01012134,1311,138,1173
2021,Redcar and Cleveland 013D,E01012136,1318,226,1092
2021,Redcar and Cleveland 016C,E01012137,1304,220,1084
2021,Redcar and Cleveland 006A,E01012138,2796,615,2181
2021,Redcar and Cleveland 006B,E01012139,1699,251,1448
2021,Redcar and Cleveland 006C,E01012140,1190,210,980
2021,Redcar and Cleveland 006D,E01012141,1004,125,879
2021,Redcar and Cleveland 002B,E01012142,1514,286,1228
2021,Redcar and Cleveland 002C,E01012143,1377,350,1027
2021,Redcar and Cleveland 002D,E01012144,1298,221,1077
2021,Redcar and Cleveland 015B,E01012145,1349,223,1126
2021,Redcar and Cleveland 022A,E01012146,1114,145,969
2021,Redcar and Cleveland 015C,E01012147,1704,313,1391
2021,Redcar and Cleveland 021A,E01012148,1328,301,1027
2021,Redcar and Cleveland 015D,E01012149,1107,151,956
2021,Redcar and Cleveland 021B,E01012150,1446,338,1108
2021,Redcar and Cleveland 021C,E01012151,1362,173,1189
2021,Redcar and Cleveland 021D,E01012152,1697,294,1403
2021,Redcar and Cleveland 006E,E01012154,1104,116,988
2021,Redcar and Cleveland 006F,E01012155,1701,311,1390
2021,Redcar and Cleveland 006G,E01012156,1562,253,1309
2021,Redcar and Cleveland 006H,E01012157,1535,233,1302
2021,Redcar and Cleveland 007A,E01012158,1465,213,1252
2021,Redcar and Cleveland 007B,E01012159,1342,147,1195
2021,Redcar and Cleveland 007C,E01012160,1483,242,1241
2021,Redcar and Cleveland 007D,E01012161,1418,223,1195
2021,Redcar and Cleveland 012A,E01012162,1267,207,1060
2021,Redcar and Cleveland 012B,E01012163,2291,426,1865
2021,Redcar and Cleveland 012C,E01012164,1503,212,1291
2021,Redcar and Cleveland 012D,E01012165,2263,496,1767
2021,Redcar and Cleveland 022B,E01012167,1971,458,1513
2021,Redcar and Cleveland 022C,E01012168,1883,416,1467
2021,Redcar and Cleveland 022D,E01012170,1162,286,876
2021,Redcar and Cleveland 011E,E01012171,1359,200,1159
2021,Redcar and Cleveland 011F,E01012172,1223,168,1055
2021,Redcar and Cleveland 022E,E01012173,1060,134,926
2021,Redcar and Cleveland 022F,E01012174,1064,174,890
2021,Redcar and Cleveland 009E,E01012175,1284,288,996
2021,Redcar and Cleveland 004A,E01012176,1374,192,1182
2021,Redcar and Cleveland 004B,E01012177,1322,226,1096
2021,Redcar and Cleveland 004C,E01012178,1308,190,1118
2021,Redcar and Cleveland 004D,E01012179,2002,365,1637
2021,Redcar and Cleveland 004E,E01012180,1548,316,1232
2021,Redcar and Cleveland 016D,E01012181,1524,303,1221
2021,Redcar and Cleveland 020C,E01012182,1286,159,1127
2021,Redcar and Cleveland 020D,E01012183,1382,211,1171
2021,Redcar and Cleveland 001D,E01012184,1337,255,1082
2021,Redcar and Cleveland 004F,E01012185,1291,238,1053
2021,Redcar and Cleveland 004G,E01012186,1534,220,1314
2021,Stockton-on-Tees 011A,E01012187,1182,207,975
2021,Stockton-on-Tees 011B,E01012188,1059,152,907
2021,Stockton-on-Tees 011C,E01012189,1244,137,1107
2021,Stockton-on-Tees 015A,E01012190,1343,222,1121
2021,Stockton-on-Tees 015B,E01012191,1493,240,1253
2021,Stockton-on-Tees 007A,E01012192,1439,207,1232
2021,Stockton-on-Tees 007B,E01012193,1427,332,1095
2021,Stockton-on-Tees 010A,E01012194,1408,275,1133
2021,Stockton-on-Tees 010B,E01012195,1432,349,1083
2021,Stockton-on-Tees 003A,E01012196,1434,252,1182
2021,Stockton-on-Tees 002A,E01012197,1664,375,1289
2021,Stockton-on-Tees 003B,E01012198,1254,263,991
2021,Stockton-on-Tees 021A,E01012199,1272,195,1077
2021,Stockton-on-Tees 021B,E01012200,1904,344,1560
2021,Stockton-on-Tees 021C,E01012201,2022,422,1600
2021,Stockton-on-Tees 021D,E01012202,1550,393,1157
2021,Stockton-on-Tees 021E,E01012203,1802,433,1369
2021,Stockton-on-Tees 013A,E01012204,1246,109,1137
2021,Stockton-on-Tees 011D,E01012205,1327,227,1100
2021,Stockton-on-Tees 013B,E01012206,1259,156,1103
2021,Stockton-on-Tees 013C,E01012207,1845,387,1458
2021,Stockton-on-Tees 013D,E01012208,1499,291,1208
2021,Stockton-on-Tees 016A,E01012209,1578,314,1264
2021,Stockton-on-Tees 006A,E01012210,1427,250,1177
2021,Stockton-on-Tees 006B,E01012211,1698,317,1381
2021,Stockton-on-Tees 006C,E01012212,1442,189,1253
2021,Stockton-on-Tees 006D,E01012213,1245,106,1139
2021,Stockton-on-Tees 003C,E01012214,1412,330,1082
2021,Stockton-on-Tees 003D,E01012215,1145,255,890
2021,Stockton-on-Tees 003E,E01012216,1100,256,844
2021,Stockton-on-Tees 016B,E01012217,1266,218,1048
2021,Stockton-on-Tees 016C,E01012218,1448,285,1163
2021,Stockton-on-Tees 012A,E01012219,1655,345,1310
2021,Stockton-on-Tees 016D,E01012223,1436,234,1202
2021,Stockton-on-Tees 015C,E01012224,1627,290,1337
2021,Stockton-on-Tees 015D,E01012225,1417,220,1197
2021,Stockton-on-Tees 015E,E01012226,1274,179,1095
2021,Stockton-on-Tees 027D,E01012227,1410,322,1088
2021,Stockton-on-Tees 022A,E01012228,1248,237,1011
2021,Stockton-on-Tees 022B,E01012230,1574,312,1262
2021,Stockton-on-Tees 028C,E01012231,1762,449,1313
2021,Stockton-on-Tees 028D,E01012232,1293,280,1013
2021,Stockton-on-Tees 022C,E01012233,1673,345,1328
2021,Stockton-on-Tees 028E,E01012234,1499,297,1202
2021,Stockton-on-Tees 024A,E01012235,2237,389,1848
2021,Stockton-on-Tees 022D,E01012236,1195,191,1004
2021,Stockton-on-Tees 022E,E01012237,1252,230,1022
2021,Stockton-on-Tees 018A,E01012238,1462,357,1105
2021,Stockton-on-Tees 018B,E01012239,2303,706,1597
2021,Stockton-on-Tees 018C,E01012240,1612,292,1320
2021,Stockton-on-Tees 018D,E01012241,1355,191,1164
2021,Stockton-on-Tees 001A,E01012242,1336,218,1118
2021,Stockton-on-Tees 001B,E01012243,1433,247,1186
2021,Stockton-on-Tees 001C,E01012244,1288,178,1110
2021,Stockton-on-Tees 003F,E01012245,1434,353,1081
2021,Stockton-on-Tees 001D,E01012246,1222,170,1052
2021,Stockton-on-Tees 008A,E01012247,1088,242,846
2021,Stockton-on-Tees 009D,E01012248,1207,182,1025
2021,Stockton-on-Tees 008B,E01012249,1494,326,1168
2021,Stockton-on-Tees 009E,E01012250,1785,376,1409
2021,Stockton-on-Tees 012B,E01012251,1464,306,1158
2021,Stockton-on-Tees 012C,E01012252,1452,420,1032
2021,Stockton-on-Tees 012D,E01012253,1145,250,895
2021,Stockton-on-Tees 012E,E01012254,1276,277,999
2021,Stockton-on-Tees 005A,E01012255,1271,136,1135
2021,Stockton-on-Tees 002B,E01012256,1176,139,1037
2021,Stockton-on-Tees 002C,E01012257,1326,225,1101
2021,Stockton-on-Tees 010C,E01012258,2140,201,1939
2021,Stockton-on-Tees 010D,E01012259,1514,237,1277
2021,Stockton-on-Tees 007C,E01012260,1555,214,1341
2021,Stockton-on-Tees 007D,E01012261,1308,189,1119
2021,Stockton-on-Tees 026B,E01012262,2426,891,1535
2021,Stockton-on-Tees 025C,E01012267,1548,291,1257
2021,Stockton-on-Tees 010E,E01012268,1982,364,1618
2021,Stockton-on-Tees 005B,E01012269,1547,225,1322
2021,Stockton-on-Tees 021F,E01012270,1284,274,1010
2021,Stockton-on-Tees 008C,E01012271,1339,366,973
2021,Stockton-on-Tees 008D,E01012272,1006,118,888
2021,Stockton-on-Tees 008E,E01012273,1412,363,1049
2021,Stockton-on-Tees 008F,E01012274,1209,248,961
2021,Stockton-on-Tees 002D,E01012275,1457,331,1126
2021,Stockton-on-Tees 002E,E01012276,1637,252,1385
2021,Stockton-on-Tees 002F,E01012277,1587,399,1188
2021,Stockton-on-Tees 004A,E01012278,1121,232,889
2021,Stockton-on-Tees 004B,E01012279,1576,330,1246
2021,Stockton-on-Tees 004C,E01012280,1447,218,1229
2021,Stockton-on-Tees 004D,E01012281,1208,230,978
2021,Stockton-on-Tees 020A,E01012282,1080,222,858
2021,Stockton-on-Tees 020B,E01012283,1141,256,885
2021,Stockton-on-Tees 020C,E01012284,1370,273,1097
2021,Stockton-on-Tees 020D,E01012285,1199,150,1049
2021,Stockton-on-Tees 017A,E01012286,1004,223,781
2021,Stockton-on-Tees 017B,E01012287,1707,277,1430
2021,Stockton-on-Tees 017C,E01012288,1162,299,863
2021,Stockton-on-Tees 017D,E01012289,1168,212,956
2021,Stockton-on-Tees 019A,E01012290,1837,264,1573
2021,Stockton-on-Tees 019B,E01012291,1737,397,1340
2021,Stockton-on-Tees 019C,E01012292,1913,453,1460
2021,Stockton-on-Tees 005D,E01012294,1287,195,1092
2021,Stockton-on-Tees 005E,E01012295,1336,337,999
2021,Stockton-on-Tees 001E,E01012296,1144,174,970
2021,Stockton-on-Tees 001F,E01012297,2353,439,1914
2021,Stockton-on-Tees 024B,E01012298,1277,227,1050
2021,Stockton-on-Tees 024C,E01012299,1243,176,1067
2021,Stockton-on-Tees 024D,E01012300,1384,251,1133
2021,Stockton-on-Tees 024E,E01012301,1208,183,1025
2021,Stockton-on-Tees 024F,E01012302,1191,204,987
2021,Stockton-on-Tees 024G,E01012303,1976,344,1632
2021,Darlington 012A,E01012304,1001,129,872
2021,Darlington 012B,E01012305,1026,137,889
2021,Darlington 012C,E01012306,1380,211,1169
2021,Darlington 009A,E01012307,2076,453,1623
2021,Darlington 006A,E01012309,1845,318,1527
2021,Darlington 006B,E01012310,2049,332,1717
2021,Darlington 006C,E01012311,1413,313,1100
2021,Darlington 006D,E01012312,1303,332,971
2021,Darlington 006E,E01012313,1322,265,1057
2021,Darlington 006F,E01012314,1265,280,985
2021,Darlington 010A,E01012315,1570,279,1291
2021,Darlington 013A,E01012317,1255,175,1080
2021,Darlington 013B,E01012318,2174,502,1672
2021,Darlington 013C,E01012319,2498,548,1950
2021,Darlington 002C,E01012323,1387,257,1130
2021,Darlington 002D,E01012324,1263,208,1055
2021,Darlington 005A,E01012325,1343,169,1174
2021,Darlington 005B,E01012326,1061,203,858
2021,Darlington 009B,E01012327,1519,416,1103
2021,Darlington 003A,E01012328,1440,243,1197
2021,Darlington 003B,E01012329,1648,235,1413
2021,Darlington 003C,E01012330,1039,166,873
2021,Darlington 003D,E01012331,1089,173,916
2021,Darlington 005C,E01012332,1360,264,1096
2021,Darlington 005D,E01012333,1553,271,1282
2021,Darlington 001B,E01012334,2590,545,2045
2021,Darlington 001C,E01012335,1478,245,1233
2021,Darlington 011A,E01012336,1573,206,1367
2021,Darlington 011B,E01012337,1755,318,1437
2021,Darlington 015A,E01012338,2044,383,1661
2021,Darlington 015B,E01012339,1866,358,1508
2021,Darlington 012D,E01012340,2171,365,1806
2021,Darlington 012E,E01012341,1548,339,1209
2021,Darlington 009C,E01012342,2475,523,1952
2021,Darlington 015C,E01012344,1360,258,1102
2021,Darlington 015D,E01012345,1515,204,1311
2021,Darlington 015E,E01012346,2158,435,1723
2021,Darlington 011C,E01012347,1636,248,1388
2021,Darlington 011D,E01012348,2044,337,1707
2021,Darlington 004A,E01012349,1359,232,1127
2021,Darlington 004B,E01012350,1306,191,1115
2021,Darlington 004C,E01012351,1287,252,1035
2021,Darlington 004D,E01012352,1366,220,1146
2021,Darlington 016E,E01012353,1362,244,1118
2021,Darlington 016F,E01012354,1418,294,1124
2021,Darlington 016G,E01012355,1319,232,1087
2021,Darlington 014A,E01012356,1512,240,1272
2021,Darlington 014B,E01012357,1238,246,992
2021,Darlington 014C,E01012358,1508,292,1216
2021,Darlington 014D,E01012359,1635,504,1131
2021,Darlington 010C,E01012360,1695,318,1377
2021,Darlington 011E,E01012361,1811,331,1480
2021,Darlington 016A,E01012362,1146,174,972
2021,Darlington 016B,E01012363,1180,169,1011
2021,Darlington 016D,E01012364,1297,180,1117
2021,Darlington 016C,E01012365,1128,177,951
2021,Darlington 001D,E01012366,1923,282,1641
2021,Halton 007A,E01012367,1731,316,1415
2021,Halton 003A,E01012368,1926,349,1577
2021,Halton 005A,E01012369,1691,350,1341
2021,Halton 007B,E01012370,1709,268,1441
2021,Halton 016A,E01012371,1140,174,966
2021,Halton 016B,E01012372,1063,138,925
2021,Halton 016C,E01012373,1173,166,1007
2021,Halton 002A,E01012374,2582,534,2048
2021,Halton 002B,E01012375,1456,304,1152
2021,Halton 002C,E01012376,2676,644,2032
2021,Halton 004A,E01012377,1633,361,1272
2021,Halton 006A,E01012378,1443,242,1201
2021,Halton 006B,E01012379,1579,265,1314
2021,Halton 006C,E01012380,1345,292,1053
2021,Halton 010A,E01012381,1585,365,1220
2021,Halton 010B,E01012382,1508,343,1165
2021,Halton 013A,E01012383,1467,256,1211
2021,Halton 010C,E01012384,1510,246,1264
2021,Halton 009A,E01012385,1972,347,1625
2021,Halton 009B,E01012386,2495,526,1969
2021,Halton 009C,E01012387,1023,133,890
2021,Halton 006D,E01012388,1669,360,1309
2021,Halton 008A,E01012389,1633,235,1398
2021,Halton 004B,E01012390,1520,300,1220
2021,Halton 008B,E01012391,2008,350,1658
2021,Halton 001A,E01012392,2731,528,2203
2021,Halton 001B,E01012393,2710,513,2197
2021,Halton 005B,E01012394,1809,349,1460
2021,Halton 001C,E01012395,1520,241,1279
2021,Halton 013B,E01012396,1323,262,1061
2021,Halton 013C,E01012397,1470,337,1133
2021,Halton 011A,E01012398,1110,223,887
2021,Halton 013D,E01012399,1271,248,1023
2021,Halton 011B,E01012400,1135,223,912
2021,Halton 008C,E01012401,1728,218,1510
2021,Halton 011C,E01012402,1424,297,1127
2021,Halton 013E,E01012403,1691,423,1268
2021,Halton 011D,E01012404,1311,243,1068
2021,Halton 011E,E01012405,1957,363,1594
2021,Halton 015A,E01012406,1322,231,1091
2021,Halton 015B,E01012407,1618,321,1297
2021,Halton 013F,E01012408,1712,385,1327
2021,Halton 015C,E01012409,1267,209,1058
2021,Halton 003B,E01012410,1044,117,927
2021,Halton 001D,E01012411,1256,166,1090
2021,Halton 003C,E01012412,1670,288,1382
2021,Halton 003D,E01012413,1356,250,1106
2021,Halton 003E,E01012414,1070,173,897
2021,Halton 016D,E01012415,1263,211,1052
2021,Halton 012A,E01012416,1769,328,1441
2021,Halton 012B,E01012417,1141,176,965
2021,Halton 016E,E01012418,1374,195,1179
2021,Halton 004C,E01012419,1026,230,796
2021,Halton 004D,E01012420,1306,246,1060
2021,Halton 002D,E01012421,1145,126,1019
2021,Halton 004E,E01012422,1361,322,1039
2021,Halton 002E,E01012423,1223,165,1058
2021,Halton 007C,E01012424,1792,483,1309
2021,Halton 005C,E01012425,1481,314,1167
2021,Halton 005D,E01012426,1300,241,1059
2021,Halton 005E,E01012427,1691,398,1293
2021,Halton 012D,E01012429,1283,257,1026
2021,Halton 012E,E01012430,1499,240,1259
2021,Halton 012F,E01012431,1989,271,1718
2021,Halton 014A,E01012432,1256,197,1059
2021,Halton 014B,E01012433,1480,294,1186
2021,Halton 009D,E01012434,1374,223,1151
2021,Halton 009E,E01012435,1995,399,1596
2021,Halton 014C,E01012436,1150,307,843
2021,Halton 015D,E01012437,1199,286,913
2021,Halton 014D,E01012438,1049,234,815
2021,Halton 015E,E01012439,1369,300,1069
2021,Halton 014E,E01012440,1158,190,968
2021,Halton 007D,E01012441,2106,390,1716
2021,Halton 006E,E01012442,1362,358,1004
2021,Halton 008D,E01012443,1400,255,1145
2021,Halton 010D,E01012444,1374,371,1003
2021,Halton 010E,E01012445,1166,305,861
2021,Warrington 025A,E01012446,1271,214,1057
2021,Warrington 025B,E01012447,1315,269,1046
2021,Warrington 024A,E01012448,1573,199,1374
2021,Warrington 025C,E01012449,1352,190,1162
2021,Warrington 023A,E01012450,1349,225,1124
2021,Warrington 023B,E01012451,1437,310,1127
2021,Warrington 025D,E01012452,1690,319,1371
2021,Warrington 013A,E01012453,1671,483,1188
2021,Warrington 013B,E01012454,2414,482,1932
2021,Warrington 013C,E01012455,1899,460,1439
2021,Warrington 013D,E01012457,1598,257,1341
2021,Warrington 018B,E01012458,2487,495,1992
2021,Warrington 005A,E01012459,1433,264,1169
2021,Warrington 004A,E01012460,1350,289,1061
2021,Warrington 005B,E01012461,1201,202,999
2021,Warrington 004B,E01012462,1170,169,1001
2021,Warrington 004C,E01012463,1035,105,930
2021,Warrington 004D,E01012464,1294,242,1052
2021,Warrington 005C,E01012465,1157,167,990
2021,Warrington 005D,E01012466,1452,295,1157
2021,Warrington 003A,E01012467,1151,123,1028
2021,Warrington 003B,E01012468,2302,416,1886
2021,Warrington 003C,E01012469,1410,226,1184
2021,Warrington 003D,E01012470,1099,217,882
2021,Warrington 001A,E01012471,2170,226,1944
2021,Warrington 001B,E01012472,1782,333,1449
2021,Warrington 002A,E01012473,1523,271,1252
2021,Warrington 002B,E01012474,1351,272,1079
2021,Warrington 002C,E01012475,1432,258,1174
2021,Warrington 001C,E01012476,1542,242,1300
2021,Warrington 001D,E01012477,1552,301,1251
2021,Warrington 012A,E01012478,2058,414,1644
2021,Warrington 017A,E01012479,1562,283,1279
2021,Warrington 017B,E01012480,2152,304,1848
2021,Warrington 011A,E01012481,1450,275,1175
2021,Warrington 011B,E01012482,1553,229,1324
2021,Warrington 018C,E01012483,1526,255,1271
2021,Warrington 022A,E01012485,1478,278,1200
2021,Warrington 022B,E01012486,1396,250,1146
2021,Warrington 022C,E01012487,1433,277,1156
2021,Warrington 024B,E01012488,1783,330,1453
2021,Warrington 022D,E01012489,1777,388,1389
2021,Warrington 022E,E01012490,1363,198,1165
2021,Warrington 015A,E01012491,1345,232,1113
2021,Warrington 015B,E01012492,1321,182,1139
2021,Warrington 015C,E01012493,1602,277,1325
2021,Warrington 015D,E01012494,1819,338,1481
2021,Warrington 016A,E01012495,1523,299,1224
2021,Warrington 016B,E01012496,1324,224,1100
2021,Warrington 016C,E01012497,1172,234,938
2021,Warrington 016D,E01012498,1460,338,1122
2021,Warrington 016E,E01012499,1730,361,1369
2021,Warrington 015E,E01012500,1317,197,1120
2021,Warrington 016F,E01012501,1315,213,1102
2021,Warrington 024C,E01012502,1509,249,1260
2021,Warrington 024D,E01012503,1708,346,1362
2021,Warrington 020B,E01012505,1343,256,1087
2021,Warrington 020C,E01012506,1502,340,1162
2021,Warrington 020D,E01012507,1748,273,1475
2021,Warrington 020E,E01012508,1592,307,1285
2021,Warrington 018D,E01012509,2146,255,1891
2021,Warrington 017D,E01012510,2123,324,1799
2021,Warrington 017E,E01012511,1511,230,1281
2021,Warrington 018E,E01012512,1447,148,1299
2021,Warrington 021A,E01012513,1917,441,1476
2021,Warrington 021B,E01012514,1796,414,1382
2021,Warrington 021C,E01012515,1451,242,1209
2021,Warrington 021D,E01012516,1299,234,1065
2021,Warrington 021E,E01012517,2196,515,1681
2021,Warrington 021F,E01012518,2037,447,1590
2021,Warrington 021G,E01012519,1401,253,1148
2021,Warrington 011C,E01012520,1516,315,1201
2021,Warrington 008A,E01012521,1467,260,1207
2021,Warrington 008B,E01012522,1307,221,1086
2021,Warrington 011D,E01012523,1320,185,1135
2021,Warrington 011E,E01012524,1408,193,1215
2021,Warrington 011F,E01012525,1416,259,1157
2021,Warrington 006A,E01012526,1596,403,1193
2021,Warrington 019A,E01012527,1403,249,1154
2021,Warrington 019B,E01012528,1132,151,981
2021,Warrington 019C,E01012529,1357,200,1157
2021,Warrington 019D,E01012530,1301,219,1082
2021,Warrington 019E,E01012531,1436,229,1207
2021,Warrington 019F,E01012532,1283,161,1122
2021,Warrington 008C,E01012533,1386,368,1018
2021,Warrington 006B,E01012534,1392,318,1074
2021,Warrington 006C,E01012535,1659,399,1260
2021,Warrington 008D,E01012536,1423,326,1097
2021,Warrington 006D,E01012537,1467,304,1163
2021,Warrington 007A,E01012538,1288,156,1132
2021,Warrington 006E,E01012539,1419,245,1174
2021,Warrington 007B,E01012540,1278,212,1066
2021,Warrington 007C,E01012541,1154,199,955
2021,Warrington 007D,E01012542,1318,230,1088
2021,Warrington 007E,E01012543,1274,229,1045
2021,Warrington 007F,E01012544,1386,275,1111
2021,Warrington 008E,E01012545,1545,378,1167
2021,Warrington 008F,E01012546,1502,396,1106
2021,Warrington 012B,E01012547,1563,304,1259
2021,Warrington 012C,E01012548,1725,274,1451
2021,Warrington 012D,E01012549,1649,252,1397
2021,Warrington 012E,E01012550,1575,229,1346
2021,Warrington 014A,E01012551,1474,258,1216
2021,Warrington 014B,E01012552,1313,227,1086
2021,Warrington 014C,E01012553,1215,183,1032
2021,Warrington 002D,E01012554,1912,271,1641
2021,Warrington 014D,E01012555,1278,218,1060
2021,Warrington 014E,E01012556,1385,220,1165
2021,Warrington 023C,E01012557,1457,218,1239
2021,Warrington 023D,E01012558,1629,284,1345
2021,Warrington 023E,E01012559,1477,273,1204
2021,Warrington 023F,E01012560,1406,292,1114
2021,Warrington 009A,E01012561,1412,208,1204
2021,Warrington 009B,E01012562,2094,450,1644
2021,Warrington 010A,E01012563,1637,266,1371
2021,Warrington 010B,E01012564,1267,137,1130
2021,Warrington 010D,E01012566,1978,497,1481
2021,Warrington 010E,E01012569,1708,360,1348
2021,Warrington 010F,E01012570,1100,150,950
2021,Blackburn with Darwen 007A,E01012571,1629,545,1084
2021,Blackburn with Darwen 007B,E01012572,1371,384,987
2021,Blackburn with Darwen 007C,E01012573,1631,519,1112
2021,Blackburn with Darwen 003A,E01012574,1390,370,1020
2021,Blackburn with Darwen 007D,E01012575,1219,300,919
2021,Blackburn with Darwen 008A,E01012576,1707,604,1103
2021,Blackburn with Darwen 003B,E01012577,1914,650,1264
2021,Blackburn with Darwen 003C,E01012578,1864,563,1301
2021,Blackburn with Darwen 004A,E01012579,1664,494,1170
2021,Blackburn with Darwen 004B,E01012580,2039,607,1432
2021,Blackburn with Darwen 002A,E01012581,1261,307,954
2021,Blackburn with Darwen 002B,E01012582,1567,416,1151
2021,Blackburn with Darwen 002C,E01012583,1869,468,1401
2021,Blackburn with Darwen 010A,E01012584,1526,403,1123
2021,Blackburn with Darwen 005A,E01012585,1690,438,1252
2021,Blackburn with Darwen 005B,E01012586,1608,469,1139
2021,Blackburn with Darwen 002D,E01012587,2160,695,1465
2021,Blackburn with Darwen 002E,E01012588,2020,640,1380
2021,Blackburn with Darwen 014A,E01012589,1287,218,1069
2021,Blackburn with Darwen 014B,E01012590,1237,242,995
2021,Blackburn with Darwen 014C,E01012591,1478,268,1210
2021,Blackburn with Darwen 018A,E01012592,1849,310,1539
2021,Blackburn with Darwen 013A,E01012593,1515,276,1239
2021,Blackburn with Darwen 012A,E01012594,1317,342,975
2021,Blackburn with Darwen 009A,E01012595,1975,423,1552
2021,Blackburn with Darwen 009B,E01012596,1888,476,1412
2021,Blackburn with Darwen 013B,E01012597,1590,325,1265
2021,Blackburn with Darwen 013C,E01012598,2795,704,2091
2021,Blackburn with Darwen 013D,E01012599,1234,267,967
2021,Blackburn with Darwen 011A,E01012600,1240,237,1003
2021,Blackburn with Darwen 011B,E01012601,1418,422,996
2021,Blackburn with Darwen 011C,E01012602,1491,278,1213
2021,Blackburn with Darwen 011D,E01012603,1612,461,1151
2021,Blackburn with Darwen 011E,E01012604,1565,357,1208
2021,Blackburn with Darwen 003D,E01012605,2192,722,1470
2021,Blackburn with Darwen 003E,E01012606,1632,548,1084
2021,Blackburn with Darwen 001A,E01012607,1505,329,1176
2021,Blackburn with Darwen 001B,E01012608,2073,626,1447
2021,Blackburn with Darwen 010B,E01012609,1483,222,1261
2021,Blackburn with Darwen 010C,E01012610,1209,214,995
2021,Blackburn with Darwen 010D,E01012611,1033,130,903
2021,Blackburn with Darwen 010E,E01012612,1335,172,1163
2021,Blackburn with Darwen 010F,E01012613,1749,308,1441
2021,Blackburn with Darwen 017A,E01012614,1577,307,1270
2021,Blackburn with Darwen 017B,E01012615,1311,197,1114
2021,Blackburn with Darwen 017C,E01012616,1857,309,1548
2021,Blackburn with Darwen 015A,E01012617,1257,244,1013
2021,Blackburn with Darwen 012B,E01012618,1449,278,1171
2021,Blackburn with Darwen 012C,E01012619,1304,350,954
2021,Blackburn with Darwen 012D,E01012620,1400,190,1210
2021,Blackburn with Darwen 012E,E01012621,1420,292,1128
2021,Blackburn with Darwen 009C,E01012622,1460,358,1102
2021,Blackburn with Darwen 009D,E01012623,1317,317,1000
2021,Blackburn with Darwen 009E,E01012624,1352,290,1062
2021,Blackburn with Darwen 009F,E01012625,1657,349,1308
2021,Blackburn with Darwen 018D,E01012628,1120,167,953
2021,Blackburn with Darwen 006A,E01012629,1181,305,876
2021,Blackburn with Darwen 007E,E01012630,2140,708,1432
2021,Blackburn with Darwen 006B,E01012631,1325,389,936
2021,Blackburn with Darwen 011F,E01012632,2065,556,1509
2021,Blackburn with Darwen 001C,E01012633,1593,349,1244
2021,Blackburn with Darwen 001D,E01012634,1453,357,1096
2021,Blackburn with Darwen 001E,E01012635,1733,479,1254
2021,Blackburn with Darwen 001F,E01012636,1635,299,1336
2021,Blackburn with Darwen 008B,E01012637,1580,468,1112
2021,Blackburn with Darwen 008C,E01012638,1544,405,1139
2021,Blackburn with Darwen 008D,E01012639,1831,551,1280
2021,Blackburn with Darwen 008E,E01012640,1846,496,1350
2021,Blackburn with Darwen 008F,E01012641,1704,584,1120
2021,Blackburn with Darwen 004C,E01012642,1753,558,1195
2021,Blackburn with Darwen 006C,E01012643,1554,422,1132
2021,Blackburn with Darwen 006D,E01012644,2315,643,1672
2021,Blackburn with Darwen 004D,E01012645,1985,615,1370
2021,Blackburn with Darwen 015B,E01012646,1538,352,1186
2021,Blackburn with Darwen 015C,E01012647,1442,289,1153
2021,Blackburn with Darwen 014D,E01012648,1111,241,870
2021,Blackburn with Darwen 016A,E01012649,1473,272,1201
2021,Blackburn with Darwen 015D,E01012650,1339,312,1027
2021,Blackburn with Darwen 016B,E01012651,1431,262,1169
2021,Blackburn with Darwen 014E,E01012652,1373,193,1180
2021,Blackburn with Darwen 016C,E01012653,1450,318,1132
2021,Blackburn with Darwen 016D,E01012654,1633,320,1313
2021,Blackburn with Darwen 006E,E01012655,2077,524,1553
2021,Blackburn with Darwen 005C,E01012656,1686,461,1225
2021,Blackburn with Darwen 005D,E01012657,1949,618,1331
2021,Blackburn with Darwen 005E,E01012658,1775,440,1335
2021,Blackburn with Darwen 017D,E01012659,1290,215,1075
2021,Blackburn with Darwen 017E,E01012660,1074,147,927
2021,Blackburn with Darwen 017F,E01012661,1388,234,1154
2021,Blackpool 002A,E01012662,1379,132,1247
2021,Blackpool 001A,E01012663,1486,255,1231
2021,Blackpool 001B,E01012664,1521,288,1233
2021,Blackpool 001C,E01012665,1597,182,1415
2021,Blackpool 003A,E01012666,1344,198,1146
2021,Blackpool 003B,E01012667,1396,204,1192
2021,Blackpool 003C,E01012668,1512,248,1264
2021,Blackpool 003D,E01012669,1700,264,1436
2021,Blackpool 011A,E01012670,1330,330,1000
2021,Blackpool 013A,E01012671,1368,222,1146
2021,Blackpool 013B,E01012672,1464,282,1182
2021,Blackpool 010A,E01012673,1235,290,945
2021,Blackpool 013C,E01012674,1635,351,1284
2021,Blackpool 010B,E01012675,1487,371,1116
2021,Blackpool 009A,E01012676,1317,237,1080
2021,Blackpool 009B,E01012677,1350,207,1143
2021,Blackpool 008A,E01012678,989,264,725
2021,Blackpool 008B,E01012679,1298,292,1006
2021,Blackpool 008C,E01012680,1592,365,1227
2021,Blackpool 006A,E01012681,1571,143,1428
2021,Blackpool 008D,E01012682,1386,218,1168
2021,Blackpool 006B,E01012683,1333,310,1023
2021,Blackpool 008E,E01012684,1331,285,1046
2021,Blackpool 016A,E01012685,1276,256,1020
2021,Blackpool 014A,E01012686,1363,304,1059
2021,Blackpool 014B,E01012687,1217,285,932
2021,Blackpool 014C,E01012688,1045,111,934
2021,Blackpool 014D,E01012689,1288,185,1103
2021,Blackpool 004A,E01012690,1552,283,1269
2021,Blackpool 004B,E01012691,1744,348,1396
2021,Blackpool 004C,E01012692,1544,235,1309
2021,Blackpool 005A,E01012693,1478,243,1235
2021,Blackpool 016B,E01012694,1254,241,1013
2021,Blackpool 015A,E01012695,1308,290,1018
2021,Blackpool 016C,E01012696,1411,282,1129
2021,Blackpool 016D,E01012697,1220,170,1050
2021,Blackpool 016E,E01012698,1504,378,1126
2021,Blackpool 019A,E01012699,1583,285,1298
2021,Blackpool 019B,E01012700,1701,335,1366
2021,Blackpool 018A,E01012701,1389,231,1158
2021,Blackpool 019C,E01012702,1343,191,1152
2021,Blackpool 002B,E01012703,1398,191,1207
2021,Blackpool 002C,E01012704,1907,307,1600
2021,Blackpool 004D,E01012705,1445,294,1151
2021,Blackpool 002D,E01012706,1473,270,1203
2021,Blackpool 007A,E01012707,1177,180,997
2021,Blackpool 009C,E01012708,1205,216,989
2021,Blackpool 009D,E01012709,1388,262,1126
2021,Blackpool 009E,E01012710,1180,179,1001
2021,Blackpool 005B,E01012711,1330,246,1084
2021,Blackpool 012A,E01012712,1575,270,1305
2021,Blackpool 012B,E01012713,1727,337,1390
2021,Blackpool 014E,E01012714,1799,273,1526
2021,Blackpool 012C,E01012715,1402,214,1188
2021,Blackpool 001D,E01012716,1331,182,1149
2021,Blackpool 002E,E01012717,1520,212,1308
2021,Blackpool 003E,E01012718,1527,209,1318
2021,Blackpool 001E,E01012719,1398,246,1152
2021,Blackpool 007B,E01012720,1568,430,1138
2021,Blackpool 007C,E01012721,1561,377,1184
2021,Blackpool 009F,E01012722,1100,175,925
2021,Blackpool 004E,E01012723,1291,193,1098
2021,Blackpool 007D,E01012724,1402,370,1032
2021,Blackpool 019D,E01012725,1355,205,1150
2021,Blackpool 017A,E01012726,1598,218,1380
2021,Blackpool 019E,E01012727,1531,242,1289
2021,Blackpool 017B,E01012728,1423,242,1181
2021,Blackpool 018B,E01012729,1518,195,1323
2021,Blackpool 018C,E01012730,1857,270,1587
2021,Blackpool 018D,E01012731,1450,239,1211
2021,Blackpool 018E,E01012732,1671,222,1449
2021,Blackpool 011B,E01012733,972,189,783
2021,Blackpool 011C,E01012734,1313,254,1059
2021,Blackpool 010C,E01012735,1221,135,1086
2021,Blackpool 010D,E01012736,1497,156,1341
2021,Blackpool 010E,E01012737,1264,212,1052
2021,Blackpool 011D,E01012738,1257,316,941
2021,Blackpool 011E,E01012739,1295,287,1008
2021,Blackpool 012D,E01012740,1442,219,1223
2021,Blackpool 012E,E01012741,1290,259,1031
2021,Blackpool 011F,E01012742,1094,179,915
2021,Blackpool 015B,E01012743,1565,309,1256
2021,Blackpool 015C,E01012744,1505,305,1200
2021,Blackpool 015D,E01012745,1559,273,1286
2021,Blackpool 015E,E01012746,1586,297,1289
2021,Blackpool 005C,E01012747,1453,238,1215
2021,Blackpool 006C,E01012748,1673,252,1421
2021,Blackpool 006D,E01012749,1646,291,1355
2021,Blackpool 005D,E01012750,1645,299,1346
2021,Blackpool 013D,E01012751,1514,186,1328
2021,Blackpool 017C,E01012752,1282,177,1105
2021,Blackpool 017D,E01012753,1113,215,898
2021,Blackpool 017E,E01012754,1165,224,941
2021,Blackpool 017F,E01012755,1378,245,1133
2021,Kingston upon Hull 025A,E01012756,1391,237,1154
2021,Kingston upon Hull 025B,E01012757,1292,224,1068
2021,Kingston upon Hull 018A,E01012758,1489,297,1192
2021,Kingston upon Hull 025C,E01012759,1516,274,1242
2021,Kingston upon Hull 025D,E01012760,1371,244,1127
2021,Kingston upon Hull 015A,E01012761,1639,254,1385
2021,Kingston upon Hull 018B,E01012762,1294,275,1019
2021,Kingston upon Hull 018C,E01012763,1652,300,1352
2021,Kingston upon Hull 005A,E01012764,1102,113,989
2021,Kingston upon Hull 005B,E01012765,1304,212,1092
2021,Kingston upon Hull 012A,E01012766,1315,242,1073
2021,Kingston upon Hull 012B,E01012767,1452,574,878
2021,Kingston upon Hull 005C,E01012768,1250,132,1118
2021,Kingston upon Hull 005D,E01012769,1256,112,1144
2021,Kingston upon Hull 028A,E01012770,1429,257,1172
2021,Kingston upon Hull 028B,E01012771,1435,241,1194
2021,Kingston upon Hull 028C,E01012772,1473,261,1212
2021,Kingston upon Hull 027A,E01012773,1499,239,1260
2021,Kingston upon Hull 019A,E01012774,1414,292,1122
2021,Kingston upon Hull 028D,E01012775,1516,313,1203
2021,Kingston upon Hull 027B,E01012776,1379,235,1144
2021,Kingston upon Hull 028E,E01012777,1488,229,1259
2021,Kingston upon Hull 004A,E01012778,1328,378,950
2021,Kingston upon Hull 034A,E01012779,1218,340,878
2021,Kingston upon Hull 034D,E01012780,1712,447,1265
2021,Kingston upon Hull 034B,E01012781,1195,301,894
2021,Kingston upon Hull 002A,E01012782,1342,356,986
2021,Kingston upon Hull 004B,E01012783,1207,346,861
2021,Kingston upon Hull 004C,E01012784,1875,475,1400
2021,Kingston upon Hull 002B,E01012785,1208,310,898
2021,Kingston upon Hull 002C,E01012786,1162,242,920
2021,Kingston upon Hull 002D,E01012787,1370,337,1033
2021,Kingston upon Hull 002E,E01012788,1342,358,984
2021,Kingston upon Hull 002F,E01012789,1191,280,911
2021,Kingston upon Hull 004D,E01012790,1256,216,1040
2021,Kingston upon Hull 014A,E01012791,1538,292,1246
2021,Kingston upon Hull 014B,E01012792,1419,266,1153
2021,Kingston upon Hull 014C,E01012793,1348,201,1147
2021,Kingston upon Hull 014D,E01012794,1394,262,1132
2021,Kingston upon Hull 019B,E01012795,1896,427,1469
2021,Kingston upon Hull 023A,E01012796,1183,179,1004
2021,Kingston upon Hull 019C,E01012797,1236,202,1034
2021,Kingston upon Hull 019D,E01012798,1603,317,1286
2021,Kingston upon Hull 023B,E01012799,1122,169,953
2021,Kingston upon Hull 023C,E01012800,1359,183,1176
2021,Kingston upon Hull 019E,E01012801,1332,220,1112
2021,Kingston upon Hull 023D,E01012802,1269,222,1047
2021,Kingston upon Hull 023E,E01012803,1293,236,1057
2021,Kingston upon Hull 016A,E01012804,1607,250,1357
2021,Kingston upon Hull 026A,E01012805,1309,274,1035
2021,Kingston upon Hull 016B,E01012806,1338,256,1082
2021,Kingston upon Hull 016C,E01012807,1287,186,1101
2021,Kingston upon Hull 026B,E01012808,1594,307,1287
2021,Kingston upon Hull 026C,E01012809,1674,261,1413
2021,Kingston upon Hull 026D,E01012810,1753,291,1462
2021,Kingston upon Hull 026E,E01012811,1504,193,1311
2021,Kingston upon Hull 013A,E01012812,1270,243,1027
2021,Kingston upon Hull 013B,E01012813,1605,309,1296
2021,Kingston upon Hull 013C,E01012814,1422,238,1184
2021,Kingston upon Hull 013D,E01012815,1434,244,1190
2021,Kingston upon Hull 020A,E01012816,1372,287,1085
2021,Kingston upon Hull 016D,E01012817,1345,220,1125
2021,Kingston upon Hull 013E,E01012818,1151,192,959
2021,Kingston upon Hull 016E,E01012819,1322,248,1074
2021,Kingston upon Hull 022A,E01012820,1268,269,999
2021,Kingston upon Hull 011A,E01012821,1757,334,1423
2021,Kingston upon Hull 007A,E01012822,1443,265,1178
2021,Kingston upon Hull 010A,E01012824,1859,300,1559
2021,Kingston upon Hull 010B,E01012825,1435,209,1226
2021,Kingston upon Hull 011D,E01012827,1505,199,1306
2021,Kingston upon Hull 011E,E01012828,1410,269,1141
2021,Kingston upon Hull 006A,E01012829,1781,303,1478
2021,Kingston upon Hull 006B,E01012830,1329,215,1114
2021,Kingston upon Hull 034E,E01012832,1677,316,1361
2021,Kingston upon Hull 009A,E01012833,1493,385,1108
2021,Kingston upon Hull 010C,E01012834,1591,455,1136
2021,Kingston upon Hull 009B,E01012835,1033,92,941
2021,Kingston upon Hull 009C,E01012836,1390,250,1140
2021,Kingston upon Hull 010D,E01012837,1527,330,1197
2021,Kingston upon Hull 010E,E01012838,1558,492,1066
2021,Kingston upon Hull 009D,E01012839,1256,268,988
2021,Kingston upon Hull 009E,E01012840,1417,365,1052
2021,Kingston upon Hull 017A,E01012841,1446,372,1074
2021,Kingston upon Hull 021A,E01012842,1384,391,993
2021,Kingston upon Hull 021B,E01012843,1489,373,1116
2021,Kingston upon Hull 017B,E01012844,1178,258,920
2021,Kingston upon Hull 021C,E01012845,1413,395,1018
2021,Kingston upon Hull 021D,E01012846,1242,278,964
2021,Kingston upon Hull 021E,E01012847,1188,353,835
2021,Kingston upon Hull 020B,E01012848,1807,187,1620
2021,Kingston upon Hull 017C,E01012849,1469,318,1151
2021,Kingston upon Hull 024A,E01012850,1569,323,1246
2021,Kingston upon Hull 024B,E01012852,1574,336,1238
2021,Kingston upon Hull 029C,E01012854,2043,426,1617
2021,Kingston upon Hull 029D,E01012855,1984,468,1516
2021,Kingston upon Hull 024C,E01012856,1617,371,1246
2021,Kingston upon Hull 024D,E01012857,1627,372,1255
2021,Kingston upon Hull 031A,E01012858,2009,468,1541
2021,Kingston upon Hull 030A,E01012859,1486,332,1154
2021,Kingston upon Hull 031B,E01012860,2318,510,1808
2021,Kingston upon Hull 025E,E01012862,1301,278,1023
2021,Kingston upon Hull 027C,E01012863,2202,452,1750
2021,Kingston upon Hull 027D,E01012864,1658,404,1254
2021,Kingston upon Hull 027E,E01012865,1251,231,1020
2021,Kingston upon Hull 018D,E01012866,1555,366,1189
2021,Kingston upon Hull 024E,E01012867,1643,338,1305
2021,Kingston upon Hull 015B,E01012868,1580,574,1006
2021,Kingston upon Hull 015C,E01012869,1520,541,979
2021,Kingston upon Hull 018E,E01012870,1634,626,1008
2021,Kingston upon Hull 015D,E01012871,1576,294,1282
2021,Kingston upon Hull 015E,E01012872,1413,378,1035
2021,Kingston upon Hull 008A,E01012873,1389,349,1040
2021,Kingston upon Hull 008B,E01012874,1418,344,1074
2021,Kingston upon Hull 003A,E01012875,1550,466,1084
2021,Kingston upon Hull 003B,E01012876,1571,485,1086
2021,Kingston upon Hull 003C,E01012877,1486,531,955
2021,Kingston upon Hull 003D,E01012878,1586,354,1232
2021,Kingston upon Hull 003E,E01012879,1326,397,929
2021,Kingston upon Hull 008C,E01012880,1594,419,1175
2021,Kingston upon Hull 008D,E01012881,1430,332,1098
2021,Kingston upon Hull 033A,E01012882,1467,229,1238
2021,Kingston upon Hull 033B,E01012883,1413,143,1270
2021,Kingston upon Hull 033C,E01012884,1717,351,1366
2021,Kingston upon Hull 031D,E01012886,1490,250,1240
2021,Kingston upon Hull 033D,E01012887,1443,331,1112
2021,Kingston upon Hull 031E,E01012888,1485,288,1197
2021,Kingston upon Hull 030B,E01012889,1503,296,1207
2021,Kingston upon Hull 030C,E01012891,2151,455,1696
2021,Kingston upon Hull 030D,E01012892,1843,408,1435
2021,Kingston upon Hull 030E,E01012893,1483,297,1186
2021,Kingston upon Hull 020C,E01012894,2023,459,1564
2021,Kingston upon Hull 020D,E01012896,1870,423,1447
2021,Kingston upon Hull 017F,E01012898,1595,330,1265
2021,Kingston upon Hull 022B,E01012899,1358,213,1145
2021,Kingston upon Hull 022C,E01012900,1446,230,1216
2021,Kingston upon Hull 020E,E01012901,1422,231,1191
2021,Kingston upon Hull 022D,E01012902,1429,255,1174
2021,Kingston upon Hull 022E,E01012903,1555,256,1299
2021,Kingston upon Hull 007B,E01012904,1192,163,1029
2021,Kingston upon Hull 006C,E01012905,1259,280,979
2021,Kingston upon Hull 004E,E01012906,1496,371,1125
2021,Kingston upon Hull 007C,E01012907,1454,226,1228
2021,Kingston upon Hull 004F,E01012908,997,176,821
2021,Kingston upon Hull 007D,E01012909,1132,143,989
2021,Kingston upon Hull 006D,E01012910,1149,216,933
2021,Kingston upon Hull 007E,E01012911,1061,139,922
2021,Kingston upon Hull 006E,E01012912,1617,266,1351
2021,Kingston upon Hull 014E,E01012913,1860,454,1406
2021,Kingston upon Hull 012C,E01012914,3261,2721,540
2021,Kingston upon Hull 008E,E01012915,1419,361,1058
2021,Kingston upon Hull 012D,E01012916,1834,733,1101
2021,Kingston upon Hull 008F,E01012917,1641,383,1258
2021,Kingston upon Hull 008G,E01012918,1614,438,1176
2021,East Riding of Yorkshire 020A,E01012919,1416,429,987
2021,East Riding of Yorkshire 020B,E01012921,1104,185,919
2021,East Riding of Yorkshire 013A,E01012922,1430,209,1221
2021,East Riding of Yorkshire 013B,E01012923,1958,377,1581
2021,East Riding of Yorkshire 014A,E01012924,1637,288,1349
2021,East Riding of Yorkshire 013C,E01012925,1250,212,1038
2021,East Riding of Yorkshire 014B,E01012926,2266,352,1914
2021,East Riding of Yorkshire 013D,E01012927,1405,183,1222
2021,East Riding of Yorkshire 003A,E01012928,1569,391,1178
2021,East Riding of Yorkshire 002A,E01012929,1736,342,1394
2021,East Riding of Yorkshire 002B,E01012930,1302,200,1102
2021,East Riding of Yorkshire 003B,E01012931,1473,254,1219
2021,East Riding of Yorkshire 003C,E01012932,1560,310,1250
2021,East Riding of Yorkshire 001A,E01012933,990,102,888
2021,East Riding of Yorkshire 001B,E01012934,1652,208,1444
2021,East Riding of Yorkshire 002C,E01012935,1288,136,1152
2021,East Riding of Yorkshire 004A,E01012936,1201,62,1139
2021,East Riding of Yorkshire 002D,E01012937,2066,196,1870
2021,East Riding of Yorkshire 001D,E01012939,1781,226,1555
2021,East Riding of Yorkshire 001E,E01012940,1542,132,1410
2021,East Riding of Yorkshire 001F,E01012941,1317,103,1214
2021,East Riding of Yorkshire 002E,E01012942,1172,89,1083
2021,East Riding of Yorkshire 004B,E01012943,1612,321,1291
2021,East Riding of Yorkshire 005A,E01012944,1370,224,1146
2021,East Riding of Yorkshire 004C,E01012945,1397,253,1144
2021,East Riding of Yorkshire 003D,E01012946,1454,308,1146
2021,East Riding of Yorkshire 005B,E01012947,1352,226,1126
2021,East Riding of Yorkshire 005C,E01012948,1295,191,1104
2021,East Riding of Yorkshire 003E,E01012949,1258,189,1069
2021,East Riding of Yorkshire 006A,E01012950,1285,156,1129
2021,East Riding of Yorkshire 005D,E01012951,1170,165,1005
2021,East Riding of Yorkshire 004D,E01012952,1432,194,1238
2021,East Riding of Yorkshire 023A,E01012953,1250,177,1073
2021,East Riding of Yorkshire 022A,E01012954,1373,224,1149
2021,East Riding of Yorkshire 023B,E01012955,1523,227,1296
2021,East Riding of Yorkshire 022B,E01012956,1124,204,920
2021,East Riding of Yorkshire 025A,E01012957,1316,152,1164
2021,East Riding of Yorkshire 022C,E01012958,985,107,878
2021,East Riding of Yorkshire 023C,E01012959,1390,222,1168
2021,East Riding of Yorkshire 025B,E01012960,1571,228,1343
2021,East Riding of Yorkshire 022D,E01012961,2062,371,1691
2021,East Riding of Yorkshire 023D,E01012962,1136,129,1007
2021,East Riding of Yorkshire 025C,E01012963,1370,196,1174
2021,East Riding of Yorkshire 023E,E01012964,1633,341,1292
2021,East Riding of Yorkshire 022E,E01012966,1207,146,1061
2021,East Riding of Yorkshire 024C,E01012967,1492,215,1277
2021,East Riding of Yorkshire 024D,E01012968,1562,251,1311
2021,East Riding of Yorkshire 024E,E01012969,1051,182,869
2021,East Riding of Yorkshire 032A,E01012970,1727,295,1432
2021,East Riding of Yorkshire 032C,E01012972,1507,267,1240
2021,East Riding of Yorkshire 032E,E01012974,1483,280,1203
2021,East Riding of Yorkshire 044A,E01012975,1498,177,1321
2021,East Riding of Yorkshire 045A,E01012976,1234,234,1000
2021,East Riding of Yorkshire 008A,E01012978,1616,233,1383
2021,East Riding of Yorkshire 045B,E01012979,1641,244,1397
2021,East Riding of Yorkshire 045C,E01012980,1589,223,1366
2021,East Riding of Yorkshire 008B,E01012981,1305,197,1108
2021,East Riding of Yorkshire 045D,E01012982,1471,195,1276
2021,East Riding of Yorkshire 008C,E01012983,1701,297,1404
2021,East Riding of Yorkshire 044C,E01012984,1776,296,1480
2021,East Riding of Yorkshire 044D,E01012985,1645,244,1401
2021,East Riding of Yorkshire 010A,E01012986,1475,182,1293
2021,East Riding of Yorkshire 010B,E01012987,1639,211,1428
2021,East Riding of Yorkshire 010C,E01012988,1507,218,1289
2021,East Riding of Yorkshire 008D,E01012989,1711,241,1470
2021,East Riding of Yorkshire 006B,E01012990,1350,190,1160
2021,East Riding of Yorkshire 006C,E01012991,1541,228,1313
2021,East Riding of Yorkshire 006D,E01012992,1352,210,1142
2021,East Riding of Yorkshire 040A,E01012993,1417,195,1222
2021,East Riding of Yorkshire 041A,E01012994,1765,324,1441
2021,East Riding of Yorkshire 041B,E01012995,1798,387,1411
2021,East Riding of Yorkshire 037A,E01012996,1687,271,1416
2021,East Riding of Yorkshire 040B,E01012997,1804,300,1504
2021,East Riding of Yorkshire 037B,E01012998,2181,368,1813
2021,East Riding of Yorkshire 040C,E01012999,1564,281,1283
2021,East Riding of Yorkshire 041C,E01013000,2066,360,1706
2021,East Riding of Yorkshire 040D,E01013001,1696,276,1420
2021,East Riding of Yorkshire 041D,E01013002,1681,381,1300
2021,East Riding of Yorkshire 038A,E01013003,1367,178,1189
2021,East Riding of Yorkshire 041E,E01013004,1683,428,1255
2021,East Riding of Yorkshire 036A,E01013005,1856,265,1591
2021,East Riding of Yorkshire 043A,E01013006,1435,267,1168
2021,East Riding of Yorkshire 036B,E01013007,1416,224,1192
2021,East Riding of Yorkshire 034A,E01013008,1312,227,1085
2021,East Riding of Yorkshire 034B,E01013009,1489,261,1228
2021,East Riding of Yorkshire 043B,E01013010,1356,224,1132
2021,East Riding of Yorkshire 036C,E01013011,1448,259,1189
2021,East Riding of Yorkshire 036D,E01013012,1683,268,1415
2021,East Riding of Yorkshire 034C,E01013013,1361,213,1148
2021,East Riding of Yorkshire 034D,E01013014,1323,217,1106
2021,East Riding of Yorkshire 037C,E01013015,1686,238,1448
2021,East Riding of Yorkshire 037D,E01013016,1728,254,1474
2021,East Riding of Yorkshire 038B,E01013017,1747,278,1469
2021,East Riding of Yorkshire 026A,E01013018,1832,327,1505
2021,East Riding of Yorkshire 026B,E01013019,1923,178,1745
2021,East Riding of Yorkshire 038C,E01013020,1797,298,1499
2021,East Riding of Yorkshire 026C,E01013021,1366,163,1203
2021,East Riding of Yorkshire 018A,E01013022,1890,318,1572
2021,East Riding of Yorkshire 018B,E01013023,1748,241,1507
2021,East Riding of Yorkshire 018C,E01013024,1747,283,1464
2021,East Riding of Yorkshire 026D,E01013025,1297,210,1087
2021,East Riding of Yorkshire 026E,E01013026,1590,261,1329
2021,East Riding of Yorkshire 014C,E01013027,1642,230,1412
2021,East Riding of Yorkshire 031A,E01013028,1515,224,1291
2021,East Riding of Yorkshire 021A,E01013029,1422,224,1198
2021,East Riding of Yorkshire 021B,E01013030,1370,185,1185
2021,East Riding of Yorkshire 021C,E01013031,1354,169,1185
2021,East Riding of Yorkshire 021D,E01013032,1362,193,1169
2021,East Riding of Yorkshire 033A,E01013033,1478,243,1235
2021,East Riding of Yorkshire 014D,E01013034,1728,293,1435
2021,East Riding of Yorkshire 021E,E01013035,1404,205,1199
2021,East Riding of Yorkshire 019A,E01013036,1344,144,1200
2021,East Riding of Yorkshire 019B,E01013037,1323,224,1099
2021,East Riding of Yorkshire 017A,E01013038,1367,348,1019
2021,East Riding of Yorkshire 020C,E01013039,1867,287,1580
2021,East Riding of Yorkshire 019C,E01013040,2220,302,1918
2021,East Riding of Yorkshire 019D,E01013041,1521,140,1381
2021,East Riding of Yorkshire 020D,E01013042,1474,246,1228
2021,East Riding of Yorkshire 020E,E01013043,1246,216,1030
2021,East Riding of Yorkshire 020F,E01013044,1847,325,1522
2021,East Riding of Yorkshire 017B,E01013045,1430,323,1107
2021,East Riding of Yorkshire 012A,E01013046,1566,172,1394
2021,East Riding of Yorkshire 012B,E01013047,1494,182,1312
2021,East Riding of Yorkshire 010D,E01013048,2150,312,1838
2021,East Riding of Yorkshire 012C,E01013049,1629,248,1381
2021,East Riding of Yorkshire 012D,E01013050,1665,201,1464
2021,East Riding of Yorkshire 012E,E01013051,1580,340,1240
2021,East Riding of Yorkshire 011B,E01013053,1680,189,1491
2021,East Riding of Yorkshire 011C,E01013054,1859,354,1505
2021,East Riding of Yorkshire 011D,E01013055,1670,265,1405
2021,East Riding of Yorkshire 011E,E01013056,1509,208,1301
2021,East Riding of Yorkshire 009A,E01013057,1565,263,1302
2021,East Riding of Yorkshire 011F,E01013058,1399,198,1201
2021,East Riding of Yorkshire 009B,E01013059,1567,273,1294
2021,East Riding of Yorkshire 009C,E01013060,2312,307,2005
2021,East Riding of Yorkshire 009D,E01013061,1503,226,1277
2021,East Riding of Yorkshire 019E,E01013062,1545,179,1366
2021,East Riding of Yorkshire 019F,E01013063,1447,198,1249
2021,East Riding of Yorkshire 016A,E01013064,1307,252,1055
2021,East Riding of Yorkshire 016B,E01013065,1516,219,1297
2021,East Riding of Yorkshire 016C,E01013066,1497,262,1235
2021,East Riding of Yorkshire 016D,E01013067,1564,289,1275
2021,East Riding of Yorkshire 016E,E01013068,2171,378,1793
2021,East Riding of Yorkshire 017C,E01013069,1460,251,1209
2021,East Riding of Yorkshire 016F,E01013070,1382,195,1187
2021,East Riding of Yorkshire 017D,E01013071,1452,256,1196
2021,East Riding of Yorkshire 042A,E01013072,1618,253,1365
2021,East Riding of Yorkshire 042B,E01013073,1717,313,1404
2021,East Riding of Yorkshire 040E,E01013074,1546,228,1318
2021,East Riding of Yorkshire 042C,E01013075,1286,180,1106
2021,East Riding of Yorkshire 038D,E01013076,1461,223,1238
2021,East Riding of Yorkshire 042D,E01013077,1978,357,1621
2021,East Riding of Yorkshire 031B,E01013078,1391,193,1198
2021,East Riding of Yorkshire 039A,E01013079,1533,207,1326
2021,East Riding of Yorkshire 039B,E01013080,1300,257,1043
2021,East Riding of Yorkshire 031C,E01013081,1459,222,1237
2021,East Riding of Yorkshire 031D,E01013082,1557,224,1333
2021,East Riding of Yorkshire 039C,E01013083,1329,196,1133
2021,East Riding of Yorkshire 039D,E01013084,1236,197,1039
2021,East Riding of Yorkshire 031E,E01013085,1637,270,1367
2021,East Riding of Yorkshire 039E,E01013086,1414,227,1187
2021,East Riding of Yorkshire 039F,E01013087,1304,214,1090
2021,East Riding of Yorkshire 035A,E01013088,1760,332,1428
2021,East Riding of Yorkshire 035B,E01013089,1602,258,1344
2021,East Riding of Yorkshire 035C,E01013090,1382,255,1127
2021,East Riding of Yorkshire 035D,E01013091,1448,248,1200
2021,East Riding of Yorkshire 032F,E01013092,2542,578,1964
2021,East Riding of Yorkshire 035E,E01013093,1543,287,1256
2021,East Riding of Yorkshire 029A,E01013094,1343,219,1124
2021,East Riding of Yorkshire 029B,E01013095,1436,185,1251
2021,East Riding of Yorkshire 029C,E01013096,1707,294,1413
2021,East Riding of Yorkshire 029D,E01013097,1218,143,1075
2021,East Riding of Yorkshire 033B,E01013098,2102,418,1684
2021,East Riding of Yorkshire 033C,E01013099,1373,211,1162
2021,East Riding of Yorkshire 033D,E01013100,1586,255,1331
2021,East Riding of Yorkshire 033E,E01013101,1553,265,1288
2021,East Riding of Yorkshire 029E,E01013102,1351,164,1187
2021,East Riding of Yorkshire 043C,E01013103,1284,181,1103
2021,East Riding of Yorkshire 043D,E01013104,1118,136,982
2021,East Riding of Yorkshire 027A,E01013105,1347,240,1107
2021,East Riding of Yorkshire 043E,E01013106,1124,278,846
2021,East Riding of Yorkshire 034E,E01013107,2024,386,1638
2021,East Riding of Yorkshire 028A,E01013108,1568,222,1346
2021,East Riding of Yorkshire 027B,E01013110,1449,266,1183
2021,East Riding of Yorkshire 027C,E01013111,1345,210,1135
2021,East Riding of Yorkshire 025D,E01013112,1341,174,1167
2021,East Riding of Yorkshire 028B,E01013113,1401,197,1204
2021,East Riding of Yorkshire 028C,E01013114,1448,253,1195
2021,East Riding of Yorkshire 027D,E01013115,1337,202,1135
2021,East Riding of Yorkshire 028D,E01013116,1736,335,1401
2021,East Riding of Yorkshire 027E,E01013117,1444,255,1189
2021,East Riding of Yorkshire 028E,E01013118,1405,222,1183
2021,East Riding of Yorkshire 011G,E01013119,1408,235,1173
2021,East Riding of Yorkshire 015A,E01013120,1918,264,1654
2021,East Riding of Yorkshire 015B,E01013121,2098,406,1692
2021,East Riding of Yorkshire 018D,E01013122,1389,193,1196
2021,East Riding of Yorkshire 015C,E01013123,1958,345,1613
2021,East Riding of Yorkshire 015D,E01013124,2129,361,1768
2021,East Riding of Yorkshire 008E,E01013125,1633,279,1354
2021,East Riding of Yorkshire 009E,E01013126,2286,295,1991
2021,East Riding of Yorkshire 018E,E01013127,1529,287,1242
2021,North East Lincolnshire 024E,E01013128,1203,230,973
2021,North East Lincolnshire 024D,E01013129,1305,243,1062
2021,North East Lincolnshire 018A,E01013130,1309,249,1060
2021,North East Lincolnshire 014A,E01013131,1399,288,1111
2021,North East Lincolnshire 014B,E01013132,1372,227,1145
2021,North East Lincolnshire 014C,E01013133,1346,230,1116
2021,North East Lincolnshire 014D,E01013134,1336,201,1135
2021,North East Lincolnshire 018B,E01013135,1413,233,1180
2021,North East Lincolnshire 002A,E01013136,1160,172,988
2021,North East Lincolnshire 006A,E01013138,1213,279,934
2021,North East Lincolnshire 006B,E01013140,1309,336,973
2021,North East Lincolnshire 006C,E01013141,1395,351,1044
2021,North East Lincolnshire 002D,E01013142,1533,345,1188
2021,North East Lincolnshire 006D,E01013143,1262,299,963
2021,North East Lincolnshire 004A,E01013144,1337,258,1079
2021,North East Lincolnshire 004B,E01013145,1154,168,986
2021,North East Lincolnshire 004C,E01013146,1602,361,1241
2021,North East Lincolnshire 009A,E01013147,1285,323,962
2021,North East Lincolnshire 004D,E01013148,1261,169,1092
2021,North East Lincolnshire 013A,E01013149,1050,142,908
2021,North East Lincolnshire 013B,E01013150,1165,199,966
2021,North East Lincolnshire 024G,E01013151,1132,164,968
2021,North East Lincolnshire 024F,E01013152,1411,237,1174
2021,North East Lincolnshire 020A,E01013153,1220,102,1118
2021,North East Lincolnshire 018C,E01013154,1247,151,1096
2021,North East Lincolnshire 024H,E01013155,1227,169,1058
2021,North East Lincolnshire 018D,E01013156,1251,143,1108
2021,North East Lincolnshire 020B,E01013157,1637,275,1362
2021,North East Lincolnshire 012A,E01013158,1287,261,1026
2021,North East Lincolnshire 011A,E01013159,1342,338,1004
2021,North East Lincolnshire 012B,E01013160,1325,194,1131
2021,North East Lincolnshire 011B,E01013161,1216,305,911
2021,North East Lincolnshire 011C,E01013162,1426,312,1114
2021,North East Lincolnshire 012C,E01013163,1220,162,1058
2021,North East Lincolnshire 012D,E01013164,1760,384,1376
2021,North East Lincolnshire 011D,E01013165,1191,243,948
2021,North East Lincolnshire 020D,E01013167,1708,230,1478
2021,North East Lincolnshire 022B,E01013170,1386,217,1169
2021,North East Lincolnshire 022C,E01013171,1757,379,1378
2021,North East Lincolnshire 022D,E01013172,1424,182,1242
2021,North East Lincolnshire 007A,E01013173,1259,179,1080
2021,North East Lincolnshire 001A,E01013174,1410,416,994
2021,North East Lincolnshire 001B,E01013175,1673,275,1398
2021,North East Lincolnshire 001C,E01013176,1323,238,1085
2021,North East Lincolnshire 001D,E01013177,1326,247,1079
2021,North East Lincolnshire 001E,E01013178,1295,188,1107
2021,North East Lincolnshire 001F,E01013179,1506,266,1240
2021,North East Lincolnshire 001G,E01013180,1331,200,1131
2021,North East Lincolnshire 016A,E01013181,1375,367,1008
2021,North East Lincolnshire 016B,E01013182,1401,216,1185
2021,North East Lincolnshire 016C,E01013183,1412,270,1142
2021,North East Lincolnshire 016D,E01013184,1417,290,1127
2021,North East Lincolnshire 016E,E01013185,1409,303,1106
2021,North East Lincolnshire 016F,E01013186,1449,281,1168
2021,North East Lincolnshire 008A,E01013187,1281,165,1116
2021,North East Lincolnshire 008B,E01013188,1489,227,1262
2021,North East Lincolnshire 021A,E01013189,1524,251,1273
2021,North East Lincolnshire 021C,E01013191,1445,209,1236
2021,North East Lincolnshire 021D,E01013192,1380,273,1107
2021,North East Lincolnshire 022E,E01013193,1459,164,1295
2021,North East Lincolnshire 021E,E01013194,1352,168,1184
2021,North East Lincolnshire 005A,E01013195,1252,298,954
2021,North East Lincolnshire 005B,E01013196,1171,297,874
2021,North East Lincolnshire 012E,E01013197,1138,184,954
2021,North East Lincolnshire 024A,E01013198,1298,223,1075
2021,North East Lincolnshire 024B,E01013199,978,161,817
2021,North East Lincolnshire 024C,E01013200,1116,198,918
2021,North East Lincolnshire 005C,E01013201,1407,360,1047
2021,North East Lincolnshire 005D,E01013202,1342,307,1035
2021,North East Lincolnshire 005E,E01013203,1409,359,1050
2021,North East Lincolnshire 019A,E01013204,1312,278,1034
2021,North East Lincolnshire 019B,E01013205,1287,381,906
2021,North East Lincolnshire 015A,E01013206,1281,278,1003
2021,North East Lincolnshire 015B,E01013207,1261,223,1038
2021,North East Lincolnshire 019C,E01013208,1253,397,856
2021,North East Lincolnshire 019D,E01013209,1296,235,1061
2021,North East Lincolnshire 019E,E01013210,1283,396,887
2021,North East Lincolnshire 015C,E01013211,1341,247,1094
2021,North East Lincolnshire 015D,E01013212,1256,305,951
2021,North East Lincolnshire 023A,E01013213,1097,144,953
2021,North East Lincolnshire 023B,E01013214,1377,169,1208
2021,North East Lincolnshire 023C,E01013215,1611,215,1396
2021,North East Lincolnshire 023D,E01013216,1135,190,945
2021,North East Lincolnshire 023E,E01013217,1313,178,1135
2021,North East Lincolnshire 003A,E01013218,1212,231,981
2021,North East Lincolnshire 003B,E01013219,1362,254,1108
2021,North East Lincolnshire 003C,E01013220,1441,287,1154
2021,North East Lincolnshire 003D,E01013221,1579,274,1305
2021,North East Lincolnshire 003E,E01013222,1430,300,1130
2021,North East Lincolnshire 007C,E01013224,1914,343,1571
2021,North East Lincolnshire 023F,E01013225,1122,168,954
2021,North East Lincolnshire 007D,E01013226,1379,217,1162
2021,North East Lincolnshire 013C,E01013227,1445,209,1236
2021,North East Lincolnshire 013D,E01013228,1386,239,1147
2021,North East Lincolnshire 013E,E01013229,1479,413,1066
2021,North East Lincolnshire 008C,E01013231,1438,270,1168
2021,North East Lincolnshire 008D,E01013233,1259,224,1035
2021,North East Lincolnshire 009D,E01013234,1303,178,1125
2021,North Lincolnshire 017A,E01013236,1497,238,1259
2021,North Lincolnshire 018B,E01013237,1640,455,1185
2021,North Lincolnshire 015A,E01013238,1547,283,1264
2021,North Lincolnshire 017B,E01013239,1387,191,1196
2021,North Lincolnshire 020A,E01013241,1428,170,1258
2021,North Lincolnshire 020B,E01013242,1781,304,1477
2021,North Lincolnshire 020C,E01013243,2147,383,1764
2021,North Lincolnshire 020D,E01013244,1827,363,1464
2021,North Lincolnshire 006A,E01013245,1357,290,1067
2021,North Lincolnshire 006B,E01013246,1468,250,1218
2021,North Lincolnshire 006C,E01013247,1632,216,1416
2021,North Lincolnshire 006D,E01013248,1712,258,1454
2021,North Lincolnshire 006E,E01013249,1706,357,1349
2021,North Lincolnshire 023A,E01013250,1654,255,1399
2021,North Lincolnshire 023B,E01013251,1742,249,1493
2021,North Lincolnshire 023C,E01013252,1580,246,1334
2021,North Lincolnshire 023D,E01013253,1857,269,1588
2021,North Lincolnshire 001A,E01013254,1675,254,1421
2021,North Lincolnshire 001B,E01013255,1966,234,1732
2021,North Lincolnshire 001C,E01013256,2378,385,1993
2021,North Lincolnshire 001D,E01013257,1782,246,1536
2021,North Lincolnshire 001E,E01013258,1633,355,1278
2021,North Lincolnshire 001F,E01013259,1875,360,1515
2021,North Lincolnshire 019A,E01013260,1346,140,1206
2021,North Lincolnshire 018C,E01013261,1355,228,1127
2021,North Lincolnshire 018D,E01013262,1241,177,1064
2021,North Lincolnshire 018E,E01013263,1321,176,1145
2021,North Lincolnshire 019B,E01013264,1749,276,1473
2021,North Lincolnshire 019C,E01013265,1524,209,1315
2021,North Lincolnshire 019D,E01013266,1744,297,1447
2021,North Lincolnshire 011A,E01013267,1178,183,995
2021,North Lincolnshire 011B,E01013268,1174,164,1010
2021,North Lincolnshire 011C,E01013269,1693,264,1429
2021,North Lincolnshire 004A,E01013270,1925,376,1549
2021,North Lincolnshire 011D,E01013271,1893,414,1479
2021,North Lincolnshire 011E,E01013272,1628,204,1424
2021,North Lincolnshire 011F,E01013273,1636,201,1435
2021,North Lincolnshire 013A,E01013274,1872,251,1621
2021,North Lincolnshire 013B,E01013275,1413,219,1194
2021,North Lincolnshire 013C,E01013276,1535,254,1281
2021,North Lincolnshire 013D,E01013277,1366,237,1129
2021,North Lincolnshire 016A,E01013278,1466,408,1058
2021,North Lincolnshire 012A,E01013279,1409,282,1127
2021,North Lincolnshire 016B,E01013280,1376,270,1106
2021,North Lincolnshire 016C,E01013281,1323,377,946
2021,North Lincolnshire 017C,E01013282,1488,341,1147
2021,North Lincolnshire 016D,E01013283,1392,387,1005
2021,North Lincolnshire 017D,E01013284,1432,336,1096
2021,North Lincolnshire 012B,E01013285,1149,182,967
2021,North Lincolnshire 005A,E01013286,2128,262,1866
2021,North Lincolnshire 005B,E01013287,1399,162,1237
2021,North Lincolnshire 003A,E01013288,1435,237,1198
2021,North Lincolnshire 005C,E01013289,1526,230,1296
2021,North Lincolnshire 005D,E01013290,1637,213,1424
2021,North Lincolnshire 003B,E01013291,1484,391,1093
2021,North Lincolnshire 003C,E01013292,1635,224,1411
2021,North Lincolnshire 005E,E01013293,1420,213,1207
2021,North Lincolnshire 003D,E01013294,1534,227,1307
2021,North Lincolnshire 009A,E01013295,1314,221,1093
2021,North Lincolnshire 008A,E01013296,1738,405,1333
2021,North Lincolnshire 007A,E01013297,2382,515,1867
2021,North Lincolnshire 008B,E01013298,1673,444,1229
2021,North Lincolnshire 008C,E01013299,1507,401,1106
2021,North Lincolnshire 007B,E01013300,1640,314,1326
2021,North Lincolnshire 009B,E01013301,1523,312,1211
2021,North Lincolnshire 007C,E01013302,1529,250,1279
2021,North Lincolnshire 002A,E01013303,1274,215,1059
2021,North Lincolnshire 002B,E01013304,1544,269,1275
2021,North Lincolnshire 002C,E01013305,1565,251,1314
2021,North Lincolnshire 004B,E01013306,1528,238,1290
2021,North Lincolnshire 002D,E01013307,1738,290,1448
2021,North Lincolnshire 004C,E01013308,1753,301,1452
2021,North Lincolnshire 004D,E01013309,1556,270,1286
2021,North Lincolnshire 010A,E01013310,1395,291,1104
2021,North Lincolnshire 015C,E01013311,1699,438,1261
2021,North Lincolnshire 010B,E01013312,1720,368,1352
2021,North Lincolnshire 010C,E01013313,1436,245,1191
2021,North Lincolnshire 010D,E01013314,1463,286,1177
2021,North Lincolnshire 014A,E01013315,1412,236,1176
2021,North Lincolnshire 012C,E01013316,1378,240,1138
2021,North Lincolnshire 014B,E01013317,1328,234,1094
2021,North Lincolnshire 014C,E01013318,1375,257,1118
2021,North Lincolnshire 014D,E01013319,1970,452,1518
2021,North Lincolnshire 015D,E01013320,1232,209,1023
2021,North Lincolnshire 012D,E01013321,1560,255,1305
2021,North Lincolnshire 022A,E01013322,2038,353,1685
2021,North Lincolnshire 022B,E01013323,1504,229,1275
2021,North Lincolnshire 021A,E01013324,1395,201,1194
2021,North Lincolnshire 022C,E01013325,1425,176,1249
2021,North Lincolnshire 021B,E01013326,1497,216,1281
2021,North Lincolnshire 021C,E01013327,1317,146,1171
2021,North Lincolnshire 021D,E01013328,1205,213,992
2021,North Lincolnshire 022D,E01013329,1777,300,1477
2021,North Lincolnshire 008D,E01013330,1743,254,1489
2021,North Lincolnshire 007D,E01013331,1493,201,1292
2021,North Lincolnshire 008E,E01013332,1761,350,1411
2021,North Lincolnshire 009C,E01013333,1545,367,1178
2021,North Lincolnshire 009D,E01013334,1565,321,1244
2021,York 012A,E01013335,1545,363,1182
2021,York 012B,E01013336,1446,239,1207
2021,York 012C,E01013337,1560,250,1310
2021,York 012D,E01013338,2180,419,1761
2021,York 012E,E01013339,1489,292,1197
2021,York 024A,E01013340,1280,308,972
2021,York 024B,E01013341,1281,240,1041
2021,York 024C,E01013342,1436,189,1247
2021,York 009A,E01013343,1726,565,1161
2021,York 007A,E01013344,1348,324,1024
2021,York 009B,E01013345,1602,360,1242
2021,York 007B,E01013346,1592,258,1334
2021,York 009C,E01013347,1524,411,1113
2021,York 010A,E01013348,1714,685,1029
2021,York 009D,E01013349,1315,361,954
2021,York 009E,E01013350,1525,353,1172
2021,York 020A,E01013351,1878,308,1570
2021,York 020B,E01013352,1685,336,1349
2021,York 022A,E01013353,1485,284,1201
2021,York 022B,E01013354,1254,143,1111
2021,York 022C,E01013355,1736,227,1509
2021,York 022D,E01013356,1302,145,1157
2021,York 021A,E01013357,2233,486,1747
2021,York 021B,E01013358,1451,253,1198
2021,York 022E,E01013359,1505,330,1175
2021,York 019A,E01013360,1675,562,1113
2021,York 019B,E01013361,1643,511,1132
2021,York 019C,E01013362,1863,380,1483
2021,York 019D,E01013363,2954,1750,1204
2021,York 019E,E01013364,1825,803,1022
2021,York 013A,E01013366,1706,419,1287
2021,York 010B,E01013368,2074,750,1324
2021,York 013C,E01013369,1652,348,1304
2021,York 002A,E01013370,1422,185,1237
2021,York 003A,E01013371,1367,253,1114
2021,York 003B,E01013372,1512,196,1316
2021,York 002B,E01013373,1463,288,1175
2021,York 003C,E01013374,1447,279,1168
2021,York 002C,E01013375,1191,138,1053
2021,York 002D,E01013376,1376,198,1178
2021,York 003D,E01013377,1522,232,1290
2021,York 023B,E01013378,6190,5519,671
2021,York 008A,E01013379,1338,250,1088
2021,York 008B,E01013380,1621,557,1064
2021,York 014A,E01013381,1526,369,1157
2021,York 010C,E01013382,1520,331,1189
2021,York 010D,E01013383,2719,1146,1573
2021,York 015A,E01013384,1566,585,981
2021,York 008C,E01013385,1323,254,1069
2021,York 010E,E01013386,1659,380,1279
2021,York 008D,E01013387,1482,249,1233
2021,York 008E,E01013388,976,100,876
2021,York 008F,E01013389,1103,191,912
2021,York 017A,E01013390,1384,175,1209
2021,York 017B,E01013391,1867,291,1576
2021,York 012F,E01013392,1548,281,1267
2021,York 016A,E01013393,1391,226,1165
2021,York 016B,E01013394,1295,246,1049
2021,York 016C,E01013395,1358,229,1129
2021,York 016D,E01013396,1472,230,1242
2021,York 017C,E01013397,1406,264,1142
2021,York 015B,E01013398,1515,653,862
2021,York 015C,E01013399,1660,596,1064
2021,York 015D,E01013400,1657,818,839
2021,York 015E,E01013401,1535,681,854
2021,York 014B,E01013402,1684,692,992
2021,York 015F,E01013403,1855,1081,774
2021,York 004A,E01013404,1636,274,1362
2021,York 005A,E01013405,1303,188,1115
2021,York 005B,E01013406,1918,309,1609
2021,York 004B,E01013407,1395,214,1181
2021,York 004C,E01013408,1201,127,1074
2021,York 005C,E01013409,1757,313,1444
2021,York 004D,E01013410,1275,276,999
2021,York 005D,E01013411,1392,196,1196
2021,York 021C,E01013412,2058,341,1717
2021,York 017D,E01013413,1500,329,1171
2021,York 021D,E01013414,1678,311,1367
2021,York 013E,E01013416,1412,262,1150
2021,York 017E,E01013417,1733,338,1395
2021,York 019F,E01013418,1434,268,1166
2021,York 014C,E01013419,2571,567,2004
2021,York 014D,E01013420,1953,522,1431
2021,York 011A,E01013421,1516,370,1146
2021,York 011B,E01013422,1658,331,1327
2021,York 024D,E01013423,1265,236,1029
2021,York 024E,E01013424,1247,227,1020
2021,York 024F,E01013425,1486,269,1217
2021,York 011C,E01013426,1656,308,1348
2021,York 011D,E01013427,1363,279,1084
2021,York 006A,E01013428,1624,254,1370
2021,York 006B,E01013429,1871,370,1501
2021,York 006C,E01013430,1586,246,1340
2021,York 006D,E01013431,2004,365,1639
2021,York 007C,E01013432,1886,363,1523
2021,York 007D,E01013433,1320,181,1139
2021,York 007E,E01013434,1430,186,1244
2021,York 006E,E01013435,1384,222,1162
2021,York 001A,E01013436,1626,348,1278
2021,York 008G,E01013437,1327,211,1116
2021,York 001B,E01013438,1915,411,1504
2021,York 001C,E01013439,1327,279,1048
2021,York 001D,E01013440,1760,321,1439
2021,York 016E,E01013441,1422,185,1237
2021,York 018A,E01013442,1385,267,1118
2021,York 018B,E01013443,1540,297,1243
2021,York 018C,E01013444,1406,354,1052
2021,York 016F,E01013445,1495,244,1251
2021,York 018D,E01013446,1578,319,1259
2021,York 018E,E01013447,1400,293,1107
2021,York 018F,E01013448,1345,327,1018
2021,York 022F,E01013449,1543,294,1249
2021,York 023C,E01013450,1189,219,970
2021,York 020C,E01013451,1221,263,958
2021,York 020D,E01013452,1576,339,1237
2021,Derby 013A,E01013453,2143,509,1634
2021,Derby 013B,E01013454,1356,431,925
2021,Derby 017A,E01013455,1851,324,1527
2021,Derby 013C,E01013456,1672,287,1385
2021,Derby 013D,E01013457,1655,296,1359
2021,Derby 017B,E01013458,1709,313,1396
2021,Derby 020A,E01013459,1972,589,1383
2021,Derby 013E,E01013460,1695,482,1213
2021,Derby 001A,E01013461,1637,278,1359
2021,Derby 001B,E01013462,1474,325,1149
2021,Derby 001C,E01013463,1448,296,1152
2021,Derby 001D,E01013464,1348,229,1119
2021,Derby 002A,E01013465,1561,298,1263
2021,Derby 002B,E01013466,1449,233,1216
2021,Derby 002C,E01013467,1311,220,1091
2021,Derby 002D,E01013468,1538,283,1255
2021,Derby 002E,E01013469,1230,129,1101
2021,Derby 024A,E01013470,1304,252,1052
2021,Derby 025A,E01013471,1742,353,1389
2021,Derby 026A,E01013472,2219,486,1733
2021,Derby 025B,E01013473,1488,295,1193
2021,Derby 024B,E01013474,1472,263,1209
2021,Derby 025C,E01013475,1518,439,1079
2021,Derby 024C,E01013476,1337,127,1210
2021,Derby 025D,E01013477,1589,243,1346
2021,Derby 016A,E01013480,2074,354,1720
2021,Derby 018A,E01013481,1872,588,1284
2021,Derby 016B,E01013483,1876,504,1372
2021,Derby 018C,E01013484,1983,541,1442
2021,Derby 016C,E01013485,2076,572,1504
2021,Derby 018D,E01013486,1969,567,1402
2021,Derby 018E,E01013487,2401,710,1691
2021,Derby 022A,E01013488,1477,278,1199
2021,Derby 022B,E01013489,1445,234,1211
2021,Derby 022C,E01013490,1463,255,1208
2021,Derby 022D,E01013491,1573,381,1192
2021,Derby 027A,E01013492,1539,295,1244
2021,Derby 027B,E01013493,1463,254,1209
2021,Derby 027C,E01013494,1792,432,1360
2021,Derby 027D,E01013495,1697,345,1352
2021,Derby 028A,E01013496,1424,329,1095
2021,Derby 026B,E01013497,1675,447,1228
2021,Derby 028B,E01013498,1380,230,1150
2021,Derby 028C,E01013499,1462,272,1190
2021,Derby 028D,E01013500,1620,292,1328
2021,Derby 028E,E01013501,1388,222,1166
2021,Derby 025E,E01013502,1394,353,1041
2021,Derby 025F,E01013503,1426,250,1176
2021,Derby 026C,E01013504,1785,518,1267
2021,Derby 006A,E01013505,1422,249,1173
2021,Derby 006B,E01013506,1464,222,1242
2021,Derby 012A,E01013507,1472,230,1242
2021,Derby 012B,E01013508,1198,300,898
2021,Derby 012C,E01013509,1564,274,1290
2021,Derby 012D,E01013510,1472,338,1134
2021,Derby 012E,E01013511,1486,239,1247
2021,Derby 012F,E01013512,1335,243,1092
2021,Derby 006C,E01013513,1276,294,982
2021,Derby 031A,E01013514,1432,252,1180
2021,Derby 031B,E01013515,1961,474,1487
2021,Derby 030B,E01013517,1400,191,1209
2021,Derby 030C,E01013518,1457,203,1254
2021,Derby 031C,E01013519,1506,388,1118
2021,Derby 031D,E01013520,1822,311,1511
2021,Derby 030D,E01013521,1281,217,1064
2021,Derby 008A,E01013522,1886,744,1142
2021,Derby 008B,E01013523,1736,301,1435
2021,Derby 008C,E01013524,2560,1745,815
2021,Derby 008D,E01013525,1793,268,1525
2021,Derby 005A,E01013526,1561,302,1259
2021,Derby 005B,E01013527,1480,286,1194
2021,Derby 005C,E01013528,1517,308,1209
2021,Derby 005D,E01013529,2153,541,1612
2021,Derby 004A,E01013530,1693,412,1281
2021,Derby 004B,E01013531,1388,343,1045
2021,Derby 004C,E01013532,1425,337,1088
2021,Derby 007A,E01013533,1497,369,1128
2021,Derby 006D,E01013534,1524,304,1220
2021,Derby 007B,E01013535,1596,557,1039
2021,Derby 007C,E01013536,1438,352,1086
2021,Derby 007D,E01013537,1522,238,1284
2021,Derby 007E,E01013538,1403,217,1186
2021,Derby 021A,E01013539,2217,537,1680
2021,Derby 019A,E01013540,1566,317,1249
2021,Derby 021B,E01013541,1641,434,1207
2021,Derby 017C,E01013542,2255,480,1775
2021,Derby 021C,E01013543,1618,388,1230
2021,Derby 021D,E01013544,1801,396,1405
2021,Derby 021E,E01013545,1620,349,1271
2021,Derby 017D,E01013546,1622,365,1257
2021,Derby 011A,E01013547,1756,652,1104
2021,Derby 009A,E01013548,1618,357,1261
2021,Derby 009B,E01013549,1421,302,1119
2021,Derby 011B,E01013550,1205,280,925
2021,Derby 011C,E01013551,1641,738,903
2021,Derby 009C,E01013552,1595,343,1252
2021,Derby 009D,E01013553,1453,330,1123
2021,Derby 011D,E01013554,1497,373,1124
2021,Derby 009E,E01013555,2445,592,1853
2021,Derby 015A,E01013556,1306,218,1088
2021,Derby 015B,E01013557,1290,157,1133
2021,Derby 015C,E01013558,2416,524,1892
2021,Derby 015D,E01013559,1269,221,1048
2021,Derby 019B,E01013560,1328,224,1104
2021,Derby 019C,E01013561,1444,203,1241
2021,Derby 019D,E01013562,1285,161,1124
2021,Derby 019E,E01013563,1274,185,1089
2021,Derby 015E,E01013564,2349,361,1988
2021,Derby 016D,E01013565,1856,567,1289
2021,Derby 016E,E01013566,2216,652,1564
2021,Derby 020B,E01013567,2128,619,1509
2021,Derby 020C,E01013568,2367,750,1617
2021,Derby 020D,E01013569,1687,489,1198
2021,Derby 023A,E01013570,2360,797,1563
2021,Derby 023B,E01013571,1938,506,1432
2021,Derby 023C,E01013572,1649,366,1283
2021,Derby 023D,E01013573,1989,550,1439
2021,Derby 003A,E01013574,1823,396,1427
2021,Derby 003B,E01013575,1409,262,1147
2021,Derby 003C,E01013576,1267,171,1096
2021,Derby 003D,E01013577,1409,255,1154
2021,Derby 003E,E01013578,1260,238,1022
2021,Derby 003F,E01013579,1314,178,1136
2021,Derby 003G,E01013580,1396,178,1218
2021,Derby 004D,E01013581,1437,352,1085
2021,Derby 006E,E01013582,1408,244,1164
2021,Derby 026D,E01013583,1728,503,1225
2021,Derby 029A,E01013584,1879,615,1264
2021,Derby 029B,E01013585,1913,497,1416
2021,Derby 029C,E01013586,1628,414,1214
2021,Derby 029D,E01013587,1564,346,1218
2021,Derby 029E,E01013588,1483,313,1170
2021,Derby 029F,E01013589,1600,251,1349
2021,Derby 026E,E01013590,2149,638,1511
2021,Derby 026F,E01013591,1991,534,1457
2021,Derby 010A,E01013592,1342,200,1142
2021,Derby 014A,E01013593,1365,237,1128
2021,Derby 010B,E01013594,1251,177,1074
2021,Derby 014B,E01013595,2321,461,1860
2021,Derby 010C,E01013596,1460,252,1208
2021,Derby 014C,E01013597,1507,276,1231
2021,Derby 014D,E01013598,1486,280,1206
2021,Derby 010D,E01013599,1329,198,1131
2021,Leicester 003A,E01013600,2032,638,1394
2021,Leicester 003B,E01013601,1767,513,1254
2021,Leicester 003C,E01013602,1808,454,1354
2021,Leicester 003D,E01013603,1609,397,1212
2021,Leicester 003E,E01013604,1764,490,1274
2021,Leicester 003F,E01013605,1971,445,1526
2021,Leicester 008A,E01013606,1818,415,1403
2021,Leicester 034A,E01013608,1489,293,1196
2021,Leicester 034B,E01013609,1506,220,1286
2021,Leicester 034C,E01013610,1614,371,1243
2021,Leicester 034D,E01013611,1585,336,1249
2021,Leicester 034E,E01013612,1710,316,1394
2021,Leicester 031A,E01013613,1724,388,1336
2021,Leicester 031B,E01013614,1605,354,1251
2021,Leicester 001A,E01013615,1629,328,1301
2021,Leicester 001B,E01013616,1547,344,1203
2021,Leicester 004A,E01013617,2534,516,2018
2021,Leicester 001C,E01013618,1552,324,1228
2021,Leicester 001D,E01013619,1673,506,1167
2021,Leicester 004B,E01013620,1730,570,1160
2021,Leicester 004C,E01013621,2239,714,1525
2021,Leicester 004D,E01013622,1580,433,1147
2021,Leicester 004E,E01013623,2089,506,1583
2021,Leicester 007A,E01013624,1634,380,1254
2021,Leicester 006A,E01013625,2089,494,1595
2021,Leicester 007B,E01013626,1905,401,1504
2021,Leicester 007C,E01013627,1295,211,1084
2021,Leicester 006B,E01013628,1647,351,1296
2021,Leicester 007D,E01013629,1721,389,1332
2021,Leicester 007E,E01013630,1933,448,1485
2021,Leicester 026A,E01013631,1502,424,1078
2021,Leicester 026B,E01013632,1790,483,1307
2021,Leicester 028A,E01013633,1607,401,1206
2021,Leicester 028B,E01013634,1419,339,1080
2021,Leicester 029A,E01013635,1471,275,1196
2021,Leicester 029B,E01013636,1287,201,1086
2021,Leicester 028C,E01013637,1949,510,1439
2021,Leicester 026C,E01013638,1650,483,1167
2021,Leicester 028D,E01013639,1530,441,1089
2021,Leicester 026D,E01013640,1984,757,1227
2021,Leicester 028E,E01013641,1435,366,1069
2021,Leicester 030A,E01013642,1652,588,1064
2021,Leicester 030B,E01013643,1786,806,980
2021,Leicester 040C,E01013648,3397,2355,1042
2021,Leicester 030C,E01013649,1271,389,882
2021,Leicester 030D,E01013650,1707,851,856
2021,Leicester 011A,E01013651,2004,604,1400
2021,Leicester 011B,E01013652,2009,662,1347
2021,Leicester 011C,E01013653,2753,803,1950
2021,Leicester 017A,E01013654,2482,665,1817
2021,Leicester 011D,E01013655,2523,625,1898
2021,Leicester 017B,E01013656,2052,498,1554
2021,Leicester 017C,E01013657,1813,444,1369
2021,Leicester 017D,E01013658,2624,755,1869
2021,Leicester 017E,E01013659,2103,571,1532
2021,Leicester 019A,E01013660,1897,483,1414
2021,Leicester 019B,E01013661,1815,523,1292
2021,Leicester 021A,E01013662,1841,434,1407
2021,Leicester 021B,E01013663,1726,469,1257
2021,Leicester 019C,E01013664,1724,427,1297
2021,Leicester 019D,E01013665,2183,582,1601
2021,Leicester 025A,E01013666,1623,324,1299
2021,Leicester 019E,E01013667,1528,339,1189
2021,Leicester 019F,E01013668,1273,317,956
2021,Leicester 025B,E01013669,1457,313,1144
2021,Leicester 025C,E01013670,1888,397,1491
2021,Leicester 025D,E01013671,1862,493,1369
2021,Leicester 025E,E01013672,1477,333,1144
2021,Leicester 036A,E01013673,1575,402,1173
2021,Leicester 036B,E01013674,1471,322,1149
2021,Leicester 036C,E01013675,1595,415,1180
2021,Leicester 036D,E01013676,2010,539,1471
2021,Leicester 036E,E01013677,1418,333,1085
2021,Leicester 035A,E01013678,1660,366,1294
2021,Leicester 035B,E01013679,1494,500,994
2021,Leicester 008C,E01013680,1984,403,1581
2021,Leicester 016A,E01013681,1887,480,1407
2021,Leicester 016B,E01013682,1746,439,1307
2021,Leicester 016C,E01013683,2224,523,1701
2021,Leicester 016D,E01013684,2230,732,1498
2021,Leicester 008D,E01013685,1433,263,1170
2021,Leicester 008E,E01013686,1757,350,1407
2021,Leicester 031C,E01013687,1564,336,1228
2021,Leicester 031D,E01013688,1841,461,1380
2021,Leicester 038A,E01013689,1939,1207,732
2021,Leicester 038B,E01013690,2174,659,1515
2021,Leicester 035C,E01013691,1615,505,1110
2021,Leicester 035D,E01013692,1384,439,945
2021,Leicester 035E,E01013693,1550,495,1055
2021,Leicester 013A,E01013694,2110,624,1486
2021,Leicester 043D,E01013696,2348,632,1716
2021,Leicester 037B,E01013698,1586,442,1144
2021,Leicester 043C,E01013699,1913,442,1471
2021,Leicester 013B,E01013700,1524,296,1228
2021,Leicester 030E,E01013702,1568,452,1116
2021,Leicester 032A,E01013703,1246,270,976
2021,Leicester 032B,E01013704,1397,240,1157
2021,Leicester 038C,E01013705,1545,342,1203
2021,Leicester 032C,E01013706,1624,367,1257
2021,Leicester 032D,E01013707,1476,343,1133
2021,Leicester 038D,E01013709,1565,367,1198
2021,Leicester 030F,E01013710,1328,278,1050
2021,Leicester 030G,E01013711,1570,221,1349
2021,Leicester 032E,E01013712,1248,210,1038
2021,Leicester 010A,E01013713,1761,347,1414
2021,Leicester 010B,E01013714,1774,340,1434
2021,Leicester 006C,E01013715,1397,248,1149
2021,Leicester 010C,E01013717,1582,373,1209
2021,Leicester 010D,E01013718,1789,371,1418
2021,Leicester 010E,E01013719,1933,420,1513
2021,Leicester 010F,E01013720,1819,402,1417
2021,Leicester 012A,E01013721,1631,388,1243
2021,Leicester 039A,E01013722,1859,572,1287
2021,Leicester 012B,E01013723,1408,464,944
2021,Leicester 012C,E01013725,1554,537,1017
2021,Leicester 012D,E01013726,1722,495,1227
2021,Leicester 039B,E01013727,1582,439,1143
2021,Leicester 012E,E01013728,1689,556,1133
2021,Leicester 020A,E01013729,1224,240,984
2021,Leicester 039C,E01013730,1592,465,1127
2021,Leicester 039D,E01013731,1485,355,1130
2021,Leicester 005A,E01013732,2373,636,1737
2021,Leicester 002A,E01013733,1897,478,1419
2021,Leicester 002B,E01013734,1393,241,1152
2021,Leicester 002C,E01013735,1162,161,1001
2021,Leicester 002D,E01013736,2036,411,1625
2021,Leicester 002E,E01013737,1331,223,1108
2021,Leicester 006E,E01013738,1353,245,1108
2021,Leicester 005B,E01013739,1450,243,1207
2021,Leicester 005C,E01013740,1422,274,1148
2021,Leicester 005D,E01013741,1645,396,1249
2021,Leicester 018A,E01013742,1733,465,1268
2021,Leicester 017F,E01013743,2046,478,1568
2021,Leicester 018B,E01013744,1755,441,1314
2021,Leicester 017G,E01013745,1594,418,1176
2021,Leicester 018C,E01013746,1694,426,1268
2021,Leicester 021C,E01013747,1865,495,1370
2021,Leicester 018D,E01013748,1807,609,1198
2021,Leicester 021D,E01013749,1485,452,1033
2021,Leicester 021E,E01013750,1491,413,1078
2021,Leicester 022A,E01013751,1838,537,1301
2021,Leicester 022B,E01013752,1507,419,1088
2021,Leicester 022C,E01013753,1646,500,1146
2021,Leicester 018E,E01013754,2296,912,1384
2021,Leicester 018F,E01013755,2266,858,1408
2021,Leicester 027A,E01013756,1920,635,1285
2021,Leicester 027B,E01013757,1574,397,1177
2021,Leicester 021F,E01013758,1589,509,1080
2021,Leicester 027C,E01013759,1810,493,1317
2021,Leicester 022D,E01013760,1791,648,1143
2021,Leicester 022E,E01013761,1884,658,1226
2021,Leicester 022F,E01013762,1687,442,1245
2021,Leicester 027D,E01013763,2111,825,1286
2021,Leicester 027E,E01013764,1544,395,1149
2021,Leicester 027F,E01013765,1741,641,1100
2021,Leicester 027G,E01013766,1891,573,1318
2021,Leicester 037C,E01013767,1570,341,1229
2021,Leicester 037D,E01013768,1784,396,1388
2021,Leicester 013C,E01013770,1388,290,1098
2021,Leicester 013D,E01013771,1586,392,1194
2021,Leicester 037E,E01013772,1540,445,1095
2021,Leicester 013E,E01013773,1358,284,1074
2021,Leicester 023A,E01013774,1743,566,1177
2021,Leicester 023B,E01013776,1775,670,1105
2021,Leicester 029D,E01013777,1782,387,1395
2021,Leicester 023D,E01013779,1967,605,1362
2021,Leicester 020B,E01013780,1515,288,1227
2021,Leicester 023E,E01013781,1638,463,1175
2021,Leicester 023F,E01013782,1407,261,1146
2021,Leicester 020C,E01013783,1427,253,1174
2021,Leicester 023G,E01013784,1287,382,905
2021,Leicester 020D,E01013785,1465,282,1183
2021,Leicester 020E,E01013786,1514,237,1277
2021,Rutland 005A,E01013787,1243,170,1073
2021,Rutland 001A,E01013788,3441,554,2887
2021,Rutland 001B,E01013789,1327,184,1143
2021,Rutland 001C,E01013790,2407,246,2161
2021,Rutland 004A,E01013791,1108,197,911
2021,Rutland 004B,E01013792,1616,268,1348
2021,Rutland 002A,E01013793,1363,200,1163
2021,Rutland 005B,E01013794,1304,179,1125
2021,Rutland 005C,E01013795,1103,119,984
2021,Rutland 001D,E01013796,1382,204,1178
2021,Rutland 004C,E01013797,1655,260,1395
2021,Rutland 003A,E01013798,1273,221,1052
2021,Rutland 003B,E01013799,1619,574,1045
2021,Rutland 002B,E01013800,1427,224,1203
2021,Rutland 003D,E01013803,2173,350,1823
2021,Rutland 004D,E01013804,1529,231,1298
2021,Rutland 004E,E01013805,1293,294,999
2021,Rutland 005D,E01013806,1784,844,940
2021,Rutland 005E,E01013807,1227,181,1046
2021,Rutland 005F,E01013808,1525,284,1241
2021,Rutland 002D,E01013809,1204,168,1036
2021,Nottingham 018A,E01013810,1791,551,1240
2021,Nottingham 018B,E01013811,1253,490,763
2021,Nottingham 018C,E01013812,1498,518,980
2021,Nottingham 022A,E01013813,2875,2224,651
2021,Nottingham 022B,E01013814,2198,1367,831
2021,Nottingham 022C,E01013815,2127,1565,562
2021,Nottingham 022D,E01013816,3958,3185,773
2021,Nottingham 011A,E01013817,1598,554,1044
2021,Nottingham 011B,E01013818,1596,583,1013
2021,Nottingham 013A,E01013819,1689,462,1227
2021,Nottingham 013B,E01013820,1607,505,1102
2021,Nottingham 013C,E01013821,1594,486,1108
2021,Nottingham 011C,E01013822,1754,615,1139
2021,Nottingham 013D,E01013823,1668,475,1193
2021,Nottingham 013E,E01013824,1560,509,1051
2021,Nottingham 011D,E01013825,1875,557,1318
2021,Nottingham 011E,E01013826,1753,611,1142
2021,Nottingham 008A,E01013827,1336,318,1018
2021,Nottingham 008B,E01013828,1696,315,1381
2021,Nottingham 009A,E01013829,1577,315,1262
2021,Nottingham 009B,E01013830,1521,320,1201
2021,Nottingham 009C,E01013831,1415,216,1199
2021,Nottingham 009D,E01013832,1765,538,1227
2021,Nottingham 009E,E01013833,1256,320,936
2021,Nottingham 008C,E01013834,1497,421,1076
2021,Nottingham 008D,E01013835,1516,378,1138
2021,Nottingham 008E,E01013836,1851,440,1411
2021,Nottingham 012A,E01013837,1942,586,1356
2021,Nottingham 012B,E01013838,1669,372,1297
2021,Nottingham 012C,E01013839,1888,451,1437
2021,Nottingham 012D,E01013840,2248,453,1795
2021,Nottingham 012E,E01013841,1514,376,1138
2021,Nottingham 018D,E01013842,1808,581,1227
2021,Nottingham 017A,E01013843,1998,472,1526
2021,Nottingham 017B,E01013844,1625,453,1172
2021,Nottingham 017C,E01013845,1740,488,1252
2021,Nottingham 018E,E01013846,1624,595,1029
2021,Nottingham 017D,E01013847,1482,400,1082
2021,Nottingham 038A,E01013849,1421,307,1114
2021,Nottingham 038B,E01013850,1335,245,1090
2021,Nottingham 038C,E01013851,1394,339,1055
2021,Nottingham 038D,E01013852,1611,378,1233
2021,Nottingham 006A,E01013853,1443,276,1167
2021,Nottingham 006B,E01013854,1360,302,1058
2021,Nottingham 006C,E01013855,1523,487,1036
2021,Nottingham 006D,E01013856,1517,383,1134
2021,Nottingham 025A,E01013858,1369,324,1045
2021,Nottingham 020A,E01013859,1420,223,1197
2021,Nottingham 025B,E01013860,1586,306,1280
2021,Nottingham 020B,E01013861,1504,341,1163
2021,Nottingham 025C,E01013862,1469,420,1049
2021,Nottingham 025D,E01013863,1412,307,1105
2021,Nottingham 014A,E01013864,1976,495,1481
2021,Nottingham 014B,E01013865,1486,342,1144
2021,Nottingham 014C,E01013866,1411,342,1069
2021,Nottingham 014D,E01013867,1509,432,1077
2021,Nottingham 020C,E01013868,1480,387,1093
2021,Nottingham 040A,E01013870,2188,587,1601
2021,Nottingham 040B,E01013871,1656,408,1248
2021,Nottingham 040C,E01013872,1916,612,1304
2021,Nottingham 040D,E01013873,1666,541,1125
2021,Nottingham 039A,E01013874,1594,346,1248
2021,Nottingham 005A,E01013875,1213,212,1001
2021,Nottingham 005B,E01013876,1577,333,1244
2021,Nottingham 005C,E01013877,1449,431,1018
2021,Nottingham 005D,E01013878,1276,358,918
2021,Nottingham 002A,E01013879,1200,272,928
2021,Nottingham 002B,E01013880,1439,335,1104
2021,Nottingham 002C,E01013881,1434,339,1095
2021,Nottingham 002D,E01013882,1379,262,1117
2021,Nottingham 005E,E01013883,1363,246,1117
2021,Nottingham 005F,E01013884,1259,232,1027
2021,Nottingham 002E,E01013885,1527,336,1191
2021,Nottingham 004A,E01013886,1347,301,1046
2021,Nottingham 001A,E01013887,1556,297,1259
2021,Nottingham 004B,E01013888,1518,258,1260
2021,Nottingham 004C,E01013889,1607,286,1321
2021,Nottingham 004D,E01013890,1408,280,1128
2021,Nottingham 004E,E01013891,1604,322,1282
2021,Nottingham 001B,E01013892,1321,165,1156
2021,Nottingham 001C,E01013893,1360,351,1009
2021,Nottingham 001D,E01013894,1437,237,1200
2021,Nottingham 034A,E01013895,1398,222,1176
2021,Nottingham 034B,E01013896,1219,264,955
2021,Nottingham 035A,E01013897,1429,304,1125
2021,Nottingham 035B,E01013898,2235,1523,712
2021,Nottingham 035C,E01013899,1228,274,954
2021,Nottingham 035D,E01013900,1437,314,1123
2021,Nottingham 034C,E01013901,1441,305,1136
2021,Nottingham 034D,E01013902,1787,296,1491
2021,Nottingham 035E,E01013903,1153,219,934
2021,Nottingham 037A,E01013904,1464,329,1135
2021,Nottingham 036A,E01013905,1387,319,1068
2021,Nottingham 037B,E01013906,1629,374,1255
2021,Nottingham 035F,E01013907,1436,287,1149
2021,Nottingham 036B,E01013908,1406,275,1131
2021,Nottingham 036C,E01013909,1392,248,1144
2021,Nottingham 037C,E01013910,1454,310,1144
2021,Nottingham 037D,E01013911,1461,300,1161
2021,Nottingham 036D,E01013912,1397,245,1152
2021,Nottingham 024A,E01013913,1662,341,1321
2021,Nottingham 024B,E01013914,1593,350,1243
2021,Nottingham 024C,E01013915,1445,257,1188
2021,Nottingham 024D,E01013916,1446,409,1037
2021,Nottingham 024E,E01013917,1830,460,1370
2021,Nottingham 029A,E01013918,1844,523,1321
2021,Nottingham 029B,E01013919,1863,429,1434
2021,Nottingham 029C,E01013920,2151,385,1766
2021,Nottingham 029D,E01013921,2041,680,1361
2021,Nottingham 031G,E01013928,1475,978,497
2021,Nottingham 020D,E01013929,1926,465,1461
2021,Nottingham 019A,E01013930,1820,547,1273
2021,Nottingham 019B,E01013931,2041,521,1520
2021,Nottingham 019C,E01013932,2334,583,1751
2021,Nottingham 019D,E01013933,1799,595,1204
2021,Nottingham 019E,E01013934,1484,321,1163
2021,Nottingham 010A,E01013935,1409,214,1195
2021,Nottingham 016A,E01013936,2000,267,1733
2021,Nottingham 015A,E01013937,1685,351,1334
2021,Nottingham 015B,E01013938,1567,401,1166
2021,Nottingham 016B,E01013939,1357,186,1171
2021,Nottingham 016C,E01013940,1802,450,1352
2021,Nottingham 015C,E01013941,1871,406,1465
2021,Nottingham 016D,E01013942,2013,543,1470
2021,Nottingham 015D,E01013943,1807,622,1185
2021,Nottingham 026A,E01013944,1675,476,1199
2021,Nottingham 026B,E01013945,2241,1375,866
2021,Nottingham 026D,E01013947,1902,923,979
2021,Nottingham 026E,E01013948,1292,402,890
2021,Nottingham 026F,E01013953,1931,1468,463
2021,Nottingham 021A,E01013954,1819,451,1368
2021,Nottingham 029E,E01013957,1519,405,1114
2021,Nottingham 023C,E01013958,1624,452,1172
2021,Nottingham 021B,E01013959,1722,433,1289
2021,Nottingham 021C,E01013960,1633,339,1294
2021,Nottingham 023D,E01013961,2374,1498,876
2021,Nottingham 021D,E01013962,1916,509,1407
2021,Nottingham 007A,E01013963,1440,348,1092
2021,Nottingham 007B,E01013964,1713,382,1331
2021,Nottingham 007C,E01013965,1405,296,1109
2021,Nottingham 007D,E01013966,1290,327,963
2021,Nottingham 007E,E01013967,1807,255,1552
2021,Nottingham 010B,E01013968,1310,195,1115
2021,Nottingham 010C,E01013969,1669,289,1380
2021,Nottingham 010D,E01013970,1471,288,1183
2021,Nottingham 010E,E01013971,1491,290,1201
2021,Nottingham 015E,E01013972,1448,244,1204
2021,Nottingham 041D,E01013977,1847,403,1444
2021,Nottingham 041A,E01013978,1691,472,1219
2021,Nottingham 041C,E01013979,1613,399,1214
2021,Nottingham 030A,E01013980,1609,342,1267
2021,Nottingham 041B,E01013981,1639,332,1307
2021,Nottingham 030B,E01013982,1638,378,1260
2021,Nottingham 030C,E01013983,1249,310,939
2021,Nottingham 030D,E01013984,1403,270,1133
2021,Nottingham 030E,E01013985,1624,336,1288
2021,Herefordshire 012A,E01013986,1535,266,1269
2021,Herefordshire 011A,E01013987,1545,236,1309
2021,Herefordshire 011B,E01013988,1773,197,1576
2021,Herefordshire 012B,E01013989,1450,354,1096
2021,Herefordshire 018A,E01013990,2009,333,1676
2021,Herefordshire 018B,E01013991,1274,222,1052
2021,Herefordshire 017A,E01013992,1457,332,1125
2021,Herefordshire 017B,E01013993,1475,333,1142
2021,Herefordshire 017C,E01013994,1316,254,1062
2021,Herefordshire 017D,E01013995,1690,414,1276
2021,Herefordshire 016A,E01013996,1450,223,1227
2021,Herefordshire 016B,E01013997,1762,278,1484
2021,Herefordshire 001A,E01013998,1377,167,1210
2021,Herefordshire 004A,E01013999,1525,253,1272
2021,Herefordshire 005A,E01014000,1269,133,1136
2021,Herefordshire 005B,E01014001,1571,196,1375
2021,Herefordshire 005C,E01014002,1367,176,1191
2021,Herefordshire 005D,E01014003,1502,280,1222
2021,Herefordshire 005E,E01014004,1398,183,1215
2021,Herefordshire 005F,E01014005,1621,227,1394
2021,Herefordshire 007A,E01014006,1497,230,1267
2021,Herefordshire 006A,E01014008,1554,227,1327
2021,Herefordshire 006B,E01014009,1491,193,1298
2021,Herefordshire 012C,E01014010,1750,195,1555
2021,Herefordshire 012D,E01014011,1408,276,1132
2021,Herefordshire 007B,E01014012,1604,226,1378
2021,Herefordshire 007C,E01014013,1864,394,1470
2021,Herefordshire 018C,E01014014,1787,274,1513
2021,Herefordshire 005G,E01014015,1562,227,1335
2021,Herefordshire 007D,E01014016,1483,212,1271
2021,Herefordshire 004B,E01014017,1421,220,1201
2021,Herefordshire 020A,E01014018,1462,236,1226
2021,Herefordshire 020B,E01014019,1467,246,1221
2021,Herefordshire 020C,E01014020,1535,262,1273
2021,Herefordshire 020D,E01014021,1363,213,1150
2021,Herefordshire 008A,E01014022,2221,410,1811
2021,Herefordshire 008B,E01014023,1860,319,1541
2021,Herefordshire 004C,E01014024,1236,159,1077
2021,Herefordshire 004D,E01014025,1453,214,1239
2021,Herefordshire 021A,E01014026,1970,283,1687
2021,Herefordshire 009A,E01014027,1384,187,1197
2021,Herefordshire 009B,E01014028,1451,177,1274
2021,Herefordshire 009C,E01014029,1434,207,1227
2021,Herefordshire 009D,E01014030,1359,179,1180
2021,Herefordshire 023A,E01014031,1540,239,1301
2021,Herefordshire 023B,E01014032,1457,193,1264
2021,Herefordshire 006C,E01014033,1694,211,1483
2021,Herefordshire 006D,E01014034,1369,207,1162
2021,Herefordshire 019A,E01014035,1646,255,1391
2021,Herefordshire 019B,E01014036,1621,195,1426
2021,Herefordshire 019C,E01014037,1391,154,1237
2021,Herefordshire 019D,E01014038,1326,207,1119
2021,Herefordshire 019E,E01014039,1585,305,1280
2021,Herefordshire 019F,E01014040,1510,225,1285
2021,Herefordshire 002A,E01014041,1408,175,1233
2021,Herefordshire 002B,E01014042,1485,332,1153
2021,Herefordshire 002C,E01014043,1002,112,890
2021,Herefordshire 002D,E01014044,1425,267,1158
2021,Herefordshire 003A,E01014045,1557,234,1323
2021,Herefordshire 003B,E01014046,1472,234,1238
2021,Herefordshire 003C,E01014047,1364,258,1106
2021,Herefordshire 003D,E01014048,1568,189,1379
2021,Herefordshire 023C,E01014049,1509,192,1317
2021,Herefordshire 023D,E01014050,1748,284,1464
2021,Herefordshire 001B,E01014051,1760,290,1470
2021,Herefordshire 001C,E01014052,1436,197,1239
2021,Herefordshire 023E,E01014053,1721,243,1478
2021,Herefordshire 018D,E01014054,1279,170,1109
2021,Herefordshire 004E,E01014055,1617,242,1375
2021,Herefordshire 006E,E01014056,1434,190,1244
2021,Herefordshire 023F,E01014057,1803,252,1551
2021,Herefordshire 023G,E01014058,1597,187,1410
2021,Herefordshire 021B,E01014059,1852,272,1580
2021,Herefordshire 021C,E01014060,1523,262,1261
2021,Herefordshire 022A,E01014061,1767,272,1495
2021,Herefordshire 022B,E01014062,1679,177,1502
2021,Herefordshire 022C,E01014063,1683,277,1406
2021,Herefordshire 022D,E01014064,1483,243,1240
2021,Herefordshire 022E,E01014065,1414,244,1170
2021,Herefordshire 022F,E01014066,1170,157,1013
2021,Herefordshire 022G,E01014067,1318,207,1111
2021,Herefordshire 015A,E01014068,1351,234,1117
2021,Herefordshire 021D,E01014069,1679,295,1384
2021,Herefordshire 015B,E01014070,2183,436,1747
2021,Herefordshire 017E,E01014071,1345,275,1070
2021,Herefordshire 015C,E01014072,1826,364,1462
2021,Herefordshire 015D,E01014073,1736,348,1388
2021,Herefordshire 015E,E01014074,1390,218,1172
2021,Herefordshire 013A,E01014075,1706,280,1426
2021,Herefordshire 013B,E01014076,2010,316,1694
2021,Herefordshire 013C,E01014077,1485,205,1280
2021,Herefordshire 013D,E01014078,1344,246,1098
2021,Herefordshire 016C,E01014079,1558,263,1295
2021,Herefordshire 016D,E01014080,1428,217,1211
2021,Herefordshire 008C,E01014081,1429,230,1199
2021,Herefordshire 008D,E01014082,1730,262,1468
2021,Herefordshire 010A,E01014083,1506,251,1255
2021,Herefordshire 010B,E01014084,1520,234,1286
2021,Herefordshire 010C,E01014085,1555,337,1218
2021,Herefordshire 012E,E01014086,1387,207,1180
2021,Herefordshire 010D,E01014087,1360,171,1189
2021,Herefordshire 010E,E01014088,1277,180,1097
2021,Herefordshire 010F,E01014089,1328,267,1061
2021,Herefordshire 014A,E01014090,1393,274,1119
2021,Herefordshire 014B,E01014091,1466,243,1223
2021,Herefordshire 012F,E01014092,1749,269,1480
2021,Herefordshire 014C,E01014093,1315,214,1101
2021,Herefordshire 014D,E01014094,1372,288,1084
2021,Herefordshire 011D,E01014095,1318,252,1066
2021,Herefordshire 001D,E01014096,1483,187,1296
2021,Herefordshire 004F,E01014097,1253,121,1132
2021,Herefordshire 021E,E01014098,1563,320,1243
2021,Herefordshire 021F,E01014099,1759,256,1503
2021,Herefordshire 007E,E01014100,1695,250,1445
2021,Herefordshire 007F,E01014101,985,159,826
2021,Telford and Wrekin 007A,E01014102,1843,332,1511
2021,Telford and Wrekin 007B,E01014103,1129,196,933
2021,Telford and Wrekin 011A,E01014104,1633,355,1278
2021,Telford and Wrekin 011B,E01014105,2174,617,1557
2021,Telford and Wrekin 020A,E01014106,1396,288,1108
2021,Telford and Wrekin 020B,E01014107,1101,179,922
2021,Telford and Wrekin 020C,E01014108,1354,328,1026
2021,Telford and Wrekin 020D,E01014109,1174,253,921
2021,Telford and Wrekin 020E,E01014110,1602,543,1059
2021,Telford and Wrekin 004A,E01014111,1516,248,1268
2021,Telford and Wrekin 002A,E01014112,1722,285,1437
2021,Telford and Wrekin 011C,E01014113,1684,344,1340
2021,Telford and Wrekin 011D,E01014114,1378,208,1170
2021,Telford and Wrekin 023A,E01014115,1402,338,1064
2021,Telford and Wrekin 023B,E01014116,1648,349,1299
2021,Telford and Wrekin 023C,E01014117,1145,156,989
2021,Telford and Wrekin 023D,E01014118,1296,395,901
2021,Telford and Wrekin 019A,E01014119,1476,248,1228
2021,Telford and Wrekin 019B,E01014120,1649,289,1360
2021,Telford and Wrekin 019C,E01014121,1246,151,1095
2021,Telford and Wrekin 019D,E01014122,1440,216,1224
2021,Telford and Wrekin 019E,E01014123,1351,222,1129
2021,Telford and Wrekin 017A,E01014124,1446,240,1206
2021,Telford and Wrekin 005A,E01014125,1366,306,1060
2021,Telford and Wrekin 005B,E01014126,1432,273,1159
2021,Telford and Wrekin 005C,E01014127,1620,381,1239
2021,Telford and Wrekin 005D,E01014128,2264,520,1744
2021,Telford and Wrekin 006A,E01014129,1050,168,882
2021,Telford and Wrekin 006B,E01014130,1415,225,1190
2021,Telford and Wrekin 002B,E01014131,2469,1025,1444
2021,Telford and Wrekin 002C,E01014132,1036,175,861
2021,Telford and Wrekin 012A,E01014133,2066,350,1716
2021,Telford and Wrekin 012B,E01014134,1504,178,1326
2021,Telford and Wrekin 002D,E01014135,1209,177,1032
2021,Telford and Wrekin 010A,E01014136,1739,205,1534
2021,Telford and Wrekin 009A,E01014137,1966,442,1524
2021,Telford and Wrekin 007C,E01014138,1571,323,1248
2021,Telford and Wrekin 009B,E01014139,1326,352,974
2021,Telford and Wrekin 007D,E01014140,1321,263,1058
2021,Telford and Wrekin 009D,E01014142,1265,320,945
2021,Telford and Wrekin 009E,E01014143,1553,296,1257
2021,Telford and Wrekin 012C,E01014144,1714,294,1420
2021,Telford and Wrekin 012D,E01014145,1884,333,1551
2021,Telford and Wrekin 010B,E01014148,1440,179,1261
2021,Telford and Wrekin 010C,E01014149,1088,158,930
2021,Telford and Wrekin 014A,E01014150,1528,216,1312
2021,Telford and Wrekin 014B,E01014151,1340,237,1103
2021,Telford and Wrekin 014C,E01014152,1796,350,1446
2021,Telford and Wrekin 014D,E01014153,1818,274,1544
2021,Telford and Wrekin 014E,E01014154,1623,317,1306
2021,Telford and Wrekin 014F,E01014155,1800,311,1489
2021,Telford and Wrekin 024C,E01014157,1334,281,1053
2021,Telford and Wrekin 024E,E01014158,1786,371,1415
2021,Telford and Wrekin 022A,E01014159,1197,170,1027
2021,Telford and Wrekin 022B,E01014160,1174,163,1011
2021,Telford and Wrekin 022C,E01014161,1017,137,880
2021,Telford and Wrekin 022D,E01014162,1727,262,1465
2021,Telford and Wrekin 017B,E01014163,1945,495,1450
2021,Telford and Wrekin 017C,E01014164,1575,370,1205
2021,Telford and Wrekin 017D,E01014165,1388,339,1049
2021,Telford and Wrekin 017E,E01014166,1438,252,1186
2021,Telford and Wrekin 004B,E01014167,2086,473,1613
2021,Telford and Wrekin 004C,E01014168,1299,236,1063
2021,Telford and Wrekin 005E,E01014169,1736,405,1331
2021,Telford and Wrekin 004D,E01014170,1422,201,1221
2021,Telford and Wrekin 001A,E01014171,1356,378,978
2021,Telford and Wrekin 001B,E01014172,1285,277,1008
2021,Telford and Wrekin 001C,E01014173,1654,400,1254
2021,Telford and Wrekin 001D,E01014174,1536,308,1228
2021,Telford and Wrekin 003A,E01014175,1497,322,1175
2021,Telford and Wrekin 003B,E01014176,1472,310,1162
2021,Telford and Wrekin 003C,E01014177,1977,478,1499
2021,Telford and Wrekin 003D,E01014178,1715,499,1216
2021,Telford and Wrekin 006C,E01014179,1132,169,963
2021,Telford and Wrekin 006D,E01014180,1267,191,1076
2021,Telford and Wrekin 015A,E01014181,2191,535,1656
2021,Telford and Wrekin 015B,E01014182,1370,280,1090
2021,Telford and Wrekin 015C,E01014183,1939,471,1468
2021,Telford and Wrekin 015D,E01014184,2077,462,1615
2021,Telford and Wrekin 013A,E01014185,1561,280,1281
2021,Telford and Wrekin 013B,E01014186,1311,203,1108
2021,Telford and Wrekin 013C,E01014187,1392,191,1201
2021,Telford and Wrekin 013D,E01014188,1304,191,1113
2021,Telford and Wrekin 006E,E01014189,1333,255,1078
2021,Telford and Wrekin 006F,E01014190,1456,259,1197
2021,Telford and Wrekin 018A,E01014191,1627,369,1258
2021,Telford and Wrekin 018B,E01014192,1437,301,1136
2021,Telford and Wrekin 018C,E01014193,1583,358,1225
2021,Telford and Wrekin 018D,E01014194,1507,349,1158
2021,Telford and Wrekin 018E,E01014195,1356,240,1116
2021,Telford and Wrekin 018F,E01014196,1440,291,1149
2021,Telford and Wrekin 021A,E01014197,1779,478,1301
2021,Telford and Wrekin 021B,E01014198,1324,372,952
2021,Telford and Wrekin 021C,E01014199,1529,414,1115
2021,Telford and Wrekin 021D,E01014200,1234,362,872
2021,Telford and Wrekin 021E,E01014201,1141,320,821
2021,Telford and Wrekin 010D,E01014202,2608,504,2104
2021,Telford and Wrekin 010E,E01014203,1544,244,1300
2021,Telford and Wrekin 010F,E01014204,1882,299,1583
2021,Telford and Wrekin 008A,E01014205,1265,166,1099
2021,Telford and Wrekin 008B,E01014206,1210,193,1017
2021,Telford and Wrekin 008C,E01014207,1223,224,999
2021,Telford and Wrekin 008D,E01014208,1281,224,1057
2021,Telford and Wrekin 008E,E01014209,1394,255,1139
2021,Stoke-on-Trent 012A,E01014210,1458,347,1111
2021,Stoke-on-Trent 012B,E01014211,1490,382,1108
2021,Stoke-on-Trent 012C,E01014212,1821,378,1443
2021,Stoke-on-Trent 012D,E01014213,1210,258,952
2021,Stoke-on-Trent 007A,E01014214,1433,225,1208
2021,Stoke-on-Trent 007B,E01014215,1419,296,1123
2021,Stoke-on-Trent 007C,E01014216,1301,187,1114
2021,Stoke-on-Trent 012E,E01014217,1344,341,1003
2021,Stoke-on-Trent 014A,E01014218,1543,409,1134
2021,Stoke-on-Trent 014B,E01014219,1218,189,1029
2021,Stoke-on-Trent 017A,E01014220,1595,427,1168
2021,Stoke-on-Trent 017B,E01014221,1525,395,1130
2021,Stoke-on-Trent 017C,E01014222,1435,396,1039
2021,Stoke-on-Trent 017D,E01014223,1640,406,1234
2021,Stoke-on-Trent 017E,E01014224,1592,425,1167
2021,Stoke-on-Trent 014C,E01014225,1424,213,1211
2021,Stoke-on-Trent 014D,E01014226,1377,214,1163
2021,Stoke-on-Trent 014E,E01014228,1172,159,1013
2021,Stoke-on-Trent 017F,E01014229,1886,497,1389
2021,Stoke-on-Trent 014F,E01014230,1458,263,1195
2021,Stoke-on-Trent 026A,E01014233,1340,209,1131
2021,Stoke-on-Trent 026B,E01014234,1471,442,1029
2021,Stoke-on-Trent 032A,E01014235,1549,312,1237
2021,Stoke-on-Trent 032C,E01014237,1552,392,1160
2021,Stoke-on-Trent 032D,E01014238,1512,433,1079
2021,Stoke-on-Trent 026C,E01014239,1405,248,1157
2021,Stoke-on-Trent 026D,E01014240,1439,310,1129
2021,Stoke-on-Trent 006A,E01014241,1492,314,1178
2021,Stoke-on-Trent 006B,E01014242,1460,352,1108
2021,Stoke-on-Trent 006C,E01014243,1363,222,1141
2021,Stoke-on-Trent 006D,E01014244,1548,468,1080
2021,Stoke-on-Trent 006E,E01014245,1568,321,1247
2021,Stoke-on-Trent 008A,E01014246,1517,324,1193
2021,Stoke-on-Trent 009A,E01014247,1494,275,1219
2021,Stoke-on-Trent 006F,E01014248,1267,255,1012
2021,Stoke-on-Trent 011A,E01014249,1638,389,1249
2021,Stoke-on-Trent 009B,E01014250,1190,279,911
2021,Stoke-on-Trent 009D,E01014252,1492,291,1201
2021,Stoke-on-Trent 011B,E01014253,1513,319,1194
2021,Stoke-on-Trent 011C,E01014254,1735,485,1250
2021,Stoke-on-Trent 009E,E01014255,1822,493,1329
2021,Stoke-on-Trent 011D,E01014256,1869,415,1454
2021,Stoke-on-Trent 001A,E01014257,1404,269,1135
2021,Stoke-on-Trent 001B,E01014258,1428,310,1118
2021,Stoke-on-Trent 001C,E01014259,1491,158,1333
2021,Stoke-on-Trent 001D,E01014260,1293,249,1044
2021,Stoke-on-Trent 003A,E01014261,1478,394,1084
2021,Stoke-on-Trent 003B,E01014262,1260,294,966
2021,Stoke-on-Trent 003C,E01014263,1557,380,1177
2021,Stoke-on-Trent 001E,E01014264,1847,372,1475
2021,Stoke-on-Trent 007D,E01014265,1416,210,1206
2021,Stoke-on-Trent 008B,E01014266,1168,242,926
2021,Stoke-on-Trent 007E,E01014267,2196,400,1796
2021,Stoke-on-Trent 008C,E01014268,2399,510,1889
2021,Stoke-on-Trent 010A,E01014269,1550,417,1133
2021,Stoke-on-Trent 008D,E01014270,1458,259,1199
2021,Stoke-on-Trent 008E,E01014271,1446,292,1154
2021,Stoke-on-Trent 007F,E01014272,1354,225,1129
2021,Stoke-on-Trent 035A,E01014273,1172,250,922
2021,Stoke-on-Trent 020A,E01014274,1643,351,1292
2021,Stoke-on-Trent 020B,E01014275,1342,261,1081
2021,Stoke-on-Trent 020C,E01014276,1418,293,1125
2021,Stoke-on-Trent 020D,E01014277,1363,212,1151
2021,Stoke-on-Trent 035C,E01014278,1134,195,939
2021,Stoke-on-Trent 020E,E01014279,1635,316,1319
2021,Stoke-on-Trent 035B,E01014280,1153,134,1019
2021,Stoke-on-Trent 015A,E01014281,1971,883,1088
2021,Stoke-on-Trent 016D,E01014282,1529,934,595
2021,Stoke-on-Trent 016E,E01014283,1892,907,985
2021,Stoke-on-Trent 016F,E01014284,1310,870,440
2021,Stoke-on-Trent 015B,E01014285,2199,576,1623
2021,Stoke-on-Trent 015C,E01014286,1582,440,1142
2021,Stoke-on-Trent 015D,E01014287,1984,497,1487
2021,Stoke-on-Trent 018A,E01014288,1463,307,1156
2021,Stoke-on-Trent 018B,E01014289,1452,260,1192
2021,Stoke-on-Trent 018C,E01014290,1383,246,1137
2021,Stoke-on-Trent 018D,E01014291,1918,524,1394
2021,Stoke-on-Trent 018E,E01014292,1419,283,1136
2021,Stoke-on-Trent 019A,E01014293,1487,375,1112
2021,Stoke-on-Trent 018F,E01014294,1319,282,1037
2021,Stoke-on-Trent 019B,E01014295,1579,263,1316
2021,Stoke-on-Trent 035H,E01014296,1294,220,1074
2021,Stoke-on-Trent 035D,E01014297,1092,168,924
2021,Stoke-on-Trent 035G,E01014298,1450,349,1101
2021,Stoke-on-Trent 025A,E01014299,1273,163,1110
2021,Stoke-on-Trent 035F,E01014300,1340,300,1040
2021,Stoke-on-Trent 025B,E01014301,1560,328,1232
2021,Stoke-on-Trent 035E,E01014302,1731,280,1451
2021,Stoke-on-Trent 025C,E01014303,1353,203,1150
2021,Stoke-on-Trent 025D,E01014304,1377,192,1185
2021,Stoke-on-Trent 029A,E01014305,1468,419,1049
2021,Stoke-on-Trent 029B,E01014306,1376,359,1017
2021,Stoke-on-Trent 029C,E01014307,1415,438,977
2021,Stoke-on-Trent 027A,E01014308,1492,173,1319
2021,Stoke-on-Trent 027B,E01014309,1178,223,955
2021,Stoke-on-Trent 031A,E01014310,2002,462,1540
2021,Stoke-on-Trent 027C,E01014311,1237,227,1010
2021,Stoke-on-Trent 029D,E01014312,1326,247,1079
2021,Stoke-on-Trent 027D,E01014313,1444,248,1196
2021,Stoke-on-Trent 031B,E01014314,1340,248,1092
2021,Stoke-on-Trent 033A,E01014315,1228,169,1059
2021,Stoke-on-Trent 031C,E01014316,1580,517,1063
2021,Stoke-on-Trent 031D,E01014317,1512,373,1139
2021,Stoke-on-Trent 033B,E01014318,1311,209,1102
2021,Stoke-on-Trent 033C,E01014319,1372,273,1099
2021,Stoke-on-Trent 033D,E01014320,1171,234,937
2021,Stoke-on-Trent 028A,E01014321,1271,185,1086
2021,Stoke-on-Trent 031E,E01014322,1604,424,1180
2021,Stoke-on-Trent 013A,E01014323,1222,195,1027
2021,Stoke-on-Trent 010B,E01014324,1366,171,1195
2021,Stoke-on-Trent 010C,E01014325,1232,181,1051
2021,Stoke-on-Trent 010D,E01014326,1318,166,1152
2021,Stoke-on-Trent 013B,E01014327,1333,224,1109
2021,Stoke-on-Trent 013C,E01014328,1394,305,1089
2021,Stoke-on-Trent 013D,E01014329,1476,253,1223
2021,Stoke-on-Trent 013E,E01014330,1246,243,1003
2021,Stoke-on-Trent 004A,E01014331,1473,363,1110
2021,Stoke-on-Trent 004B,E01014332,1540,218,1322
2021,Stoke-on-Trent 003D,E01014333,1335,183,1152
2021,Stoke-on-Trent 003E,E01014334,1297,129,1168
2021,Stoke-on-Trent 004C,E01014335,1640,287,1353
2021,Stoke-on-Trent 004D,E01014336,1544,381,1163
2021,Stoke-on-Trent 004E,E01014337,1592,317,1275
2021,Stoke-on-Trent 023A,E01014338,1348,235,1113
2021,Stoke-on-Trent 019C,E01014339,1760,328,1432
2021,Stoke-on-Trent 019D,E01014340,2019,454,1565
2021,Stoke-on-Trent 023B,E01014341,1699,414,1285
2021,Stoke-on-Trent 023C,E01014342,1461,384,1077
2021,Stoke-on-Trent 023D,E01014343,1682,294,1388
2021,Stoke-on-Trent 023E,E01014344,1478,392,1086
2021,Stoke-on-Trent 019E,E01014345,2024,666,1358
2021,Stoke-on-Trent 030A,E01014346,1472,177,1295
2021,Stoke-on-Trent 034A,E01014347,1291,214,1077
2021,Stoke-on-Trent 030B,E01014348,1380,236,1144
2021,Stoke-on-Trent 030C,E01014349,1321,174,1147
2021,Stoke-on-Trent 034B,E01014350,1273,202,1071
2021,Stoke-on-Trent 034C,E01014351,1392,191,1201
2021,Stoke-on-Trent 034D,E01014352,1300,218,1082
2021,Stoke-on-Trent 030D,E01014353,1585,406,1179
2021,Stoke-on-Trent 005A,E01014354,1648,368,1280
2021,Stoke-on-Trent 005B,E01014355,1878,455,1423
2021,Stoke-on-Trent 005C,E01014356,1691,394,1297
2021,Stoke-on-Trent 002A,E01014357,1458,227,1231
2021,Stoke-on-Trent 002B,E01014358,1251,318,933
2021,Stoke-on-Trent 002C,E01014359,1748,366,1382
2021,Stoke-on-Trent 002D,E01014360,2594,603,1991
2021,Stoke-on-Trent 005D,E01014361,1608,407,1201
2021,Stoke-on-Trent 025E,E01014362,1227,164,1063
2021,Stoke-on-Trent 024A,E01014363,1262,153,1109
2021,Stoke-on-Trent 024B,E01014364,1458,286,1172
2021,Stoke-on-Trent 024C,E01014365,1410,207,1203
2021,Stoke-on-Trent 028B,E01014366,1743,468,1275
2021,Stoke-on-Trent 028C,E01014367,1658,431,1227
2021,Stoke-on-Trent 028D,E01014368,1640,378,1262
2021,Stoke-on-Trent 024D,E01014369,1692,355,1337
2021,Bath and North East Somerset 007A,E01014370,1788,442,1346
2021,Bath and North East Somerset 007B,E01014371,1923,538,1385
2021,Bath and North East Somerset 007C,E01014372,1839,383,1456
2021,Bath and North East Somerset 010A,E01014373,1523,343,1180
2021,Bath and North East Somerset 010B,E01014374,1490,305,1185
2021,Bath and North East Somerset 010C,E01014375,1244,209,1035
2021,Bath and North East Somerset 010D,E01014376,1530,269,1261
2021,Bath and North East Somerset 010E,E01014377,1420,284,1136
2021,Bath and North East Somerset 012A,E01014380,4163,3062,1101
2021,Bath and North East Somerset 012B,E01014381,1452,347,1105
2021,Bath and North East Somerset 021A,E01014382,2399,448,1951
2021,Bath and North East Somerset 021B,E01014383,1087,192,895
2021,Bath and North East Somerset 021C,E01014384,1543,350,1193
2021,Bath and North East Somerset 020A,E01014385,1391,230,1161
2021,Bath and North East Somerset 020B,E01014386,1140,230,910
2021,Bath and North East Somerset 018A,E01014387,1569,430,1139
2021,Bath and North East Somerset 018B,E01014388,1251,289,962
2021,Bath and North East Somerset 018C,E01014389,1830,477,1353
2021,Bath and North East Somerset 018D,E01014390,1285,325,960
2021,Bath and North East Somerset 016A,E01014391,1611,254,1357
2021,Bath and North East Somerset 016B,E01014392,1072,155,917
2021,Bath and North East Somerset 023A,E01014393,1286,236,1050
2021,Bath and North East Somerset 023B,E01014394,1657,279,1378
2021,Bath and North East Somerset 003A,E01014395,1229,175,1054
2021,Bath and North East Somerset 003B,E01014396,1451,240,1211
2021,Bath and North East Somerset 003C,E01014397,1250,215,1035
2021,Bath and North East Somerset 003D,E01014398,1575,290,1285
2021,Bath and North East Somerset 001A,E01014399,2301,394,1907
2021,Bath and North East Somerset 001B,E01014400,2463,423,2040
2021,Bath and North East Somerset 001C,E01014401,1605,318,1287
2021,Bath and North East Somerset 002B,E01014403,1709,188,1521
2021,Bath and North East Somerset 002C,E01014404,1934,389,1545
2021,Bath and North East Somerset 009A,E01014405,2036,605,1431
2021,Bath and North East Somerset 009C,E01014407,1642,879,763
2021,Bath and North East Somerset 004A,E01014409,1535,299,1236
2021,Bath and North East Somerset 004B,E01014410,1701,365,1336
2021,Bath and North East Somerset 004C,E01014411,2082,397,1685
2021,Bath and North East Somerset 007D,E01014412,1293,296,997
2021,Bath and North East Somerset 007E,E01014413,2373,705,1668
2021,Bath and North East Somerset 007F,E01014414,1482,329,1153
2021,Bath and North East Somerset 017A,E01014415,1875,475,1400
2021,Bath and North East Somerset 017B,E01014416,1697,379,1318
2021,Bath and North East Somerset 017C,E01014417,1770,386,1384
2021,Bath and North East Somerset 021D,E01014418,1408,234,1174
2021,Bath and North East Somerset 020C,E01014419,1431,252,1179
2021,Bath and North East Somerset 025A,E01014420,1406,227,1179
2021,Bath and North East Somerset 025B,E01014421,1441,264,1177
2021,Bath and North East Somerset 025C,E01014422,1610,251,1359
2021,Bath and North East Somerset 025D,E01014423,1430,254,1176
2021,Bath and North East Somerset 027A,E01014424,2053,384,1669
2021,Bath and North East Somerset 027B,E01014425,2242,425,1817
2021,Bath and North East Somerset 027C,E01014426,1377,225,1152
2021,Bath and North East Somerset 008A,E01014427,1208,329,879
2021,Bath and North East Somerset 008B,E01014428,1282,342,940
2021,Bath and North East Somerset 008C,E01014429,1489,401,1088
2021,Bath and North East Somerset 008D,E01014430,1517,262,1255
2021,Bath and North East Somerset 019A,E01014431,1153,250,903
2021,Bath and North East Somerset 019B,E01014432,1318,368,950
2021,Bath and North East Somerset 019C,E01014433,1265,267,998
2021,Bath and North East Somerset 019D,E01014434,1840,465,1375
2021,Bath and North East Somerset 014A,E01014435,1660,1116,544
2021,Bath and North East Somerset 014B,E01014436,1529,664,865
2021,Bath and North East Somerset 014C,E01014437,1359,346,1013
2021,Bath and North East Somerset 014D,E01014438,1199,306,893
2021,Bath and North East Somerset 023C,E01014439,1731,288,1443
2021,Bath and North East Somerset 023D,E01014440,2391,486,1905
2021,Bath and North East Somerset 023E,E01014441,1950,356,1594
2021,Bath and North East Somerset 022B,E01014442,1581,266,1315
2021,Bath and North East Somerset 022C,E01014443,1546,265,1281
2021,Bath and North East Somerset 022D,E01014444,1593,342,1251
2021,Bath and North East Somerset 022E,E01014445,1615,346,1269
2021,Bath and North East Somerset 020D,E01014446,1151,181,970
2021,Bath and North East Somerset 020E,E01014447,1863,344,1519
2021,Bath and North East Somerset 024A,E01014448,1371,246,1125
2021,Bath and North East Somerset 024B,E01014449,1383,281,1102
2021,Bath and North East Somerset 024C,E01014450,1355,305,1050
2021,Bath and North East Somerset 024D,E01014451,1624,321,1303
2021,Bath and North East Somerset 016C,E01014452,1365,191,1174
2021,Bath and North East Somerset 016D,E01014453,1310,265,1045
2021,Bath and North East Somerset 016E,E01014454,1313,263,1050
2021,Bath and North East Somerset 015A,E01014455,1275,292,983
2021,Bath and North East Somerset 015B,E01014456,1435,293,1142
2021,Bath and North East Somerset 015C,E01014457,1354,264,1090
2021,Bath and North East Somerset 015D,E01014458,1292,376,916
2021,Bath and North East Somerset 016F,E01014459,1438,257,1181
2021,Bath and North East Somerset 016G,E01014460,1081,144,937
2021,Bath and North East Somerset 011A,E01014461,1117,274,843
2021,Bath and North East Somerset 011B,E01014462,1383,378,1005
2021,Bath and North East Somerset 011C,E01014463,1523,291,1232
2021,Bath and North East Somerset 011D,E01014464,1377,392,985
2021,Bath and North East Somerset 006A,E01014465,1454,285,1169
2021,Bath and North East Somerset 006B,E01014466,1227,273,954
2021,Bath and North East Somerset 006C,E01014467,1493,276,1217
2021,Bath and North East Somerset 006D,E01014468,1425,332,1093
2021,Bath and North East Somerset 026A,E01014469,1314,296,1018
2021,Bath and North East Somerset 026B,E01014470,1602,277,1325
2021,Bath and North East Somerset 026C,E01014471,1493,276,1217
2021,Bath and North East Somerset 026D,E01014472,1778,362,1416
2021,Bath and North East Somerset 013A,E01014473,1727,892,835
2021,Bath and North East Somerset 013B,E01014474,1230,445,785
2021,Bath and North East Somerset 013D,E01014476,1472,716,756
2021,Bath and North East Somerset 005A,E01014477,1404,286,1118
2021,Bath and North East Somerset 005B,E01014478,1132,279,853
2021,Bath and North East Somerset 005C,E01014479,1363,259,1104
2021,Bath and North East Somerset 005D,E01014480,1390,296,1094
2021,Bath and North East Somerset 012C,E01014481,1342,539,803
2021,Bath and North East Somerset 012D,E01014482,1260,358,902
2021,Bath and North East Somerset 012E,E01014483,1427,507,920
2021,Bath and North East Somerset 012F,E01014484,1850,1017,833
2021,Bristol 058A,E01014485,1843,298,1545
2021,Bristol 058C,E01014486,2569,592,1977
2021,Bristol 020A,E01014487,1913,632,1281
2021,Bristol 058B,E01014488,1925,358,1567
2021,Bristol 059A,E01014489,2473,561,1912
2021,Bristol 020B,E01014491,1973,506,1467
2021,Bristol 008A,E01014492,1561,267,1294
2021,Bristol 008B,E01014493,1500,306,1194
2021,Bristol 008C,E01014494,1488,223,1265
2021,Bristol 008D,E01014495,1656,293,1363
2021,Bristol 008E,E01014496,1849,291,1558
2021,Bristol 003A,E01014497,1608,369,1239
2021,Bristol 003B,E01014498,1539,394,1145
2021,Bristol 008F,E01014499,1591,332,1259
2021,Bristol 039A,E01014500,1760,207,1553
2021,Bristol 041A,E01014501,2020,360,1660
2021,Bristol 039B,E01014502,1928,285,1643
2021,Bristol 041B,E01014504,1515,228,1287
2021,Bristol 041C,E01014505,1708,214,1494
2021,Bristol 041D,E01014506,1538,285,1253
2021,Bristol 016A,E01014507,1762,557,1205
2021,Bristol 016B,E01014508,1589,449,1140
2021,Bristol 016C,E01014509,2440,663,1777
2021,Bristol 010A,E01014510,1980,590,1390
2021,Bristol 016D,E01014511,1343,389,954
2021,Bristol 016E,E01014512,1448,335,1113
2021,Bristol 016F,E01014513,1564,408,1156
2021,Bristol 016G,E01014514,2283,562,1721
2021,Bristol 050A,E01014515,1468,285,1183
2021,Bristol 050B,E01014516,1367,337,1030
2021,Bristol 050C,E01014517,1246,313,933
2021,Bristol 046A,E01014518,1675,288,1387
2021,Bristol 046B,E01014519,1305,239,1066
2021,Bristol 046C,E01014520,1566,237,1329
2021,Bristol 046D,E01014521,1304,241,1063
2021,Bristol 050D,E01014522,1737,411,1326
2021,Bristol 038A,E01014523,1557,241,1316
2021,Bristol 038B,E01014524,1496,273,1223
2021,Bristol 038C,E01014525,1547,269,1278
2021,Bristol 038D,E01014526,1481,318,1163
2021,Bristol 038E,E01014527,1305,173,1132
2021,Bristol 035A,E01014528,1463,204,1259
2021,Bristol 035B,E01014529,1380,311,1069
2021,Bristol 035C,E01014530,1384,224,1160
2021,Bristol 035D,E01014531,1996,251,1745
2021,Bristol 035E,E01014532,1385,230,1155
2021,Bristol 043A,E01014533,1510,278,1232
2021,Bristol 043B,E01014534,1555,241,1314
2021,Bristol 043C,E01014535,1888,371,1517
2021,Bristol 043D,E01014536,1530,241,1289
2021,Bristol 035F,E01014537,1721,338,1383
2021,Bristol 060A,E01014538,1782,1056,726
2021,Bristol 025A,E01014539,1820,649,1171
2021,Bristol 030A,E01014544,1101,204,897
2021,Bristol 030B,E01014545,1836,688,1148
2021,Bristol 030C,E01014546,1504,465,1039
2021,Bristol 030D,E01014547,1613,276,1337
2021,Bristol 034A,E01014548,1604,412,1192
2021,Bristol 034B,E01014549,1138,344,794
2021,Bristol 034C,E01014550,2167,768,1399
2021,Bristol 026A,E01014551,1779,662,1117
2021,Bristol 026B,E01014552,1810,640,1170
2021,Bristol 026C,E01014553,1865,799,1066
2021,Bristol 026D,E01014554,1748,544,1204
2021,Bristol 034D,E01014555,1861,1007,854
2021,Bristol 026E,E01014556,1720,429,1291
2021,Bristol 022A,E01014557,1644,721,923
2021,Bristol 022B,E01014558,1789,839,950
2021,Bristol 022C,E01014559,1872,621,1251
2021,Bristol 022D,E01014560,1616,503,1113
2021,Bristol 025C,E01014561,1624,379,1245
2021,Bristol 022E,E01014562,1662,810,852
2021,Bristol 025D,E01014563,1750,572,1178
2021,Bristol 055A,E01014564,1787,356,1431
2021,Bristol 029A,E01014565,1667,222,1445
2021,Bristol 029B,E01014566,1588,192,1396
2021,Bristol 029C,E01014567,1816,251,1565
2021,Bristol 057A,E01014568,2410,471,1939
2021,Bristol 057B,E01014569,2112,420,1692
2021,Bristol 057C,E01014570,1827,372,1455
2021,Bristol 012A,E01014571,1645,567,1078
2021,Bristol 019A,E01014572,1949,475,1474
2021,Bristol 019B,E01014573,1908,458,1450
2021,Bristol 057D,E01014574,2153,447,1706
2021,Bristol 019C,E01014575,1513,316,1197
2021,Bristol 019D,E01014576,2098,405,1693
2021,Bristol 012B,E01014577,1566,322,1244
2021,Bristol 044A,E01014578,1733,419,1314
2021,Bristol 045A,E01014579,1455,314,1141
2021,Bristol 045B,E01014580,1473,275,1198
2021,Bristol 045C,E01014581,1520,404,1116
2021,Bristol 045D,E01014582,1336,341,995
2021,Bristol 044B,E01014583,1682,404,1278
2021,Bristol 045E,E01014584,1421,372,1049
2021,Bristol 044C,E01014585,1874,593,1281
2021,Bristol 012C,E01014586,1478,253,1225
2021,Bristol 012D,E01014587,1680,594,1086
2021,Bristol 013A,E01014588,2224,478,1746
2021,Bristol 013B,E01014589,1520,431,1089
2021,Bristol 013C,E01014590,2226,587,1639
2021,Bristol 013D,E01014591,1848,360,1488
2021,Bristol 013E,E01014592,1639,407,1232
2021,Bristol 051A,E01014593,1420,417,1003
2021,Bristol 048A,E01014594,1542,432,1110
2021,Bristol 051B,E01014595,1307,207,1100
2021,Bristol 051C,E01014596,1538,325,1213
2021,Bristol 051D,E01014597,1283,267,1016
2021,Bristol 048B,E01014598,2095,276,1819
2021,Bristol 048C,E01014599,1240,238,1002
2021,Bristol 048D,E01014600,1422,232,1190
2021,Bristol 001A,E01014601,1755,385,1370
2021,Bristol 001B,E01014602,1793,389,1404
2021,Bristol 001C,E01014603,2431,475,1956
2021,Bristol 001E,E01014605,1699,335,1364
2021,Bristol 047A,E01014607,1555,313,1242
2021,Bristol 047B,E01014608,1689,360,1329
2021,Bristol 047C,E01014609,1743,341,1402
2021,Bristol 047D,E01014610,1462,282,1180
2021,Bristol 052A,E01014611,1314,196,1118
2021,Bristol 052B,E01014612,1428,271,1157
2021,Bristol 047E,E01014613,1478,242,1236
2021,Bristol 047F,E01014614,1327,226,1101
2021,Bristol 011A,E01014615,1490,341,1149
2021,Bristol 006A,E01014616,1487,309,1178
2021,Bristol 011B,E01014617,1328,291,1037
2021,Bristol 011C,E01014618,1529,322,1207
2021,Bristol 017A,E01014619,1395,279,1116
2021,Bristol 011D,E01014620,1526,344,1182
2021,Bristol 017B,E01014621,1477,386,1091
2021,Bristol 021A,E01014622,1636,351,1285
2021,Bristol 021B,E01014623,1669,385,1284
2021,Bristol 018A,E01014624,1633,365,1268
2021,Bristol 021C,E01014626,2526,603,1923
2021,Bristol 021D,E01014627,2058,379,1679
2021,Bristol 018D,E01014629,1488,363,1125
2021,Bristol 005A,E01014630,2102,606,1496
2021,Bristol 004A,E01014631,1167,204,963
2021,Bristol 004B,E01014632,2075,476,1599
2021,Bristol 004C,E01014633,1744,352,1392
2021,Bristol 005B,E01014634,1766,536,1230
2021,Bristol 010B,E01014635,1875,508,1367
2021,Bristol 004D,E01014636,1446,323,1123
2021,Bristol 010C,E01014637,1583,546,1037
2021,Bristol 003C,E01014638,1683,333,1350
2021,Bristol 003D,E01014639,1433,420,1013
2021,Bristol 003E,E01014640,1543,417,1126
2021,Bristol 007A,E01014641,1437,251,1186
2021,Bristol 007B,E01014642,1426,283,1143
2021,Bristol 007C,E01014643,1383,319,1064
2021,Bristol 007D,E01014644,1584,325,1259
2021,Bristol 042A,E01014645,1566,236,1330
2021,Bristol 042B,E01014646,1669,333,1336
2021,Bristol 044D,E01014647,1684,440,1244
2021,Bristol 042C,E01014648,1578,309,1269
2021,Bristol 042D,E01014649,1664,324,1340
2021,Bristol 044E,E01014650,1607,337,1270
2021,Bristol 042E,E01014651,1648,323,1325
2021,Bristol 055B,E01014653,2524,764,1760
2021,Bristol 056A,E01014654,2356,660,1696
2021,Bristol 055C,E01014655,2431,609,1822
2021,Bristol 056B,E01014658,2209,834,1375
2021,Bristol 005C,E01014659,2093,629,1464
2021,Bristol 014A,E01014660,2081,474,1607
2021,Bristol 005D,E01014661,1681,458,1223
2021,Bristol 010D,E01014662,1603,464,1139
2021,Bristol 014B,E01014663,1494,416,1078
2021,Bristol 014C,E01014664,1632,404,1228
2021,Bristol 014D,E01014665,2086,519,1567
2021,Bristol 017C,E01014666,1851,554,1297
2021,Bristol 017D,E01014667,1645,482,1163
2021,Bristol 020C,E01014668,1543,415,1128
2021,Bristol 020D,E01014669,1531,458,1073
2021,Bristol 020E,E01014670,1477,402,1075
2021,Bristol 020F,E01014671,1658,535,1123
2021,Bristol 017E,E01014672,2051,449,1602
2021,Bristol 027A,E01014673,1751,284,1467
2021,Bristol 027B,E01014674,1578,285,1293
2021,Bristol 027C,E01014675,1649,268,1381
2021,Bristol 027D,E01014676,1476,265,1211
2021,Bristol 033A,E01014677,1459,191,1268
2021,Bristol 033B,E01014678,1597,282,1315
2021,Bristol 033C,E01014679,1516,248,1268
2021,Bristol 033D,E01014680,1226,207,1019
2021,Bristol 029D,E01014681,2367,347,2020
2021,Bristol 028A,E01014682,1635,287,1348
2021,Bristol 028B,E01014683,1782,286,1496
2021,Bristol 029E,E01014684,1818,223,1595
2021,Bristol 028C,E01014685,1589,392,1197
2021,Bristol 028D,E01014686,1800,370,1430
2021,Bristol 028E,E01014687,1499,214,1285
2021,Bristol 002A,E01014688,1768,467,1301
2021,Bristol 002B,E01014689,1565,409,1156
2021,Bristol 002C,E01014690,2127,533,1594
2021,Bristol 002D,E01014691,1927,369,1558
2021,Bristol 002E,E01014692,1668,438,1230
2021,Bristol 002F,E01014693,1326,200,1126
2021,Bristol 002G,E01014694,1634,369,1265
2021,Bristol 036A,E01014695,1994,332,1662
2021,Bristol 036B,E01014696,1753,384,1369
2021,Bristol 036C,E01014698,1858,297,1561
2021,Bristol 036D,E01014699,1561,254,1307
2021,Bristol 036E,E01014700,1578,259,1319
2021,Bristol 036F,E01014701,1787,322,1465
2021,Bristol 049A,E01014702,1410,236,1174
2021,Bristol 049B,E01014703,1386,228,1158
2021,Bristol 049C,E01014704,1752,327,1425
2021,Bristol 049D,E01014705,1303,189,1114
2021,Bristol 049E,E01014706,1293,217,1076
2021,Bristol 049F,E01014707,1546,259,1287
2021,Bristol 049G,E01014708,1805,314,1491
2021,Bristol 015A,E01014709,1237,212,1025
2021,Bristol 015B,E01014710,1542,593,949
2021,Bristol 015C,E01014711,1262,263,999
2021,Bristol 015D,E01014712,1223,259,964
2021,Bristol 015E,E01014713,1259,193,1066
2021,Bristol 015F,E01014714,3395,2309,1086
2021,Bristol 009A,E01014715,1598,409,1189
2021,Bristol 009B,E01014716,1486,323,1163
2021,Bristol 009C,E01014717,1633,410,1223
2021,Bristol 009D,E01014718,1460,260,1200
2021,Bristol 006B,E01014719,1368,262,1106
2021,Bristol 006C,E01014720,1545,283,1262
2021,Bristol 006D,E01014721,1579,289,1290
2021,Bristol 052C,E01014722,1452,235,1217
2021,Bristol 052D,E01014723,1296,208,1088
2021,Bristol 052E,E01014725,1395,182,1213
2021,Bristol 053B,E01014726,1602,414,1188
2021,Bristol 053C,E01014727,1451,382,1069
2021,Bristol 040A,E01014729,1730,389,1341
2021,Bristol 037A,E01014730,1606,203,1403
2021,Bristol 037B,E01014731,1527,183,1344
2021,Bristol 037C,E01014732,1635,288,1347
2021,Bristol 040B,E01014733,1685,278,1407
2021,Bristol 040C,E01014734,1562,316,1246
2021,Bristol 037D,E01014735,1685,286,1399
2021,Bristol 040D,E01014736,2065,436,1629
2021,North Somerset 011A,E01014737,1551,346,1205
2021,North Somerset 011B,E01014738,1432,343,1089
2021,North Somerset 011C,E01014739,1521,280,1241
2021,North Somerset 011D,E01014740,1412,301,1111
2021,North Somerset 024A,E01014741,1453,228,1225
2021,North Somerset 024B,E01014742,1455,248,1207
2021,North Somerset 023A,E01014744,1417,185,1232
2021,North Somerset 024C,E01014745,1661,256,1405
2021,North Somerset 023B,E01014746,1503,280,1223
2021,North Somerset 024D,E01014747,1386,263,1123
2021,North Somerset 024E,E01014748,1324,333,991
2021,North Somerset 024F,E01014749,1376,305,1071
2021,North Somerset 007A,E01014750,1630,263,1367
2021,North Somerset 007B,E01014751,1502,250,1252
2021,North Somerset 005A,E01014752,1532,279,1253
2021,North Somerset 007C,E01014753,1794,326,1468
2021,North Somerset 005B,E01014754,1286,136,1150
2021,North Somerset 007D,E01014755,1336,133,1203
2021,North Somerset 010A,E01014756,1458,202,1256
2021,North Somerset 010B,E01014757,1335,230,1105
2021,North Somerset 005C,E01014758,1242,181,1061
2021,North Somerset 005D,E01014759,1403,233,1170
2021,North Somerset 007E,E01014760,1407,277,1130
2021,North Somerset 010C,E01014761,1464,204,1260
2021,North Somerset 010D,E01014762,1400,237,1163
2021,North Somerset 010E,E01014763,1647,307,1340
2021,North Somerset 014A,E01014764,1750,350,1400
2021,North Somerset 014B,E01014765,1823,359,1464
2021,North Somerset 004A,E01014766,1370,267,1103
2021,North Somerset 004B,E01014767,1312,202,1110
2021,North Somerset 023D,E01014770,1307,146,1161
2021,North Somerset 023E,E01014771,1337,173,1164
2021,North Somerset 023F,E01014772,1386,165,1221
2021,North Somerset 014C,E01014773,1687,390,1297
2021,North Somerset 014D,E01014774,1804,236,1568
2021,North Somerset 009A,E01014775,1158,201,957
2021,North Somerset 009B,E01014776,1169,208,961
2021,North Somerset 009C,E01014777,1419,286,1133
2021,North Somerset 009D,E01014778,1236,195,1041
2021,North Somerset 009E,E01014779,1072,141,931
2021,North Somerset 008A,E01014780,1551,250,1301
2021,North Somerset 008B,E01014781,1662,244,1418
2021,North Somerset 008C,E01014782,1288,185,1103
2021,North Somerset 008D,E01014783,1485,246,1239
2021,North Somerset 008E,E01014784,1560,256,1304
2021,North Somerset 008F,E01014785,1325,182,1143
2021,North Somerset 004C,E01014786,1583,267,1316
2021,North Somerset 004D,E01014787,1815,324,1491
2021,North Somerset 002A,E01014789,1330,173,1157
2021,North Somerset 001B,E01014790,1507,313,1194
2021,North Somerset 003B,E01014792,1737,272,1465
2021,North Somerset 002B,E01014793,1440,208,1232
2021,North Somerset 002C,E01014794,1702,279,1423
2021,North Somerset 001C,E01014795,1385,232,1153
2021,North Somerset 003C,E01014796,1717,286,1431
2021,North Somerset 001D,E01014797,1726,338,1388
2021,North Somerset 002D,E01014798,1415,294,1121
2021,North Somerset 020A,E01014799,1643,232,1411
2021,North Somerset 020B,E01014800,1683,293,1390
2021,North Somerset 020C,E01014801,1581,142,1439
2021,North Somerset 020D,E01014802,1586,181,1405
2021,North Somerset 025A,E01014803,1429,253,1176
2021,North Somerset 022A,E01014804,1411,166,1245
2021,North Somerset 025B,E01014805,1566,167,1399
2021,North Somerset 022B,E01014806,1619,196,1423
2021,North Somerset 022C,E01014807,1531,219,1312
2021,North Somerset 022D,E01014808,1337,219,1118
2021,North Somerset 020E,E01014809,1882,364,1518
2021,North Somerset 020F,E01014811,1685,302,1383
2021,North Somerset 017A,E01014812,1356,182,1174
2021,North Somerset 017B,E01014813,1730,310,1420
2021,North Somerset 017C,E01014815,1297,275,1022
2021,North Somerset 017D,E01014816,1438,218,1220
2021,North Somerset 016A,E01014817,1508,206,1302
2021,North Somerset 017E,E01014818,1687,243,1444
2021,North Somerset 017F,E01014819,1507,212,1295
2021,North Somerset 016B,E01014820,1421,202,1219
2021,North Somerset 015A,E01014821,1066,192,874
2021,North Somerset 015B,E01014822,1341,282,1059
2021,North Somerset 015C,E01014823,1199,242,957
2021,North Somerset 015D,E01014824,1372,210,1162
2021,North Somerset 015E,E01014825,1160,214,946
2021,North Somerset 015F,E01014826,1400,269,1131
2021,North Somerset 015G,E01014827,1274,270,1004
2021,North Somerset 025C,E01014828,1377,317,1060
2021,North Somerset 021A,E01014829,1848,417,1431
2021,North Somerset 021B,E01014830,1404,247,1157
2021,North Somerset 021C,E01014831,1224,289,935
2021,North Somerset 021D,E01014832,1414,305,1109
2021,North Somerset 021E,E01014833,1373,306,1067
2021,North Somerset 025D,E01014834,1286,262,1024
2021,North Somerset 016C,E01014835,1357,232,1125
2021,North Somerset 016D,E01014836,1377,244,1133
2021,North Somerset 016E,E01014838,1343,235,1108
2021,North Somerset 026A,E01014839,1502,301,1201
2021,North Somerset 016F,E01014840,1322,237,1085
2021,North Somerset 018A,E01014841,1702,130,1572
2021,North Somerset 018B,E01014842,1529,149,1380
2021,North Somerset 018C,E01014843,1419,128,1291
2021,North Somerset 018D,E01014844,1403,178,1225
2021,North Somerset 018E,E01014845,1257,136,1121
2021,North Somerset 018F,E01014846,1413,199,1214
2021,North Somerset 013A,E01014847,1729,306,1423
2021,North Somerset 013B,E01014848,1342,215,1127
2021,North Somerset 006B,E01014849,1705,265,1440
2021,North Somerset 006C,E01014850,2047,431,1616
2021,North Somerset 006D,E01014851,2492,574,1918
2021,North Somerset 006E,E01014852,1595,307,1288
2021,North Somerset 013C,E01014853,1634,331,1303
2021,North Somerset 013D,E01014854,1361,231,1130
2021,North Somerset 012A,E01014855,1400,222,1178
2021,North Somerset 012B,E01014856,2056,404,1652
2021,North Somerset 012C,E01014857,1433,291,1142
2021,North Somerset 012D,E01014858,1642,266,1376
2021,North Somerset 012E,E01014859,1442,249,1193
2021,North Somerset 012F,E01014860,1433,275,1158
2021,South Gloucestershire 005A,E01014861,2203,367,1836
2021,South Gloucestershire 005B,E01014862,2799,562,2237
2021,South Gloucestershire 004A,E01014863,1459,238,1221
2021,South Gloucestershire 004B,E01014864,1464,216,1248
2021,South Gloucestershire 024A,E01014865,2041,368,1673
2021,South Gloucestershire 032A,E01014866,1467,211,1256
2021,South Gloucestershire 019A,E01014867,1568,162,1406
2021,South Gloucestershire 024B,E01014869,1523,271,1252
2021,South Gloucestershire 024C,E01014870,1544,252,1292
2021,South Gloucestershire 024D,E01014871,1178,185,993
2021,South Gloucestershire 009A,E01014872,1461,267,1194
2021,South Gloucestershire 012A,E01014873,1334,233,1101
2021,South Gloucestershire 009B,E01014874,1368,266,1102
2021,South Gloucestershire 012B,E01014875,1657,303,1354
2021,South Gloucestershire 009C,E01014876,1616,337,1279
2021,South Gloucestershire 009D,E01014877,1508,335,1173
2021,South Gloucestershire 012C,E01014878,2042,445,1597
2021,South Gloucestershire 009E,E01014879,1653,277,1376
2021,South Gloucestershire 012D,E01014880,1849,419,1430
2021,South Gloucestershire 009F,E01014881,1840,471,1369
2021,South Gloucestershire 012E,E01014882,2026,485,1541
2021,South Gloucestershire 012F,E01014883,1172,207,965
2021,South Gloucestershire 003A,E01014884,2002,279,1723
2021,South Gloucestershire 003B,E01014885,2213,456,1757
2021,South Gloucestershire 008A,E01014886,1722,269,1453
2021,South Gloucestershire 008B,E01014887,1334,200,1134
2021,South Gloucestershire 008C,E01014888,1777,226,1551
2021,South Gloucestershire 008D,E01014889,1384,250,1134
2021,South Gloucestershire 024E,E01014890,2087,363,1724
2021,South Gloucestershire 024F,E01014891,1631,250,1381
2021,South Gloucestershire 014A,E01014892,1669,367,1302
2021,South Gloucestershire 014B,E01014893,1360,214,1146
2021,South Gloucestershire 014C,E01014894,1144,204,940
2021,South Gloucestershire 014D,E01014895,1315,254,1061
2021,South Gloucestershire 014E,E01014896,1208,253,955
2021,South Gloucestershire 022A,E01014897,1486,285,1201
2021,South Gloucestershire 022B,E01014898,1712,305,1407
2021,South Gloucestershire 022C,E01014899,1665,276,1389
2021,South Gloucestershire 022D,E01014900,1496,276,1220
2021,South Gloucestershire 020A,E01014901,1671,372,1299
2021,South Gloucestershire 020B,E01014902,1251,226,1025
2021,South Gloucestershire 020C,E01014903,1441,243,1198
2021,South Gloucestershire 018A,E01014904,1502,415,1087
2021,South Gloucestershire 018B,E01014905,1620,414,1206
2021,South Gloucestershire 018C,E01014906,1645,310,1335
2021,South Gloucestershire 018D,E01014907,1590,437,1153
2021,South Gloucestershire 018E,E01014908,1363,267,1096
2021,South Gloucestershire 018F,E01014909,1516,502,1014
2021,South Gloucestershire 018G,E01014910,1500,388,1112
2021,South Gloucestershire 013A,E01014911,1412,254,1158
2021,South Gloucestershire 013B,E01014912,1749,315,1434
2021,South Gloucestershire 013C,E01014913,1601,313,1288
2021,South Gloucestershire 013D,E01014914,2037,462,1575
2021,South Gloucestershire 028A,E01014915,1575,274,1301
2021,South Gloucestershire 031A,E01014916,1497,253,1244
2021,South Gloucestershire 031B,E01014917,1585,297,1288
2021,South Gloucestershire 031C,E01014918,1411,191,1220
2021,South Gloucestershire 031D,E01014919,1332,237,1095
2021,South Gloucestershire 031E,E01014920,1319,203,1116
2021,South Gloucestershire 031F,E01014921,1587,261,1326
2021,South Gloucestershire 026A,E01014922,1319,233,1086
2021,South Gloucestershire 026B,E01014923,1404,230,1174
2021,South Gloucestershire 026C,E01014924,1701,277,1424
2021,South Gloucestershire 027A,E01014925,1481,231,1250
2021,South Gloucestershire 027B,E01014926,1610,336,1274
2021,South Gloucestershire 027C,E01014927,1720,207,1513
2021,South Gloucestershire 027D,E01014928,1391,242,1149
2021,South Gloucestershire 003C,E01014929,2165,334,1831
2021,South Gloucestershire 003D,E01014930,1988,414,1574
2021,South Gloucestershire 032B,E01014931,1583,241,1342
2021,South Gloucestershire 032C,E01014932,1507,217,1290
2021,South Gloucestershire 032D,E01014933,1279,176,1103
2021,South Gloucestershire 032E,E01014934,1214,184,1030
2021,South Gloucestershire 032F,E01014935,1352,189,1163
2021,South Gloucestershire 030A,E01014936,1344,245,1099
2021,South Gloucestershire 032G,E01014937,1269,222,1047
2021,South Gloucestershire 030B,E01014938,1473,274,1199
2021,South Gloucestershire 030C,E01014939,1150,245,905
2021,South Gloucestershire 030D,E01014940,1263,203,1060
2021,South Gloucestershire 030E,E01014941,1546,344,1202
2021,South Gloucestershire 030F,E01014942,1440,274,1166
2021,South Gloucestershire 029A,E01014943,1592,223,1369
2021,South Gloucestershire 029B,E01014944,1639,306,1333
2021,South Gloucestershire 030G,E01014945,1586,249,1337
2021,South Gloucestershire 033C,E01014946,1492,289,1203
2021,South Gloucestershire 033B,E01014947,1415,188,1227
2021,South Gloucestershire 033A,E01014948,1534,290,1244
2021,South Gloucestershire 033D,E01014950,1417,258,1159
2021,South Gloucestershire 034B,E01014951,1277,227,1050
2021,South Gloucestershire 005C,E01014953,1967,357,1610
2021,South Gloucestershire 005D,E01014954,1454,220,1234
2021,South Gloucestershire 025A,E01014955,1310,216,1094
2021,South Gloucestershire 025B,E01014956,1434,201,1233
2021,South Gloucestershire 025C,E01014957,1109,151,958
2021,South Gloucestershire 027E,E01014958,1113,229,884
2021,South Gloucestershire 023A,E01014959,1336,284,1052
2021,South Gloucestershire 023B,E01014960,1658,334,1324
2021,South Gloucestershire 023C,E01014961,1482,303,1179
2021,South Gloucestershire 004C,E01014962,1692,256,1436
2021,South Gloucestershire 004D,E01014963,1790,290,1500
2021,South Gloucestershire 021A,E01014964,1634,316,1318
2021,South Gloucestershire 020D,E01014965,1491,276,1215
2021,South Gloucestershire 021C,E01014967,2007,460,1547
2021,South Gloucestershire 023D,E01014968,1684,321,1363
2021,South Gloucestershire 021D,E01014969,1537,300,1237
2021,South Gloucestershire 029C,E01014972,1635,260,1375
2021,South Gloucestershire 026D,E01014973,1433,289,1144
2021,South Gloucestershire 025D,E01014974,1616,272,1344
2021,South Gloucestershire 026E,E01014975,1652,291,1361
2021,South Gloucestershire 026F,E01014976,1645,292,1353
2021,South Gloucestershire 025E,E01014977,1325,234,1091
2021,South Gloucestershire 036A,E01014978,1432,304,1128
2021,South Gloucestershire 015A,E01014979,1407,196,1211
2021,South Gloucestershire 015B,E01014980,1478,228,1250
2021,South Gloucestershire 015C,E01014982,1395,242,1153
2021,South Gloucestershire 015D,E01014983,1429,280,1149
2021,South Gloucestershire 015E,E01014984,1442,303,1139
2021,South Gloucestershire 001A,E01014985,1268,173,1095
2021,South Gloucestershire 001B,E01014986,1594,269,1325
2021,South Gloucestershire 001C,E01014987,2243,457,1786
2021,South Gloucestershire 001D,E01014988,1626,291,1335
2021,South Gloucestershire 001E,E01014989,2092,366,1726
2021,South Gloucestershire 002A,E01014990,1400,214,1186
2021,South Gloucestershire 002B,E01014991,2081,384,1697
2021,South Gloucestershire 002C,E01014992,1362,241,1121
2021,South Gloucestershire 002D,E01014993,1561,242,1319
2021,South Gloucestershire 019D,E01014994,1859,229,1630
2021,South Gloucestershire 019E,E01014995,1578,235,1343
2021,South Gloucestershire 036D,E01014996,1755,295,1460
2021,South Gloucestershire 016A,E01014998,1496,250,1246
2021,South Gloucestershire 016B,E01014999,1557,242,1315
2021,South Gloucestershire 016C,E01015000,1553,280,1273
2021,South Gloucestershire 016D,E01015001,1516,309,1207
2021,South Gloucestershire 029D,E01015002,1439,236,1203
2021,South Gloucestershire 028B,E01015003,1546,266,1280
2021,South Gloucestershire 029E,E01015004,1560,241,1319
2021,South Gloucestershire 028C,E01015005,2182,430,1752
2021,South Gloucestershire 029F,E01015006,1536,275,1261
2021,South Gloucestershire 028D,E01015007,1864,291,1573
2021,South Gloucestershire 028E,E01015008,1667,268,1399
2021,South Gloucestershire 010A,E01015009,1306,216,1090
2021,South Gloucestershire 010B,E01015010,1277,243,1034
2021,South Gloucestershire 010C,E01015011,1692,299,1393
2021,South Gloucestershire 010D,E01015012,1690,300,1390
2021,South Gloucestershire 010E,E01015013,1243,236,1007
2021,South Gloucestershire 006A,E01015014,2759,546,2213
2021,South Gloucestershire 006B,E01015015,1497,247,1250
2021,South Gloucestershire 006C,E01015016,1079,161,918
2021,South Gloucestershire 006D,E01015017,1369,225,1144
2021,South Gloucestershire 006E,E01015018,1419,252,1167
2021,South Gloucestershire 007A,E01015019,1535,267,1268
2021,South Gloucestershire 007B,E01015020,1491,315,1176
2021,South Gloucestershire 007C,E01015021,1428,217,1211
2021,South Gloucestershire 007D,E01015022,1492,193,1299
2021,Plymouth 003A,E01015023,1695,381,1314
2021,Plymouth 004A,E01015024,1265,159,1106
2021,Plymouth 001A,E01015025,1673,243,1430
2021,Plymouth 003B,E01015026,1418,251,1167
2021,Plymouth 002A,E01015027,1548,284,1264
2021,Plymouth 003C,E01015028,1526,361,1165
2021,Plymouth 008A,E01015029,1827,431,1396
2021,Plymouth 007A,E01015030,1512,276,1236
2021,Plymouth 023A,E01015031,1447,297,1150
2021,Plymouth 023B,E01015032,1692,610,1082
2021,Plymouth 016A,E01015033,1500,291,1209
2021,Plymouth 016B,E01015034,1417,274,1143
2021,Plymouth 012A,E01015035,1374,238,1136
2021,Plymouth 016C,E01015036,1458,258,1200
2021,Plymouth 012B,E01015037,1255,186,1069
2021,Plymouth 016D,E01015038,1634,308,1326
2021,Plymouth 014A,E01015039,977,175,802
2021,Plymouth 014B,E01015040,1429,312,1117
2021,Plymouth 014C,E01015041,1525,260,1265
2021,Plymouth 020A,E01015042,1359,267,1092
2021,Plymouth 026A,E01015043,1297,266,1031
2021,Plymouth 020B,E01015044,1391,232,1159
2021,Plymouth 026B,E01015045,1368,256,1112
2021,Plymouth 026C,E01015046,1783,397,1386
2021,Plymouth 026D,E01015047,1885,411,1474
2021,Plymouth 026E,E01015048,2201,468,1733
2021,Plymouth 023C,E01015049,1602,728,874
2021,Plymouth 023D,E01015050,1799,909,890
2021,Plymouth 023E,E01015051,1751,1066,685
2021,Plymouth 028A,E01015052,1811,804,1007
2021,Plymouth 027A,E01015053,1170,491,679
2021,Plymouth 027B,E01015054,2693,2088,605
2021,Plymouth 021A,E01015055,1378,287,1091
2021,Plymouth 021B,E01015056,1573,236,1337
2021,Plymouth 021C,E01015057,1578,393,1185
2021,Plymouth 012C,E01015058,1485,391,1094
2021,Plymouth 021D,E01015059,1428,265,1163
2021,Plymouth 021E,E01015060,1410,270,1140
2021,Plymouth 025A,E01015061,1456,416,1040
2021,Plymouth 025B,E01015062,1739,791,948
2021,Plymouth 010A,E01015063,1368,250,1118
2021,Plymouth 008B,E01015064,1548,218,1330
2021,Plymouth 008C,E01015065,1242,205,1037
2021,Plymouth 012D,E01015066,1308,208,1100
2021,Plymouth 012E,E01015067,1375,177,1198
2021,Plymouth 010B,E01015068,1508,299,1209
2021,Plymouth 010C,E01015069,1442,277,1165
2021,Plymouth 007B,E01015070,2576,484,2092
2021,Plymouth 008D,E01015071,1459,255,1204
2021,Plymouth 013A,E01015072,1273,261,1012
2021,Plymouth 013B,E01015073,1388,253,1135
2021,Plymouth 011A,E01015074,1426,280,1146
2021,Plymouth 014D,E01015075,1443,277,1166
2021,Plymouth 009A,E01015076,1331,215,1116
2021,Plymouth 011B,E01015077,2323,486,1837
2021,Plymouth 013C,E01015078,1363,308,1055
2021,Plymouth 011C,E01015079,1640,338,1302
2021,Plymouth 013D,E01015080,1336,347,989
2021,Plymouth 007C,E01015081,1595,373,1222
2021,Plymouth 004B,E01015082,1542,282,1260
2021,Plymouth 004C,E01015083,1510,277,1233
2021,Plymouth 004D,E01015084,1400,252,1148
2021,Plymouth 006A,E01015085,1520,229,1291
2021,Plymouth 007D,E01015086,1315,211,1104
2021,Plymouth 006B,E01015087,1516,381,1135
2021,Plymouth 006C,E01015088,1473,406,1067
2021,Plymouth 007E,E01015089,1618,250,1368
2021,Plymouth 005A,E01015090,1282,199,1083
2021,Plymouth 005B,E01015091,1374,206,1168
2021,Plymouth 005C,E01015092,2652,935,1717
2021,Plymouth 005D,E01015093,1284,209,1075
2021,Plymouth 005E,E01015094,1447,295,1152
2021,Plymouth 010D,E01015095,1299,193,1106
2021,Plymouth 010E,E01015096,1317,254,1063
2021,Plymouth 001B,E01015097,2151,242,1909
2021,Plymouth 017A,E01015098,1520,337,1183
2021,Plymouth 017B,E01015099,1363,266,1097
2021,Plymouth 017C,E01015100,1400,346,1054
2021,Plymouth 016E,E01015101,1526,255,1271
2021,Plymouth 011D,E01015102,1545,276,1269
2021,Plymouth 017D,E01015103,1406,280,1126
2021,Plymouth 011E,E01015104,1418,295,1123
2021,Plymouth 017E,E01015105,1435,296,1139
2021,Plymouth 013E,E01015106,1144,190,954
2021,Plymouth 018A,E01015107,1709,345,1364
2021,Plymouth 022A,E01015108,1701,326,1375
2021,Plymouth 022B,E01015109,1271,184,1087
2021,Plymouth 018B,E01015110,1443,273,1170
2021,Plymouth 018C,E01015111,1606,305,1301
2021,Plymouth 019A,E01015112,1567,303,1264
2021,Plymouth 019B,E01015113,1387,257,1130
2021,Plymouth 019C,E01015114,1406,264,1142
2021,Plymouth 022C,E01015115,1317,231,1086
2021,Plymouth 022D,E01015116,1349,251,1098
2021,Plymouth 022E,E01015117,1323,232,1091
2021,Plymouth 019D,E01015118,1567,315,1252
2021,Plymouth 018D,E01015119,1553,326,1227
2021,Plymouth 015A,E01015120,1528,291,1237
2021,Plymouth 015B,E01015121,1457,254,1203
2021,Plymouth 019E,E01015122,1520,316,1204
2021,Plymouth 015C,E01015123,1607,186,1421
2021,Plymouth 015D,E01015124,1474,234,1240
2021,Plymouth 015E,E01015125,1413,260,1153
2021,Plymouth 030A,E01015126,1486,237,1249
2021,Plymouth 030B,E01015127,1393,214,1179
2021,Plymouth 032A,E01015128,1498,220,1278
2021,Plymouth 032B,E01015129,1301,234,1067
2021,Plymouth 032C,E01015130,1448,313,1135
2021,Plymouth 030C,E01015131,2334,466,1868
2021,Plymouth 030D,E01015132,1439,284,1155
2021,Plymouth 030E,E01015133,1401,214,1187
2021,Plymouth 032D,E01015134,1465,262,1203
2021,Plymouth 031B,E01015136,1410,251,1159
2021,Plymouth 031C,E01015137,1691,328,1363
2021,Plymouth 031D,E01015138,1808,281,1527
2021,Plymouth 031E,E01015139,1373,225,1148
2021,Plymouth 032E,E01015140,1362,217,1145
2021,Plymouth 031F,E01015141,1703,304,1399
2021,Plymouth 009B,E01015142,1341,207,1134
2021,Plymouth 009C,E01015143,1245,173,1072
2021,Plymouth 009D,E01015144,1488,348,1140
2021,Plymouth 014E,E01015145,1233,367,866
2021,Plymouth 009E,E01015146,1809,540,1269
2021,Plymouth 006D,E01015147,1206,220,986
2021,Plymouth 006E,E01015148,1416,264,1152
2021,Plymouth 009F,E01015149,1408,362,1046
2021,Plymouth 009G,E01015150,1358,220,1138
2021,Plymouth 033A,E01015151,1755,540,1215
2021,Plymouth 027C,E01015152,2393,1094,1299
2021,Plymouth 033C,E01015153,1736,352,1384
2021,Plymouth 034A,E01015155,1722,347,1375
2021,Plymouth 027E,E01015156,1968,661,1307
2021,Plymouth 002B,E01015159,1626,286,1340
2021,Plymouth 001C,E01015160,1396,213,1183
2021,Plymouth 002C,E01015161,1559,344,1215
2021,Plymouth 002D,E01015162,1401,291,1110
2021,Plymouth 003D,E01015163,1520,266,1254
2021,Plymouth 001D,E01015164,1771,430,1341
2021,Plymouth 003E,E01015165,1589,362,1227
2021,Plymouth 002E,E01015166,2035,494,1541
2021,Plymouth 020C,E01015167,1407,229,1178
2021,Plymouth 020D,E01015168,1718,297,1421
2021,Plymouth 024A,E01015169,1729,492,1237
2021,Plymouth 024B,E01015170,1475,289,1186
2021,Plymouth 020E,E01015171,1664,260,1404
2021,Plymouth 033B,E01015172,1653,301,1352
2021,Plymouth 024C,E01015173,1593,258,1335
2021,Plymouth 024D,E01015174,1587,251,1336
2021,Plymouth 025C,E01015175,1520,323,1197
2021,Plymouth 021F,E01015176,1338,272,1066
2021,Plymouth 025D,E01015177,1618,324,1294
2021,Plymouth 025E,E01015178,1845,494,1351
2021,Plymouth 028B,E01015179,1570,509,1061
2021,Plymouth 028C,E01015180,1623,301,1322
2021,Plymouth 028D,E01015181,2036,356,1680
2021,Plymouth 028E,E01015182,1852,373,1479
2021,Torbay 017A,E01015183,1322,197,1125
2021,Torbay 017B,E01015184,1239,103,1136
2021,Torbay 017C,E01015185,1263,143,1120
2021,Torbay 017D,E01015186,1248,178,1070
2021,Torbay 017E,E01015187,1649,189,1460
2021,Torbay 017F,E01015188,1464,207,1257
2021,Torbay 017G,E01015189,987,112,875
2021,Torbay 013A,E01015190,1905,352,1553
2021,Torbay 013B,E01015191,1524,283,1241
2021,Torbay 013C,E01015192,1489,343,1146
2021,Torbay 013D,E01015193,1289,224,1065
2021,Torbay 013E,E01015194,1351,248,1103
2021,Torbay 013G,E01015196,1668,457,1211
2021,Torbay 016A,E01015197,1352,164,1188
2021,Torbay 016B,E01015198,1524,192,1332
2021,Torbay 016C,E01015199,1342,124,1218
2021,Torbay 016D,E01015200,1027,183,844
2021,Torbay 016E,E01015201,1207,133,1074
2021,Torbay 012A,E01015202,1433,301,1132
2021,Torbay 012B,E01015203,1201,171,1030
2021,Torbay 012C,E01015204,1428,266,1162
2021,Torbay 012D,E01015205,1415,240,1175
2021,Torbay 012E,E01015206,1484,250,1234
2021,Torbay 019E,E01015207,1490,288,1202
2021,Torbay 019F,E01015208,1944,232,1712
2021,Torbay 019A,E01015209,1469,189,1280
2021,Torbay 019B,E01015210,1607,408,1199
2021,Torbay 019G,E01015211,1444,326,1118
2021,Torbay 019C,E01015212,1425,317,1108
2021,Torbay 019D,E01015213,1419,318,1101
2021,Torbay 006A,E01015214,1456,289,1167
2021,Torbay 006B,E01015215,1363,259,1104
2021,Torbay 006C,E01015216,1389,262,1127
2021,Torbay 008A,E01015217,1579,232,1347
2021,Torbay 006D,E01015218,1458,281,1177
2021,Torbay 015A,E01015219,1335,161,1174
2021,Torbay 015B,E01015220,1366,185,1181
2021,Torbay 015C,E01015221,1429,200,1229
2021,Torbay 015D,E01015222,1511,212,1299
2021,Torbay 015E,E01015223,1221,226,995
2021,Torbay 011A,E01015224,1552,247,1305
2021,Torbay 011B,E01015225,1386,240,1146
2021,Torbay 011C,E01015226,1366,198,1168
2021,Torbay 011D,E01015227,1536,281,1255
2021,Torbay 011E,E01015228,1492,208,1284
2021,Torbay 014A,E01015229,1448,154,1294
2021,Torbay 011F,E01015230,1349,156,1193
2021,Torbay 014B,E01015231,1684,241,1443
2021,Torbay 014C,E01015232,1888,188,1700
2021,Torbay 014D,E01015233,1454,198,1256
2021,Torbay 014E,E01015234,1278,263,1015
2021,Torbay 014F,E01015235,1738,101,1637
2021,Torbay 002A,E01015236,1431,189,1242
2021,Torbay 002B,E01015237,1283,256,1027
2021,Torbay 002C,E01015238,1309,215,1094
2021,Torbay 002D,E01015239,1639,186,1453
2021,Torbay 005A,E01015240,1502,143,1359
2021,Torbay 005B,E01015241,1537,286,1251
2021,Torbay 005C,E01015242,1251,304,947
2021,Torbay 005D,E01015243,1239,180,1059
2021,Torbay 018A,E01015244,1359,178,1181
2021,Torbay 018B,E01015245,1213,159,1054
2021,Torbay 018C,E01015246,1406,208,1198
2021,Torbay 018D,E01015247,1747,312,1435
2021,Torbay 018E,E01015248,1371,213,1158
2021,Torbay 003A,E01015249,1414,296,1118
2021,Torbay 003B,E01015250,1441,292,1149
2021,Torbay 003C,E01015251,1189,248,941
2021,Torbay 003E,E01015253,1863,391,1472
2021,Torbay 003F,E01015254,1380,223,1157
2021,Torbay 008B,E01015255,1747,209,1538
2021,Torbay 008C,E01015256,1913,213,1700
2021,Torbay 004A,E01015257,1378,288,1090
2021,Torbay 004B,E01015258,1964,362,1602
2021,Torbay 004C,E01015259,1490,337,1153
2021,Torbay 004D,E01015260,1619,231,1388
2021,Torbay 008D,E01015261,2165,400,1765
2021,Torbay 001A,E01015262,1295,270,1025
2021,Torbay 001B,E01015263,1510,382,1128
2021,Torbay 001C,E01015264,1284,165,1119
2021,Torbay 001D,E01015265,1318,190,1128
2021,Torbay 001E,E01015266,1492,377,1115
2021,Torbay 010A,E01015267,1649,117,1532
2021,Torbay 010B,E01015268,1657,112,1545
2021,Torbay 010C,E01015269,1517,121,1396
2021,Torbay 010D,E01015270,1651,111,1540
2021,Torbay 010E,E01015271,1476,150,1326
2021,"Bournemouth, Christchurch and Poole 035A",E01015272,1806,346,1460
2021,"Bournemouth, Christchurch and Poole 035B",E01015273,2038,450,1588
2021,"Bournemouth, Christchurch and Poole 036A",E01015274,1789,284,1505
2021,"Bournemouth, Christchurch and Poole 035C",E01015275,1607,388,1219
2021,"Bournemouth, Christchurch and Poole 035D",E01015276,1667,394,1273
2021,"Bournemouth, Christchurch and Poole 035E",E01015277,1868,435,1433
2021,"Bournemouth, Christchurch and Poole 037A",E01015279,1833,308,1525
2021,"Bournemouth, Christchurch and Poole 037B",E01015280,2001,312,1689
2021,"Bournemouth, Christchurch and Poole 037C",E01015281,1736,310,1426
2021,"Bournemouth, Christchurch and Poole 038A",E01015286,1934,194,1740
2021,"Bournemouth, Christchurch and Poole 041A",E01015288,1920,470,1450
2021,"Bournemouth, Christchurch and Poole 041B",E01015289,1901,281,1620
2021,"Bournemouth, Christchurch and Poole 041C",E01015290,2706,1034,1672
2021,"Bournemouth, Christchurch and Poole 041D",E01015291,1831,185,1646
2021,"Bournemouth, Christchurch and Poole 025A",E01015292,1771,409,1362
2021,"Bournemouth, Christchurch and Poole 025B",E01015293,1510,302,1208
2021,"Bournemouth, Christchurch and Poole 025C",E01015294,2001,456,1545
2021,"Bournemouth, Christchurch and Poole 039A",E01015295,1446,207,1239
2021,"Bournemouth, Christchurch and Poole 039B",E01015296,1846,207,1639
2021,"Bournemouth, Christchurch and Poole 036B",E01015297,1472,186,1286
2021,"Bournemouth, Christchurch and Poole 039C",E01015298,1492,144,1348
2021,"Bournemouth, Christchurch and Poole 039D",E01015299,1728,310,1418
2021,"Bournemouth, Christchurch and Poole 039E",E01015300,1540,281,1259
2021,"Bournemouth, Christchurch and Poole 003A",E01015301,1519,251,1268
2021,"Bournemouth, Christchurch and Poole 005A",E01015302,1746,256,1490
2021,"Bournemouth, Christchurch and Poole 003B",E01015303,1546,244,1302
2021,"Bournemouth, Christchurch and Poole 005B",E01015304,1731,298,1433
2021,"Bournemouth, Christchurch and Poole 003C",E01015305,1502,330,1172
2021,"Bournemouth, Christchurch and Poole 003D",E01015306,1603,283,1320
2021,"Bournemouth, Christchurch and Poole 010A",E01015307,1409,322,1087
2021,"Bournemouth, Christchurch and Poole 005C",E01015308,1705,330,1375
2021,"Bournemouth, Christchurch and Poole 010B",E01015309,1378,287,1091
2021,"Bournemouth, Christchurch and Poole 011A",E01015310,1491,311,1180
2021,"Bournemouth, Christchurch and Poole 005D",E01015311,1335,82,1253
2021,"Bournemouth, Christchurch and Poole 010C",E01015312,1413,354,1059
2021,"Bournemouth, Christchurch and Poole 010D",E01015313,1291,312,979
2021,"Bournemouth, Christchurch and Poole 020A",E01015314,1491,298,1193
2021,"Bournemouth, Christchurch and Poole 020B",E01015315,1820,383,1437
2021,"Bournemouth, Christchurch and Poole 026A",E01015316,1591,279,1312
2021,"Bournemouth, Christchurch and Poole 026B",E01015317,1580,295,1285
2021,"Bournemouth, Christchurch and Poole 020C",E01015318,1657,325,1332
2021,"Bournemouth, Christchurch and Poole 020D",E01015319,1300,248,1052
2021,"Bournemouth, Christchurch and Poole 009A",E01015320,1624,338,1286
2021,"Bournemouth, Christchurch and Poole 015A",E01015321,1826,575,1251
2021,"Bournemouth, Christchurch and Poole 017A",E01015322,1632,340,1292
2021,"Bournemouth, Christchurch and Poole 009B",E01015323,1568,379,1189
2021,"Bournemouth, Christchurch and Poole 009C",E01015324,1585,366,1219
2021,"Bournemouth, Christchurch and Poole 009D",E01015325,1700,404,1296
2021,"Bournemouth, Christchurch and Poole 027A",E01015326,1843,417,1426
2021,"Bournemouth, Christchurch and Poole 025D",E01015327,1993,533,1460
2021,"Bournemouth, Christchurch and Poole 038B",E01015328,1878,298,1580
2021,"Bournemouth, Christchurch and Poole 025E",E01015329,1583,338,1245
2021,"Bournemouth, Christchurch and Poole 017B",E01015330,1800,372,1428
2021,"Bournemouth, Christchurch and Poole 027B",E01015331,2228,560,1668
2021,"Bournemouth, Christchurch and Poole 006A",E01015332,1522,238,1284
2021,"Bournemouth, Christchurch and Poole 006B",E01015333,1492,224,1268
2021,"Bournemouth, Christchurch and Poole 006C",E01015334,1575,266,1309
2021,"Bournemouth, Christchurch and Poole 006D",E01015335,1590,270,1320
2021,"Bournemouth, Christchurch and Poole 011B",E01015336,1696,377,1319
2021,"Bournemouth, Christchurch and Poole 006E",E01015337,1740,388,1352
2021,"Bournemouth, Christchurch and Poole 012A",E01015338,1673,335,1338
2021,"Bournemouth, Christchurch and Poole 012B",E01015339,1530,336,1194
2021,"Bournemouth, Christchurch and Poole 012C",E01015340,1592,237,1355
2021,"Bournemouth, Christchurch and Poole 012D",E01015341,1370,324,1046
2021,"Bournemouth, Christchurch and Poole 017C",E01015342,1563,319,1244
2021,"Bournemouth, Christchurch and Poole 007A",E01015343,1564,316,1248
2021,"Bournemouth, Christchurch and Poole 028A",E01015344,1797,302,1495
2021,"Bournemouth, Christchurch and Poole 027C",E01015345,1821,513,1308
2021,"Bournemouth, Christchurch and Poole 028B",E01015346,1553,401,1152
2021,"Bournemouth, Christchurch and Poole 028C",E01015348,1813,388,1425
2021,"Bournemouth, Christchurch and Poole 007B",E01015349,1648,348,1300
2021,"Bournemouth, Christchurch and Poole 009E",E01015350,1487,294,1193
2021,"Bournemouth, Christchurch and Poole 007C",E01015351,1388,291,1097
2021,"Bournemouth, Christchurch and Poole 007D",E01015352,1526,382,1144
2021,"Bournemouth, Christchurch and Poole 007E",E01015353,1075,195,880
2021,"Bournemouth, Christchurch and Poole 007F",E01015354,1685,374,1311
2021,"Bournemouth, Christchurch and Poole 011C",E01015355,1642,384,1258
2021,"Bournemouth, Christchurch and Poole 015B",E01015356,1708,523,1185
2021,"Bournemouth, Christchurch and Poole 011D",E01015357,1432,313,1119
2021,"Bournemouth, Christchurch and Poole 011E",E01015358,2060,683,1377
2021,"Bournemouth, Christchurch and Poole 010E",E01015359,1545,283,1262
2021,"Bournemouth, Christchurch and Poole 028D",E01015360,1940,958,982
2021,"Bournemouth, Christchurch and Poole 026C",E01015361,1314,276,1038
2021,"Bournemouth, Christchurch and Poole 026D",E01015362,1105,233,872
2021,"Bournemouth, Christchurch and Poole 026E",E01015363,1598,344,1254
2021,"Bournemouth, Christchurch and Poole 036C",E01015364,1617,302,1315
2021,"Bournemouth, Christchurch and Poole 036D",E01015365,1550,277,1273
2021,"Bournemouth, Christchurch and Poole 036E",E01015366,1758,219,1539
2021,"Bournemouth, Christchurch and Poole 045A",E01015367,2354,312,2042
2021,"Bournemouth, Christchurch and Poole 045B",E01015368,1699,139,1560
2021,"Bournemouth, Christchurch and Poole 045C",E01015369,1589,108,1481
2021,"Bournemouth, Christchurch and Poole 045D",E01015370,1567,168,1399
2021,"Bournemouth, Christchurch and Poole 040A",E01015371,1307,122,1185
2021,"Bournemouth, Christchurch and Poole 040B",E01015372,1956,156,1800
2021,"Bournemouth, Christchurch and Poole 017D",E01015373,1679,496,1183
2021,"Bournemouth, Christchurch and Poole 015C",E01015374,2421,1183,1238
2021,"Bournemouth, Christchurch and Poole 015D",E01015375,2054,964,1090
2021,"Bournemouth, Christchurch and Poole 027D",E01015376,1763,729,1034
2021,"Bournemouth, Christchurch and Poole 015E",E01015377,1615,565,1050
2021,"Bournemouth, Christchurch and Poole 017E",E01015378,1740,635,1105
2021,"Bournemouth, Christchurch and Poole 008A",E01015379,1377,324,1053
2021,"Bournemouth, Christchurch and Poole 022A",E01015380,1732,233,1499
2021,"Bournemouth, Christchurch and Poole 022B",E01015381,1630,393,1237
2021,"Bournemouth, Christchurch and Poole 022C",E01015382,1792,383,1409
2021,"Bournemouth, Christchurch and Poole 022D",E01015383,1430,204,1226
2021,"Bournemouth, Christchurch and Poole 022E",E01015384,1542,475,1067
2021,"Bournemouth, Christchurch and Poole 022F",E01015385,1676,293,1383
2021,"Bournemouth, Christchurch and Poole 029A",E01015386,1589,266,1323
2021,"Bournemouth, Christchurch and Poole 029B",E01015387,1432,239,1193
2021,"Bournemouth, Christchurch and Poole 029C",E01015388,1416,471,945
2021,"Bournemouth, Christchurch and Poole 029D",E01015389,1390,181,1209
2021,"Bournemouth, Christchurch and Poole 032A",E01015390,1603,286,1317
2021,"Bournemouth, Christchurch and Poole 032B",E01015391,1376,202,1174
2021,"Bournemouth, Christchurch and Poole 032C",E01015392,1395,219,1176
2021,"Bournemouth, Christchurch and Poole 032D",E01015393,1228,217,1011
2021,"Bournemouth, Christchurch and Poole 032E",E01015394,1563,299,1264
2021,"Bournemouth, Christchurch and Poole 004A",E01015395,1322,154,1168
2021,"Bournemouth, Christchurch and Poole 004B",E01015396,1549,246,1303
2021,"Bournemouth, Christchurch and Poole 004C",E01015397,1350,254,1096
2021,"Bournemouth, Christchurch and Poole 004D",E01015398,1273,247,1026
2021,"Bournemouth, Christchurch and Poole 004E",E01015399,1527,232,1295
2021,"Bournemouth, Christchurch and Poole 004F",E01015400,1561,285,1276
2021,"Bournemouth, Christchurch and Poole 004G",E01015401,1416,197,1219
2021,"Bournemouth, Christchurch and Poole 048A",E01015402,1782,209,1573
2021,"Bournemouth, Christchurch and Poole 048B",E01015403,1683,52,1631
2021,"Bournemouth, Christchurch and Poole 048C",E01015404,1718,199,1519
2021,"Bournemouth, Christchurch and Poole 048D",E01015405,1628,196,1432
2021,"Bournemouth, Christchurch and Poole 048E",E01015406,1472,161,1311
2021,"Bournemouth, Christchurch and Poole 016A",E01015407,1430,240,1190
2021,"Bournemouth, Christchurch and Poole 016B",E01015408,1636,344,1292
2021,"Bournemouth, Christchurch and Poole 016C",E01015409,1345,281,1064
2021,"Bournemouth, Christchurch and Poole 016D",E01015410,1403,234,1169
2021,"Bournemouth, Christchurch and Poole 016E",E01015411,1307,253,1054
2021,"Bournemouth, Christchurch and Poole 013A",E01015412,1255,214,1041
2021,"Bournemouth, Christchurch and Poole 013B",E01015413,1358,241,1117
2021,"Bournemouth, Christchurch and Poole 013C",E01015414,1471,247,1224
2021,"Bournemouth, Christchurch and Poole 013D",E01015415,1167,270,897
2021,"Bournemouth, Christchurch and Poole 013E",E01015416,1226,234,992
2021,"Bournemouth, Christchurch and Poole 021A",E01015417,1431,237,1194
2021,"Bournemouth, Christchurch and Poole 021B",E01015418,1449,222,1227
2021,"Bournemouth, Christchurch and Poole 021C",E01015419,1685,265,1420
2021,"Bournemouth, Christchurch and Poole 021D",E01015420,1559,296,1263
2021,"Bournemouth, Christchurch and Poole 021E",E01015421,1526,231,1295
2021,"Bournemouth, Christchurch and Poole 021F",E01015422,1319,200,1119
2021,"Bournemouth, Christchurch and Poole 046A",E01015424,1338,231,1107
2021,"Bournemouth, Christchurch and Poole 046B",E01015425,1247,169,1078
2021,"Bournemouth, Christchurch and Poole 046C",E01015426,1351,228,1123
2021,"Bournemouth, Christchurch and Poole 042A",E01015427,1571,276,1295
2021,"Bournemouth, Christchurch and Poole 042B",E01015428,2304,360,1944
2021,"Bournemouth, Christchurch and Poole 042C",E01015429,1669,364,1305
2021,"Bournemouth, Christchurch and Poole 042D",E01015430,1412,357,1055
2021,"Bournemouth, Christchurch and Poole 001A",E01015431,1424,548,876
2021,"Bournemouth, Christchurch and Poole 001B",E01015432,1641,258,1383
2021,"Bournemouth, Christchurch and Poole 001C",E01015433,1479,239,1240
2021,"Bournemouth, Christchurch and Poole 001D",E01015434,1567,231,1336
2021,"Bournemouth, Christchurch and Poole 008B",E01015435,1724,316,1408
2021,"Bournemouth, Christchurch and Poole 008C",E01015436,1307,199,1108
2021,"Bournemouth, Christchurch and Poole 008D",E01015437,1194,202,992
2021,"Bournemouth, Christchurch and Poole 023A",E01015438,1475,251,1224
2021,"Bournemouth, Christchurch and Poole 023B",E01015439,1729,358,1371
2021,"Bournemouth, Christchurch and Poole 030A",E01015440,1982,344,1638
2021,"Bournemouth, Christchurch and Poole 023C",E01015441,1850,287,1563
2021,"Bournemouth, Christchurch and Poole 023D",E01015442,1913,412,1501
2021,"Bournemouth, Christchurch and Poole 023E",E01015443,1864,313,1551
2021,"Bournemouth, Christchurch and Poole 023F",E01015444,1640,271,1369
2021,"Bournemouth, Christchurch and Poole 034A",E01015445,1826,297,1529
2021,"Bournemouth, Christchurch and Poole 034B",E01015446,1547,290,1257
2021,"Bournemouth, Christchurch and Poole 030B",E01015447,1655,280,1375
2021,"Bournemouth, Christchurch and Poole 034C",E01015448,1506,291,1215
2021,"Bournemouth, Christchurch and Poole 030C",E01015449,1680,313,1367
2021,"Bournemouth, Christchurch and Poole 034D",E01015450,1662,312,1350
2021,"Bournemouth, Christchurch and Poole 034E",E01015451,1509,225,1284
2021,"Bournemouth, Christchurch and Poole 047A",E01015452,2004,353,1651
2021,"Bournemouth, Christchurch and Poole 047B",E01015453,1825,248,1577
2021,"Bournemouth, Christchurch and Poole 047C",E01015454,1956,323,1633
2021,"Bournemouth, Christchurch and Poole 047D",E01015455,1845,306,1539
2021,"Bournemouth, Christchurch and Poole 030D",E01015456,1741,288,1453
2021,"Bournemouth, Christchurch and Poole 030E",E01015457,1785,243,1542
2021,"Bournemouth, Christchurch and Poole 043A",E01015458,1497,282,1215
2021,"Bournemouth, Christchurch and Poole 047E",E01015459,1732,281,1451
2021,"Bournemouth, Christchurch and Poole 043B",E01015460,1738,397,1341
2021,"Bournemouth, Christchurch and Poole 043C",E01015461,1555,280,1275
2021,"Bournemouth, Christchurch and Poole 043D",E01015462,1605,339,1266
2021,"Bournemouth, Christchurch and Poole 043E",E01015463,1605,265,1340
2021,"Bournemouth, Christchurch and Poole 043F",E01015464,1566,251,1315
2021,"Bournemouth, Christchurch and Poole 044A",E01015465,1634,300,1334
2021,"Bournemouth, Christchurch and Poole 044B",E01015466,1706,262,1444
2021,Swindon 028A,E01015471,2018,414,1604
2021,Swindon 008A,E01015473,1846,297,1549
2021,Swindon 015A,E01015475,2341,516,1825
2021,Swindon 015C,E01015477,1612,314,1298
2021,Swindon 021A,E01015478,1489,250,1239
2021,Swindon 017A,E01015479,2189,441,1748
2021,Swindon 015D,E01015480,2972,654,2318
2021,Swindon 013A,E01015481,1668,303,1365
2021,Swindon 013B,E01015482,1191,172,1019
2021,Swindon 013C,E01015483,1318,189,1129
2021,Swindon 013D,E01015484,1353,178,1175
2021,Swindon 013E,E01015485,1319,199,1120
2021,Swindon 013F,E01015486,1322,171,1151
2021,Swindon 023A,E01015487,1421,187,1234
2021,Swindon 023B,E01015488,1387,223,1164
2021,Swindon 023C,E01015489,1343,220,1123
2021,Swindon 023D,E01015490,1179,196,983
2021,Swindon 023E,E01015491,1327,195,1132
2021,Swindon 023F,E01015492,1318,285,1033
2021,Swindon 017B,E01015493,2098,480,1618
2021,Swindon 019A,E01015494,2037,319,1718
2021,Swindon 019C,E01015496,1768,282,1486
2021,Swindon 019D,E01015497,1541,251,1290
2021,Swindon 021B,E01015498,1639,275,1364
2021,Swindon 018A,E01015499,1333,260,1073
2021,Swindon 018B,E01015500,1384,218,1166
2021,Swindon 022A,E01015501,1259,204,1055
2021,Swindon 022B,E01015502,1450,349,1101
2021,Swindon 022C,E01015503,1245,248,997
2021,Swindon 018C,E01015504,1225,227,998
2021,Swindon 018D,E01015505,1399,285,1114
2021,Swindon 007A,E01015506,1418,249,1169
2021,Swindon 007B,E01015507,1506,388,1118
2021,Swindon 010A,E01015508,1447,302,1145
2021,Swindon 010B,E01015509,1654,304,1350
2021,Swindon 010C,E01015510,2014,349,1665
2021,Swindon 010D,E01015511,1740,319,1421
2021,Swindon 028C,E01015512,1555,359,1196
2021,Swindon 004A,E01015513,1365,210,1155
2021,Swindon 004B,E01015514,1154,157,997
2021,Swindon 004C,E01015515,1354,220,1134
2021,Swindon 004D,E01015516,1236,122,1114
2021,Swindon 004E,E01015517,1344,155,1189
2021,Swindon 028D,E01015518,1405,332,1073
2021,Swindon 001A,E01015519,1446,248,1198
2021,Swindon 001B,E01015520,1206,167,1039
2021,Swindon 001C,E01015521,1530,268,1262
2021,Swindon 001D,E01015522,1270,169,1101
2021,Swindon 001E,E01015523,1561,238,1323
2021,Swindon 001F,E01015524,1040,168,872
2021,Swindon 026A,E01015525,1471,243,1228
2021,Swindon 006A,E01015526,1407,247,1160
2021,Swindon 007C,E01015527,1652,342,1310
2021,Swindon 006B,E01015528,2029,466,1563
2021,Swindon 006C,E01015529,1532,269,1263
2021,Swindon 006D,E01015530,1982,459,1523
2021,Swindon 021D,E01015532,1589,302,1287
2021,Swindon 024A,E01015533,1421,181,1240
2021,Swindon 024B,E01015534,2060,278,1782
2021,Swindon 024C,E01015535,1974,341,1633
2021,Swindon 020A,E01015537,1687,405,1282
2021,Swindon 016A,E01015538,1782,365,1417
2021,Swindon 020B,E01015539,1556,357,1199
2021,Swindon 020C,E01015540,1740,398,1342
2021,Swindon 020D,E01015541,1688,363,1325
2021,Swindon 020E,E01015542,1316,311,1005
2021,Swindon 003A,E01015543,1443,248,1195
2021,Swindon 003B,E01015544,1620,383,1237
2021,Swindon 003C,E01015545,1499,404,1095
2021,Swindon 003D,E01015546,1662,464,1198
2021,Swindon 008C,E01015547,1758,300,1458
2021,Swindon 008D,E01015548,1505,265,1240
2021,Swindon 009A,E01015549,1565,240,1325
2021,Swindon 009B,E01015550,1762,230,1532
2021,Swindon 009C,E01015551,1584,237,1347
2021,Swindon 009D,E01015552,2112,382,1730
2021,Swindon 009E,E01015553,1436,220,1216
2021,Swindon 009F,E01015554,1327,203,1124
2021,Swindon 005A,E01015555,1428,190,1238
2021,Swindon 005B,E01015556,1426,179,1247
2021,Swindon 005C,E01015557,1699,255,1444
2021,Swindon 005D,E01015558,1477,339,1138
2021,Swindon 005E,E01015559,1425,205,1220
2021,Swindon 005F,E01015560,1980,345,1635
2021,Swindon 014A,E01015561,1506,256,1250
2021,Swindon 011A,E01015562,1403,283,1120
2021,Swindon 011B,E01015563,1414,260,1154
2021,Swindon 014B,E01015564,1453,249,1204
2021,Swindon 011C,E01015565,1390,245,1145
2021,Swindon 011D,E01015566,1470,267,1203
2021,Swindon 014C,E01015567,1529,300,1229
2021,Swindon 014D,E01015568,1595,221,1374
2021,Swindon 022D,E01015569,1432,298,1134
2021,Swindon 022E,E01015570,1383,245,1138
2021,Swindon 022F,E01015571,1464,240,1224
2021,Swindon 016B,E01015572,1288,341,947
2021,Swindon 016C,E01015573,2159,561,1598
2021,Swindon 017C,E01015574,1532,293,1239
2021,Swindon 016D,E01015575,1311,388,923
2021,Swindon 017D,E01015576,1501,244,1257
2021,Swindon 012B,E01015578,2029,320,1709
2021,Swindon 012C,E01015579,1556,285,1271
2021,Swindon 007D,E01015580,1625,359,1266
2021,Swindon 012D,E01015581,1565,288,1277
2021,Swindon 012E,E01015582,2025,401,1624
2021,Swindon 025B,E01015584,1385,217,1168
2021,Swindon 025C,E01015585,1881,332,1549
2021,Swindon 025D,E01015586,1322,142,1180
2021,Swindon 025E,E01015587,1781,288,1493
2021,Swindon 025F,E01015588,1706,270,1436
2021,Peterborough 004A,E01015589,1923,422,1501
2021,Peterborough 004B,E01015590,1444,280,1164
2021,Peterborough 011A,E01015591,1452,284,1168
2021,Peterborough 011B,E01015592,1485,361,1124
2021,Peterborough 009A,E01015593,1554,410,1144
2021,Peterborough 011C,E01015594,2216,417,1799
2021,Peterborough 011D,E01015595,1521,344,1177
2021,Peterborough 009B,E01015596,1639,454,1185
2021,Peterborough 011E,E01015597,1648,470,1178
2021,Peterborough 015A,E01015598,1444,229,1215
2021,Peterborough 014A,E01015599,2470,484,1986
2021,Peterborough 014B,E01015600,1778,464,1314
2021,Peterborough 012A,E01015601,2112,603,1509
2021,Peterborough 010A,E01015603,2328,573,1755
2021,Peterborough 010B,E01015604,1824,521,1303
2021,Peterborough 008A,E01015605,1656,421,1235
2021,Peterborough 013A,E01015606,1757,363,1394
2021,Peterborough 007A,E01015607,1624,375,1249
2021,Peterborough 008B,E01015608,1639,426,1213
2021,Peterborough 007B,E01015609,1738,537,1201
2021,Peterborough 008C,E01015610,1807,500,1307
2021,Peterborough 014D,E01015612,2342,531,1811
2021,Peterborough 013C,E01015613,1468,357,1111
2021,Peterborough 013D,E01015614,1981,447,1534
2021,Peterborough 013E,E01015615,1798,427,1371
2021,Peterborough 013F,E01015616,2048,600,1448
2021,Peterborough 005A,E01015617,1372,226,1146
2021,Peterborough 005B,E01015618,1246,216,1030
2021,Peterborough 005C,E01015619,2114,423,1691
2021,Peterborough 005D,E01015620,2057,359,1698
2021,Peterborough 016A,E01015622,2455,473,1982
2021,Peterborough 017B,E01015623,1701,329,1372
2021,Peterborough 017C,E01015624,1617,321,1296
2021,Peterborough 004C,E01015626,1244,320,924
2021,Peterborough 018A,E01015627,1731,292,1439
2021,Peterborough 004D,E01015628,1913,319,1594
2021,Peterborough 001A,E01015629,1684,338,1346
2021,Peterborough 003A,E01015630,1872,417,1455
2021,Peterborough 003B,E01015631,1405,251,1154
2021,Peterborough 010C,E01015632,1849,467,1382
2021,Peterborough 008D,E01015633,2262,471,1791
2021,Peterborough 008E,E01015634,1923,549,1374
2021,Peterborough 001B,E01015635,1542,277,1265
2021,Peterborough 001C,E01015636,1078,159,919
2021,Peterborough 021A,E01015637,1502,395,1107
2021,Peterborough 022A,E01015638,1563,260,1303
2021,Peterborough 021B,E01015639,1627,387,1240
2021,Peterborough 021C,E01015640,1440,302,1138
2021,Peterborough 021D,E01015641,1302,268,1034
2021,Peterborough 021E,E01015642,1560,464,1096
2021,Peterborough 023A,E01015643,1362,306,1056
2021,Peterborough 018B,E01015644,2375,491,1884
2021,Peterborough 018C,E01015645,1600,261,1339
2021,Peterborough 018D,E01015646,1785,213,1572
2021,Peterborough 021F,E01015647,1551,414,1137
2021,Peterborough 018E,E01015648,1297,162,1135
2021,Peterborough 022B,E01015650,1895,320,1575
2021,Peterborough 012B,E01015651,2120,597,1523
2021,Peterborough 012C,E01015652,2117,648,1469
2021,Peterborough 012D,E01015653,1828,419,1409
2021,Peterborough 012E,E01015654,2582,658,1924
2021,Peterborough 014E,E01015655,2054,409,1645
2021,Peterborough 007C,E01015656,1531,318,1213
2021,Peterborough 007E,E01015658,1560,410,1150
2021,Peterborough 003C,E01015659,1806,294,1512
2021,Peterborough 007F,E01015660,1506,236,1270
2021,Peterborough 010D,E01015661,2216,375,1841
2021,Peterborough 009C,E01015662,1394,370,1024
2021,Peterborough 009D,E01015663,1485,364,1121
2021,Peterborough 009E,E01015664,1583,394,1189
2021,Peterborough 016C,E01015665,1693,467,1226
2021,Peterborough 017D,E01015666,1364,199,1165
2021,Peterborough 019A,E01015667,1367,268,1099
2021,Peterborough 017E,E01015668,1948,391,1557
2021,Peterborough 019B,E01015669,1402,267,1135
2021,Peterborough 019C,E01015670,1365,219,1146
2021,Peterborough 019E,E01015672,1438,230,1208
2021,Peterborough 019F,E01015673,1432,283,1149
2021,Peterborough 006A,E01015674,1470,318,1152
2021,Peterborough 006B,E01015675,1530,260,1270
2021,Peterborough 006C,E01015676,1858,330,1528
2021,Peterborough 010E,E01015677,1109,221,888
2021,Peterborough 002A,E01015678,1268,251,1017
2021,Peterborough 001D,E01015679,1651,218,1433
2021,Peterborough 002B,E01015680,1415,328,1087
2021,Peterborough 002C,E01015681,1419,229,1190
2021,Peterborough 002D,E01015682,1368,218,1150
2021,Peterborough 006D,E01015683,1726,204,1522
2021,Peterborough 003D,E01015684,1361,138,1223
2021,Peterborough 003E,E01015685,1470,174,1296
2021,Peterborough 006E,E01015686,1430,165,1265
2021,Peterborough 015B,E01015687,1570,328,1242
2021,Peterborough 016D,E01015688,2310,420,1890
2021,Peterborough 015C,E01015689,1441,217,1224
2021,Peterborough 015D,E01015690,1200,199,1001
2021,Peterborough 015E,E01015691,1903,473,1430
2021,Peterborough 016E,E01015692,1549,422,1127
2021,Luton 007A,E01015693,1639,446,1193
2021,Luton 007B,E01015694,1494,403,1091
2021,Luton 007C,E01015695,1659,496,1163
2021,Luton 007D,E01015696,1271,315,956
2021,Luton 007E,E01015697,1628,344,1284
2021,Luton 017A,E01015698,1648,433,1215
2021,Luton 017B,E01015699,1810,469,1341
2021,Luton 010A,E01015700,2569,836,1733
2021,Luton 010B,E01015701,2073,648,1425
2021,Luton 017C,E01015702,1770,574,1196
2021,Luton 015A,E01015703,1976,611,1365
2021,Luton 010C,E01015704,1961,685,1276
2021,Luton 017D,E01015705,1475,455,1020
2021,Luton 001A,E01015706,1337,209,1128
2021,Luton 001B,E01015707,1399,250,1149
2021,Luton 001C,E01015708,1309,224,1085
2021,Luton 001D,E01015709,1428,242,1186
2021,Luton 001E,E01015710,1405,247,1158
2021,Luton 011A,E01015711,1853,573,1280
2021,Luton 011B,E01015712,1929,554,1375
2021,Luton 013A,E01015713,1530,385,1145
2021,Luton 013B,E01015714,1830,446,1384
2021,Luton 011C,E01015715,2042,711,1331
2021,Luton 011D,E01015716,2026,626,1400
2021,Luton 011E,E01015717,1584,487,1097
2021,Luton 013C,E01015718,1493,377,1116
2021,Luton 016A,E01015719,1981,352,1629
2021,Luton 016B,E01015720,1589,421,1168
2021,Luton 014A,E01015721,1579,332,1247
2021,Luton 014B,E01015722,1337,300,1037
2021,Luton 016C,E01015723,1342,317,1025
2021,Luton 019A,E01015724,2357,755,1602
2021,Luton 017E,E01015725,1643,605,1038
2021,Luton 015B,E01015726,2214,712,1502
2021,Luton 017F,E01015727,2213,742,1471
2021,Luton 019B,E01015728,1636,518,1118
2021,Luton 019C,E01015729,2123,491,1632
2021,Luton 019D,E01015730,2252,805,1447
2021,Luton 015C,E01015731,1983,700,1283
2021,Luton 020A,E01015732,1744,544,1200
2021,Luton 020B,E01015733,1997,660,1337
2021,Luton 020C,E01015734,1914,498,1416
2021,Luton 020D,E01015735,1776,457,1319
2021,Luton 020E,E01015736,1901,557,1344
2021,Luton 020F,E01015737,1496,421,1075
2021,Luton 021A,E01015738,1882,515,1367
2021,Luton 022A,E01015739,1998,381,1617
2021,Luton 012A,E01015740,1518,345,1173
2021,Luton 022B,E01015742,1863,536,1327
2021,Luton 022E,E01015743,1646,401,1245
2021,Luton 004A,E01015744,1497,372,1125
2021,Luton 007F,E01015745,1563,360,1203
2021,Luton 004B,E01015746,1525,313,1212
2021,Luton 004C,E01015747,1388,236,1152
2021,Luton 004D,E01015748,1697,300,1397
2021,Luton 005A,E01015749,2122,703,1419
2021,Luton 011F,E01015750,2468,786,1682
2021,Luton 005B,E01015751,1941,524,1417
2021,Luton 005C,E01015752,1350,355,995
2021,Luton 005D,E01015753,1475,318,1157
2021,Luton 005E,E01015754,1785,442,1343
2021,Luton 005F,E01015755,1775,365,1410
2021,Luton 009A,E01015756,1683,438,1245
2021,Luton 009B,E01015757,1585,413,1172
2021,Luton 009C,E01015758,1467,410,1057
2021,Luton 009D,E01015759,1624,494,1130
2021,Luton 009E,E01015760,1394,354,1040
2021,Luton 009F,E01015761,1698,489,1209
2021,Luton 013D,E01015762,1836,400,1436
2021,Luton 013E,E01015763,1555,347,1208
2021,Luton 006A,E01015764,1564,299,1265
2021,Luton 006B,E01015765,1740,402,1338
2021,Luton 006C,E01015766,1624,470,1154
2021,Luton 006D,E01015767,1551,335,1216
2021,Luton 006E,E01015768,1528,351,1177
2021,Luton 003A,E01015769,1183,288,895
2021,Luton 001F,E01015770,1279,252,1027
2021,Luton 003B,E01015771,1471,491,980
2021,Luton 003C,E01015772,1473,392,1081
2021,Luton 003D,E01015773,1202,331,871
2021,Luton 003E,E01015774,1349,400,949
2021,Luton 012B,E01015775,1766,341,1425
2021,Luton 012C,E01015776,1868,428,1440
2021,Luton 012D,E01015777,1790,464,1326
2021,Luton 012E,E01015778,1705,404,1301
2021,Luton 016D,E01015779,1473,400,1073
2021,Luton 016E,E01015780,1695,430,1265
2021,Luton 016F,E01015781,1567,412,1155
2021,Luton 010D,E01015782,2259,682,1577
2021,Luton 006F,E01015783,1653,488,1165
2021,Luton 010E,E01015784,2384,802,1582
2021,Luton 006G,E01015785,2363,590,1773
2021,Luton 010F,E01015786,2236,688,1548
2021,Luton 015D,E01015787,2269,658,1611
2021,Luton 015E,E01015788,1955,591,1364
2021,Luton 023D,E01015789,2209,871,1338
2021,Luton 021B,E01015790,1522,369,1153
2021,Luton 021D,E01015792,1776,457,1319
2021,Luton 021E,E01015793,1676,332,1344
2021,Luton 021F,E01015795,2469,677,1792
2021,Luton 012F,E01015796,1401,204,1197
2021,Luton 008A,E01015797,1242,189,1053
2021,Luton 008B,E01015798,1300,252,1048
2021,Luton 008C,E01015799,1323,217,1106
2021,Luton 008D,E01015800,1354,227,1127
2021,Luton 002A,E01015801,1771,453,1318
2021,Luton 003F,E01015802,1517,387,1130
2021,Luton 002B,E01015803,1513,290,1223
2021,Luton 002C,E01015804,1817,483,1334
2021,Luton 002D,E01015805,1219,233,986
2021,Luton 014C,E01015806,1291,187,1104
2021,Luton 016G,E01015807,1611,450,1161
2021,Luton 014D,E01015808,1356,241,1115
2021,Luton 014E,E01015809,1362,263,1099
2021,Luton 014F,E01015810,1300,307,993
2021,Luton 014G,E01015811,1365,272,1093
2021,Luton 008E,E01015812,1272,243,1029
2021,Luton 008F,E01015813,1283,174,1109
2021,Southend-on-Sea 003A,E01015814,1326,218,1108
2021,Southend-on-Sea 003B,E01015815,1563,312,1251
2021,Southend-on-Sea 003C,E01015816,1521,190,1331
2021,Southend-on-Sea 003D,E01015817,1602,228,1374
2021,Southend-on-Sea 003E,E01015818,1635,240,1395
2021,Southend-on-Sea 003F,E01015819,1397,267,1130
2021,Southend-on-Sea 005A,E01015820,1599,378,1221
2021,Southend-on-Sea 005B,E01015821,1574,232,1342
2021,Southend-on-Sea 005C,E01015822,1201,257,944
2021,Southend-on-Sea 005D,E01015823,1628,277,1351
2021,Southend-on-Sea 005E,E01015824,1474,345,1129
2021,Southend-on-Sea 005F,E01015825,1545,332,1213
2021,Southend-on-Sea 005G,E01015826,1348,265,1083
2021,Southend-on-Sea 012A,E01015827,1652,240,1412
2021,Southend-on-Sea 012B,E01015828,1668,184,1484
2021,Southend-on-Sea 012C,E01015829,1480,260,1220
2021,Southend-on-Sea 012D,E01015830,1465,252,1213
2021,Southend-on-Sea 012E,E01015831,1609,298,1311
2021,Southend-on-Sea 012F,E01015832,1556,220,1336
2021,Southend-on-Sea 001A,E01015833,1498,239,1259
2021,Southend-on-Sea 001B,E01015834,1381,198,1183
2021,Southend-on-Sea 001C,E01015835,1643,274,1369
2021,Southend-on-Sea 001D,E01015836,1449,212,1237
2021,Southend-on-Sea 001E,E01015837,1627,269,1358
2021,Southend-on-Sea 001F,E01015838,1410,193,1217
2021,Southend-on-Sea 014A,E01015839,1765,347,1418
2021,Southend-on-Sea 014B,E01015840,1685,344,1341
2021,Southend-on-Sea 014C,E01015841,2366,492,1874
2021,Southend-on-Sea 014D,E01015842,1832,406,1426
2021,Southend-on-Sea 014E,E01015843,1567,299,1268
2021,Southend-on-Sea 014F,E01015844,1998,366,1632
2021,Southend-on-Sea 011A,E01015845,1491,284,1207
2021,Southend-on-Sea 011B,E01015846,1654,278,1376
2021,Southend-on-Sea 011C,E01015847,1516,244,1272
2021,Southend-on-Sea 011D,E01015848,1606,150,1456
2021,Southend-on-Sea 011E,E01015849,1609,295,1314
2021,Southend-on-Sea 011F,E01015850,1491,294,1197
2021,Southend-on-Sea 015A,E01015851,1593,144,1449
2021,Southend-on-Sea 015B,E01015852,1987,298,1689
2021,Southend-on-Sea 015C,E01015853,1741,230,1511
2021,Southend-on-Sea 015D,E01015854,2035,663,1372
2021,Southend-on-Sea 015E,E01015855,1938,368,1570
2021,Southend-on-Sea 015F,E01015856,1748,319,1429
2021,Southend-on-Sea 004A,E01015857,1566,270,1296
2021,Southend-on-Sea 004B,E01015858,1735,356,1379
2021,Southend-on-Sea 004C,E01015859,1840,398,1442
2021,Southend-on-Sea 004D,E01015860,1499,273,1226
2021,Southend-on-Sea 004E,E01015861,1844,358,1486
2021,Southend-on-Sea 004F,E01015862,1608,329,1279
2021,Southend-on-Sea 002A,E01015863,2239,454,1785
2021,Southend-on-Sea 002B,E01015864,1379,220,1159
2021,Southend-on-Sea 002C,E01015865,1391,194,1197
2021,Southend-on-Sea 002D,E01015866,2005,332,1673
2021,Southend-on-Sea 002E,E01015867,1375,261,1114
2021,Southend-on-Sea 002F,E01015868,1587,346,1241
2021,Southend-on-Sea 006A,E01015869,1550,370,1180
2021,Southend-on-Sea 006B,E01015870,1520,327,1193
2021,Southend-on-Sea 006C,E01015871,1556,296,1260
2021,Southend-on-Sea 006D,E01015872,1540,296,1244
2021,Southend-on-Sea 006E,E01015873,1179,253,926
2021,Southend-on-Sea 006F,E01015874,1636,294,1342
2021,Southend-on-Sea 006G,E01015875,1528,294,1234
2021,Southend-on-Sea 013A,E01015876,2372,438,1934
2021,Southend-on-Sea 013B,E01015877,1801,336,1465
2021,Southend-on-Sea 013C,E01015878,1198,175,1023
2021,Southend-on-Sea 013D,E01015879,1290,280,1010
2021,Southend-on-Sea 013E,E01015880,1437,292,1145
2021,Southend-on-Sea 013F,E01015881,1322,246,1076
2021,Southend-on-Sea 013G,E01015882,1657,332,1325
2021,Southend-on-Sea 009A,E01015883,1385,256,1129
2021,Southend-on-Sea 009B,E01015884,2207,420,1787
2021,Southend-on-Sea 009C,E01015885,1658,291,1367
2021,Southend-on-Sea 009D,E01015886,1434,377,1057
2021,Southend-on-Sea 009E,E01015887,1494,355,1139
2021,Southend-on-Sea 009F,E01015888,1448,210,1238
2021,Southend-on-Sea 016A,E01015889,1340,192,1148
2021,Southend-on-Sea 016B,E01015890,1483,225,1258
2021,Southend-on-Sea 016C,E01015891,1373,188,1185
2021,Southend-on-Sea 016D,E01015892,1596,348,1248
2021,Southend-on-Sea 016E,E01015893,1479,127,1352
2021,Southend-on-Sea 016F,E01015894,1456,248,1208
2021,Southend-on-Sea 010B,E01015896,1810,390,1420
2021,Southend-on-Sea 010C,E01015897,1913,404,1509
2021,Southend-on-Sea 010D,E01015898,1803,339,1464
2021,Southend-on-Sea 010E,E01015899,1954,419,1535
2021,Southend-on-Sea 010F,E01015900,1627,398,1229
2021,Southend-on-Sea 007A,E01015901,1497,334,1163
2021,Southend-on-Sea 007B,E01015902,1552,299,1253
2021,Southend-on-Sea 007C,E01015903,1508,331,1177
2021,Southend-on-Sea 007D,E01015904,1632,344,1288
2021,Southend-on-Sea 007E,E01015905,1384,268,1116
2021,Southend-on-Sea 007F,E01015906,1433,332,1101
2021,Southend-on-Sea 007G,E01015907,1481,306,1175
2021,Southend-on-Sea 008A,E01015908,1529,302,1227
2021,Southend-on-Sea 008B,E01015909,1456,317,1139
2021,Southend-on-Sea 008C,E01015910,1475,264,1211
2021,Southend-on-Sea 008D,E01015911,1223,233,990
2021,Southend-on-Sea 008E,E01015912,1510,280,1230
2021,Southend-on-Sea 008F,E01015913,1634,254,1380
2021,Southend-on-Sea 017A,E01015914,1256,227,1029
2021,Southend-on-Sea 017B,E01015915,1363,221,1142
2021,Southend-on-Sea 017C,E01015916,1311,374,937
2021,Southend-on-Sea 017D,E01015917,1543,382,1161
2021,Southend-on-Sea 017E,E01015918,1329,257,1072
2021,Southend-on-Sea 017F,E01015919,1285,281,1004
2021,Southend-on-Sea 017G,E01015920,1495,215,1280
2021,Thurrock 021A,E01015921,1181,236,945
2021,Thurrock 008A,E01015922,1526,355,1171
2021,Thurrock 008B,E01015923,2127,525,1602
2021,Thurrock 008C,E01015924,1513,340,1173
2021,Thurrock 008D,E01015925,1689,328,1361
2021,Thurrock 008E,E01015926,1985,448,1537
2021,Thurrock 007A,E01015927,1781,479,1302
2021,Thurrock 007B,E01015928,1671,363,1308
2021,Thurrock 007C,E01015929,1441,324,1117
2021,Thurrock 007D,E01015930,1707,419,1288
2021,Thurrock 007E,E01015931,1400,326,1074
2021,Thurrock 006A,E01015932,1750,370,1380
2021,Thurrock 012A,E01015933,1684,339,1345
2021,Thurrock 012B,E01015934,1417,392,1025
2021,Thurrock 012C,E01015935,1728,465,1263
2021,Thurrock 012D,E01015936,1813,383,1430
2021,Thurrock 012E,E01015937,1516,243,1273
2021,Thurrock 012F,E01015938,1724,409,1315
2021,Thurrock 020A,E01015939,1451,341,1110
2021,Thurrock 020B,E01015941,1375,324,1051
2021,Thurrock 020C,E01015942,1463,287,1176
2021,Thurrock 001A,E01015943,1459,225,1234
2021,Thurrock 001B,E01015944,1233,211,1022
2021,Thurrock 002A,E01015945,1242,211,1031
2021,Thurrock 001C,E01015946,1516,274,1242
2021,Thurrock 013A,E01015947,1356,303,1053
2021,Thurrock 013B,E01015948,2364,602,1762
2021,Thurrock 013C,E01015949,1671,332,1339
2021,Thurrock 013D,E01015950,1682,321,1361
2021,Thurrock 017A,E01015951,1608,413,1195
2021,Thurrock 017B,E01015952,2130,522,1608
2021,Thurrock 017C,E01015953,2418,478,1940
2021,Thurrock 017D,E01015954,2313,645,1668
2021,Thurrock 016A,E01015955,1587,280,1307
2021,Thurrock 016B,E01015956,1998,389,1609
2021,Thurrock 009A,E01015957,1450,294,1156
2021,Thurrock 009B,E01015958,1282,299,983
2021,Thurrock 016C,E01015959,1805,353,1452
2021,Thurrock 014A,E01015960,1438,278,1160
2021,Thurrock 016D,E01015961,1551,328,1223
2021,Thurrock 016E,E01015962,1713,427,1286
2021,Thurrock 010A,E01015963,1091,265,826
2021,Thurrock 010B,E01015964,1543,296,1247
2021,Thurrock 010C,E01015965,2433,519,1914
2021,Thurrock 010D,E01015966,1570,302,1268
2021,Thurrock 014B,E01015967,1488,263,1225
2021,Thurrock 014C,E01015968,1361,260,1101
2021,Thurrock 014D,E01015969,1726,295,1431
2021,Thurrock 014E,E01015970,1328,298,1030
2021,Thurrock 006B,E01015971,1461,282,1179
2021,Thurrock 006C,E01015972,1784,391,1393
2021,Thurrock 006E,E01015974,1360,265,1095
2021,Thurrock 006F,E01015975,1495,305,1190
2021,Thurrock 007F,E01015976,1672,360,1312
2021,Thurrock 004A,E01015977,1835,320,1515
2021,Thurrock 004B,E01015978,1446,224,1222
2021,Thurrock 004C,E01015979,1387,239,1148
2021,Thurrock 004D,E01015980,1454,231,1223
2021,Thurrock 019A,E01015982,2486,672,1814
2021,Thurrock 002B,E01015983,1390,227,1163
2021,Thurrock 003A,E01015984,1210,205,1005
2021,Thurrock 003B,E01015985,1298,162,1136
2021,Thurrock 003C,E01015986,1441,313,1128
2021,Thurrock 002C,E01015987,1465,358,1107
2021,Thurrock 002D,E01015988,1365,313,1052
2021,Thurrock 005A,E01015989,1396,238,1158
2021,Thurrock 003D,E01015990,1448,252,1196
2021,Thurrock 005B,E01015991,1639,313,1326
2021,Thurrock 005C,E01015992,2612,568,2044
2021,Thurrock 009C,E01015993,1556,352,1204
2021,Thurrock 009D,E01015994,1624,336,1288
2021,Thurrock 009E,E01015995,1610,302,1308
2021,Thurrock 009F,E01015996,1656,403,1253
2021,Thurrock 001D,E01015997,1306,213,1093
2021,Thurrock 002E,E01015998,1452,296,1156
2021,Thurrock 001E,E01015999,1244,221,1023
2021,Thurrock 005D,E01016000,1400,273,1127
2021,Thurrock 003E,E01016001,1321,235,1086
2021,Thurrock 005E,E01016002,1275,220,1055
2021,Thurrock 018A,E01016003,2219,495,1724
2021,Thurrock 018B,E01016004,1788,536,1252
2021,Thurrock 018C,E01016005,1551,453,1098
2021,Thurrock 018D,E01016006,1714,621,1093
2021,Thurrock 018E,E01016007,1831,522,1309
2021,Thurrock 018F,E01016008,1445,385,1060
2021,Thurrock 018G,E01016009,1630,437,1193
2021,Thurrock 018H,E01016010,1420,406,1014
2021,Thurrock 022A,E01016011,1634,357,1277
2021,Thurrock 021C,E01016013,2307,530,1777
2021,Thurrock 021B,E01016014,2595,765,1830
2021,Thurrock 022B,E01016015,2462,611,1851
2021,Medway 015A,E01016016,1405,307,1098
2021,Medway 015B,E01016017,1589,311,1278
2021,Medway 022A,E01016018,1785,501,1284
2021,Medway 015C,E01016019,1667,447,1220
2021,Medway 021A,E01016020,1211,325,886
2021,Medway 021B,E01016021,1507,337,1170
2021,Medway 021C,E01016022,1355,344,1011
2021,Medway 022B,E01016023,1645,506,1139
2021,Medway 022C,E01016024,1843,521,1322
2021,Medway 027A,E01016025,1543,316,1227
2021,Medway 028A,E01016026,1243,210,1033
2021,Medway 028B,E01016027,1442,279,1163
2021,Medway 028C,E01016028,1468,229,1239
2021,Medway 028D,E01016029,2057,393,1664
2021,Medway 010A,E01016030,1749,426,1323
2021,Medway 012A,E01016031,1646,464,1182
2021,Medway 010B,E01016032,1268,369,899
2021,Medway 009A,E01016033,1174,307,867
2021,Medway 010C,E01016034,2370,501,1869
2021,Medway 007A,E01016035,1779,468,1311
2021,Medway 009C,E01016037,1579,414,1165
2021,Medway 010D,E01016038,1512,356,1156
2021,Medway 009D,E01016039,1571,398,1173
2021,Medway 013A,E01016040,1687,387,1300
2021,Medway 012B,E01016041,1636,373,1263
2021,Medway 013B,E01016042,1355,349,1006
2021,Medway 013C,E01016043,1361,263,1098
2021,Medway 016A,E01016044,1644,348,1296
2021,Medway 012C,E01016045,1584,365,1219
2021,Medway 016B,E01016046,1492,304,1188
2021,Medway 016C,E01016047,1656,417,1239
2021,Medway 016D,E01016048,1613,400,1213
2021,Medway 012D,E01016049,1917,453,1464
2021,Medway 035A,E01016050,1604,278,1326
2021,Medway 035B,E01016051,1478,257,1221
2021,Medway 035C,E01016052,1584,264,1320
2021,Medway 035D,E01016053,1531,224,1307
2021,Medway 035E,E01016054,1528,269,1259
2021,Medway 038A,E01016055,1449,300,1149
2021,Medway 038B,E01016056,1347,240,1107
2021,Medway 038C,E01016057,1623,347,1276
2021,Medway 031A,E01016058,1362,210,1152
2021,Medway 031B,E01016059,1225,250,975
2021,Medway 038D,E01016060,1520,266,1254
2021,Medway 020A,E01016061,1527,364,1163
2021,Medway 022D,E01016062,1496,378,1118
2021,Medway 020B,E01016063,1488,346,1142
2021,Medway 020C,E01016064,1604,320,1284
2021,Medway 027B,E01016065,1316,193,1123
2021,Medway 027C,E01016066,1574,367,1207
2021,Medway 027D,E01016067,1559,342,1217
2021,Medway 027E,E01016068,1624,405,1219
2021,Medway 020D,E01016069,1595,359,1236
2021,Medway 001A,E01016070,1592,228,1364
2021,Medway 001B,E01016071,1615,319,1296
2021,Medway 001C,E01016072,1239,218,1021
2021,Medway 003A,E01016073,2156,403,1753
2021,Medway 001D,E01016074,1958,228,1730
2021,Medway 003B,E01016075,1619,285,1334
2021,Medway 003D,E01016077,1522,316,1206
2021,Medway 034A,E01016078,1354,211,1143
2021,Medway 031C,E01016079,1227,238,989
2021,Medway 034B,E01016080,1370,266,1104
2021,Medway 034C,E01016081,1545,346,1199
2021,Medway 034D,E01016082,1415,276,1139
2021,Medway 031D,E01016083,1220,258,962
2021,Medway 031E,E01016084,1387,356,1031
2021,Medway 030A,E01016085,1577,258,1319
2021,Medway 030B,E01016086,1278,241,1037
2021,Medway 029A,E01016087,1697,332,1365
2021,Medway 029B,E01016088,1475,329,1146
2021,Medway 029C,E01016089,1469,244,1225
2021,Medway 029D,E01016090,1458,252,1206
2021,Medway 030C,E01016091,1483,240,1243
2021,Medway 036A,E01016092,1426,249,1177
2021,Medway 023A,E01016093,1723,274,1449
2021,Medway 025A,E01016094,1506,254,1252
2021,Medway 025B,E01016095,1272,249,1023
2021,Medway 023B,E01016096,1452,224,1228
2021,Medway 025C,E01016097,1386,305,1081
2021,Medway 025D,E01016098,1342,232,1110
2021,Medway 036B,E01016099,1435,295,1140
2021,Medway 036C,E01016100,1443,259,1184
2021,Medway 032A,E01016101,1361,286,1075
2021,Medway 025E,E01016102,1359,238,1121
2021,Medway 032B,E01016103,1759,332,1427
2021,Medway 032C,E01016104,1323,273,1050
2021,Medway 036D,E01016105,1333,200,1133
2021,Medway 036E,E01016106,1367,274,1093
2021,Medway 032D,E01016107,1403,270,1133
2021,Medway 015E,E01016111,1589,315,1274
2021,Medway 017A,E01016113,1393,268,1125
2021,Medway 017B,E01016114,1445,336,1109
2021,Medway 017C,E01016115,1858,415,1443
2021,Medway 024A,E01016116,1785,403,1382
2021,Medway 014A,E01016117,1793,335,1458
2021,Medway 017D,E01016118,1640,305,1335
2021,Medway 026A,E01016119,1443,244,1199
2021,Medway 026B,E01016120,1353,291,1062
2021,Medway 033A,E01016121,1425,214,1211
2021,Medway 033B,E01016122,2197,406,1791
2021,Medway 033C,E01016123,1439,232,1207
2021,Medway 026C,E01016124,1693,311,1382
2021,Medway 021D,E01016125,1702,377,1325
2021,Medway 026D,E01016126,1645,347,1298
2021,Medway 024B,E01016127,1414,251,1163
2021,Medway 024C,E01016128,2137,314,1823
2021,Medway 014B,E01016129,1812,303,1509
2021,Medway 014C,E01016130,1757,260,1497
2021,Medway 014D,E01016131,1631,254,1377
2021,Medway 024D,E01016132,1680,332,1348
2021,Medway 005A,E01016133,1314,181,1133
2021,Medway 005B,E01016134,1335,243,1092
2021,Medway 006A,E01016135,1506,264,1242
2021,Medway 006B,E01016136,1613,342,1271
2021,Medway 006C,E01016137,1470,335,1135
2021,Medway 005C,E01016138,1414,220,1194
2021,Medway 005D,E01016139,1595,315,1280
2021,Medway 006D,E01016140,1405,270,1135
2021,Medway 006E,E01016141,1678,371,1307
2021,Medway 002A,E01016142,1279,211,1068
2021,Medway 003E,E01016143,2781,610,2171
2021,Medway 002B,E01016144,1401,204,1197
2021,Medway 002C,E01016145,1296,267,1029
2021,Medway 004B,E01016147,1839,333,1506
2021,Medway 004C,E01016148,2060,418,1642
2021,Medway 002D,E01016149,1456,282,1174
2021,Medway 011A,E01016150,1667,485,1182
2021,Medway 008A,E01016151,1609,340,1269
2021,Medway 008B,E01016152,1462,288,1174
2021,Medway 008C,E01016153,1431,387,1044
2021,Medway 011B,E01016154,1617,318,1299
2021,Medway 008D,E01016155,1571,345,1226
2021,Medway 011C,E01016156,1567,335,1232
2021,Medway 011D,E01016157,2234,526,1708
2021,Medway 011E,E01016158,2260,485,1775
2021,Medway 019A,E01016159,1409,366,1043
2021,Medway 018A,E01016160,1448,296,1152
2021,Medway 018B,E01016161,1480,282,1198
2021,Medway 018C,E01016162,1569,328,1241
2021,Medway 018D,E01016163,1265,265,1000
2021,Medway 018E,E01016164,1394,245,1149
2021,Medway 018F,E01016165,1213,198,1015
2021,Medway 023C,E01016166,1476,280,1196
2021,Medway 023D,E01016167,1380,240,1140
2021,Medway 037A,E01016168,1581,321,1260
2021,Medway 037B,E01016169,1587,335,1252
2021,Medway 038E,E01016170,1494,272,1222
2021,Medway 037C,E01016171,1577,371,1206
2021,Medway 037D,E01016172,1393,249,1144
2021,Medway 033D,E01016173,1621,386,1235
2021,Medway 019B,E01016174,1430,260,1170
2021,Medway 019C,E01016175,1869,331,1538
2021,Medway 030D,E01016176,1433,230,1203
2021,Medway 013D,E01016177,1455,291,1164
2021,Medway 013E,E01016178,1411,293,1118
2021,Medway 019D,E01016179,1275,222,1053
2021,Bracknell Forest 005A,E01016180,1217,235,982
2021,Bracknell Forest 005B,E01016181,1692,415,1277
2021,Bracknell Forest 005C,E01016182,1426,250,1176
2021,Bracknell Forest 005D,E01016183,1283,297,986
2021,Bracknell Forest 002B,E01016185,1358,190,1168
2021,Bracknell Forest 002D,E01016187,1544,273,1271
2021,Bracknell Forest 002E,E01016188,1800,356,1444
2021,Bracknell Forest 003A,E01016190,1527,314,1213
2021,Bracknell Forest 006B,E01016191,1604,334,1270
2021,Bracknell Forest 014A,E01016192,1315,228,1087
2021,Bracknell Forest 015A,E01016193,1202,201,1001
2021,Bracknell Forest 014B,E01016194,1197,209,988
2021,Bracknell Forest 014C,E01016195,1121,212,909
2021,Bracknell Forest 015B,E01016196,2020,379,1641
2021,Bracknell Forest 015C,E01016197,1331,261,1070
2021,Bracknell Forest 015D,E01016198,1109,156,953
2021,Bracknell Forest 015E,E01016199,1114,175,939
2021,Bracknell Forest 008A,E01016200,1228,170,1058
2021,Bracknell Forest 008B,E01016201,1202,174,1028
2021,Bracknell Forest 008C,E01016202,1126,120,1006
2021,Bracknell Forest 008D,E01016203,1231,212,1019
2021,Bracknell Forest 008E,E01016204,1121,216,905
2021,Bracknell Forest 010A,E01016205,1210,205,1005
2021,Bracknell Forest 012A,E01016206,1871,318,1553
2021,Bracknell Forest 013A,E01016207,1917,364,1553
2021,Bracknell Forest 012B,E01016208,2016,360,1656
2021,Bracknell Forest 009A,E01016209,1418,284,1134
2021,Bracknell Forest 009B,E01016210,1192,266,926
2021,Bracknell Forest 011A,E01016212,1247,273,974
2021,Bracknell Forest 009D,E01016213,1038,187,851
2021,Bracknell Forest 009E,E01016214,1265,234,1031
2021,Bracknell Forest 009F,E01016215,1134,254,880
2021,Bracknell Forest 011B,E01016216,1250,241,1009
2021,Bracknell Forest 010B,E01016217,1293,218,1075
2021,Bracknell Forest 010C,E01016218,1315,208,1107
2021,Bracknell Forest 011C,E01016219,1276,228,1048
2021,Bracknell Forest 011D,E01016220,1309,255,1054
2021,Bracknell Forest 011E,E01016221,1207,208,999
2021,Bracknell Forest 005E,E01016222,1187,189,998
2021,Bracknell Forest 006C,E01016223,1171,218,953
2021,Bracknell Forest 006D,E01016224,2017,455,1562
2021,Bracknell Forest 006E,E01016226,1382,253,1129
2021,Bracknell Forest 014D,E01016227,1270,318,952
2021,Bracknell Forest 014E,E01016228,1707,342,1365
2021,Bracknell Forest 012C,E01016229,1090,179,911
2021,Bracknell Forest 012D,E01016230,1859,964,895
2021,Bracknell Forest 010D,E01016231,1835,382,1453
2021,Bracknell Forest 010E,E01016232,1354,242,1112
2021,Bracknell Forest 007B,E01016233,2434,561,1873
2021,Bracknell Forest 013B,E01016234,1055,189,866
2021,Bracknell Forest 013C,E01016235,1177,204,973
2021,Bracknell Forest 013D,E01016236,1426,307,1119
2021,Bracknell Forest 013E,E01016237,1083,189,894
2021,Bracknell Forest 003B,E01016238,1538,222,1316
2021,Bracknell Forest 004A,E01016239,1474,297,1177
2021,Bracknell Forest 004B,E01016240,1562,345,1217
2021,Bracknell Forest 004C,E01016241,1550,366,1184
2021,Bracknell Forest 004D,E01016242,1950,348,1602
2021,Bracknell Forest 003C,E01016243,1330,263,1067
2021,Bracknell Forest 003D,E01016245,2194,426,1768
2021,Bracknell Forest 003E,E01016246,1477,314,1163
2021,Bracknell Forest 003F,E01016247,1639,295,1344
2021,Bracknell Forest 007C,E01016248,1466,311,1155
2021,Bracknell Forest 007E,E01016250,1664,284,1380
2021,Bracknell Forest 001C,E01016252,1448,228,1220
2021,Bracknell Forest 001D,E01016253,1356,294,1062
2021,West Berkshire 011A,E01016254,1416,190,1226
2021,West Berkshire 011B,E01016255,1400,246,1154
2021,West Berkshire 003A,E01016256,1687,289,1398
2021,West Berkshire 003B,E01016257,1309,305,1004
2021,West Berkshire 005A,E01016258,1493,232,1261
2021,West Berkshire 006A,E01016259,1463,258,1205
2021,West Berkshire 006B,E01016260,1614,307,1307
2021,West Berkshire 005B,E01016261,1551,306,1245
2021,West Berkshire 006C,E01016262,1292,245,1047
2021,West Berkshire 007A,E01016263,2270,544,1726
2021,West Berkshire 011C,E01016264,1653,800,853
2021,West Berkshire 011D,E01016265,1483,288,1195
2021,West Berkshire 011E,E01016266,1278,212,1066
2021,West Berkshire 015A,E01016267,1419,284,1135
2021,West Berkshire 015B,E01016268,1621,374,1247
2021,West Berkshire 015C,E01016269,1371,250,1121
2021,West Berkshire 015D,E01016270,1363,329,1034
2021,West Berkshire 008A,E01016271,1398,221,1177
2021,West Berkshire 006D,E01016272,1453,257,1196
2021,West Berkshire 006E,E01016273,1612,331,1281
2021,West Berkshire 008B,E01016274,1380,249,1131
2021,West Berkshire 008C,E01016275,1361,218,1143
2021,West Berkshire 008D,E01016276,1377,233,1144
2021,West Berkshire 001A,E01016277,1555,529,1026
2021,West Berkshire 013A,E01016279,2077,410,1667
2021,West Berkshire 013B,E01016280,1737,321,1416
2021,West Berkshire 013C,E01016281,1346,214,1132
2021,West Berkshire 013D,E01016282,1382,226,1156
2021,West Berkshire 007D,E01016284,1321,233,1088
2021,West Berkshire 007E,E01016285,1552,346,1206
2021,West Berkshire 001B,E01016286,1688,419,1269
2021,West Berkshire 001C,E01016287,1388,252,1136
2021,West Berkshire 001D,E01016288,1662,330,1332
2021,West Berkshire 021A,E01016289,1370,257,1113
2021,West Berkshire 021B,E01016290,1471,290,1181
2021,West Berkshire 021C,E01016291,1794,392,1402
2021,West Berkshire 021D,E01016292,1555,339,1216
2021,West Berkshire 020A,E01016294,1447,243,1204
2021,West Berkshire 020B,E01016295,1391,314,1077
2021,West Berkshire 010A,E01016296,1455,222,1233
2021,West Berkshire 010B,E01016297,1558,285,1273
2021,West Berkshire 010C,E01016298,1115,115,1000
2021,West Berkshire 010D,E01016299,1417,234,1183
2021,West Berkshire 018A,E01016300,1378,245,1133
2021,West Berkshire 018B,E01016301,1959,304,1655
2021,West Berkshire 018C,E01016302,1534,277,1257
2021,West Berkshire 002A,E01016303,1414,222,1192
2021,West Berkshire 002B,E01016304,1529,230,1299
2021,West Berkshire 002C,E01016305,1201,152,1049
2021,West Berkshire 002D,E01016306,1294,258,1036
2021,West Berkshire 022A,E01016307,1619,313,1306
2021,West Berkshire 022B,E01016308,1856,364,1492
2021,West Berkshire 022C,E01016309,2287,483,1804
2021,West Berkshire 012A,E01016310,1896,290,1606
2021,West Berkshire 012B,E01016311,1618,230,1388
2021,West Berkshire 020C,E01016312,1902,339,1563
2021,West Berkshire 003C,E01016313,1598,276,1322
2021,West Berkshire 003D,E01016314,1528,386,1142
2021,West Berkshire 004A,E01016315,1561,221,1340
2021,West Berkshire 004B,E01016316,1970,377,1593
2021,West Berkshire 004C,E01016317,1462,275,1187
2021,West Berkshire 004D,E01016318,1413,235,1178
2021,West Berkshire 020D,E01016319,1746,300,1446
2021,West Berkshire 020E,E01016320,1370,232,1138
2021,West Berkshire 021E,E01016321,1555,294,1261
2021,West Berkshire 021F,E01016322,1388,336,1052
2021,West Berkshire 012C,E01016323,1324,210,1114
2021,West Berkshire 012D,E01016324,1356,238,1118
2021,West Berkshire 012E,E01016325,1442,274,1168
2021,West Berkshire 018D,E01016326,1338,226,1112
2021,West Berkshire 009A,E01016327,1161,205,956
2021,West Berkshire 009B,E01016328,1813,360,1453
2021,West Berkshire 014A,E01016329,1346,195,1151
2021,West Berkshire 016A,E01016330,1319,182,1137
2021,West Berkshire 016B,E01016331,1437,328,1109
2021,West Berkshire 016C,E01016332,1485,233,1252
2021,West Berkshire 017A,E01016333,1208,248,960
2021,West Berkshire 016D,E01016334,1625,330,1295
2021,West Berkshire 017B,E01016335,1430,288,1142
2021,West Berkshire 016E,E01016336,1235,251,984
2021,West Berkshire 017C,E01016337,2231,566,1665
2021,West Berkshire 017D,E01016338,1681,290,1391
2021,West Berkshire 011F,E01016339,2699,518,2181
2021,West Berkshire 014B,E01016340,1823,331,1492
2021,West Berkshire 014C,E01016341,1277,239,1038
2021,West Berkshire 014D,E01016342,1895,301,1594
2021,West Berkshire 014E,E01016343,1343,168,1175
2021,West Berkshire 009C,E01016344,1493,216,1277
2021,West Berkshire 009D,E01016345,1408,258,1150
2021,West Berkshire 019B,E01016346,1371,136,1235
2021,West Berkshire 019D,E01016348,2227,329,1898
2021,West Berkshire 005C,E01016349,1207,222,985
2021,West Berkshire 005D,E01016350,1431,249,1182
2021,Reading 019C,E01016353,1952,299,1653
2021,Reading 007A,E01016355,1806,257,1549
2021,Reading 008A,E01016356,1522,285,1237
2021,Reading 008B,E01016357,1690,271,1419
2021,Reading 007B,E01016358,1781,277,1504
2021,Reading 007C,E01016359,2564,570,1994
2021,Reading 007D,E01016360,2386,473,1913
2021,Reading 007E,E01016361,1946,418,1528
2021,Reading 004A,E01016362,1695,214,1481
2021,Reading 004B,E01016363,1799,480,1319
2021,Reading 003A,E01016364,1358,253,1105
2021,Reading 004C,E01016365,1586,212,1374
2021,Reading 004D,E01016366,1493,281,1212
2021,Reading 004E,E01016367,1557,284,1273
2021,Reading 017A,E01016368,1479,379,1100
2021,Reading 018A,E01016369,1689,340,1349
2021,Reading 016A,E01016370,3473,2582,891
2021,Reading 016B,E01016371,1635,419,1216
2021,Reading 017B,E01016372,1329,322,1007
2021,Reading 016C,E01016373,1522,398,1124
2021,Reading 014A,E01016374,1667,278,1389
2021,Reading 014B,E01016375,1210,246,964
2021,Reading 014C,E01016376,1792,408,1384
2021,Reading 017C,E01016377,1682,373,1309
2021,Reading 014D,E01016379,2006,349,1657
2021,Reading 005A,E01016380,1632,298,1334
2021,Reading 006A,E01016381,1458,359,1099
2021,Reading 006B,E01016382,1797,390,1407
2021,Reading 005B,E01016383,1459,243,1216
2021,Reading 005C,E01016384,1596,280,1316
2021,Reading 006C,E01016385,1577,317,1260
2021,Reading 002A,E01016386,1462,288,1174
2021,Reading 002B,E01016387,1503,306,1197
2021,Reading 013A,E01016388,1410,224,1186
2021,Reading 013B,E01016389,1707,481,1226
2021,Reading 013C,E01016390,1525,220,1305
2021,Reading 020E,E01016391,1954,331,1623
2021,Reading 013D,E01016392,2107,300,1807
2021,Reading 013E,E01016393,1846,371,1475
2021,Reading 009A,E01016394,1428,395,1033
2021,Reading 008C,E01016395,1344,252,1092
2021,Reading 006D,E01016396,1545,304,1241
2021,Reading 006E,E01016397,1661,437,1224
2021,Reading 008D,E01016398,1645,324,1321
2021,Reading 008E,E01016399,1424,279,1145
2021,Reading 008F,E01016400,1567,288,1279
2021,Reading 012A,E01016401,1390,400,990
2021,Reading 010B,E01016402,1787,790,997
2021,Reading 012B,E01016403,2033,626,1407
2021,Reading 010C,E01016404,2041,450,1591
2021,Reading 010D,E01016405,2031,459,1572
2021,Reading 010E,E01016406,1524,557,967
2021,Reading 001A,E01016407,1489,308,1181
2021,Reading 001B,E01016408,1389,251,1138
2021,Reading 003B,E01016409,1757,362,1395
2021,Reading 001C,E01016410,1687,309,1378
2021,Reading 001D,E01016411,1591,301,1290
2021,Reading 001E,E01016412,1464,309,1155
2021,Reading 014E,E01016413,1719,837,882
2021,Reading 014F,E01016414,1759,489,1270
2021,Reading 016D,E01016415,1615,423,1192
2021,Reading 012C,E01016416,1949,888,1061
2021,Reading 012D,E01016417,1695,892,803
2021,Reading 012E,E01016418,1560,835,725
2021,Reading 015A,E01016419,1962,340,1622
2021,Reading 015B,E01016420,1452,377,1075
2021,Reading 015C,E01016421,1235,211,1024
2021,Reading 015D,E01016422,1341,260,1081
2021,Reading 015E,E01016423,1493,344,1149
2021,Reading 015F,E01016424,1347,257,1090
2021,Reading 002C,E01016425,1670,403,1267
2021,Reading 002D,E01016426,1396,341,1055
2021,Reading 003C,E01016427,1623,394,1229
2021,Reading 003D,E01016428,1814,411,1403
2021,Reading 003E,E01016429,1566,337,1229
2021,Reading 002E,E01016430,1390,362,1028
2021,Reading 005D,E01016431,1593,330,1263
2021,Reading 005E,E01016432,1414,258,1156
2021,Reading 009B,E01016433,1396,249,1147
2021,Reading 009C,E01016434,1930,427,1503
2021,Reading 009D,E01016435,1450,307,1143
2021,Reading 009E,E01016436,1501,291,1210
2021,Reading 018B,E01016437,1346,298,1048
2021,Reading 017D,E01016438,1331,336,995
2021,Reading 018C,E01016439,1840,394,1446
2021,Reading 018D,E01016440,1433,269,1164
2021,Reading 018E,E01016441,1437,331,1106
2021,Reading 017F,E01016443,1526,407,1119
2021,Slough 004A,E01016444,1661,524,1137
2021,Slough 004B,E01016445,1781,526,1255
2021,Slough 004C,E01016446,1613,468,1145
2021,Slough 004D,E01016447,1747,475,1272
2021,Slough 004E,E01016448,2246,508,1738
2021,Slough 004F,E01016449,2321,738,1583
2021,Slough 001A,E01016450,1503,415,1088
2021,Slough 001B,E01016451,1727,578,1149
2021,Slough 001C,E01016452,1841,521,1320
2021,Slough 001D,E01016453,1593,396,1197
2021,Slough 001E,E01016454,1560,458,1102
2021,Slough 001F,E01016455,1947,608,1339
2021,Slough 016D,E01016456,2093,459,1634
2021,Slough 016C,E01016457,1902,520,1382
2021,Slough 015A,E01016458,1746,478,1268
2021,Slough 016A,E01016460,1957,506,1451
2021,Slough 009A,E01016462,2369,616,1753
2021,Slough 009B,E01016463,1876,551,1325
2021,Slough 009C,E01016464,2056,578,1478
2021,Slough 009D,E01016465,2652,709,1943
2021,Slough 006A,E01016467,1472,380,1092
2021,Slough 006B,E01016468,1851,493,1358
2021,Slough 006C,E01016469,1696,407,1289
2021,Slough 006D,E01016470,1659,382,1277
2021,Slough 006E,E01016471,1393,339,1054
2021,Slough 006F,E01016472,1670,425,1245
2021,Slough 008A,E01016473,2539,726,1813
2021,Slough 008B,E01016474,1938,439,1499
2021,Slough 008C,E01016475,2078,556,1522
2021,Slough 008D,E01016476,1658,437,1221
2021,Slough 008E,E01016477,2545,695,1850
2021,Slough 008F,E01016478,1803,475,1328
2021,Slough 014A,E01016479,1539,426,1113
2021,Slough 014B,E01016480,1361,365,996
2021,Slough 014C,E01016481,1415,264,1151
2021,Slough 014D,E01016482,1617,296,1321
2021,Slough 002A,E01016483,1922,550,1372
2021,Slough 002B,E01016484,1705,433,1272
2021,Slough 002C,E01016485,1738,476,1262
2021,Slough 002D,E01016486,1559,405,1154
2021,Slough 002E,E01016487,1715,369,1346
2021,Slough 002F,E01016488,1787,452,1335
2021,Slough 013B,E01016490,1876,479,1397
2021,Slough 013C,E01016491,1693,395,1298
2021,Slough 013D,E01016492,1674,412,1262
2021,Slough 003A,E01016493,1179,241,938
2021,Slough 003B,E01016494,1742,389,1353
2021,Slough 003C,E01016495,1359,270,1089
2021,Slough 003D,E01016496,1271,297,974
2021,Slough 003E,E01016497,1364,285,1079
2021,Slough 003F,E01016498,1555,372,1183
2021,Slough 003G,E01016499,1274,335,939
2021,Slough 012A,E01016500,1835,522,1313
2021,Slough 012B,E01016501,1673,447,1226
2021,Slough 012C,E01016502,1502,438,1064
2021,Slough 012D,E01016503,1573,397,1176
2021,Slough 012E,E01016504,1422,265,1157
2021,Slough 012F,E01016505,1713,488,1225
2021,Slough 010A,E01016506,1689,383,1306
2021,Slough 010B,E01016507,1786,529,1257
2021,Slough 010C,E01016508,2052,576,1476
2021,Slough 010D,E01016509,1567,390,1177
2021,Slough 010E,E01016510,2010,475,1535
2021,Slough 011A,E01016511,2204,434,1770
2021,Slough 011D,E01016514,1873,350,1523
2021,Slough 011E,E01016515,1982,498,1484
2021,Slough 005A,E01016516,1809,530,1279
2021,Slough 005B,E01016517,1598,435,1163
2021,Slough 005C,E01016518,1768,436,1332
2021,Slough 005D,E01016519,2746,733,2013
2021,Slough 005E,E01016520,1645,449,1196
2021,Slough 005F,E01016521,1968,488,1480
2021,Windsor and Maidenhead 017A,E01016522,1820,382,1438
2021,Windsor and Maidenhead 017B,E01016523,1524,380,1144
2021,Windsor and Maidenhead 017C,E01016524,2039,468,1571
2021,Windsor and Maidenhead 005A,E01016525,1670,318,1352
2021,Windsor and Maidenhead 006A,E01016526,1702,359,1343
2021,Windsor and Maidenhead 006B,E01016527,1508,254,1254
2021,Windsor and Maidenhead 005B,E01016528,1601,330,1271
2021,Windsor and Maidenhead 005C,E01016529,2011,367,1644
2021,Windsor and Maidenhead 002A,E01016530,1499,301,1198
2021,Windsor and Maidenhead 002B,E01016531,1377,207,1170
2021,Windsor and Maidenhead 002C,E01016532,1831,294,1537
2021,Windsor and Maidenhead 002D,E01016533,1797,333,1464
2021,Windsor and Maidenhead 006C,E01016534,1558,317,1241
2021,Windsor and Maidenhead 007A,E01016535,1275,284,991
2021,Windsor and Maidenhead 005D,E01016536,1798,279,1519
2021,Windsor and Maidenhead 007B,E01016537,1696,398,1298
2021,Windsor and Maidenhead 007C,E01016538,1470,284,1186
2021,Windsor and Maidenhead 009A,E01016539,1549,274,1275
2021,Windsor and Maidenhead 009B,E01016540,1546,275,1271
2021,Windsor and Maidenhead 009C,E01016541,1284,230,1054
2021,Windsor and Maidenhead 009D,E01016542,1164,248,916
2021,Windsor and Maidenhead 009E,E01016543,1871,505,1366
2021,Windsor and Maidenhead 010A,E01016544,1926,219,1707
2021,Windsor and Maidenhead 012A,E01016545,2020,264,1756
2021,Windsor and Maidenhead 015A,E01016546,1538,232,1306
2021,Windsor and Maidenhead 012B,E01016547,1613,277,1336
2021,Windsor and Maidenhead 014A,E01016548,1809,336,1473
2021,Windsor and Maidenhead 014B,E01016549,1909,350,1559
2021,Windsor and Maidenhead 012C,E01016550,1408,272,1136
2021,Windsor and Maidenhead 013A,E01016551,1501,234,1267
2021,Windsor and Maidenhead 012D,E01016552,1654,319,1335
2021,Windsor and Maidenhead 013B,E01016553,1436,224,1212
2021,Windsor and Maidenhead 014C,E01016554,1663,365,1298
2021,Windsor and Maidenhead 014D,E01016555,1541,348,1193
2021,Windsor and Maidenhead 014E,E01016556,1755,352,1403
2021,Windsor and Maidenhead 013C,E01016557,1829,317,1512
2021,Windsor and Maidenhead 013D,E01016558,1286,311,975
2021,Windsor and Maidenhead 008A,E01016559,1419,295,1124
2021,Windsor and Maidenhead 008B,E01016560,1452,311,1141
2021,Windsor and Maidenhead 008C,E01016561,1707,366,1341
2021,Windsor and Maidenhead 008D,E01016562,1307,253,1054
2021,Windsor and Maidenhead 008E,E01016563,1278,260,1018
2021,Windsor and Maidenhead 011A,E01016564,1665,334,1331
2021,Windsor and Maidenhead 011B,E01016565,1594,277,1317
2021,Windsor and Maidenhead 011C,E01016566,1617,285,1332
2021,Windsor and Maidenhead 010B,E01016567,3082,1552,1530
2021,Windsor and Maidenhead 010C,E01016568,1220,228,992
2021,Windsor and Maidenhead 010D,E01016569,994,130,864
2021,Windsor and Maidenhead 001A,E01016570,1512,312,1200
2021,Windsor and Maidenhead 003A,E01016571,1713,397,1316
2021,Windsor and Maidenhead 001B,E01016572,1312,249,1063
2021,Windsor and Maidenhead 003B,E01016573,1426,328,1098
2021,Windsor and Maidenhead 003C,E01016574,1492,334,1158
2021,Windsor and Maidenhead 016A,E01016575,1820,274,1546
2021,Windsor and Maidenhead 016B,E01016576,1746,301,1445
2021,Windsor and Maidenhead 011D,E01016577,1750,286,1464
2021,Windsor and Maidenhead 002E,E01016578,1647,305,1342
2021,Windsor and Maidenhead 002F,E01016579,1720,307,1413
2021,Windsor and Maidenhead 008F,E01016580,1470,285,1185
2021,Windsor and Maidenhead 002G,E01016581,1392,247,1145
2021,Windsor and Maidenhead 001C,E01016582,1512,337,1175
2021,Windsor and Maidenhead 004A,E01016583,1801,284,1517
2021,Windsor and Maidenhead 005E,E01016584,2173,451,1722
2021,Windsor and Maidenhead 004B,E01016585,1596,197,1399
2021,Windsor and Maidenhead 004C,E01016586,1301,187,1114
2021,Windsor and Maidenhead 016C,E01016587,1669,312,1357
2021,Windsor and Maidenhead 016D,E01016588,1742,294,1448
2021,Windsor and Maidenhead 016E,E01016589,1678,291,1387
2021,Windsor and Maidenhead 004D,E01016591,2161,437,1724
2021,Windsor and Maidenhead 004E,E01016592,1932,275,1657
2021,Windsor and Maidenhead 007D,E01016593,1706,373,1333
2021,Windsor and Maidenhead 007E,E01016594,1469,295,1174
2021,Windsor and Maidenhead 015B,E01016595,1704,372,1332
2021,Windsor and Maidenhead 015C,E01016596,1881,338,1543
2021,Windsor and Maidenhead 015D,E01016597,1649,362,1287
2021,Windsor and Maidenhead 006D,E01016598,1389,284,1105
2021,Windsor and Maidenhead 003D,E01016599,1584,364,1220
2021,Windsor and Maidenhead 001D,E01016600,1075,196,879
2021,Windsor and Maidenhead 006E,E01016601,1572,358,1214
2021,Windsor and Maidenhead 006F,E01016602,1595,339,1256
2021,Windsor and Maidenhead 018A,E01016603,1718,331,1387
2021,Windsor and Maidenhead 018B,E01016604,2180,436,1744
2021,Windsor and Maidenhead 018C,E01016605,1508,345,1163
2021,Windsor and Maidenhead 018D,E01016606,1619,345,1274
2021,Windsor and Maidenhead 018E,E01016607,1913,692,1221
2021,Windsor and Maidenhead 018F,E01016608,1874,348,1526
2021,Windsor and Maidenhead 017D,E01016609,1754,365,1389
2021,Wokingham 018B,E01016611,1755,373,1382
2021,Wokingham 015A,E01016612,2552,556,1996
2021,Wokingham 006A,E01016613,1442,326,1116
2021,Wokingham 006B,E01016614,1453,284,1169
2021,Wokingham 005A,E01016615,1430,307,1123
2021,Wokingham 005B,E01016616,1557,256,1301
2021,Wokingham 005C,E01016617,1932,465,1467
2021,Wokingham 006C,E01016618,1265,284,981
2021,Wokingham 002A,E01016619,1571,352,1219
2021,Wokingham 002B,E01016620,1433,342,1091
2021,Wokingham 003A,E01016621,1460,313,1147
2021,Wokingham 004A,E01016622,1120,211,909
2021,Wokingham 003B,E01016623,1438,282,1156
2021,Wokingham 003C,E01016624,1357,262,1095
2021,Wokingham 016A,E01016625,1665,307,1358
2021,Wokingham 013A,E01016626,2002,351,1651
2021,Wokingham 010A,E01016627,1958,397,1561
2021,Wokingham 010B,E01016628,2392,552,1840
2021,Wokingham 015B,E01016629,1355,273,1082
2021,Wokingham 015C,E01016630,1427,301,1126
2021,Wokingham 016B,E01016631,1268,280,988
2021,Wokingham 016C,E01016632,1750,393,1357
2021,Wokingham 019A,E01016633,1306,271,1035
2021,Wokingham 016D,E01016634,1914,307,1607
2021,Wokingham 015D,E01016635,1343,315,1028
2021,Wokingham 019B,E01016636,1411,270,1141
2021,Wokingham 019C,E01016637,1103,222,881
2021,Wokingham 019D,E01016638,1220,271,949
2021,Wokingham 019E,E01016639,1513,276,1237
2021,Wokingham 019F,E01016640,1541,249,1292
2021,Wokingham 019G,E01016643,1346,312,1034
2021,Wokingham 011A,E01016644,1353,353,1000
2021,Wokingham 011B,E01016645,1459,226,1233
2021,Wokingham 011C,E01016646,1527,323,1204
2021,Wokingham 009A,E01016647,1756,407,1349
2021,Wokingham 011D,E01016648,1382,291,1091
2021,Wokingham 011E,E01016649,1366,273,1093
2021,Wokingham 012A,E01016651,1405,300,1105
2021,Wokingham 008B,E01016652,1197,262,935
2021,Wokingham 008C,E01016653,1341,294,1047
2021,Wokingham 012B,E01016654,1305,216,1089
2021,Wokingham 012C,E01016655,1228,259,969
2021,Wokingham 010C,E01016656,1418,275,1143
2021,Wokingham 004B,E01016657,1373,291,1082
2021,Wokingham 004C,E01016658,2495,555,1940
2021,Wokingham 004D,E01016659,1307,214,1093
2021,Wokingham 004E,E01016660,1581,317,1264
2021,Wokingham 007A,E01016661,1240,218,1022
2021,Wokingham 005D,E01016662,1657,390,1267
2021,Wokingham 007B,E01016663,1521,315,1206
2021,Wokingham 006D,E01016664,1249,321,928
2021,Wokingham 008D,E01016665,1505,334,1171
2021,Wokingham 008E,E01016666,1337,332,1005
2021,Wokingham 006E,E01016668,1626,395,1231
2021,Wokingham 006F,E01016669,1865,420,1445
2021,Wokingham 014A,E01016670,2600,544,2056
2021,Wokingham 013B,E01016671,2030,238,1792
2021,Wokingham 014B,E01016672,2563,561,2002
2021,Wokingham 013C,E01016673,1732,338,1394
2021,Wokingham 013D,E01016674,1690,385,1305
2021,Wokingham 001B,E01016676,1511,290,1221
2021,Wokingham 001D,E01016678,1380,256,1124
2021,Wokingham 012D,E01016679,2142,469,1673
2021,Wokingham 012E,E01016680,1274,289,985
2021,Wokingham 003D,E01016684,1527,264,1263
2021,Wokingham 003E,E01016685,1560,282,1278
2021,Wokingham 007C,E01016686,1070,211,859
2021,Wokingham 007D,E01016687,1165,211,954
2021,Wokingham 007E,E01016688,1939,439,1500
2021,Wokingham 007F,E01016689,1315,220,1095
2021,Wokingham 017C,E01016690,2056,403,1653
2021,Wokingham 017D,E01016691,1228,225,1003
2021,Wokingham 002C,E01016692,1467,275,1192
2021,Wokingham 002D,E01016693,1297,228,1069
2021,Wokingham 002E,E01016694,1509,292,1217
2021,Wokingham 002F,E01016695,1526,364,1162
2021,Wokingham 013E,E01016696,1727,233,1494
2021,Wokingham 016E,E01016699,1679,332,1347
2021,Wokingham 010D,E01016700,1892,385,1507
2021,Wokingham 009B,E01016701,1930,436,1494
2021,Wokingham 009C,E01016702,1736,345,1391
2021,Wokingham 009D,E01016703,2517,561,1956
2021,Wokingham 009E,E01016704,2142,466,1676
2021,Wokingham 020A,E01016705,1572,406,1166
2021,Wokingham 020B,E01016706,1607,312,1295
2021,Wokingham 020C,E01016707,1705,333,1372
2021,Wokingham 020D,E01016708,1555,289,1266
2021,Wokingham 020E,E01016709,1601,365,1236
2021,Milton Keynes 030A,E01016710,1887,367,1520
2021,Milton Keynes 031A,E01016711,2732,501,2231
2021,Milton Keynes 031B,E01016713,1648,251,1397
2021,Milton Keynes 030B,E01016714,2070,488,1582
2021,Milton Keynes 031C,E01016715,1657,362,1295
2021,Milton Keynes 030C,E01016716,2399,426,1973
2021,Milton Keynes 013A,E01016717,1575,310,1265
2021,Milton Keynes 014A,E01016718,1794,482,1312
2021,Milton Keynes 011A,E01016719,1359,233,1126
2021,Milton Keynes 013B,E01016720,1493,350,1143
2021,Milton Keynes 009A,E01016721,1643,363,1280
2021,Milton Keynes 011B,E01016722,1514,303,1211
2021,Milton Keynes 013C,E01016723,1516,280,1236
2021,Milton Keynes 013D,E01016724,1702,402,1300
2021,Milton Keynes 021A,E01016725,1539,408,1131
2021,Milton Keynes 018A,E01016726,1700,449,1251
2021,Milton Keynes 021B,E01016727,1673,410,1263
2021,Milton Keynes 021C,E01016728,1950,503,1447
2021,Milton Keynes 014B,E01016729,2142,615,1527
2021,Milton Keynes 016A,E01016731,1494,288,1206
2021,Milton Keynes 016B,E01016732,1334,268,1066
2021,Milton Keynes 018B,E01016733,1693,469,1224
2021,Milton Keynes 024A,E01016734,1592,288,1304
2021,Milton Keynes 024C,E01016736,1364,187,1177
2021,Milton Keynes 027A,E01016737,1627,334,1293
2021,Milton Keynes 027B,E01016738,1825,430,1395
2021,Milton Keynes 027C,E01016739,1387,245,1142
2021,Milton Keynes 027D,E01016740,1360,246,1114
2021,Milton Keynes 027E,E01016741,1553,334,1219
2021,Milton Keynes 032A,E01016742,1859,641,1218
2021,Milton Keynes 032C,E01016744,1671,578,1093
2021,Milton Keynes 030D,E01016745,1559,332,1227
2021,Milton Keynes 032D,E01016746,1717,394,1323
2021,Milton Keynes 028A,E01016748,1993,477,1516
2021,Milton Keynes 028C,E01016750,1535,305,1230
2021,Milton Keynes 028D,E01016751,1540,372,1168
2021,Milton Keynes 025B,E01016752,1599,371,1228
2021,Milton Keynes 025C,E01016753,2096,476,1620
2021,Milton Keynes 026A,E01016754,1565,273,1292
2021,Milton Keynes 025D,E01016755,1737,418,1319
2021,Milton Keynes 026B,E01016756,2150,519,1631
2021,Milton Keynes 026C,E01016757,1449,285,1164
2021,Milton Keynes 026D,E01016758,1595,338,1257
2021,Milton Keynes 002A,E01016759,1545,289,1256
2021,Milton Keynes 002C,E01016761,1439,225,1214
2021,Milton Keynes 005A,E01016762,1264,240,1024
2021,Milton Keynes 007A,E01016763,1273,166,1107
2021,Milton Keynes 005B,E01016764,1369,200,1169
2021,Milton Keynes 009B,E01016765,1560,269,1291
2021,Milton Keynes 005C,E01016766,1310,268,1042
2021,Milton Keynes 005D,E01016767,1243,192,1051
2021,Milton Keynes 014D,E01016768,2359,457,1902
2021,Milton Keynes 007B,E01016769,1284,173,1111
2021,Milton Keynes 007C,E01016770,1468,229,1239
2021,Milton Keynes 005E,E01016771,1292,268,1024
2021,Milton Keynes 009C,E01016772,1280,277,1003
2021,Milton Keynes 007D,E01016773,1801,255,1546
2021,Milton Keynes 020A,E01016774,1670,333,1337
2021,Milton Keynes 020B,E01016775,1604,356,1248
2021,Milton Keynes 015A,E01016776,1311,230,1081
2021,Milton Keynes 020C,E01016777,1542,326,1216
2021,Milton Keynes 020D,E01016778,1650,358,1292
2021,Milton Keynes 037C,E01016780,1597,351,1246
2021,Milton Keynes 037D,E01016781,1426,278,1148
2021,Milton Keynes 035A,E01016783,1783,495,1288
2021,Milton Keynes 016D,E01016784,1691,361,1330
2021,Milton Keynes 003A,E01016786,1373,242,1131
2021,Milton Keynes 003B,E01016787,1603,290,1313
2021,Milton Keynes 003C,E01016788,1499,313,1186
2021,Milton Keynes 003D,E01016789,1278,296,982
2021,Milton Keynes 003E,E01016790,1387,247,1140
2021,Milton Keynes 004A,E01016791,1368,256,1112
2021,Milton Keynes 004B,E01016792,1176,206,970
2021,Milton Keynes 004C,E01016793,1994,384,1610
2021,Milton Keynes 004D,E01016794,1602,259,1343
2021,Milton Keynes 004E,E01016795,1491,270,1221
2021,Milton Keynes 001A,E01016796,1625,298,1327
2021,Milton Keynes 001B,E01016797,1673,245,1428
2021,Milton Keynes 001C,E01016798,1782,333,1449
2021,Milton Keynes 001D,E01016799,1826,369,1457
2021,Milton Keynes 001E,E01016800,1719,339,1380
2021,Milton Keynes 002D,E01016801,1270,196,1074
2021,Milton Keynes 002E,E01016802,1396,209,1187
2021,Milton Keynes 002F,E01016803,1296,208,1088
2021,Milton Keynes 009D,E01016804,1718,386,1332
2021,Milton Keynes 011C,E01016805,1215,135,1080
2021,Milton Keynes 006A,E01016806,1886,525,1361
2021,Milton Keynes 006B,E01016807,1710,389,1321
2021,Milton Keynes 011D,E01016808,1337,276,1061
2021,Milton Keynes 006C,E01016809,1333,258,1075
2021,Milton Keynes 012A,E01016810,1430,362,1068
2021,Milton Keynes 012B,E01016811,1451,512,939
2021,Milton Keynes 010A,E01016812,1489,282,1207
2021,Milton Keynes 015B,E01016813,1280,217,1063
2021,Milton Keynes 015C,E01016815,1245,278,967
2021,Milton Keynes 015D,E01016816,1479,301,1178
2021,Milton Keynes 010B,E01016817,1478,299,1179
2021,Milton Keynes 010C,E01016818,1707,205,1502
2021,Milton Keynes 012C,E01016819,1173,317,856
2021,Milton Keynes 035D,E01016820,1857,431,1426
2021,Milton Keynes 035B,E01016821,1459,339,1120
2021,Milton Keynes 022A,E01016822,1468,327,1141
2021,Milton Keynes 035C,E01016823,1574,293,1281
2021,Milton Keynes 022B,E01016824,1545,355,1190
2021,Milton Keynes 022C,E01016825,1373,280,1093
2021,Milton Keynes 024D,E01016826,1385,290,1095
2021,Milton Keynes 022D,E01016827,1622,309,1313
2021,Milton Keynes 022E,E01016828,1653,283,1370
2021,Milton Keynes 029A,E01016829,1604,381,1223
2021,Milton Keynes 031D,E01016830,1149,178,971
2021,Milton Keynes 029B,E01016831,1474,291,1183
2021,Milton Keynes 029C,E01016832,1171,197,974
2021,Milton Keynes 029D,E01016833,1207,180,1027
2021,Milton Keynes 029E,E01016834,1560,360,1200
2021,Milton Keynes 006D,E01016835,1712,430,1282
2021,Milton Keynes 008A,E01016836,1593,349,1244
2021,Milton Keynes 008B,E01016837,1833,379,1454
2021,Milton Keynes 008C,E01016838,1566,375,1191
2021,Milton Keynes 012D,E01016839,1708,528,1180
2021,Milton Keynes 008D,E01016841,2279,442,1837
2021,Milton Keynes 023B,E01016842,1438,441,997
2021,Milton Keynes 023C,E01016843,1561,513,1048
2021,Milton Keynes 023D,E01016844,1570,394,1176
2021,Milton Keynes 018C,E01016845,1715,558,1157
2021,Milton Keynes 018D,E01016846,1547,368,1179
2021,Milton Keynes 021D,E01016847,2051,513,1538
2021,Milton Keynes 018E,E01016848,1565,288,1277
2021,Brighton and Hove 026A,E01016849,1495,219,1276
2021,Brighton and Hove 029A,E01016850,1566,264,1302
2021,Brighton and Hove 029B,E01016851,1676,213,1463
2021,Brighton and Hove 026B,E01016852,1547,270,1277
2021,Brighton and Hove 026C,E01016853,1803,221,1582
2021,Brighton and Hove 029C,E01016854,1560,165,1395
2021,Brighton and Hove 026D,E01016855,1529,176,1353
2021,Brighton and Hove 026E,E01016856,1572,190,1382
2021,Brighton and Hove 028A,E01016857,1532,192,1340
2021,Brighton and Hove 028B,E01016858,1417,181,1236
2021,Brighton and Hove 028C,E01016859,1347,126,1221
2021,Brighton and Hove 019A,E01016860,1603,249,1354
2021,Brighton and Hove 031A,E01016861,1531,199,1332
2021,Brighton and Hove 031B,E01016862,1506,254,1252
2021,Brighton and Hove 032A,E01016863,1584,250,1334
2021,Brighton and Hove 025A,E01016864,1406,272,1134
2021,Brighton and Hove 025B,E01016865,1409,379,1030
2021,Brighton and Hove 025C,E01016866,1428,327,1101
2021,Brighton and Hove 025D,E01016867,1301,237,1064
2021,Brighton and Hove 025E,E01016868,1526,336,1190
2021,Brighton and Hove 032B,E01016869,1858,383,1475
2021,Brighton and Hove 020A,E01016870,1534,263,1271
2021,Brighton and Hove 019B,E01016871,1698,213,1485
2021,Brighton and Hove 019C,E01016872,1696,236,1460
2021,Brighton and Hove 019D,E01016873,1717,226,1491
2021,Brighton and Hove 020B,E01016874,1812,269,1543
2021,Brighton and Hove 020C,E01016875,1487,346,1141
2021,Brighton and Hove 020D,E01016876,1720,281,1439
2021,Brighton and Hove 020E,E01016877,1734,250,1484
2021,Brighton and Hove 019E,E01016878,1769,264,1505
2021,Brighton and Hove 013A,E01016879,1449,339,1110
2021,Brighton and Hove 013B,E01016880,1319,368,951
2021,Brighton and Hove 013C,E01016881,1482,335,1147
2021,Brighton and Hove 006A,E01016882,1457,335,1122
2021,Brighton and Hove 006B,E01016883,1442,214,1228
2021,Brighton and Hove 006C,E01016884,1598,393,1205
2021,Brighton and Hove 006D,E01016885,1313,303,1010
2021,Brighton and Hove 006E,E01016886,1515,324,1191
2021,Brighton and Hove 013D,E01016887,1392,236,1156
2021,Brighton and Hove 013E,E01016888,1448,333,1115
2021,Brighton and Hove 022A,E01016889,1694,678,1016
2021,Brighton and Hove 015A,E01016890,1851,768,1083
2021,Brighton and Hove 022B,E01016891,1788,642,1146
2021,Brighton and Hove 018A,E01016892,1605,566,1039
2021,Brighton and Hove 018B,E01016893,1743,497,1246
2021,Brighton and Hove 022C,E01016894,1843,680,1163
2021,Brighton and Hove 025F,E01016895,1544,406,1138
2021,Brighton and Hove 022D,E01016896,1603,493,1110
2021,Brighton and Hove 022E,E01016897,1609,451,1158
2021,Brighton and Hove 002A,E01016898,2255,972,1283
2021,Brighton and Hove 002B,E01016899,4123,3393,730
2021,Brighton and Hove 008A,E01016900,1533,482,1051
2021,Brighton and Hove 010A,E01016901,1599,475,1124
2021,Brighton and Hove 008B,E01016902,1508,439,1069
2021,Brighton and Hove 010B,E01016903,1789,632,1157
2021,Brighton and Hove 008C,E01016904,1795,714,1081
2021,Brighton and Hove 008D,E01016905,1625,421,1204
2021,Brighton and Hove 009A,E01016906,1557,411,1146
2021,Brighton and Hove 009B,E01016907,1726,809,917
2021,Brighton and Hove 009C,E01016908,1451,448,1003
2021,Brighton and Hove 008E,E01016909,1679,712,967
2021,Brighton and Hove 009D,E01016910,1331,404,927
2021,Brighton and Hove 009E,E01016911,1425,382,1043
2021,Brighton and Hove 018C,E01016912,1865,867,998
2021,Brighton and Hove 018D,E01016913,1685,783,902
2021,Brighton and Hove 002C,E01016914,2087,1210,877
2021,Brighton and Hove 002D,E01016915,1438,533,905
2021,Brighton and Hove 005A,E01016916,1367,256,1111
2021,Brighton and Hove 005B,E01016917,1325,258,1067
2021,Brighton and Hove 005C,E01016918,1340,269,1071
2021,Brighton and Hove 005D,E01016919,1227,235,992
2021,Brighton and Hove 005E,E01016920,1473,284,1189
2021,Brighton and Hove 012A,E01016921,1567,360,1207
2021,Brighton and Hove 012B,E01016922,1234,265,969
2021,Brighton and Hove 003A,E01016923,1520,272,1248
2021,Brighton and Hove 001A,E01016924,1386,258,1128
2021,Brighton and Hove 004A,E01016925,1458,326,1132
2021,Brighton and Hove 001B,E01016926,1483,372,1111
2021,Brighton and Hove 001C,E01016927,1503,312,1191
2021,Brighton and Hove 003B,E01016928,1593,318,1275
2021,Brighton and Hove 001D,E01016929,1492,309,1183
2021,Brighton and Hove 004B,E01016930,1835,398,1437
2021,Brighton and Hove 001E,E01016931,1548,310,1238
2021,Brighton and Hove 014A,E01016932,1538,355,1183
2021,Brighton and Hove 014B,E01016933,1338,255,1083
2021,Brighton and Hove 010C,E01016934,1266,293,973
2021,Brighton and Hove 014C,E01016935,1526,246,1280
2021,Brighton and Hove 014D,E01016936,1736,462,1274
2021,Brighton and Hove 014E,E01016937,2066,514,1552
2021,Brighton and Hove 024A,E01016938,1842,366,1476
2021,Brighton and Hove 010D,E01016939,1512,384,1128
2021,Brighton and Hove 010E,E01016940,1508,391,1117
2021,Brighton and Hove 030A,E01016941,1904,345,1559
2021,Brighton and Hove 031C,E01016942,1840,445,1395
2021,Brighton and Hove 031D,E01016943,1417,299,1118
2021,Brighton and Hove 031E,E01016944,1586,249,1337
2021,Brighton and Hove 030B,E01016945,1542,285,1257
2021,Brighton and Hove 018E,E01016946,1433,360,1073
2021,Brighton and Hove 030C,E01016947,2024,633,1391
2021,Brighton and Hove 030D,E01016948,1691,405,1286
2021,Brighton and Hove 030E,E01016949,1686,351,1335
2021,Brighton and Hove 024B,E01016950,1713,226,1487
2021,Brighton and Hove 024C,E01016951,1504,261,1243
2021,Brighton and Hove 027A,E01016952,1731,504,1227
2021,Brighton and Hove 027B,E01016953,1496,238,1258
2021,Brighton and Hove 029D,E01016954,1640,239,1401
2021,Brighton and Hove 029E,E01016955,1579,220,1359
2021,Brighton and Hove 033A,E01016956,1487,231,1256
2021,Brighton and Hove 032C,E01016957,2155,469,1686
2021,Brighton and Hove 033B,E01016958,1722,270,1452
2021,Brighton and Hove 033C,E01016959,1438,190,1248
2021,Brighton and Hove 033D,E01016960,1671,222,1449
2021,Brighton and Hove 033E,E01016961,1887,297,1590
2021,Brighton and Hove 033F,E01016962,1596,230,1366
2021,Brighton and Hove 032D,E01016963,1864,310,1554
2021,Brighton and Hove 027C,E01016964,2369,748,1621
2021,Brighton and Hove 015B,E01016966,1678,649,1029
2021,Brighton and Hove 024D,E01016967,1725,266,1459
2021,Brighton and Hove 024E,E01016968,1379,197,1182
2021,Brighton and Hove 027E,E01016969,1784,306,1478
2021,Brighton and Hove 015C,E01016970,1528,398,1130
2021,Brighton and Hove 015D,E01016971,1910,939,971
2021,Brighton and Hove 015E,E01016972,1696,425,1271
2021,Brighton and Hove 012C,E01016973,1442,256,1186
2021,Brighton and Hove 021A,E01016974,1706,322,1384
2021,Brighton and Hove 021B,E01016975,1527,317,1210
2021,Brighton and Hove 013F,E01016976,1524,302,1222
2021,Brighton and Hove 012D,E01016977,1507,306,1201
2021,Brighton and Hove 012E,E01016978,1607,287,1320
2021,Brighton and Hove 016A,E01016979,1734,403,1331
2021,Brighton and Hove 007A,E01016980,1603,380,1223
2021,Brighton and Hove 011A,E01016981,1605,356,1249
2021,Brighton and Hove 007B,E01016982,1249,277,972
2021,Brighton and Hove 007C,E01016983,1437,304,1133
2021,Brighton and Hove 007D,E01016984,1460,296,1164
2021,Brighton and Hove 007E,E01016985,1500,337,1163
2021,Brighton and Hove 028D,E01016986,1569,189,1380
2021,Brighton and Hove 023A,E01016987,1655,289,1366
2021,Brighton and Hove 028E,E01016988,1472,238,1234
2021,Brighton and Hove 023B,E01016989,1445,245,1200
2021,Brighton and Hove 016B,E01016990,1581,296,1285
2021,Brighton and Hove 016C,E01016991,1625,301,1324
2021,Brighton and Hove 021C,E01016992,1674,397,1277
2021,Brighton and Hove 023C,E01016993,1441,283,1158
2021,Brighton and Hove 021D,E01016994,1621,324,1297
2021,Brighton and Hove 023D,E01016995,1662,413,1249
2021,Brighton and Hove 016D,E01016996,1750,408,1342
2021,Brighton and Hove 021E,E01016997,1589,370,1219
2021,Brighton and Hove 003C,E01016998,1440,337,1103
2021,Brighton and Hove 003D,E01016999,1429,273,1156
2021,Brighton and Hove 003E,E01017000,1734,328,1406
2021,Brighton and Hove 004C,E01017001,1511,362,1149
2021,Brighton and Hove 011B,E01017002,1610,305,1305
2021,Brighton and Hove 004D,E01017003,1567,368,1199
2021,Brighton and Hove 011C,E01017004,1618,329,1289
2021,Brighton and Hove 011D,E01017005,1630,358,1272
2021,Brighton and Hove 011E,E01017006,1582,280,1302
2021,Brighton and Hove 017A,E01017007,1480,288,1192
2021,Brighton and Hove 017B,E01017008,1649,227,1422
2021,Brighton and Hove 017C,E01017009,1437,229,1208
2021,Brighton and Hove 017D,E01017010,1717,317,1400
2021,Brighton and Hove 017E,E01017011,1303,303,1000
2021,Brighton and Hove 017F,E01017012,1707,367,1340
2021,Portsmouth 012A,E01017013,1654,385,1269
2021,Portsmouth 008A,E01017014,1470,283,1187
2021,Portsmouth 014A,E01017015,1400,257,1143
2021,Portsmouth 014B,E01017016,1506,296,1210
2021,Portsmouth 014C,E01017017,1378,230,1148
2021,Portsmouth 014D,E01017018,1514,298,1216
2021,Portsmouth 014E,E01017019,1670,339,1331
2021,Portsmouth 014F,E01017020,2229,466,1763
2021,Portsmouth 017A,E01017021,1373,192,1181
2021,Portsmouth 020A,E01017022,1343,392,951
2021,Portsmouth 019A,E01017023,1553,381,1172
2021,Portsmouth 020B,E01017024,1800,702,1098
2021,Portsmouth 019B,E01017025,1856,586,1270
2021,Portsmouth 019C,E01017026,1649,439,1210
2021,Portsmouth 020C,E01017027,1633,682,951
2021,Portsmouth 020D,E01017028,2084,1054,1030
2021,Portsmouth 019D,E01017029,1560,411,1149
2021,Portsmouth 019E,E01017030,1752,707,1045
2021,Portsmouth 028A,E01017031,1835,445,1390
2021,Portsmouth 027C,E01017032,4847,3960,887
2021,Portsmouth 027A,E01017034,2489,1408,1081
2021,Portsmouth 018A,E01017035,1601,445,1156
2021,Portsmouth 013A,E01017036,1416,359,1057
2021,Portsmouth 013B,E01017037,1503,421,1082
2021,Portsmouth 013C,E01017038,1657,473,1184
2021,Portsmouth 028C,E01017039,1752,515,1237
2021,Portsmouth 028B,E01017040,1384,411,973
2021,Portsmouth 011A,E01017041,1350,312,1038
2021,Portsmouth 012B,E01017042,1383,321,1062
2021,Portsmouth 011B,E01017043,1265,308,957
2021,Portsmouth 011C,E01017044,1411,309,1102
2021,Portsmouth 012C,E01017045,1175,227,948
2021,Portsmouth 008B,E01017046,1560,185,1375
2021,Portsmouth 008C,E01017047,1565,321,1244
2021,Portsmouth 008D,E01017048,1426,262,1164
2021,Portsmouth 011D,E01017049,1433,241,1192
2021,Portsmouth 003A,E01017050,1658,308,1350
2021,Portsmouth 002A,E01017051,1976,449,1527
2021,Portsmouth 002B,E01017052,1394,291,1103
2021,Portsmouth 002C,E01017053,1229,299,930
2021,Portsmouth 004A,E01017054,1343,244,1099
2021,Portsmouth 006A,E01017055,1531,270,1261
2021,Portsmouth 006B,E01017056,1300,286,1014
2021,Portsmouth 006C,E01017057,1414,286,1128
2021,Portsmouth 006D,E01017058,1789,422,1367
2021,Portsmouth 026A,E01017059,1517,281,1236
2021,Portsmouth 006E,E01017060,1837,387,1450
2021,Portsmouth 003B,E01017061,1636,242,1394
2021,Portsmouth 026B,E01017062,1587,379,1208
2021,Portsmouth 003C,E01017063,1501,291,1210
2021,Portsmouth 003D,E01017064,1772,310,1462
2021,Portsmouth 026C,E01017066,1769,361,1408
2021,Portsmouth 023A,E01017067,1359,180,1179
2021,Portsmouth 023B,E01017068,1625,207,1418
2021,Portsmouth 023C,E01017069,1426,235,1191
2021,Portsmouth 023D,E01017070,1427,225,1202
2021,Portsmouth 025A,E01017071,1355,318,1037
2021,Portsmouth 025B,E01017072,1367,217,1150
2021,Portsmouth 024A,E01017073,1763,229,1534
2021,Portsmouth 023E,E01017074,1674,321,1353
2021,Portsmouth 012D,E01017075,1482,315,1167
2021,Portsmouth 015A,E01017076,1612,317,1295
2021,Portsmouth 015B,E01017077,1676,309,1367
2021,Portsmouth 015C,E01017078,1452,323,1129
2021,Portsmouth 015D,E01017079,1461,354,1107
2021,Portsmouth 015E,E01017080,1907,623,1284
2021,Portsmouth 015F,E01017081,1524,396,1128
2021,Portsmouth 012E,E01017082,1667,366,1301
2021,Portsmouth 012F,E01017083,1632,345,1287
2021,Portsmouth 009A,E01017084,1346,255,1091
2021,Portsmouth 008E,E01017085,1340,185,1155
2021,Portsmouth 007A,E01017086,1284,247,1037
2021,Portsmouth 009B,E01017087,1329,237,1092
2021,Portsmouth 009C,E01017088,1734,346,1388
2021,Portsmouth 007B,E01017089,1493,347,1146
2021,Portsmouth 007C,E01017090,1661,357,1304
2021,Portsmouth 007D,E01017091,1544,298,1246
2021,Portsmouth 007E,E01017092,1424,233,1191
2021,Portsmouth 017B,E01017093,1061,186,875
2021,Portsmouth 021A,E01017094,1395,290,1105
2021,Portsmouth 021B,E01017095,1694,299,1395
2021,Portsmouth 017C,E01017096,1300,208,1092
2021,Portsmouth 021C,E01017097,1458,264,1194
2021,Portsmouth 021D,E01017098,1390,284,1106
2021,Portsmouth 017D,E01017099,2474,589,1885
2021,Portsmouth 017E,E01017100,1278,255,1023
2021,Portsmouth 017F,E01017101,1421,297,1124
2021,Portsmouth 013D,E01017102,1629,301,1328
2021,Portsmouth 013E,E01017103,1188,326,862
2021,Portsmouth 010A,E01017104,1124,214,910
2021,Portsmouth 009D,E01017105,1479,264,1215
2021,Portsmouth 010B,E01017106,1425,300,1125
2021,Portsmouth 009E,E01017107,1531,346,1185
2021,Portsmouth 010C,E01017108,1502,271,1231
2021,Portsmouth 010D,E01017109,1334,224,1110
2021,Portsmouth 011E,E01017110,1366,263,1103
2021,Portsmouth 011F,E01017111,1514,305,1209
2021,Portsmouth 001A,E01017112,1737,429,1308
2021,Portsmouth 004B,E01017113,1568,277,1291
2021,Portsmouth 004C,E01017114,1422,133,1289
2021,Portsmouth 001B,E01017115,1316,325,991
2021,Portsmouth 004D,E01017116,1646,416,1230
2021,Portsmouth 001C,E01017117,1455,368,1087
2021,Portsmouth 002D,E01017118,1426,316,1110
2021,Portsmouth 001D,E01017119,1596,340,1256
2021,Portsmouth 001E,E01017120,1580,384,1196
2021,Portsmouth 025C,E01017121,1560,316,1244
2021,Portsmouth 022A,E01017122,1618,285,1333
2021,Portsmouth 024B,E01017123,1900,281,1619
2021,Portsmouth 020E,E01017124,1537,349,1188
2021,Portsmouth 022B,E01017125,1595,267,1328
2021,Portsmouth 025D,E01017126,1618,349,1269
2021,Portsmouth 022C,E01017127,1758,376,1382
2021,Portsmouth 018B,E01017128,1666,816,850
2021,Portsmouth 018C,E01017129,1848,1033,815
2021,Portsmouth 018D,E01017130,2115,873,1242
2021,Portsmouth 024C,E01017131,1740,673,1067
2021,Portsmouth 018E,E01017132,1531,774,757
2021,Portsmouth 018F,E01017133,1597,501,1096
2021,Portsmouth 022D,E01017135,1561,359,1202
2021,Southampton 023A,E01017136,1913,904,1009
2021,Southampton 023B,E01017137,1454,775,679
2021,Southampton 023C,E01017138,2091,769,1322
2021,Southampton 033B,E01017139,2656,1057,1599
2021,Southampton 001A,E01017144,1024,286,738
2021,Southampton 001B,E01017145,1462,244,1218
2021,Southampton 001C,E01017146,2642,1401,1241
2021,Southampton 006A,E01017147,1312,234,1078
2021,Southampton 001D,E01017148,1681,866,815
2021,Southampton 001E,E01017149,1376,588,788
2021,Southampton 006B,E01017150,1454,328,1126
2021,Southampton 006C,E01017151,1515,247,1268
2021,Southampton 006D,E01017152,1487,246,1241
2021,Southampton 022A,E01017153,1753,714,1039
2021,Southampton 022B,E01017154,2358,651,1707
2021,Southampton 022C,E01017155,1690,560,1130
2021,Southampton 022D,E01017156,1687,536,1151
2021,Southampton 017A,E01017157,1600,776,824
2021,Southampton 017B,E01017158,2028,641,1387
2021,Southampton 017C,E01017159,1408,676,732
2021,Southampton 017D,E01017160,1438,385,1053
2021,Southampton 025A,E01017162,1376,220,1156
2021,Southampton 025B,E01017163,1425,390,1035
2021,Southampton 025C,E01017164,1511,241,1270
2021,Southampton 025D,E01017165,1472,312,1160
2021,Southampton 025E,E01017166,1632,412,1220
2021,Southampton 027A,E01017167,1508,408,1100
2021,Southampton 027B,E01017168,1562,304,1258
2021,Southampton 027C,E01017169,1500,383,1117
2021,Southampton 027D,E01017170,1487,314,1173
2021,Southampton 014A,E01017171,1741,292,1449
2021,Southampton 014B,E01017172,1740,310,1430
2021,Southampton 014C,E01017173,1428,299,1129
2021,Southampton 008A,E01017174,1352,256,1096
2021,Southampton 008B,E01017175,1429,322,1107
2021,Southampton 008C,E01017176,1476,255,1221
2021,Southampton 014D,E01017177,1508,246,1262
2021,Southampton 014E,E01017178,1415,324,1091
2021,Southampton 008D,E01017179,1178,246,932
2021,Southampton 002A,E01017180,1364,249,1115
2021,Southampton 002B,E01017181,1336,257,1079
2021,Southampton 004A,E01017182,1307,170,1137
2021,Southampton 002C,E01017183,1523,283,1240
2021,Southampton 004B,E01017184,1348,228,1120
2021,Southampton 002D,E01017185,1611,352,1259
2021,Southampton 004C,E01017186,1618,326,1292
2021,Southampton 002E,E01017187,1601,299,1302
2021,Southampton 004D,E01017188,1567,379,1188
2021,Southampton 020A,E01017189,1414,291,1123
2021,Southampton 020B,E01017190,1543,389,1154
2021,Southampton 020C,E01017191,1597,288,1309
2021,Southampton 021A,E01017192,1919,356,1563
2021,Southampton 021B,E01017193,1649,235,1414
2021,Southampton 021C,E01017194,1972,358,1614
2021,Southampton 021D,E01017195,1832,297,1535
2021,Southampton 020D,E01017196,1986,410,1576
2021,Southampton 020E,E01017197,1334,294,1040
2021,Southampton 018A,E01017198,1410,210,1200
2021,Southampton 018B,E01017199,1518,238,1280
2021,Southampton 016A,E01017200,1752,253,1499
2021,Southampton 016B,E01017201,1186,251,935
2021,Southampton 016C,E01017202,1601,383,1218
2021,Southampton 016D,E01017203,1562,356,1206
2021,Southampton 016E,E01017204,1478,287,1191
2021,Southampton 018C,E01017205,1523,376,1147
2021,Southampton 018D,E01017206,1590,305,1285
2021,Southampton 015A,E01017207,1507,414,1093
2021,Southampton 019A,E01017208,1404,349,1055
2021,Southampton 015B,E01017209,1322,245,1077
2021,Southampton 019B,E01017210,1665,438,1227
2021,Southampton 015C,E01017211,1619,192,1427
2021,Southampton 015D,E01017212,1373,285,1088
2021,Southampton 015E,E01017213,1682,297,1385
2021,Southampton 019C,E01017214,1456,311,1145
2021,Southampton 019D,E01017215,1699,364,1335
2021,Southampton 019E,E01017216,1346,286,1060
2021,Southampton 024A,E01017217,1500,239,1261
2021,Southampton 028A,E01017218,1275,310,965
2021,Southampton 028B,E01017219,1718,297,1421
2021,Southampton 028C,E01017220,1709,324,1385
2021,Southampton 028D,E01017221,1537,313,1224
2021,Southampton 028E,E01017222,1395,276,1119
2021,Southampton 024B,E01017223,1579,329,1250
2021,Southampton 024C,E01017224,1282,243,1039
2021,Southampton 024D,E01017225,1465,296,1169
2021,Southampton 009A,E01017226,1544,268,1276
2021,Southampton 013A,E01017227,1124,528,596
2021,Southampton 013B,E01017228,1388,236,1152
2021,Southampton 009D,E01017231,1677,889,788
2021,Southampton 009E,E01017232,1190,426,764
2021,Southampton 013C,E01017233,1521,301,1220
2021,Southampton 013D,E01017234,2040,1007,1033
2021,Southampton 013E,E01017235,1470,642,828
2021,Southampton 012A,E01017236,1356,311,1045
2021,Southampton 012B,E01017237,1485,376,1109
2021,Southampton 007A,E01017238,1885,426,1459
2021,Southampton 012C,E01017239,1411,280,1131
2021,Southampton 012D,E01017240,1255,269,986
2021,Southampton 007B,E01017241,1358,269,1089
2021,Southampton 007C,E01017242,1886,337,1549
2021,Southampton 007D,E01017243,1634,307,1327
2021,Southampton 007E,E01017244,1372,336,1036
2021,Southampton 012E,E01017245,1418,394,1024
2021,Southampton 010A,E01017246,2037,441,1596
2021,Southampton 011A,E01017247,1567,304,1263
2021,Southampton 011B,E01017248,1495,349,1146
2021,Southampton 011C,E01017249,1265,258,1007
2021,Southampton 010B,E01017250,1532,360,1172
2021,Southampton 010C,E01017251,1516,305,1211
2021,Southampton 011D,E01017252,1494,285,1209
2021,Southampton 010D,E01017253,1684,410,1274
2021,Southampton 011E,E01017254,1597,359,1238
2021,Southampton 030A,E01017255,1522,240,1282
2021,Southampton 026A,E01017256,1979,327,1652
2021,Southampton 026B,E01017257,1475,228,1247
2021,Southampton 030B,E01017258,1422,263,1159
2021,Southampton 026C,E01017259,1288,201,1087
2021,Southampton 026D,E01017260,1281,177,1104
2021,Southampton 030C,E01017261,1595,242,1353
2021,Southampton 026E,E01017262,1229,220,1009
2021,Southampton 030D,E01017263,1469,280,1189
2021,Southampton 003A,E01017264,2358,1589,769
2021,Southampton 003B,E01017265,1527,312,1215
2021,Southampton 005A,E01017266,1377,490,887
2021,Southampton 005B,E01017267,1217,498,719
2021,Southampton 003C,E01017270,1279,332,947
2021,Southampton 003D,E01017271,1058,158,900
2021,Southampton 005E,E01017272,1349,363,986
2021,Southampton 031A,E01017273,1461,252,1209
2021,Southampton 032A,E01017274,1379,317,1062
2021,Southampton 031B,E01017275,1613,288,1325
2021,Southampton 031C,E01017276,1750,314,1436
2021,Southampton 032B,E01017277,1399,279,1120
2021,Southampton 031E,E01017279,1539,221,1318
2021,Southampton 032C,E01017280,1569,301,1268
2021,Southampton 032D,E01017281,1351,349,1002
2021,Isle of Wight 006A,E01017282,1308,264,1044
2021,Isle of Wight 006B,E01017283,1623,223,1400
2021,Isle of Wight 010A,E01017284,1553,153,1400
2021,Isle of Wight 010B,E01017285,1924,232,1692
2021,Isle of Wight 005A,E01017286,1558,212,1346
2021,Isle of Wight 005B,E01017287,1557,212,1345
2021,Isle of Wight 010C,E01017288,1202,174,1028
2021,Isle of Wight 014A,E01017289,2096,313,1783
2021,Isle of Wight 013A,E01017290,1206,131,1075
2021,Isle of Wight 013B,E01017291,1164,132,1032
2021,Isle of Wight 011A,E01017292,1686,349,1337
2021,Isle of Wight 011B,E01017293,1849,398,1451
2021,Isle of Wight 013C,E01017294,1544,265,1279
2021,Isle of Wight 009A,E01017295,1267,260,1007
2021,Isle of Wight 011C,E01017296,1289,153,1136
2021,Isle of Wight 017A,E01017297,1398,183,1215
2021,Isle of Wight 017B,E01017298,1485,180,1305
2021,Isle of Wight 017C,E01017299,1202,154,1048
2021,Isle of Wight 001A,E01017300,2076,197,1879
2021,Isle of Wight 002A,E01017301,1041,153,888
2021,Isle of Wight 002B,E01017302,1660,361,1299
2021,Isle of Wight 001B,E01017303,1124,169,955
2021,Isle of Wight 002C,E01017304,1320,275,1045
2021,Isle of Wight 001C,E01017305,1438,265,1173
2021,Isle of Wight 001D,E01017306,1283,272,1011
2021,Isle of Wight 003A,E01017307,2275,318,1957
2021,Isle of Wight 003B,E01017308,1639,302,1337
2021,Isle of Wight 001E,E01017309,1465,271,1194
2021,Isle of Wight 008A,E01017310,1444,194,1250
2021,Isle of Wight 008B,E01017311,1470,246,1224
2021,Isle of Wight 012A,E01017312,1725,234,1491
2021,Isle of Wight 012D,E01017315,1461,195,1266
2021,Isle of Wight 002D,E01017316,2002,318,1684
2021,Isle of Wight 015A,E01017317,1389,186,1203
2021,Isle of Wight 016A,E01017318,1118,206,912
2021,Isle of Wight 016B,E01017319,1240,141,1099
2021,Isle of Wight 015B,E01017320,1058,77,981
2021,Isle of Wight 011D,E01017321,1362,206,1156
2021,Isle of Wight 011E,E01017322,1374,305,1069
2021,Isle of Wight 015C,E01017323,1132,116,1016
2021,Isle of Wight 015D,E01017324,1410,210,1200
2021,Isle of Wight 009B,E01017325,1180,178,1002
2021,Isle of Wight 009C,E01017326,1521,226,1295
2021,Isle of Wight 011F,E01017327,1452,250,1202
2021,Isle of Wight 009D,E01017328,1332,223,1109
2021,Isle of Wight 002E,E01017329,2223,325,1898
2021,Isle of Wight 008C,E01017331,2108,437,1671
2021,Isle of Wight 008D,E01017332,1839,415,1424
2021,Isle of Wight 009E,E01017333,1675,367,1308
2021,Isle of Wight 008E,E01017334,1937,202,1735
2021,Isle of Wight 004A,E01017335,1450,191,1259
2021,Isle of Wight 004B,E01017336,1536,169,1367
2021,Isle of Wight 004C,E01017337,1570,204,1366
2021,Isle of Wight 006C,E01017338,1360,178,1182
2021,Isle of Wight 007A,E01017339,1719,329,1390
2021,Isle of Wight 007B,E01017340,1728,294,1434
2021,Isle of Wight 006D,E01017341,1538,336,1202
2021,Isle of Wight 006E,E01017342,1552,292,1260
2021,Isle of Wight 007C,E01017343,1271,246,1025
2021,Isle of Wight 007D,E01017344,1637,217,1420
2021,Isle of Wight 007E,E01017345,1742,421,1321
2021,Isle of Wight 004D,E01017346,1318,154,1164
2021,Isle of Wight 014B,E01017347,1702,249,1453
2021,Isle of Wight 014C,E01017348,1377,192,1185
2021,Isle of Wight 014D,E01017349,2009,240,1769
2021,Isle of Wight 014E,E01017350,1761,311,1450
2021,Isle of Wight 010D,E01017351,1379,183,1196
2021,Isle of Wight 010E,E01017352,1088,98,990
2021,Isle of Wight 013D,E01017353,1228,143,1085
2021,Isle of Wight 012E,E01017354,1060,111,949
2021,Isle of Wight 015E,E01017355,1508,225,1283
2021,Isle of Wight 016C,E01017356,1487,194,1293
2021,Isle of Wight 016D,E01017357,1425,224,1201
2021,Isle of Wight 015F,E01017358,1249,104,1145
2021,Isle of Wight 016E,E01017359,1462,135,1327
2021,Isle of Wight 016F,E01017360,1673,205,1468
2021,Isle of Wight 012F,E01017361,1411,121,1290
2021,Isle of Wight 012G,E01017362,1462,164,1298
2021,Isle of Wight 018A,E01017363,1356,159,1197
2021,Isle of Wight 018B,E01017364,1309,145,1164
2021,Isle of Wight 018C,E01017365,1354,121,1233
2021,Isle of Wight 018D,E01017366,1385,297,1088
2021,Isle of Wight 005C,E01017367,1825,207,1618
2021,Isle of Wight 005D,E01017368,1456,217,1239
2021,Isle of Wight 017D,E01017369,1430,216,1214
2021,Isle of Wight 018E,E01017370,1675,246,1429
2021,Central Bedfordshire 012A,E01017371,1669,348,1321
2021,Central Bedfordshire 012B,E01017372,1731,328,1403
2021,Central Bedfordshire 012C,E01017373,2208,574,1634
2021,Central Bedfordshire 012D,E01017374,1473,250,1223
2021,Central Bedfordshire 012E,E01017375,1423,231,1192
2021,Central Bedfordshire 010A,E01017376,1929,329,1600
2021,Central Bedfordshire 010B,E01017377,1809,325,1484
2021,Central Bedfordshire 010C,E01017378,1923,334,1589
2021,Central Bedfordshire 007A,E01017379,1151,218,933
2021,Central Bedfordshire 007B,E01017380,1213,201,1012
2021,Central Bedfordshire 006A,E01017381,1370,191,1179
2021,Central Bedfordshire 006B,E01017382,1445,264,1181
2021,Central Bedfordshire 005A,E01017383,1824,271,1553
2021,Central Bedfordshire 005B,E01017384,1531,302,1229
2021,Central Bedfordshire 005C,E01017385,1788,204,1584
2021,Central Bedfordshire 005D,E01017386,1653,297,1356
2021,Central Bedfordshire 005E,E01017387,1196,205,991
2021,Central Bedfordshire 005F,E01017388,2542,479,2063
2021,Central Bedfordshire 013A,E01017391,1451,278,1173
2021,Central Bedfordshire 013B,E01017392,1776,287,1489
2021,Central Bedfordshire 013C,E01017393,1929,327,1602
2021,Central Bedfordshire 007C,E01017394,1401,298,1103
2021,Central Bedfordshire 007F,E01017397,1688,358,1330
2021,Central Bedfordshire 017A,E01017398,2430,464,1966
2021,Central Bedfordshire 015A,E01017399,1376,257,1119
2021,Central Bedfordshire 015B,E01017400,1467,291,1176
2021,Central Bedfordshire 015C,E01017401,1142,198,944
2021,Central Bedfordshire 015D,E01017402,1480,208,1272
2021,Central Bedfordshire 016A,E01017403,1356,211,1145
2021,Central Bedfordshire 016B,E01017404,1204,204,1000
2021,Central Bedfordshire 016C,E01017405,1303,214,1089
2021,Central Bedfordshire 016D,E01017406,2366,456,1910
2021,Central Bedfordshire 016E,E01017407,1417,222,1195
2021,Central Bedfordshire 017B,E01017408,1022,183,839
2021,Central Bedfordshire 017C,E01017409,1174,191,983
2021,Central Bedfordshire 008A,E01017410,1143,172,971
2021,Central Bedfordshire 004A,E01017412,1457,266,1191
2021,Central Bedfordshire 010D,E01017413,2111,357,1754
2021,Central Bedfordshire 010E,E01017414,1784,270,1514
2021,Central Bedfordshire 010F,E01017415,1915,371,1544
2021,Central Bedfordshire 009C,E01017418,1406,234,1172
2021,Central Bedfordshire 008C,E01017419,1596,268,1328
2021,Central Bedfordshire 008D,E01017420,1598,327,1271
2021,Central Bedfordshire 008E,E01017421,1753,318,1435
2021,Central Bedfordshire 004B,E01017422,1584,244,1340
2021,Central Bedfordshire 004C,E01017423,1880,339,1541
2021,Central Bedfordshire 004D,E01017424,1343,177,1166
2021,Central Bedfordshire 003A,E01017425,1107,156,951
2021,Central Bedfordshire 003B,E01017426,1348,208,1140
2021,Central Bedfordshire 003C,E01017427,1875,353,1522
2021,Central Bedfordshire 003D,E01017428,1564,274,1290
2021,Central Bedfordshire 003E,E01017429,1810,292,1518
2021,Central Bedfordshire 002A,E01017430,1403,250,1153
2021,Central Bedfordshire 002B,E01017431,1568,250,1318
2021,Central Bedfordshire 002C,E01017432,1432,215,1217
2021,Central Bedfordshire 001A,E01017433,1516,358,1158
2021,Central Bedfordshire 001B,E01017434,1552,284,1268
2021,Central Bedfordshire 002D,E01017435,1729,375,1354
2021,Central Bedfordshire 001C,E01017436,2332,458,1874
2021,Central Bedfordshire 011A,E01017437,1791,364,1427
2021,Central Bedfordshire 011B,E01017438,1598,299,1299
2021,Central Bedfordshire 011C,E01017439,1933,406,1527
2021,Central Bedfordshire 011D,E01017440,1809,339,1470
2021,Central Bedfordshire 011E,E01017441,1992,411,1581
2021,Central Bedfordshire 013D,E01017442,2606,558,2048
2021,Central Bedfordshire 013E,E01017443,1514,240,1274
2021,Central Bedfordshire 011F,E01017444,1990,355,1635
2021,Central Bedfordshire 014A,E01017446,1686,297,1389
2021,Central Bedfordshire 014B,E01017447,2412,450,1962
2021,Central Bedfordshire 014D,E01017449,2000,393,1607
2021,Central Bedfordshire 017E,E01017450,2152,370,1782
2021,Central Bedfordshire 009D,E01017451,1361,234,1127
2021,Central Bedfordshire 009E,E01017452,1197,171,1026
2021,Bedford 005A,E01017453,1292,229,1063
2021,Bedford 005B,E01017454,1389,261,1128
2021,Bedford 005C,E01017455,1350,213,1137
2021,Bedford 005D,E01017456,1417,217,1200
2021,Bedford 005E,E01017457,1159,247,912
2021,Bedford 005F,E01017458,1162,212,950
2021,Bedford 008A,E01017459,1585,291,1294
2021,Bedford 008B,E01017460,2218,423,1795
2021,Bedford 008D,E01017462,1513,270,1243
2021,Bedford 008E,E01017463,1292,221,1071
2021,Bedford 002A,E01017464,1360,194,1166
2021,Bedford 002B,E01017465,1458,248,1210
2021,Bedford 012A,E01017466,2160,402,1758
2021,Bedford 012B,E01017467,1284,205,1079
2021,Bedford 012C,E01017468,1304,253,1051
2021,Bedford 012E,E01017470,1228,247,981
2021,Bedford 012F,E01017471,1742,265,1477
2021,Bedford 015A,E01017472,1449,403,1046
2021,Bedford 015C,E01017474,1755,427,1328
2021,Bedford 015D,E01017475,1540,342,1198
2021,Bedford 015E,E01017476,1430,259,1171
2021,Bedford 015F,E01017477,1269,338,931
2021,Bedford 003A,E01017478,1671,297,1374
2021,Bedford 003B,E01017479,1277,177,1100
2021,Bedford 003C,E01017480,1868,468,1400
2021,Bedford 003D,E01017481,1132,249,883
2021,Bedford 009A,E01017482,1357,234,1123
2021,Bedford 009B,E01017483,1673,580,1093
2021,Bedford 009C,E01017484,1368,277,1091
2021,Bedford 009D,E01017485,1296,260,1036
2021,Bedford 021B,E01017487,1801,416,1385
2021,Bedford 007A,E01017488,1491,239,1252
2021,Bedford 007B,E01017489,1494,393,1101
2021,Bedford 007C,E01017490,1286,289,997
2021,Bedford 007D,E01017491,1465,301,1164
2021,Bedford 007E,E01017492,1392,303,1089
2021,Bedford 007F,E01017493,1563,378,1185
2021,Bedford 004B,E01017495,2107,392,1715
2021,Bedford 004C,E01017496,1515,225,1290
2021,Bedford 010A,E01017497,1286,261,1025
2021,Bedford 010B,E01017498,1131,192,939
2021,Bedford 010C,E01017499,1309,199,1110
2021,Bedford 010D,E01017500,1132,196,936
2021,Bedford 010E,E01017501,1772,205,1567
2021,Bedford 010F,E01017502,1789,237,1552
2021,Bedford 002C,E01017503,1302,296,1006
2021,Bedford 002D,E01017504,1876,345,1531
2021,Bedford 017A,E01017505,1455,223,1232
2021,Bedford 017B,E01017506,1452,285,1167
2021,Bedford 017C,E01017507,1321,257,1064
2021,Bedford 017D,E01017508,1589,315,1274
2021,Bedford 016A,E01017509,1161,224,937
2021,Bedford 016B,E01017510,1518,253,1265
2021,Bedford 016C,E01017511,1137,171,966
2021,Bedford 016D,E01017512,1422,296,1126
2021,Bedford 018A,E01017513,1380,298,1082
2021,Bedford 018B,E01017514,1624,381,1243
2021,Bedford 018C,E01017515,1556,334,1222
2021,Bedford 018E,E01017517,1486,266,1220
2021,Bedford 014A,E01017518,1617,373,1244
2021,Bedford 014B,E01017519,1526,351,1175
2021,Bedford 014C,E01017520,1707,299,1408
2021,Bedford 014D,E01017521,1554,321,1233
2021,Bedford 014E,E01017522,1962,376,1586
2021,Bedford 014F,E01017523,1626,491,1135
2021,Bedford 011A,E01017524,1610,314,1296
2021,Bedford 011B,E01017525,1170,258,912
2021,Bedford 011C,E01017526,1411,271,1140
2021,Bedford 011D,E01017527,1139,169,970
2021,Bedford 003E,E01017528,2402,534,1868
2021,Bedford 006A,E01017529,1227,221,1006
2021,Bedford 006B,E01017530,1380,243,1137
2021,Bedford 006C,E01017531,1290,281,1009
2021,Bedford 006D,E01017532,1243,213,1030
2021,Bedford 006E,E01017533,1124,165,959
2021,Bedford 006F,E01017534,1490,261,1229
2021,Bedford 013A,E01017535,2018,535,1483
2021,Bedford 013B,E01017536,2342,613,1729
2021,Bedford 013C,E01017537,1367,373,994
2021,Bedford 013D,E01017538,1723,505,1218
2021,Bedford 013E,E01017539,1520,414,1106
2021,Bedford 001A,E01017540,1408,213,1195
2021,Bedford 001B,E01017541,1256,224,1032
2021,Bedford 004D,E01017542,1375,168,1207
2021,Bedford 004E,E01017543,1557,233,1324
2021,Bedford 001C,E01017544,1390,254,1136
2021,Bedford 001D,E01017545,1410,282,1128
2021,Bedford 002E,E01017546,1146,192,954
2021,Bedford 002F,E01017547,1530,241,1289
2021,Bedford 021F,E01017549,1456,184,1272
2021,Bedford 020B,E01017552,2470,557,1913
2021,Bedford 020C,E01017553,1293,210,1083
2021,Bedford 020D,E01017554,1848,368,1480
2021,Central Bedfordshire 021A,E01017555,1951,257,1694
2021,Central Bedfordshire 021B,E01017556,1552,264,1288
2021,Central Bedfordshire 021C,E01017557,1803,247,1556
2021,Central Bedfordshire 018A,E01017558,1700,301,1399
2021,Central Bedfordshire 018B,E01017559,1600,306,1294
2021,Central Bedfordshire 018C,E01017560,1448,234,1214
2021,Central Bedfordshire 033A,E01017561,1418,217,1201
2021,Central Bedfordshire 033B,E01017562,2285,367,1918
2021,Central Bedfordshire 033C,E01017563,1519,229,1290
2021,Central Bedfordshire 033D,E01017564,1381,222,1159
2021,Central Bedfordshire 029A,E01017565,1456,232,1224
2021,Central Bedfordshire 028A,E01017566,1413,223,1190
2021,Central Bedfordshire 029B,E01017567,1574,291,1283
2021,Central Bedfordshire 029C,E01017568,2102,354,1748
2021,Central Bedfordshire 029D,E01017569,1716,307,1409
2021,Central Bedfordshire 032A,E01017571,1185,165,1020
2021,Central Bedfordshire 032B,E01017572,1329,215,1114
2021,Central Bedfordshire 024A,E01017573,1330,187,1143
2021,Central Bedfordshire 024D,E01017576,1290,211,1079
2021,Central Bedfordshire 019A,E01017577,2375,378,1997
2021,Central Bedfordshire 026A,E01017578,2212,404,1808
2021,Central Bedfordshire 026B,E01017579,1856,389,1467
2021,Central Bedfordshire 026C,E01017580,2289,525,1764
2021,Central Bedfordshire 026D,E01017581,1740,312,1428
2021,Central Bedfordshire 027A,E01017582,1448,267,1181
2021,Central Bedfordshire 027B,E01017583,1865,372,1493
2021,Central Bedfordshire 027C,E01017584,1980,353,1627
2021,Central Bedfordshire 027D,E01017585,1342,245,1097
2021,Central Bedfordshire 032C,E01017586,1441,262,1179
2021,Central Bedfordshire 032D,E01017587,1584,201,1383
2021,Central Bedfordshire 032E,E01017588,1159,148,1011
2021,Central Bedfordshire 022A,E01017589,1560,194,1366
2021,Central Bedfordshire 022B,E01017590,1471,222,1249
2021,Central Bedfordshire 022C,E01017591,1651,277,1374
2021,Central Bedfordshire 030A,E01017592,1595,244,1351
2021,Central Bedfordshire 030B,E01017593,1423,227,1196
2021,Central Bedfordshire 030C,E01017594,2133,607,1526
2021,Central Bedfordshire 028B,E01017595,1125,230,895
2021,Central Bedfordshire 028C,E01017596,1558,391,1167
2021,Central Bedfordshire 028D,E01017597,1479,313,1166
2021,Central Bedfordshire 028E,E01017598,1528,301,1227
2021,Central Bedfordshire 025A,E01017600,1903,389,1514
2021,Central Bedfordshire 025B,E01017601,1417,399,1018
2021,Central Bedfordshire 025C,E01017602,1451,302,1149
2021,Central Bedfordshire 020A,E01017603,1389,203,1186
2021,Central Bedfordshire 020B,E01017604,1483,224,1259
2021,Central Bedfordshire 020C,E01017605,1315,321,994
2021,Central Bedfordshire 020D,E01017606,1680,273,1407
2021,Central Bedfordshire 020E,E01017607,1390,213,1177
2021,Central Bedfordshire 021D,E01017608,1707,302,1405
2021,Central Bedfordshire 021E,E01017609,1981,485,1496
2021,Central Bedfordshire 022D,E01017610,1053,176,877
2021,Central Bedfordshire 023A,E01017611,1165,205,960
2021,Central Bedfordshire 023B,E01017612,1203,217,986
2021,Central Bedfordshire 023C,E01017613,1319,243,1076
2021,Central Bedfordshire 023D,E01017614,1379,265,1114
2021,Central Bedfordshire 018D,E01017616,2225,447,1778
2021,Central Bedfordshire 026E,E01017617,1254,210,1044
2021,Central Bedfordshire 025D,E01017618,2046,544,1502
2021,Central Bedfordshire 025E,E01017619,2094,574,1520
2021,Central Bedfordshire 019C,E01017620,1782,309,1473
2021,Central Bedfordshire 019D,E01017621,1437,245,1192
2021,Central Bedfordshire 019E,E01017622,1620,311,1309
2021,Central Bedfordshire 031A,E01017623,1604,270,1334
2021,Central Bedfordshire 031B,E01017624,1690,286,1404
2021,Central Bedfordshire 031C,E01017625,1479,225,1254
2021,Central Bedfordshire 031D,E01017626,1517,233,1284
2021,Buckinghamshire 021A,E01017627,1696,338,1358
2021,Buckinghamshire 021B,E01017628,1703,308,1395
2021,Buckinghamshire 021C,E01017629,1649,265,1384
2021,Buckinghamshire 021D,E01017630,1525,276,1249
2021,Buckinghamshire 021E,E01017631,2259,423,1836
2021,Buckinghamshire 015A,E01017634,1534,275,1259
2021,Buckinghamshire 018A,E01017635,1434,309,1125
2021,Buckinghamshire 018B,E01017636,1466,283,1183
2021,Buckinghamshire 018C,E01017637,1202,225,977
2021,Buckinghamshire 018D,E01017638,1218,230,988
2021,Buckinghamshire 018E,E01017639,1463,264,1199
2021,Buckinghamshire 018F,E01017640,1591,343,1248
2021,Buckinghamshire 010A,E01017642,1231,210,1021
2021,Buckinghamshire 010B,E01017643,1336,235,1101
2021,Buckinghamshire 002A,E01017644,1387,253,1134
2021,Buckinghamshire 002B,E01017645,1371,390,981
2021,Buckinghamshire 002C,E01017646,2188,505,1683
2021,Buckinghamshire 002D,E01017647,1488,250,1238
2021,Buckinghamshire 001A,E01017648,1600,307,1293
2021,Buckinghamshire 001B,E01017649,2350,554,1796
2021,Buckinghamshire 008A,E01017651,1526,277,1249
2021,Buckinghamshire 008B,E01017652,1604,274,1330
2021,Buckinghamshire 016A,E01017653,1371,226,1145
2021,Buckinghamshire 016B,E01017654,1561,337,1224
2021,Buckinghamshire 016C,E01017655,1719,287,1432
2021,Buckinghamshire 008C,E01017657,1503,266,1237
2021,Buckinghamshire 008D,E01017658,1552,269,1283
2021,Buckinghamshire 012A,E01017659,1529,308,1221
2021,Buckinghamshire 012B,E01017660,1475,211,1264
2021,Buckinghamshire 012C,E01017661,1496,322,1174
2021,Buckinghamshire 015B,E01017662,1354,274,1080
2021,Buckinghamshire 015C,E01017663,1582,312,1270
2021,Buckinghamshire 012D,E01017664,1312,184,1128
2021,Buckinghamshire 013A,E01017665,2477,592,1885
2021,Buckinghamshire 013B,E01017666,2170,386,1784
2021,Buckinghamshire 013C,E01017667,1369,405,964
2021,Buckinghamshire 013D,E01017668,1477,287,1190
2021,Buckinghamshire 006A,E01017669,2401,512,1889
2021,Buckinghamshire 006B,E01017670,1755,303,1452
2021,Buckinghamshire 003A,E01017671,1528,287,1241
2021,Buckinghamshire 003B,E01017672,1521,250,1271
2021,Buckinghamshire 010C,E01017673,1344,299,1045
2021,Buckinghamshire 010D,E01017674,1729,232,1497
2021,Buckinghamshire 022A,E01017675,1666,299,1367
2021,Buckinghamshire 022B,E01017676,1413,217,1196
2021,Buckinghamshire 022C,E01017677,1806,321,1485
2021,Buckinghamshire 022D,E01017678,1362,203,1159
2021,Buckinghamshire 022E,E01017679,1532,283,1249
2021,Buckinghamshire 022F,E01017680,1146,199,947
2021,Buckinghamshire 023A,E01017681,1310,258,1052
2021,Buckinghamshire 023B,E01017682,1206,265,941
2021,Buckinghamshire 023C,E01017683,1704,300,1404
2021,Buckinghamshire 023D,E01017684,1088,185,903
2021,Buckinghamshire 019A,E01017687,2437,572,1865
2021,Buckinghamshire 019B,E01017688,1095,200,895
2021,Buckinghamshire 019C,E01017689,1249,213,1036
2021,Buckinghamshire 019D,E01017690,1103,194,909
2021,Buckinghamshire 019E,E01017691,1271,204,1067
2021,Buckinghamshire 019F,E01017692,1476,208,1268
2021,Buckinghamshire 004A,E01017693,1071,205,866
2021,Buckinghamshire 004B,E01017694,2351,492,1859
2021,Buckinghamshire 003C,E01017695,1160,161,999
2021,Buckinghamshire 003D,E01017696,1339,266,1073
2021,Buckinghamshire 014A,E01017697,1250,192,1058
2021,Buckinghamshire 014B,E01017698,1324,293,1031
2021,Buckinghamshire 014C,E01017699,1641,329,1312
2021,Buckinghamshire 014D,E01017700,1564,297,1267
2021,Buckinghamshire 008E,E01017701,2647,659,1988
2021,Buckinghamshire 008F,E01017702,1435,229,1206
2021,Buckinghamshire 009A,E01017703,1274,249,1025
2021,Buckinghamshire 009B,E01017704,1252,216,1036
2021,Buckinghamshire 011A,E01017706,1357,283,1074
2021,Buckinghamshire 011B,E01017707,1246,287,959
2021,Buckinghamshire 011C,E01017708,1466,332,1134
2021,Buckinghamshire 017A,E01017709,1621,433,1188
2021,Buckinghamshire 017B,E01017710,1528,368,1160
2021,Buckinghamshire 017C,E01017711,1575,368,1207
2021,Buckinghamshire 017D,E01017712,2182,464,1718
2021,Buckinghamshire 004C,E01017713,1349,225,1124
2021,Buckinghamshire 004D,E01017714,1565,301,1264
2021,Buckinghamshire 006C,E01017715,1168,187,981
2021,Buckinghamshire 006D,E01017716,1792,353,1439
2021,Buckinghamshire 004E,E01017717,1705,317,1388
2021,Buckinghamshire 004F,E01017718,1800,346,1454
2021,Buckinghamshire 009C,E01017719,1187,266,921
2021,Buckinghamshire 009D,E01017720,1257,272,985
2021,Buckinghamshire 020A,E01017721,1566,265,1301
2021,Buckinghamshire 020B,E01017722,1360,201,1159
2021,Buckinghamshire 020C,E01017723,1244,290,954
2021,Buckinghamshire 020D,E01017724,1385,373,1012
2021,Buckinghamshire 024A,E01017726,1128,152,976
2021,Buckinghamshire 024B,E01017727,1758,316,1442
2021,Buckinghamshire 024C,E01017729,1561,308,1253
2021,Buckinghamshire 024D,E01017730,1505,287,1218
2021,Buckinghamshire 007A,E01017731,1274,227,1047
2021,Buckinghamshire 007B,E01017732,1579,302,1277
2021,Buckinghamshire 007C,E01017733,1246,200,1046
2021,Buckinghamshire 007D,E01017734,1465,244,1221
2021,Buckinghamshire 005A,E01017735,1347,207,1140
2021,Buckinghamshire 005B,E01017736,1458,253,1205
2021,Buckinghamshire 005C,E01017737,1249,159,1090
2021,Buckinghamshire 005D,E01017738,2271,420,1851
2021,Buckinghamshire 034A,E01017739,1227,253,974
2021,Buckinghamshire 034B,E01017740,1377,320,1057
2021,Buckinghamshire 032A,E01017741,1575,363,1212
2021,Buckinghamshire 032B,E01017742,1676,317,1359
2021,Buckinghamshire 032C,E01017743,1806,457,1349
2021,Buckinghamshire 034C,E01017744,1446,294,1152
2021,Buckinghamshire 034D,E01017745,1638,265,1373
2021,Buckinghamshire 034E,E01017746,1512,369,1143
2021,Buckinghamshire 027A,E01017747,1422,322,1100
2021,Buckinghamshire 027B,E01017748,1760,357,1403
2021,Buckinghamshire 027C,E01017749,1752,340,1412
2021,Buckinghamshire 029A,E01017750,2152,389,1763
2021,Buckinghamshire 054A,E01017751,2051,438,1613
2021,Buckinghamshire 029B,E01017752,2188,419,1769
2021,Buckinghamshire 054B,E01017753,1202,247,955
2021,Buckinghamshire 050A,E01017754,1480,295,1185
2021,Buckinghamshire 050B,E01017755,1847,333,1514
2021,Buckinghamshire 050C,E01017756,1445,263,1182
2021,Buckinghamshire 050D,E01017757,1125,210,915
2021,Buckinghamshire 050E,E01017758,1318,246,1072
2021,Buckinghamshire 047A,E01017759,1732,328,1404
2021,Buckinghamshire 047B,E01017760,1651,323,1328
2021,Buckinghamshire 047C,E01017761,2033,440,1593
2021,Buckinghamshire 035A,E01017762,1351,279,1072
2021,Buckinghamshire 032D,E01017763,1680,315,1365
2021,Buckinghamshire 032E,E01017764,1622,389,1233
2021,Buckinghamshire 032F,E01017765,1649,383,1266
2021,Buckinghamshire 029C,E01017766,2236,399,1837
2021,Buckinghamshire 054C,E01017767,2217,465,1752
2021,Buckinghamshire 031A,E01017768,2217,412,1805
2021,Buckinghamshire 028A,E01017769,1562,297,1265
2021,Buckinghamshire 030A,E01017770,1560,262,1298
2021,Buckinghamshire 028B,E01017771,1426,244,1182
2021,Buckinghamshire 039A,E01017773,1461,234,1227
2021,Buckinghamshire 039B,E01017774,1272,237,1035
2021,Buckinghamshire 035B,E01017775,1606,308,1298
2021,Buckinghamshire 035C,E01017776,2119,542,1577
2021,Buckinghamshire 035D,E01017777,1702,411,1291
2021,Buckinghamshire 029D,E01017778,1268,261,1007
2021,Buckinghamshire 031B,E01017779,1073,256,817
2021,Buckinghamshire 028C,E01017780,1353,286,1067
2021,Buckinghamshire 028D,E01017781,1161,278,883
2021,Buckinghamshire 039C,E01017782,1470,368,1102
2021,Buckinghamshire 039D,E01017783,1485,298,1187
2021,Buckinghamshire 039E,E01017784,1591,292,1299
2021,Buckinghamshire 031C,E01017785,1537,224,1313
2021,Buckinghamshire 031D,E01017786,1472,311,1161
2021,Buckinghamshire 031E,E01017787,1536,305,1231
2021,Buckinghamshire 031F,E01017788,1584,292,1292
2021,Buckinghamshire 027D,E01017789,1267,239,1028
2021,Buckinghamshire 027E,E01017790,1431,373,1058
2021,Buckinghamshire 030B,E01017791,1408,259,1149
2021,Buckinghamshire 030C,E01017792,2085,330,1755
2021,Buckinghamshire 030D,E01017793,1362,238,1124
2021,Buckinghamshire 047D,E01017794,2174,467,1707
2021,Buckinghamshire 027F,E01017795,2124,478,1646
2021,Buckinghamshire 053A,E01017796,1739,367,1372
2021,Buckinghamshire 053B,E01017797,1325,284,1041
2021,Buckinghamshire 053C,E01017798,1751,378,1373
2021,Buckinghamshire 053D,E01017799,2066,453,1613
2021,Buckinghamshire 053E,E01017800,1595,398,1197
2021,Buckinghamshire 053F,E01017801,1591,370,1221
2021,Buckinghamshire 053G,E01017802,1549,349,1200
2021,Buckinghamshire 065A,E01017803,1342,210,1132
2021,Buckinghamshire 066A,E01017804,1562,227,1335
2021,Buckinghamshire 066B,E01017805,1820,363,1457
2021,Buckinghamshire 065B,E01017806,1667,302,1365
2021,Buckinghamshire 066C,E01017807,1484,278,1206
2021,Buckinghamshire 066D,E01017808,1547,260,1287
2021,Buckinghamshire 066E,E01017809,1546,357,1189
2021,Buckinghamshire 059A,E01017810,2130,308,1822
2021,Buckinghamshire 059B,E01017811,1176,139,1037
2021,Buckinghamshire 059C,E01017812,1786,351,1435
2021,Buckinghamshire 059D,E01017813,1922,278,1644
2021,Buckinghamshire 065C,E01017814,1612,308,1304
2021,Buckinghamshire 063A,E01017815,1852,384,1468
2021,Buckinghamshire 063B,E01017816,1664,297,1367
2021,Buckinghamshire 063C,E01017817,2044,449,1595
2021,Buckinghamshire 058A,E01017818,1973,447,1526
2021,Buckinghamshire 058B,E01017819,1602,367,1235
2021,Buckinghamshire 058C,E01017820,1706,263,1443
2021,Buckinghamshire 058D,E01017821,1538,318,1220
2021,Buckinghamshire 058E,E01017822,2010,493,1517
2021,Buckinghamshire 063D,E01017823,1363,265,1098
2021,Buckinghamshire 067A,E01017824,1603,275,1328
2021,Buckinghamshire 067B,E01017825,1620,291,1329
2021,Buckinghamshire 067C,E01017826,1522,288,1234
2021,Buckinghamshire 067D,E01017827,1916,362,1554
2021,Buckinghamshire 067E,E01017828,1450,235,1215
2021,Buckinghamshire 067F,E01017829,2079,357,1722
2021,Buckinghamshire 064A,E01017830,1868,367,1501
2021,Buckinghamshire 064B,E01017831,1653,309,1344
2021,Buckinghamshire 064C,E01017832,1771,296,1475
2021,Buckinghamshire 065D,E01017833,2253,286,1967
2021,Buckinghamshire 064D,E01017834,1579,329,1250
2021,Buckinghamshire 064E,E01017835,1592,233,1359
2021,Buckinghamshire 049A,E01017836,1611,386,1225
2021,Buckinghamshire 049B,E01017837,2412,657,1755
2021,Buckinghamshire 049C,E01017838,1541,374,1167
2021,Buckinghamshire 049D,E01017839,2269,877,1392
2021,Buckinghamshire 049E,E01017840,1887,429,1458
2021,Buckinghamshire 049F,E01017841,2395,643,1752
2021,Buckinghamshire 052A,E01017843,1511,250,1261
2021,Buckinghamshire 052B,E01017844,1675,316,1359
2021,Buckinghamshire 052C,E01017845,1552,284,1268
2021,Buckinghamshire 060A,E01017846,1389,191,1198
2021,Buckinghamshire 060B,E01017847,1602,248,1354
2021,Buckinghamshire 060C,E01017848,1197,228,969
2021,Buckinghamshire 060D,E01017849,1382,168,1214
2021,Buckinghamshire 042A,E01017850,1326,327,999
2021,Buckinghamshire 042B,E01017851,1607,321,1286
2021,Buckinghamshire 042C,E01017852,2410,659,1751
2021,Buckinghamshire 040A,E01017853,1279,198,1081
2021,Buckinghamshire 040B,E01017854,1138,159,979
2021,Buckinghamshire 052D,E01017855,1541,243,1298
2021,Buckinghamshire 052E,E01017856,1432,342,1090
2021,Buckinghamshire 038A,E01017857,1382,323,1059
2021,Buckinghamshire 038B,E01017858,2360,759,1601
2021,Buckinghamshire 038C,E01017859,1608,334,1274
2021,Buckinghamshire 038D,E01017860,1380,345,1035
2021,Buckinghamshire 038E,E01017861,1495,289,1206
2021,Buckinghamshire 038F,E01017862,1749,412,1337
2021,Buckinghamshire 038G,E01017863,1651,382,1269
2021,Buckinghamshire 055A,E01017864,1231,220,1011
2021,Buckinghamshire 055B,E01017865,1454,284,1170
2021,Buckinghamshire 057A,E01017866,1416,218,1198
2021,Buckinghamshire 055C,E01017867,1446,318,1128
2021,Buckinghamshire 055D,E01017868,1500,245,1255
2021,Buckinghamshire 033A,E01017869,1250,227,1023
2021,Buckinghamshire 033B,E01017870,1137,175,962
2021,Buckinghamshire 033C,E01017871,1445,260,1185
2021,Buckinghamshire 033D,E01017872,1506,215,1291
2021,Buckinghamshire 033E,E01017873,1307,224,1083
2021,Buckinghamshire 033F,E01017874,1277,267,1010
2021,Buckinghamshire 057B,E01017875,1395,310,1085
2021,Buckinghamshire 057C,E01017876,1986,452,1534
2021,Buckinghamshire 057D,E01017877,1516,323,1193
2021,Buckinghamshire 040C,E01017878,2322,393,1929
2021,Buckinghamshire 036A,E01017880,1321,281,1040
2021,Buckinghamshire 036B,E01017881,1860,376,1484
2021,Buckinghamshire 036C,E01017882,1537,313,1224
2021,Buckinghamshire 036D,E01017883,1566,338,1228
2021,Buckinghamshire 036E,E01017884,1325,237,1088
2021,Buckinghamshire 025A,E01017885,2009,387,1622
2021,Buckinghamshire 025B,E01017886,1448,240,1208
2021,Buckinghamshire 025C,E01017887,1096,176,920
2021,Buckinghamshire 025D,E01017888,1446,279,1167
2021,Buckinghamshire 062A,E01017889,1409,350,1059
2021,Buckinghamshire 062B,E01017890,1265,292,973
2021,Buckinghamshire 062C,E01017891,1377,269,1108
2021,Buckinghamshire 062D,E01017892,1495,335,1160
2021,Buckinghamshire 062E,E01017893,1667,258,1409
2021,Buckinghamshire 062F,E01017894,1534,327,1207
2021,Buckinghamshire 061A,E01017895,1259,232,1027
2021,Buckinghamshire 061B,E01017896,1347,256,1091
2021,Buckinghamshire 061C,E01017897,1601,336,1265
2021,Buckinghamshire 061D,E01017898,1166,281,885
2021,Buckinghamshire 048A,E01017899,1625,381,1244
2021,Buckinghamshire 048B,E01017900,1109,251,858
2021,Buckinghamshire 048C,E01017901,1124,263,861
2021,Buckinghamshire 048D,E01017902,1511,380,1131
2021,Buckinghamshire 046A,E01017903,1634,432,1202
2021,Buckinghamshire 046B,E01017904,1807,400,1407
2021,Buckinghamshire 046C,E01017905,2127,408,1719
2021,Buckinghamshire 046D,E01017906,1792,586,1206
2021,Buckinghamshire 046E,E01017907,1703,389,1314
2021,Buckinghamshire 051A,E01017910,2385,406,1979
2021,Buckinghamshire 044A,E01017911,1590,356,1234
2021,Buckinghamshire 044B,E01017912,1410,263,1147
2021,Buckinghamshire 044C,E01017913,1977,412,1565
2021,Buckinghamshire 044D,E01017914,1300,251,1049
2021,Buckinghamshire 037A,E01017915,1371,246,1125
2021,Buckinghamshire 037B,E01017916,1132,166,966
2021,Buckinghamshire 037C,E01017917,1578,287,1291
2021,Buckinghamshire 037D,E01017918,1469,250,1219
2021,Buckinghamshire 042D,E01017919,1252,210,1042
2021,Buckinghamshire 041A,E01017920,1421,274,1147
2021,Buckinghamshire 041B,E01017921,1653,338,1315
2021,Buckinghamshire 041C,E01017922,2248,601,1647
2021,Buckinghamshire 041D,E01017923,1557,273,1284
2021,Buckinghamshire 041E,E01017924,1542,363,1179
2021,Buckinghamshire 043A,E01017925,1979,469,1510
2021,Buckinghamshire 043B,E01017926,1351,304,1047
2021,Buckinghamshire 043C,E01017927,1656,341,1315
2021,Buckinghamshire 043D,E01017928,1383,251,1132
2021,Buckinghamshire 026A,E01017929,1639,285,1354
2021,Buckinghamshire 026B,E01017930,1787,292,1495
2021,Buckinghamshire 026C,E01017931,1404,224,1180
2021,Buckinghamshire 026D,E01017932,1537,245,1292
2021,Buckinghamshire 026E,E01017933,1796,265,1531
2021,Buckinghamshire 056A,E01017934,1731,338,1393
2021,Buckinghamshire 056B,E01017935,1883,351,1532
2021,Buckinghamshire 056C,E01017936,1408,252,1156
2021,Buckinghamshire 045A,E01017937,1365,268,1097
2021,Buckinghamshire 045B,E01017938,1236,248,988
2021,Buckinghamshire 056D,E01017939,1325,237,1088
2021,Buckinghamshire 045C,E01017940,1479,237,1242
2021,Buckinghamshire 051B,E01017941,1341,233,1108
2021,Buckinghamshire 045D,E01017942,1402,291,1111
2021,Cambridge 006A,E01017943,2082,563,1519
2021,Cambridge 006B,E01017944,1356,316,1040
2021,Cambridge 006C,E01017945,1668,321,1347
2021,Cambridge 006D,E01017946,1499,358,1141
2021,Cambridge 006E,E01017947,1650,352,1298
2021,Cambridge 006F,E01017948,1566,331,1235
2021,Cambridge 002A,E01017949,1537,328,1209
2021,Cambridge 002B,E01017950,1254,364,890
2021,Cambridge 002C,E01017951,1432,272,1160
2021,Cambridge 002D,E01017952,1502,340,1162
2021,Cambridge 002E,E01017953,1988,536,1452
2021,Cambridge 002F,E01017954,1449,347,1102
2021,Cambridge 005A,E01017955,1406,330,1076
2021,Cambridge 011A,E01017959,1690,406,1284
2021,Cambridge 011B,E01017960,1345,321,1024
2021,Cambridge 011C,E01017961,1143,199,944
2021,Cambridge 011D,E01017962,1789,387,1402
2021,Cambridge 011E,E01017963,1528,289,1239
2021,Cambridge 011F,E01017964,1297,255,1042
2021,Cambridge 010A,E01017965,1655,480,1175
2021,Cambridge 010C,E01017967,1662,514,1148
2021,Cambridge 010D,E01017968,1526,295,1231
2021,Cambridge 010E,E01017969,1701,413,1288
2021,Cambridge 003B,E01017971,1579,286,1293
2021,Cambridge 003C,E01017972,1643,299,1344
2021,Cambridge 003D,E01017973,1876,456,1420
2021,Cambridge 003E,E01017974,1652,327,1325
2021,Cambridge 001A,E01017975,2157,394,1763
2021,Cambridge 001B,E01017976,1637,291,1346
2021,Cambridge 001C,E01017977,1648,334,1314
2021,Cambridge 001D,E01017978,1416,319,1097
2021,Cambridge 001E,E01017979,1466,282,1184
2021,Cambridge 001F,E01017980,1387,175,1212
2021,Cambridge 007C,E01017983,2677,982,1695
2021,Cambridge 007E,E01017985,1816,729,1087
2021,Cambridge 008A,E01017987,1923,619,1304
2021,Cambridge 008B,E01017988,1713,859,854
2021,Cambridge 008C,E01017989,1848,460,1388
2021,Cambridge 008D,E01017990,1157,245,912
2021,Cambridge 008E,E01017991,1337,492,845
2021,Cambridge 013A,E01017992,1989,398,1591
2021,Cambridge 013C,E01017994,1807,357,1450
2021,Cambridge 013D,E01017995,2030,407,1623
2021,Cambridge 013E,E01017996,2001,921,1080
2021,Cambridge 009A,E01017997,2501,539,1962
2021,Cambridge 009B,E01017998,1824,394,1430
2021,Cambridge 009C,E01017999,2110,686,1424
2021,Cambridge 009D,E01018000,1735,458,1277
2021,Cambridge 009E,E01018001,1563,355,1208
2021,Cambridge 014A,E01018005,1769,646,1123
2021,Cambridge 004A,E01018006,1477,237,1240
2021,Cambridge 004B,E01018007,1474,305,1169
2021,Cambridge 004C,E01018008,1536,380,1156
2021,Cambridge 004D,E01018009,2088,616,1472
2021,Cambridge 004E,E01018010,1592,312,1280
2021,East Cambridgeshire 009A,E01018011,2491,423,2068
2021,East Cambridgeshire 009B,E01018012,1543,327,1216
2021,East Cambridgeshire 008A,E01018013,1781,298,1483
2021,East Cambridgeshire 008B,E01018014,1693,299,1394
2021,East Cambridgeshire 008C,E01018015,1308,223,1085
2021,East Cambridgeshire 008D,E01018016,1348,281,1067
2021,East Cambridgeshire 011A,E01018017,1230,191,1039
2021,East Cambridgeshire 011B,E01018019,1018,164,854
2021,East Cambridgeshire 002A,E01018020,1483,266,1217
2021,East Cambridgeshire 002B,E01018021,1402,214,1188
2021,East Cambridgeshire 002C,E01018022,1353,214,1139
2021,East Cambridgeshire 011C,E01018023,2053,350,1703
2021,East Cambridgeshire 004A,E01018024,1170,150,1020
2021,East Cambridgeshire 004B,E01018025,1457,277,1180
2021,East Cambridgeshire 004C,E01018026,1404,168,1236
2021,East Cambridgeshire 003A,E01018027,1687,268,1419
2021,East Cambridgeshire 003D,E01018032,2372,368,2004
2021,East Cambridgeshire 003E,E01018033,1814,294,1520
2021,East Cambridgeshire 007A,E01018034,1657,347,1310
2021,East Cambridgeshire 007B,E01018035,2063,337,1726
2021,East Cambridgeshire 005A,E01018036,1585,303,1282
2021,East Cambridgeshire 005B,E01018037,1394,226,1168
2021,East Cambridgeshire 005C,E01018038,1506,252,1254
2021,East Cambridgeshire 005D,E01018039,1249,219,1030
2021,East Cambridgeshire 007C,E01018040,1250,195,1055
2021,East Cambridgeshire 007D,E01018041,1102,196,906
2021,East Cambridgeshire 001A,E01018042,1328,165,1163
2021,East Cambridgeshire 001B,E01018043,2174,363,1811
2021,East Cambridgeshire 001C,E01018044,1673,236,1437
2021,East Cambridgeshire 001D,E01018045,1294,216,1078
2021,East Cambridgeshire 006A,E01018047,1952,361,1591
2021,East Cambridgeshire 006C,E01018049,1900,302,1598
2021,East Cambridgeshire 006D,E01018050,1407,294,1113
2021,East Cambridgeshire 006E,E01018051,2272,452,1820
2021,East Cambridgeshire 006F,E01018052,1799,309,1490
2021,East Cambridgeshire 005E,E01018053,1727,338,1389
2021,East Cambridgeshire 005F,E01018054,2313,368,1945
2021,East Cambridgeshire 002D,E01018055,1920,313,1607
2021,East Cambridgeshire 002E,E01018056,1881,380,1501
2021,East Cambridgeshire 009C,E01018057,1982,375,1607
2021,Fenland 008A,E01018058,1377,163,1214
2021,Fenland 008B,E01018059,1431,216,1215
2021,Fenland 008C,E01018060,1817,323,1494
2021,Fenland 008D,E01018061,1220,214,1006
2021,Fenland 011A,E01018062,2507,425,2082
2021,Fenland 002A,E01018063,2624,444,2180
2021,Fenland 006A,E01018064,2326,421,1905
2021,Fenland 010A,E01018065,2420,367,2053
2021,Fenland 004A,E01018066,1429,211,1218
2021,Fenland 004B,E01018067,1766,285,1481
2021,Fenland 004C,E01018068,1505,239,1266
2021,Fenland 003A,E01018069,1664,257,1407
2021,Fenland 003B,E01018070,1853,318,1535
2021,Fenland 003C,E01018071,1856,286,1570
2021,Fenland 006B,E01018072,2239,490,1749
2021,Fenland 002B,E01018073,2477,406,2071
2021,Fenland 006C,E01018074,1177,187,990
2021,Fenland 006D,E01018075,1144,203,941
2021,Fenland 010B,E01018076,2471,429,2042
2021,Fenland 007A,E01018077,1768,221,1547
2021,Fenland 007B,E01018078,1662,295,1367
2021,Fenland 007C,E01018079,1615,233,1382
2021,Fenland 007D,E01018080,2214,410,1804
2021,Fenland 005A,E01018081,1903,302,1601
2021,Fenland 005B,E01018082,1867,347,1520
2021,Fenland 005C,E01018083,1768,373,1395
2021,Fenland 005D,E01018084,1944,289,1655
2021,Fenland 009A,E01018085,1575,196,1379
2021,Fenland 009B,E01018086,1965,386,1579
2021,Fenland 009C,E01018087,2143,300,1843
2021,Fenland 009D,E01018088,1472,196,1276
2021,Fenland 004D,E01018090,1931,297,1634
2021,Fenland 004E,E01018091,1443,226,1217
2021,Fenland 004F,E01018092,1803,298,1505
2021,Fenland 003E,E01018093,2341,373,1968
2021,Fenland 001A,E01018094,1749,294,1455
2021,Fenland 001B,E01018095,1666,241,1425
2021,Fenland 001C,E01018096,1614,198,1416
2021,Fenland 001D,E01018097,1488,185,1303
2021,Fenland 006E,E01018098,1222,204,1018
2021,Fenland 006F,E01018099,1165,156,1009
2021,Fenland 006G,E01018100,1358,185,1173
2021,Fenland 006H,E01018101,1411,202,1209
2021,Fenland 003F,E01018103,1134,216,918
2021,Fenland 003G,E01018104,1118,140,978
2021,Fenland 011C,E01018105,1140,175,965
2021,Fenland 011D,E01018106,1496,218,1278
2021,Fenland 002C,E01018107,1650,393,1257
2021,Fenland 002D,E01018108,1874,373,1501
2021,Fenland 002E,E01018109,1829,321,1508
2021,Fenland 011E,E01018110,2571,405,2166
2021,Fenland 010C,E01018111,2262,359,1903
2021,Huntingdonshire 010B,E01018113,1420,219,1201
2021,Huntingdonshire 017A,E01018115,2301,153,2148
2021,Huntingdonshire 010D,E01018116,2547,632,1915
2021,Huntingdonshire 010E,E01018117,1667,249,1418
2021,Huntingdonshire 010F,E01018118,1917,365,1552
2021,Huntingdonshire 017B,E01018119,1489,227,1262
2021,Huntingdonshire 017C,E01018120,1750,263,1487
2021,Huntingdonshire 007A,E01018121,1237,189,1048
2021,Huntingdonshire 007B,E01018122,1030,137,893
2021,Huntingdonshire 007C,E01018123,1563,245,1318
2021,Huntingdonshire 007D,E01018124,1799,286,1513
2021,Huntingdonshire 015A,E01018125,1476,239,1237
2021,Huntingdonshire 015B,E01018126,1617,264,1353
2021,Huntingdonshire 002A,E01018127,1424,222,1202
2021,Huntingdonshire 002B,E01018128,1107,158,949
2021,Huntingdonshire 016A,E01018129,1557,239,1318
2021,Huntingdonshire 016B,E01018130,1828,333,1495
2021,Huntingdonshire 014A,E01018131,1442,256,1186
2021,Huntingdonshire 014C,E01018133,1566,300,1266
2021,Huntingdonshire 014D,E01018134,1760,383,1377
2021,Huntingdonshire 018B,E01018136,1611,286,1325
2021,Huntingdonshire 017D,E01018137,1643,275,1368
2021,Huntingdonshire 012A,E01018138,2000,280,1720
2021,Huntingdonshire 009A,E01018139,1549,281,1268
2021,Huntingdonshire 009B,E01018140,1205,161,1044
2021,Huntingdonshire 009C,E01018141,1536,217,1319
2021,Huntingdonshire 009D,E01018142,1434,210,1224
2021,Huntingdonshire 008A,E01018143,2005,418,1587
2021,Huntingdonshire 008B,E01018144,1659,430,1229
2021,Huntingdonshire 008C,E01018145,1265,284,981
2021,Huntingdonshire 008D,E01018146,1970,458,1512
2021,Huntingdonshire 008E,E01018147,1568,372,1196
2021,Huntingdonshire 012B,E01018148,2594,602,1992
2021,Huntingdonshire 012C,E01018149,1370,272,1098
2021,Huntingdonshire 012D,E01018150,1515,285,1230
2021,Huntingdonshire 015C,E01018152,1367,232,1135
2021,Huntingdonshire 015D,E01018153,1673,300,1373
2021,Huntingdonshire 018C,E01018154,2326,433,1893
2021,Huntingdonshire 018D,E01018155,1496,244,1252
2021,Huntingdonshire 003A,E01018156,1540,229,1311
2021,Huntingdonshire 003B,E01018157,2011,369,1642
2021,Huntingdonshire 003C,E01018158,1548,169,1379
2021,Huntingdonshire 003D,E01018159,1515,258,1257
2021,Huntingdonshire 003E,E01018160,1528,325,1203
2021,Huntingdonshire 011A,E01018161,1292,216,1076
2021,Huntingdonshire 011B,E01018162,1384,224,1160
2021,Huntingdonshire 011C,E01018163,1260,241,1019
2021,Huntingdonshire 011D,E01018164,1182,223,959
2021,Huntingdonshire 011E,E01018165,1172,204,968
2021,Huntingdonshire 013A,E01018166,1451,247,1204
2021,Huntingdonshire 013B,E01018167,1370,212,1158
2021,Huntingdonshire 013C,E01018168,1965,187,1778
2021,Huntingdonshire 013D,E01018169,2128,478,1650
2021,Huntingdonshire 011F,E01018170,1288,196,1092
2021,Huntingdonshire 011G,E01018171,1553,287,1266
2021,Huntingdonshire 020A,E01018172,1358,188,1170
2021,Huntingdonshire 020B,E01018173,1097,174,923
2021,Huntingdonshire 020C,E01018174,1432,189,1243
2021,Huntingdonshire 020D,E01018175,1296,220,1076
2021,Huntingdonshire 020E,E01018176,1233,192,1041
2021,Huntingdonshire 022A,E01018177,1351,175,1176
2021,Huntingdonshire 022B,E01018178,1598,261,1337
2021,Huntingdonshire 022C,E01018179,1343,252,1091
2021,Huntingdonshire 022D,E01018180,1168,205,963
2021,Huntingdonshire 021B,E01018182,1346,245,1101
2021,Huntingdonshire 021C,E01018183,1315,223,1092
2021,Huntingdonshire 021D,E01018184,1124,219,905
2021,Huntingdonshire 021E,E01018185,1488,173,1315
2021,Huntingdonshire 021F,E01018186,1601,261,1340
2021,Huntingdonshire 019A,E01018187,1941,239,1702
2021,Huntingdonshire 019B,E01018188,1337,211,1126
2021,Huntingdonshire 019C,E01018189,1223,213,1010
2021,Huntingdonshire 019D,E01018190,1483,264,1219
2021,Huntingdonshire 004A,E01018191,1266,219,1047
2021,Huntingdonshire 004B,E01018192,1764,284,1480
2021,Huntingdonshire 004C,E01018193,1202,180,1022
2021,Huntingdonshire 004D,E01018194,1283,182,1101
2021,Huntingdonshire 004E,E01018195,1217,235,982
2021,Huntingdonshire 006A,E01018196,1238,164,1074
2021,Huntingdonshire 006B,E01018197,1317,205,1112
2021,Huntingdonshire 006C,E01018198,1548,214,1334
2021,Huntingdonshire 006D,E01018199,1489,220,1269
2021,Huntingdonshire 002C,E01018200,1584,270,1314
2021,Huntingdonshire 002D,E01018201,1306,228,1078
2021,Huntingdonshire 016C,E01018202,1406,230,1176
2021,Huntingdonshire 016D,E01018203,1752,269,1483
2021,Huntingdonshire 016E,E01018204,1345,269,1076
2021,Huntingdonshire 016F,E01018205,1690,242,1448
2021,Huntingdonshire 006E,E01018206,2058,405,1653
2021,Huntingdonshire 006F,E01018207,1467,233,1234
2021,Huntingdonshire 005A,E01018208,1981,345,1636
2021,Huntingdonshire 005B,E01018209,1458,193,1265
2021,Huntingdonshire 005C,E01018210,1245,170,1075
2021,Huntingdonshire 005D,E01018211,1838,327,1511
2021,Huntingdonshire 001A,E01018212,1522,240,1282
2021,Huntingdonshire 001B,E01018213,1837,364,1473
2021,Huntingdonshire 001C,E01018214,1849,377,1472
2021,Huntingdonshire 001D,E01018215,1411,276,1135
2021,Huntingdonshire 001E,E01018216,2393,480,1913
2021,Huntingdonshire 001F,E01018217,1527,217,1310
2021,South Cambridgeshire 016A,E01018218,1641,286,1355
2021,South Cambridgeshire 016B,E01018219,1359,214,1145
2021,South Cambridgeshire 016C,E01018220,1358,225,1133
2021,South Cambridgeshire 022A,E01018221,1529,244,1285
2021,South Cambridgeshire 022B,E01018222,1352,209,1143
2021,South Cambridgeshire 022C,E01018223,1854,324,1530
2021,South Cambridgeshire 022F,E01018224,1403,328,1075
2021,South Cambridgeshire 022G,E01018225,1006,150,856
2021,South Cambridgeshire 019A,E01018226,1147,214,933
2021,South Cambridgeshire 019B,E01018227,1816,362,1454
2021,South Cambridgeshire 019C,E01018228,1552,292,1260
2021,South Cambridgeshire 010A,E01018231,2754,619,2135
2021,South Cambridgeshire 010B,E01018232,2179,441,1738
2021,South Cambridgeshire 002A,E01018233,1474,236,1238
2021,South Cambridgeshire 002B,E01018234,1501,244,1257
2021,South Cambridgeshire 002C,E01018235,1550,306,1244
2021,South Cambridgeshire 002D,E01018236,1938,385,1553
2021,South Cambridgeshire 003A,E01018237,1424,269,1155
2021,South Cambridgeshire 017A,E01018238,1390,278,1112
2021,South Cambridgeshire 017B,E01018239,1426,282,1144
2021,South Cambridgeshire 014A,E01018240,1211,214,997
2021,South Cambridgeshire 018A,E01018241,1237,254,983
2021,South Cambridgeshire 011A,E01018242,1592,291,1301
2021,South Cambridgeshire 011B,E01018243,1548,302,1246
2021,South Cambridgeshire 011C,E01018244,1578,262,1316
2021,South Cambridgeshire 013A,E01018245,1606,235,1371
2021,South Cambridgeshire 013B,E01018246,1476,209,1267
2021,South Cambridgeshire 013C,E01018247,1692,280,1412
2021,South Cambridgeshire 022E,E01018248,2132,631,1501
2021,South Cambridgeshire 010C,E01018251,1086,192,894
2021,South Cambridgeshire 010D,E01018252,1449,283,1166
2021,South Cambridgeshire 014B,E01018253,1118,243,875
2021,South Cambridgeshire 014C,E01018254,1866,356,1510
2021,South Cambridgeshire 010E,E01018255,1077,198,879
2021,South Cambridgeshire 014D,E01018256,2358,526,1832
2021,South Cambridgeshire 006A,E01018257,1404,287,1117
2021,South Cambridgeshire 006B,E01018258,1572,305,1267
2021,South Cambridgeshire 006C,E01018259,1361,272,1089
2021,South Cambridgeshire 006D,E01018260,1840,309,1531
2021,South Cambridgeshire 006F,E01018262,1317,253,1064
2021,South Cambridgeshire 016D,E01018263,1418,291,1127
2021,South Cambridgeshire 016E,E01018264,1523,270,1253
2021,South Cambridgeshire 016F,E01018265,1623,300,1323
2021,South Cambridgeshire 018B,E01018267,2195,350,1845
2021,South Cambridgeshire 018C,E01018268,1864,346,1518
2021,South Cambridgeshire 018D,E01018269,1408,238,1170
2021,South Cambridgeshire 018E,E01018270,1064,166,898
2021,South Cambridgeshire 018F,E01018271,1584,356,1228
2021,South Cambridgeshire 007A,E01018272,1445,282,1163
2021,South Cambridgeshire 007B,E01018273,1293,174,1119
2021,South Cambridgeshire 007C,E01018274,1442,194,1248
2021,South Cambridgeshire 013D,E01018275,2493,437,2056
2021,South Cambridgeshire 021A,E01018276,1422,282,1140
2021,South Cambridgeshire 021B,E01018277,1739,301,1438
2021,South Cambridgeshire 021C,E01018278,2430,556,1874
2021,South Cambridgeshire 015A,E01018279,1549,274,1275
2021,South Cambridgeshire 015B,E01018280,1393,253,1140
2021,South Cambridgeshire 015C,E01018281,1480,285,1195
2021,South Cambridgeshire 015D,E01018282,1243,213,1030
2021,South Cambridgeshire 015E,E01018283,1191,233,958
2021,South Cambridgeshire 003C,E01018284,1306,304,1002
2021,South Cambridgeshire 003D,E01018285,1297,299,998
2021,South Cambridgeshire 011D,E01018286,1502,293,1209
2021,South Cambridgeshire 011E,E01018287,1182,191,991
2021,South Cambridgeshire 017C,E01018288,1225,210,1015
2021,South Cambridgeshire 017D,E01018289,1210,230,980
2021,South Cambridgeshire 019D,E01018290,2348,427,1921
2021,South Cambridgeshire 014E,E01018291,1095,213,882
2021,South Cambridgeshire 012A,E01018292,1476,294,1182
2021,South Cambridgeshire 012B,E01018293,1493,293,1200
2021,South Cambridgeshire 012C,E01018294,1641,219,1422
2021,South Cambridgeshire 012D,E01018295,1586,306,1280
2021,South Cambridgeshire 011F,E01018296,990,177,813
2021,South Cambridgeshire 007D,E01018297,1601,231,1370
2021,South Cambridgeshire 004A,E01018298,1436,226,1210
2021,South Cambridgeshire 004B,E01018299,2151,400,1751
2021,South Cambridgeshire 004C,E01018300,1195,175,1020
2021,South Cambridgeshire 004D,E01018301,1292,199,1093
2021,South Cambridgeshire 017E,E01018302,1423,264,1159
2021,South Cambridgeshire 017F,E01018303,1190,218,972
2021,South Cambridgeshire 001A,E01018304,1959,356,1603
2021,South Cambridgeshire 001B,E01018305,1243,211,1032
2021,South Cambridgeshire 001C,E01018306,1521,327,1194
2021,South Cambridgeshire 001D,E01018307,2125,414,1711
2021,Cheshire West and Chester 022A,E01018308,1917,334,1583
2021,Cheshire West and Chester 029A,E01018309,1541,305,1236
2021,Cheshire West and Chester 029B,E01018310,1585,394,1191
2021,Cheshire West and Chester 029C,E01018311,1334,279,1055
2021,Cheshire West and Chester 029D,E01018312,1442,348,1094
2021,Cheshire West and Chester 031A,E01018313,1322,202,1120
2021,Cheshire West and Chester 031B,E01018314,1566,315,1251
2021,Cheshire West and Chester 031C,E01018315,1167,196,971
2021,Cheshire West and Chester 031D,E01018316,1341,332,1009
2021,Cheshire West and Chester 031E,E01018317,1468,312,1156
2021,Cheshire West and Chester 036A,E01018319,2095,364,1731
2021,Cheshire West and Chester 041A,E01018320,1410,283,1127
2021,Cheshire West and Chester 041B,E01018321,1238,217,1021
2021,Cheshire West and Chester 041C,E01018322,1077,172,905
2021,Cheshire West and Chester 039A,E01018323,1434,276,1158
2021,Cheshire West and Chester 039B,E01018324,1306,248,1058
2021,Cheshire West and Chester 039C,E01018325,1418,246,1172
2021,Cheshire West and Chester 034B,E01018328,1500,866,634
2021,Cheshire West and Chester 034D,E01018330,1334,636,698
2021,Cheshire West and Chester 034E,E01018331,1542,536,1006
2021,Cheshire West and Chester 043A,E01018332,1020,195,825
2021,Cheshire West and Chester 043B,E01018333,1509,273,1236
2021,Cheshire West and Chester 043C,E01018334,1547,257,1290
2021,Cheshire West and Chester 046A,E01018335,2111,362,1749
2021,Cheshire West and Chester 022B,E01018336,1156,172,984
2021,Cheshire West and Chester 022C,E01018337,1227,197,1030
2021,Cheshire West and Chester 022D,E01018338,1682,278,1404
2021,Cheshire West and Chester 047A,E01018339,2475,484,1991
2021,Cheshire West and Chester 043D,E01018340,1572,317,1255
2021,Cheshire West and Chester 043E,E01018341,1074,154,920
2021,Cheshire West and Chester 043F,E01018342,1774,276,1498
2021,Cheshire West and Chester 033C,E01018343,1486,173,1313
2021,Cheshire West and Chester 036B,E01018344,1735,237,1498
2021,Cheshire West and Chester 032A,E01018345,1252,260,992
2021,Cheshire West and Chester 032B,E01018346,1403,230,1173
2021,Cheshire West and Chester 032C,E01018347,1319,260,1059
2021,Cheshire West and Chester 030A,E01018349,1690,281,1409
2021,Cheshire West and Chester 030B,E01018350,2096,359,1737
2021,Cheshire West and Chester 044A,E01018351,1377,320,1057
2021,Cheshire West and Chester 044B,E01018352,1799,305,1494
2021,Cheshire West and Chester 044C,E01018353,1448,291,1157
2021,Cheshire West and Chester 044D,E01018354,1498,331,1167
2021,Cheshire West and Chester 047B,E01018355,1306,185,1121
2021,Cheshire West and Chester 047C,E01018356,1593,265,1328
2021,Cheshire West and Chester 047D,E01018357,1842,381,1461
2021,Cheshire West and Chester 022E,E01018358,1249,332,917
2021,Cheshire West and Chester 022F,E01018359,1033,181,852
2021,Cheshire West and Chester 025A,E01018360,2640,386,2254
2021,Cheshire West and Chester 033D,E01018361,1366,320,1046
2021,Cheshire West and Chester 028A,E01018362,1462,283,1179
2021,Cheshire West and Chester 028B,E01018363,964,128,836
2021,Cheshire West and Chester 027A,E01018364,1421,262,1159
2021,Cheshire West and Chester 027B,E01018365,1898,310,1588
2021,Cheshire West and Chester 025B,E01018366,1414,211,1203
2021,Cheshire West and Chester 025C,E01018367,2010,359,1651
2021,Cheshire West and Chester 030C,E01018368,1466,261,1205
2021,Cheshire West and Chester 046B,E01018369,1640,282,1358
2021,Cheshire West and Chester 030D,E01018370,1560,316,1244
2021,Cheshire West and Chester 046C,E01018371,2024,326,1698
2021,Cheshire West and Chester 046D,E01018372,2085,326,1759
2021,Cheshire West and Chester 047E,E01018373,2117,356,1761
2021,Cheshire West and Chester 028C,E01018374,1712,279,1433
2021,Cheshire West and Chester 028D,E01018375,1707,315,1392
2021,Cheshire West and Chester 028E,E01018376,1670,370,1300
2021,Cheshire West and Chester 028F,E01018377,2019,376,1643
2021,Cheshire West and Chester 027C,E01018378,1183,250,933
2021,Cheshire West and Chester 027D,E01018379,1319,215,1104
2021,Cheshire West and Chester 027E,E01018380,1085,175,910
2021,Cheshire West and Chester 036C,E01018381,1161,241,920
2021,Cheshire West and Chester 036D,E01018382,1548,179,1369
2021,Cheshire West and Chester 032D,E01018383,1390,297,1093
2021,Cheshire West and Chester 032E,E01018384,1388,240,1148
2021,Cheshire West and Chester 039D,E01018385,1922,351,1571
2021,Cheshire East 042A,E01018386,2021,344,1677
2021,Cheshire East 040A,E01018387,1820,280,1540
2021,Cheshire East 040B,E01018388,1596,362,1234
2021,Cheshire East 040C,E01018389,1614,240,1374
2021,Cheshire East 040D,E01018390,1541,226,1315
2021,Cheshire East 042B,E01018391,2369,517,1852
2021,Cheshire East 042C,E01018392,1753,319,1434
2021,Cheshire East 026A,E01018395,1842,261,1581
2021,Cheshire East 026B,E01018396,1381,295,1086
2021,Cheshire East 028A,E01018397,1941,376,1565
2021,Cheshire East 027A,E01018398,1384,198,1186
2021,Cheshire East 027B,E01018399,1678,261,1417
2021,Cheshire East 026C,E01018400,2320,456,1864
2021,Cheshire East 026D,E01018401,1535,358,1177
2021,Cheshire East 027C,E01018402,1797,204,1593
2021,Cheshire East 027D,E01018403,2303,404,1899
2021,Cheshire East 029A,E01018404,1382,186,1196
2021,Cheshire East 029B,E01018405,1265,178,1087
2021,Cheshire East 029C,E01018406,1359,211,1148
2021,Cheshire East 029D,E01018407,1446,192,1254
2021,Cheshire East 028B,E01018408,1782,258,1524
2021,Cheshire East 028C,E01018409,1864,261,1603
2021,Cheshire East 028D,E01018410,1746,293,1453
2021,Cheshire East 022B,E01018411,2301,396,1905
2021,Cheshire East 022C,E01018412,1548,237,1311
2021,Cheshire East 023A,E01018413,1433,266,1167
2021,Cheshire East 023B,E01018414,1529,273,1256
2021,Cheshire East 023C,E01018415,1657,256,1401
2021,Cheshire East 023D,E01018416,1719,367,1352
2021,Cheshire East 033B,E01018417,1576,163,1413
2021,Cheshire East 033C,E01018418,1439,185,1254
2021,Cheshire East 025A,E01018419,2169,425,1744
2021,Cheshire East 025B,E01018420,1817,379,1438
2021,Cheshire East 025C,E01018421,1209,223,986
2021,Cheshire East 025D,E01018422,1279,218,1061
2021,Cheshire East 025E,E01018423,1412,281,1131
2021,Cheshire East 024A,E01018424,1625,232,1393
2021,Cheshire East 024B,E01018425,1580,214,1366
2021,Cheshire East 024C,E01018426,1441,177,1264
2021,Cheshire East 024D,E01018427,1171,170,1001
2021,Cheshire East 033D,E01018428,1227,171,1056
2021,Cheshire East 033E,E01018429,1469,221,1248
2021,Cheshire East 033F,E01018430,1250,199,1051
2021,Cheshire East 033G,E01018431,1197,177,1020
2021,Cheshire East 032A,E01018432,1297,197,1100
2021,Cheshire East 032B,E01018433,1361,170,1191
2021,Cheshire East 032C,E01018434,1289,155,1134
2021,Cheshire East 032D,E01018435,1382,231,1151
2021,Cheshire East 030A,E01018436,1571,240,1331
2021,Cheshire East 030B,E01018437,1485,224,1261
2021,Cheshire East 030C,E01018438,1250,142,1108
2021,Cheshire East 030D,E01018439,1956,319,1637
2021,Cheshire East 031A,E01018440,2446,491,1955
2021,Cheshire East 031B,E01018441,1928,364,1564
2021,Cheshire East 031D,E01018443,2033,347,1686
2021,Cheshire East 045A,E01018445,1808,410,1398
2021,Cheshire East 045B,E01018446,1370,243,1127
2021,Cheshire East 045C,E01018447,1857,311,1546
2021,Cheshire East 045D,E01018448,1614,274,1340
2021,Cheshire East 051A,E01018449,1681,221,1460
2021,Cheshire East 051B,E01018450,2565,423,2142
2021,Cheshire East 047A,E01018451,1266,149,1117
2021,Cheshire East 050A,E01018452,1037,164,873
2021,Cheshire East 047B,E01018454,1488,260,1228
2021,Cheshire East 047C,E01018455,1281,173,1108
2021,Cheshire East 047D,E01018456,1259,148,1111
2021,Cheshire East 047E,E01018457,1411,170,1241
2021,Cheshire East 051C,E01018458,2211,383,1828
2021,Cheshire East 036A,E01018459,1342,396,946
2021,Cheshire East 036B,E01018460,1329,206,1123
2021,Cheshire East 036C,E01018461,1442,265,1177
2021,Cheshire East 039A,E01018462,1802,314,1488
2021,Cheshire East 035A,E01018463,1353,220,1133
2021,Cheshire East 039B,E01018464,1473,247,1226
2021,Cheshire East 036D,E01018466,2148,330,1818
2021,Cheshire East 041B,E01018468,1457,217,1240
2021,Cheshire East 041C,E01018469,1679,264,1415
2021,Cheshire East 041D,E01018470,1802,293,1509
2021,Cheshire East 041E,E01018471,1335,195,1140
2021,Cheshire East 034A,E01018472,1279,172,1107
2021,Cheshire East 034B,E01018473,1467,262,1205
2021,Cheshire East 034C,E01018474,1673,336,1337
2021,Cheshire East 034D,E01018475,1612,334,1278
2021,Cheshire East 035B,E01018476,1483,384,1099
2021,Cheshire East 035C,E01018477,1630,376,1254
2021,Cheshire East 035D,E01018478,1609,383,1226
2021,Cheshire East 035E,E01018479,2178,356,1822
2021,Cheshire East 051D,E01018481,1946,306,1640
2021,Cheshire East 037A,E01018482,1303,215,1088
2021,Cheshire East 037B,E01018483,1291,163,1128
2021,Cheshire East 037C,E01018484,2065,573,1492
2021,Cheshire East 037D,E01018485,1429,349,1080
2021,Cheshire East 043A,E01018486,1509,207,1302
2021,Cheshire East 043B,E01018487,1648,322,1326
2021,Cheshire East 043C,E01018488,1515,272,1243
2021,Cheshire East 043D,E01018489,1551,223,1328
2021,Cheshire East 046A,E01018490,1661,248,1413
2021,Cheshire East 046B,E01018491,1551,267,1284
2021,Cheshire East 046C,E01018492,1034,128,906
2021,Cheshire East 048A,E01018493,1293,144,1149
2021,Cheshire East 048B,E01018494,2493,458,2035
2021,Cheshire East 048C,E01018495,1449,241,1208
2021,Cheshire East 039C,E01018496,1518,306,1212
2021,Cheshire East 039D,E01018497,1142,188,954
2021,Cheshire East 039E,E01018498,1569,382,1187
2021,Cheshire East 038A,E01018499,1418,196,1222
2021,Cheshire East 038B,E01018500,1093,149,944
2021,Cheshire East 038C,E01018501,1458,179,1279
2021,Cheshire East 038D,E01018502,1383,119,1264
2021,Cheshire East 050C,E01018503,1656,273,1383
2021,Cheshire East 050D,E01018504,1583,190,1393
2021,Cheshire East 046D,E01018505,1195,201,994
2021,Cheshire East 046E,E01018506,1262,169,1093
2021,Cheshire East 046F,E01018507,1280,164,1116
2021,Cheshire East 048D,E01018508,1350,260,1090
2021,Cheshire East 048E,E01018509,1111,176,935
2021,Cheshire East 044A,E01018510,1609,302,1307
2021,Cheshire East 044B,E01018511,1331,257,1074
2021,Cheshire East 044C,E01018512,1584,358,1226
2021,Cheshire East 044D,E01018513,1471,223,1248
2021,Cheshire East 051E,E01018514,2023,315,1708
2021,Cheshire East 053F,E01018515,2257,444,1813
2021,Cheshire East 053C,E01018516,1507,210,1297
2021,Cheshire West and Chester 004A,E01018518,1518,196,1322
2021,Cheshire West and Chester 007A,E01018519,1322,243,1079
2021,Cheshire West and Chester 007B,E01018520,1787,318,1469
2021,Cheshire West and Chester 011A,E01018521,1301,310,991
2021,Cheshire West and Chester 010A,E01018522,1384,293,1091
2021,Cheshire West and Chester 008A,E01018523,1279,245,1034
2021,Cheshire West and Chester 008B,E01018524,1396,394,1002
2021,Cheshire West and Chester 007C,E01018525,1626,332,1294
2021,Cheshire West and Chester 016A,E01018526,1541,302,1239
2021,Cheshire West and Chester 016B,E01018527,1523,244,1279
2021,Cheshire West and Chester 009A,E01018528,1587,261,1326
2021,Cheshire West and Chester 009B,E01018529,1313,154,1159
2021,Cheshire West and Chester 009C,E01018530,1401,257,1144
2021,Cheshire West and Chester 009D,E01018531,1498,223,1275
2021,Cheshire West and Chester 006A,E01018532,1814,317,1497
2021,Cheshire West and Chester 006B,E01018533,1412,226,1186
2021,Cheshire West and Chester 001A,E01018534,2371,516,1855
2021,Cheshire West and Chester 001B,E01018535,1590,355,1235
2021,Cheshire West and Chester 001C,E01018536,1656,241,1415
2021,Cheshire West and Chester 001D,E01018537,1990,222,1768
2021,Cheshire West and Chester 010B,E01018538,1157,226,931
2021,Cheshire West and Chester 010C,E01018539,1134,254,880
2021,Cheshire West and Chester 010D,E01018540,1357,260,1097
2021,Cheshire West and Chester 008C,E01018541,1295,206,1089
2021,Cheshire West and Chester 008D,E01018542,1241,349,892
2021,Cheshire West and Chester 008E,E01018543,1212,223,989
2021,Cheshire West and Chester 006C,E01018544,1369,178,1191
2021,Cheshire West and Chester 006D,E01018545,1796,337,1459
2021,Cheshire West and Chester 005A,E01018546,1488,293,1195
2021,Cheshire West and Chester 005B,E01018547,1268,172,1096
2021,Cheshire West and Chester 005C,E01018548,2010,362,1648
2021,Cheshire West and Chester 005D,E01018549,1391,171,1220
2021,Cheshire West and Chester 011B,E01018550,1049,261,788
2021,Cheshire West and Chester 011C,E01018551,1442,256,1186
2021,Cheshire West and Chester 011D,E01018552,2371,503,1868
2021,Cheshire West and Chester 011E,E01018553,1679,342,1337
2021,Cheshire West and Chester 016C,E01018554,2099,290,1809
2021,Cheshire West and Chester 016D,E01018555,1064,171,893
2021,Cheshire West and Chester 013A,E01018556,1353,187,1166
2021,Cheshire West and Chester 013B,E01018557,1331,263,1068
2021,Cheshire West and Chester 013C,E01018558,1098,167,931
2021,Cheshire West and Chester 013D,E01018559,1066,162,904
2021,Cheshire West and Chester 009E,E01018560,1079,162,917
2021,Cheshire West and Chester 009F,E01018561,1136,183,953
2021,Cheshire West and Chester 009G,E01018562,1330,251,1079
2021,Cheshire West and Chester 014A,E01018565,1531,266,1265
2021,Cheshire West and Chester 014B,E01018566,1223,142,1081
2021,Cheshire West and Chester 014C,E01018567,1368,207,1161
2021,Cheshire West and Chester 014D,E01018568,1415,290,1125
2021,Cheshire West and Chester 004B,E01018569,1276,198,1078
2021,Cheshire West and Chester 004C,E01018570,1339,212,1127
2021,Cheshire West and Chester 004D,E01018571,1296,165,1131
2021,Cheshire East 012A,E01018572,1739,259,1480
2021,Cheshire East 012B,E01018573,1415,253,1162
2021,Cheshire East 012C,E01018574,1915,302,1613
2021,Cheshire East 013A,E01018575,1236,229,1007
2021,Cheshire East 013B,E01018576,1734,251,1483
2021,Cheshire East 013C,E01018577,2258,367,1891
2021,Cheshire East 013D,E01018578,1172,193,979
2021,Cheshire East 013E,E01018579,1181,232,949
2021,Cheshire East 012D,E01018580,1717,237,1480
2021,Cheshire East 012E,E01018581,1447,175,1272
2021,Cheshire East 004A,E01018582,2241,370,1871
2021,Cheshire East 005A,E01018583,1774,349,1425
2021,Cheshire East 005B,E01018584,1856,384,1472
2021,Cheshire East 001A,E01018585,1316,192,1124
2021,Cheshire East 001B,E01018586,1836,308,1528
2021,Cheshire East 001C,E01018587,1537,236,1301
2021,Cheshire East 008A,E01018588,1450,295,1155
2021,Cheshire East 008B,E01018589,1530,344,1186
2021,Cheshire East 008C,E01018590,1870,450,1420
2021,Cheshire East 020A,E01018591,2312,311,2001
2021,Cheshire East 004B,E01018592,1697,293,1404
2021,Cheshire East 004C,E01018593,1700,289,1411
2021,Cheshire East 004D,E01018594,1649,292,1357
2021,Cheshire East 004E,E01018595,1601,277,1324
2021,Cheshire East 004F,E01018596,1896,412,1484
2021,Cheshire East 007A,E01018598,1843,391,1452
2021,Cheshire East 007B,E01018599,1104,173,931
2021,Cheshire East 006A,E01018600,1637,320,1317
2021,Cheshire East 006B,E01018601,1726,235,1491
2021,Cheshire East 006C,E01018602,1721,262,1459
2021,Cheshire East 010A,E01018603,1282,288,994
2021,Cheshire East 010B,E01018604,1294,244,1050
2021,Cheshire East 009A,E01018605,1061,186,875
2021,Cheshire East 010C,E01018606,1422,197,1225
2021,Cheshire East 010D,E01018607,1236,240,996
2021,Cheshire East 010E,E01018608,1294,258,1036
2021,Cheshire East 009B,E01018609,1633,270,1363
2021,Cheshire East 009C,E01018610,1841,347,1494
2021,Cheshire East 009D,E01018611,1557,349,1208
2021,Cheshire East 005C,E01018612,1297,282,1015
2021,Cheshire East 005D,E01018613,1502,293,1209
2021,Cheshire East 015A,E01018614,1739,303,1436
2021,Cheshire East 017A,E01018615,1147,164,983
2021,Cheshire East 017B,E01018616,1471,251,1220
2021,Cheshire East 017C,E01018617,1301,187,1114
2021,Cheshire East 015B,E01018618,1417,361,1056
2021,Cheshire East 015C,E01018619,1442,285,1157
2021,Cheshire East 015D,E01018620,1397,293,1104
2021,Cheshire East 015E,E01018621,1276,213,1063
2021,Cheshire East 018A,E01018622,1263,170,1093
2021,Cheshire East 018B,E01018623,1342,183,1159
2021,Cheshire East 018C,E01018624,1893,211,1682
2021,Cheshire East 018D,E01018625,1372,211,1161
2021,Cheshire East 018E,E01018627,1628,184,1444
2021,Cheshire East 016B,E01018628,1475,265,1210
2021,Cheshire East 016C,E01018629,1762,313,1449
2021,Cheshire East 016D,E01018630,1218,194,1024
2021,Cheshire East 016E,E01018631,1279,212,1067
2021,Cheshire East 017D,E01018632,1640,281,1359
2021,Cheshire East 017E,E01018633,1434,226,1208
2021,Cheshire East 019A,E01018634,1750,301,1449
2021,Cheshire East 018F,E01018635,1129,159,970
2021,Cheshire East 018G,E01018636,1300,228,1072
2021,Cheshire East 021A,E01018637,1740,377,1363
2021,Cheshire East 021B,E01018638,1447,272,1175
2021,Cheshire East 021C,E01018639,1453,211,1242
2021,Cheshire East 021D,E01018640,1207,215,992
2021,Cheshire East 014A,E01018641,1491,280,1211
2021,Cheshire East 014B,E01018642,1262,246,1016
2021,Cheshire East 014C,E01018643,1926,372,1554
2021,Cheshire East 014D,E01018644,1310,188,1122
2021,Cheshire East 019B,E01018645,1667,259,1408
2021,Cheshire East 019C,E01018646,1639,312,1327
2021,Cheshire East 019D,E01018647,1438,271,1167
2021,Cheshire East 007C,E01018648,2231,351,1880
2021,Cheshire East 007D,E01018649,1338,158,1180
2021,Cheshire East 007E,E01018650,1628,293,1335
2021,Cheshire East 007F,E01018651,1497,226,1271
2021,Cheshire East 006D,E01018652,1476,320,1156
2021,Cheshire East 008D,E01018653,2057,397,1660
2021,Cheshire East 007G,E01018654,2309,322,1987
2021,Cheshire East 003A,E01018655,1501,217,1284
2021,Cheshire East 002A,E01018657,1073,203,870
2021,Cheshire East 003C,E01018658,1119,188,931
2021,Cheshire East 003D,E01018659,1181,186,995
2021,Cheshire East 001D,E01018661,1150,152,998
2021,Cheshire East 002B,E01018662,1148,216,932
2021,Cheshire East 002C,E01018663,1497,276,1221
2021,Cheshire East 002D,E01018664,1308,214,1094
2021,Cheshire East 002E,E01018665,1088,194,894
2021,Cheshire East 011A,E01018666,1749,333,1416
2021,Cheshire East 011B,E01018667,1579,232,1347
2021,Cheshire East 011C,E01018668,1779,254,1525
2021,Cheshire East 020C,E01018669,2450,373,2077
2021,Cheshire East 020D,E01018670,2252,327,1925
2021,Cheshire West and Chester 012A,E01018671,1175,185,990
2021,Cheshire West and Chester 012B,E01018672,1622,343,1279
2021,Cheshire West and Chester 012C,E01018673,1102,181,921
2021,Cheshire West and Chester 012D,E01018674,1481,265,1216
2021,Cheshire West and Chester 003A,E01018675,1958,294,1664
2021,Cheshire West and Chester 024A,E01018676,1775,317,1458
2021,Cheshire West and Chester 024B,E01018677,1604,201,1403
2021,Cheshire West and Chester 024C,E01018678,1219,187,1032
2021,Cheshire West and Chester 024D,E01018679,2035,428,1607
2021,Cheshire West and Chester 026A,E01018680,1635,290,1345
2021,Cheshire West and Chester 026B,E01018681,1571,267,1304
2021,Cheshire West and Chester 026C,E01018682,1251,221,1030
2021,Cheshire West and Chester 026D,E01018683,1693,280,1413
2021,Cheshire West and Chester 015A,E01018684,2265,331,1934
2021,Cheshire West and Chester 002A,E01018685,1245,264,981
2021,Cheshire West and Chester 002B,E01018686,1398,297,1101
2021,Cheshire West and Chester 002C,E01018687,1261,201,1060
2021,Cheshire West and Chester 002D,E01018688,1504,238,1266
2021,Cheshire West and Chester 002E,E01018689,1340,184,1156
2021,Cheshire West and Chester 002F,E01018690,2053,359,1694
2021,Cheshire West and Chester 023A,E01018691,1572,277,1295
2021,Cheshire West and Chester 024E,E01018692,1877,312,1565
2021,Cheshire West and Chester 023B,E01018693,1964,380,1584
2021,Cheshire West and Chester 023C,E01018694,2107,410,1697
2021,Cheshire West and Chester 015B,E01018695,1891,304,1587
2021,Cheshire West and Chester 015C,E01018696,1426,205,1221
2021,Cheshire West and Chester 015D,E01018697,1706,259,1447
2021,Cheshire West and Chester 015E,E01018698,1929,296,1633
2021,Cheshire West and Chester 021A,E01018699,1470,261,1209
2021,Cheshire West and Chester 023D,E01018700,1802,414,1388
2021,Cheshire West and Chester 021B,E01018701,1363,294,1069
2021,Cheshire West and Chester 023E,E01018702,1410,313,1097
2021,Cheshire West and Chester 023F,E01018703,1906,278,1628
2021,Cheshire West and Chester 017A,E01018704,1325,196,1129
2021,Cheshire West and Chester 017B,E01018705,1404,238,1166
2021,Cheshire West and Chester 017C,E01018706,1805,317,1488
2021,Cheshire West and Chester 045A,E01018707,1696,256,1440
2021,Cheshire West and Chester 003B,E01018708,2076,301,1775
2021,Cheshire West and Chester 020A,E01018709,1375,241,1134
2021,Cheshire West and Chester 020B,E01018710,1363,274,1089
2021,Cheshire West and Chester 020C,E01018711,1412,219,1193
2021,Cheshire West and Chester 020D,E01018712,1423,219,1204
2021,Cheshire West and Chester 018B,E01018714,1848,247,1601
2021,Cheshire West and Chester 018C,E01018715,1577,234,1343
2021,Cheshire West and Chester 021C,E01018716,1488,289,1199
2021,Cheshire West and Chester 021D,E01018717,1627,288,1339
2021,Cheshire West and Chester 017D,E01018718,1774,279,1495
2021,Cheshire West and Chester 021E,E01018719,1401,225,1176
2021,Cheshire West and Chester 021F,E01018720,1657,304,1353
2021,Cheshire West and Chester 003C,E01018721,2172,285,1887
2021,Cheshire West and Chester 017E,E01018722,2527,348,2179
2021,Cheshire West and Chester 045B,E01018723,1388,264,1124
2021,Cheshire West and Chester 045C,E01018724,1699,301,1398
2021,Cheshire West and Chester 045D,E01018725,1417,267,1150
2021,Cheshire West and Chester 019A,E01018726,1467,273,1194
2021,Cheshire West and Chester 019B,E01018727,1701,236,1465
2021,Cheshire West and Chester 019C,E01018728,1506,294,1212
2021,Cheshire West and Chester 019D,E01018729,1573,303,1270
2021,Cheshire West and Chester 040A,E01018730,1387,216,1171
2021,Cheshire West and Chester 042A,E01018731,1854,336,1518
2021,Cheshire West and Chester 038A,E01018732,1269,162,1107
2021,Cheshire West and Chester 035A,E01018733,1334,149,1185
2021,Cheshire West and Chester 035B,E01018734,1181,187,994
2021,Cheshire West and Chester 042B,E01018735,1176,152,1024
2021,Cheshire West and Chester 037A,E01018736,1664,327,1337
2021,Cheshire West and Chester 037B,E01018737,2014,354,1660
2021,Cheshire West and Chester 040B,E01018738,1667,519,1148
2021,Cheshire West and Chester 040C,E01018739,1844,453,1391
2021,Cheshire West and Chester 042C,E01018740,1387,335,1052
2021,Cheshire West and Chester 040D,E01018741,1145,182,963
2021,Cheshire West and Chester 042D,E01018742,2204,375,1829
2021,Cheshire West and Chester 037C,E01018743,1285,189,1096
2021,Cheshire West and Chester 037D,E01018744,1602,317,1285
2021,Cheshire West and Chester 038B,E01018745,1472,312,1160
2021,Cheshire West and Chester 038C,E01018746,1789,318,1471
2021,Cheshire West and Chester 038D,E01018747,1597,236,1361
2021,Cheshire West and Chester 035C,E01018748,1320,343,977
2021,Cheshire West and Chester 035D,E01018749,2355,535,1820
2021,Cornwall 013A,E01018750,2180,300,1880
2021,Cornwall 013B,E01018751,1507,257,1250
2021,Cornwall 013C,E01018752,2042,317,1725
2021,Cornwall 010A,E01018753,1702,218,1484
2021,Cornwall 010B,E01018754,1786,328,1458
2021,Cornwall 010C,E01018755,1409,143,1266
2021,Cornwall 010D,E01018756,1521,192,1329
2021,Cornwall 023A,E01018757,2117,281,1836
2021,Cornwall 028A,E01018759,1488,215,1273
2021,Cornwall 028B,E01018760,1285,179,1106
2021,Cornwall 028C,E01018761,1792,214,1578
2021,Cornwall 037A,E01018762,1171,146,1025
2021,Cornwall 023B,E01018763,1071,197,874
2021,Cornwall 022A,E01018764,1429,209,1220
2021,Cornwall 023C,E01018765,1451,193,1258
2021,Cornwall 028D,E01018766,1637,207,1430
2021,Cornwall 017A,E01018767,1386,269,1117
2021,Cornwall 016B,E01018768,1979,409,1570
2021,Cornwall 017B,E01018770,1257,223,1034
2021,Cornwall 017C,E01018771,1268,118,1150
2021,Cornwall 017D,E01018772,1765,311,1454
2021,Cornwall 037B,E01018773,1491,169,1322
2021,Cornwall 028E,E01018774,1805,291,1514
2021,Cornwall 012A,E01018777,2013,279,1734
2021,Cornwall 016D,E01018778,1687,267,1420
2021,Cornwall 013D,E01018779,2211,349,1862
2021,Cornwall 034A,E01018780,2225,373,1852
2021,Cornwall 034B,E01018781,1696,220,1476
2021,Cornwall 012B,E01018782,1414,188,1226
2021,Cornwall 012C,E01018783,1438,180,1258
2021,Cornwall 012D,E01018784,1480,204,1276
2021,Cornwall 023D,E01018785,1865,286,1579
2021,Cornwall 025A,E01018786,1204,198,1006
2021,Cornwall 022B,E01018787,1472,288,1184
2021,Cornwall 025B,E01018788,1346,191,1155
2021,Cornwall 026A,E01018789,1335,255,1080
2021,Cornwall 025C,E01018790,1149,226,923
2021,Cornwall 026B,E01018791,1225,232,993
2021,Cornwall 026C,E01018792,2609,494,2115
2021,Cornwall 026D,E01018793,1626,235,1391
2021,Cornwall 025D,E01018794,1357,223,1134
2021,Cornwall 022C,E01018795,1191,177,1014
2021,Cornwall 022D,E01018796,1116,230,886
2021,Cornwall 029A,E01018797,1064,164,900
2021,Cornwall 029B,E01018798,1469,222,1247
2021,Cornwall 029C,E01018799,1120,228,892
2021,Cornwall 029D,E01018800,1406,241,1165
2021,Cornwall 063A,E01018803,1909,576,1333
2021,Cornwall 063B,E01018804,1913,915,998
2021,Cornwall 063C,E01018805,1503,256,1247
2021,Cornwall 063D,E01018806,1570,608,962
2021,Cornwall 044A,E01018807,1823,358,1465
2021,Cornwall 044B,E01018808,1445,282,1163
2021,Cornwall 044D,E01018810,1321,239,1082
2021,Cornwall 064A,E01018811,1527,257,1270
2021,Cornwall 064B,E01018812,1656,380,1276
2021,Cornwall 064C,E01018813,1567,281,1286
2021,Cornwall 064D,E01018814,1442,231,1211
2021,Cornwall 032A,E01018815,2326,466,1860
2021,Cornwall 047A,E01018816,1554,216,1338
2021,Cornwall 047B,E01018817,2024,311,1713
2021,Cornwall 047C,E01018818,1732,266,1466
2021,Cornwall 043A,E01018819,1393,221,1172
2021,Cornwall 047D,E01018820,1785,327,1458
2021,Cornwall 047E,E01018821,1646,319,1327
2021,Cornwall 043B,E01018822,1339,225,1114
2021,Cornwall 042A,E01018823,1470,186,1284
2021,Cornwall 042B,E01018824,2544,524,2020
2021,Cornwall 040A,E01018825,1645,325,1320
2021,Cornwall 040B,E01018826,2277,380,1897
2021,Cornwall 056A,E01018827,1477,213,1264
2021,Cornwall 056B,E01018828,1409,177,1232
2021,Cornwall 056C,E01018829,1290,222,1068
2021,Cornwall 056D,E01018830,1544,224,1320
2021,Cornwall 032B,E01018831,1480,281,1199
2021,Cornwall 032C,E01018832,1277,210,1067
2021,Cornwall 033A,E01018833,1869,357,1512
2021,Cornwall 060A,E01018834,1905,450,1455
2021,Cornwall 060B,E01018835,2079,843,1236
2021,Cornwall 060C,E01018836,1689,562,1127
2021,Cornwall 060D,E01018837,2410,579,1831
2021,Cornwall 062A,E01018838,1538,441,1097
2021,Cornwall 062B,E01018839,1150,316,834
2021,Cornwall 062C,E01018840,1860,879,981
2021,Cornwall 062D,E01018841,1636,489,1147
2021,Cornwall 033B,E01018842,1647,315,1332
2021,Cornwall 033C,E01018843,1379,247,1132
2021,Cornwall 033D,E01018844,1235,180,1055
2021,Cornwall 048A,E01018845,1784,341,1443
2021,Cornwall 048B,E01018846,1404,205,1199
2021,Cornwall 032D,E01018847,1725,355,1370
2021,Cornwall 048C,E01018848,1651,273,1378
2021,Cornwall 048D,E01018849,1788,219,1569
2021,Cornwall 048E,E01018850,1281,162,1119
2021,Cornwall 040C,E01018851,1257,197,1060
2021,Cornwall 042C,E01018853,2708,576,2132
2021,Cornwall 042D,E01018854,1349,291,1058
2021,Cornwall 043D,E01018856,1251,170,1081
2021,Cornwall 043E,E01018857,1352,217,1135
2021,Cornwall 043F,E01018858,1414,196,1218
2021,Cornwall 064E,E01018859,1714,348,1366
2021,Cornwall 062E,E01018860,1797,343,1454
2021,Cornwall 072A,E01018861,1469,191,1278
2021,Cornwall 072B,E01018862,1418,175,1243
2021,Cornwall 059A,E01018863,1650,262,1388
2021,Cornwall 059B,E01018864,1688,242,1446
2021,Cornwall 052A,E01018865,2127,377,1750
2021,Cornwall 052B,E01018866,2070,385,1685
2021,Cornwall 052D,E01018868,1833,294,1539
2021,Cornwall 055A,E01018869,1671,294,1377
2021,Cornwall 055B,E01018870,1222,317,905
2021,Cornwall 055C,E01018871,1624,246,1378
2021,Cornwall 055D,E01018872,1216,185,1031
2021,Cornwall 055E,E01018873,1161,235,926
2021,Cornwall 053A,E01018874,1265,167,1098
2021,Cornwall 053B,E01018875,1256,200,1056
2021,Cornwall 053C,E01018876,1419,244,1175
2021,Cornwall 053D,E01018877,1506,194,1312
2021,Cornwall 053E,E01018878,1583,270,1313
2021,Cornwall 066A,E01018879,1861,249,1612
2021,Cornwall 066B,E01018880,2155,343,1812
2021,Cornwall 073A,E01018881,2049,304,1745
2021,Cornwall 071A,E01018882,1424,222,1202
2021,Cornwall 071B,E01018883,1558,281,1277
2021,Cornwall 071C,E01018884,1553,266,1287
2021,Cornwall 071D,E01018885,1398,231,1167
2021,Cornwall 071E,E01018886,1597,386,1211
2021,Cornwall 071F,E01018887,1796,440,1356
2021,Cornwall 071G,E01018888,2124,427,1697
2021,Cornwall 045A,E01018889,1218,198,1020
2021,Cornwall 045B,E01018890,1559,237,1322
2021,Cornwall 045C,E01018891,1218,141,1077
2021,Cornwall 045D,E01018892,1588,300,1288
2021,Cornwall 045E,E01018893,1266,177,1089
2021,Cornwall 051A,E01018894,1898,385,1513
2021,Cornwall 051B,E01018895,1876,347,1529
2021,Cornwall 051C,E01018896,1361,188,1173
2021,Cornwall 051D,E01018897,2195,417,1778
2021,Cornwall 051E,E01018898,1198,250,948
2021,Cornwall 066C,E01018899,2847,1533,1314
2021,Cornwall 066D,E01018900,1919,312,1607
2021,Cornwall 066E,E01018901,1479,238,1241
2021,Cornwall 073B,E01018902,1153,182,971
2021,Cornwall 073C,E01018903,1147,186,961
2021,Cornwall 073D,E01018904,2232,426,1806
2021,Cornwall 072C,E01018905,1391,215,1176
2021,Cornwall 072D,E01018906,1060,128,932
2021,Cornwall 072E,E01018907,1265,211,1054
2021,Cornwall 046A,E01018908,1766,267,1499
2021,Cornwall 046B,E01018909,1607,266,1341
2021,Cornwall 046C,E01018910,1915,448,1467
2021,Cornwall 046D,E01018911,1651,190,1461
2021,Cornwall 049A,E01018912,1826,312,1514
2021,Cornwall 049B,E01018913,1808,322,1486
2021,Cornwall 049C,E01018914,2062,347,1715
2021,Cornwall 049D,E01018915,2093,374,1719
2021,Cornwall 050A,E01018916,1338,245,1093
2021,Cornwall 050B,E01018917,1385,223,1162
2021,Cornwall 050C,E01018918,1837,279,1558
2021,Cornwall 050D,E01018919,1453,239,1214
2021,Cornwall 073E,E01018920,2011,273,1738
2021,Cornwall 059C,E01018921,2147,396,1751
2021,Cornwall 059D,E01018922,2470,390,2080
2021,Cornwall 011A,E01018923,1349,205,1144
2021,Cornwall 007A,E01018924,1246,226,1020
2021,Cornwall 006A,E01018925,2163,299,1864
2021,Cornwall 011B,E01018926,2431,308,2123
2021,Cornwall 015A,E01018927,1610,311,1299
2021,Cornwall 015B,E01018928,1595,285,1310
2021,Cornwall 015C,E01018929,1769,335,1434
2021,Cornwall 015D,E01018930,1443,327,1116
2021,Cornwall 015E,E01018931,1053,148,905
2021,Cornwall 014A,E01018932,1600,283,1317
2021,Cornwall 014B,E01018933,1824,335,1489
2021,Cornwall 014C,E01018934,2519,405,2114
2021,Cornwall 014D,E01018935,2511,501,2010
2021,Cornwall 001A,E01018936,1539,212,1327
2021,Cornwall 001B,E01018937,1971,405,1566
2021,Cornwall 001C,E01018938,1596,212,1384
2021,Cornwall 003A,E01018940,1570,243,1327
2021,Cornwall 003B,E01018941,1583,289,1294
2021,Cornwall 003C,E01018942,1458,186,1272
2021,Cornwall 002A,E01018943,2271,411,1860
2021,Cornwall 011C,E01018944,1090,161,929
2021,Cornwall 011D,E01018945,1302,198,1104
2021,Cornwall 005A,E01018946,1442,229,1213
2021,Cornwall 005C,E01018948,1643,258,1385
2021,Cornwall 005D,E01018949,1302,312,990
2021,Cornwall 005E,E01018950,1616,242,1374
2021,Cornwall 002B,E01018951,2337,353,1984
2021,Cornwall 006B,E01018952,1199,150,1049
2021,Cornwall 004B,E01018953,1239,180,1059
2021,Cornwall 008A,E01018954,1486,356,1130
2021,Cornwall 008B,E01018955,1512,254,1258
2021,Cornwall 008C,E01018956,1034,139,895
2021,Cornwall 008D,E01018957,1439,209,1230
2021,Cornwall 008E,E01018958,975,128,847
2021,Cornwall 001D,E01018959,1392,157,1235
2021,Cornwall 001E,E01018960,2292,507,1785
2021,Cornwall 001F,E01018961,1356,201,1155
2021,Cornwall 007B,E01018962,1871,289,1582
2021,Cornwall 006C,E01018965,2364,323,2041
2021,Cornwall 006D,E01018966,1055,142,913
2021,Cornwall 006E,E01018967,1291,239,1052
2021,Cornwall 004C,E01018968,2439,350,2089
2021,Cornwall 003D,E01018969,2184,260,1924
2021,Cornwall 009A,E01018970,1569,272,1297
2021,Cornwall 009B,E01018971,1842,279,1563
2021,Cornwall 009C,E01018972,1682,265,1417
2021,Cornwall 009D,E01018973,1452,241,1211
2021,Cornwall 002C,E01018974,2570,391,2179
2021,Cornwall 061A,E01018975,2036,354,1682
2021,Cornwall 067A,E01018976,2015,268,1747
2021,Cornwall 067B,E01018977,1250,230,1020
2021,Cornwall 057A,E01018978,1452,241,1211
2021,Cornwall 061B,E01018979,1414,232,1182
2021,Cornwall 061C,E01018980,1560,297,1263
2021,Cornwall 057B,E01018981,1975,309,1666
2021,Cornwall 057C,E01018982,1973,341,1632
2021,Cornwall 057D,E01018983,1506,173,1333
2021,Cornwall 058A,E01018985,2261,333,1928
2021,Cornwall 058B,E01018986,1466,179,1287
2021,Cornwall 058C,E01018987,1977,248,1729
2021,Cornwall 065A,E01018988,1555,227,1328
2021,Cornwall 065B,E01018989,1772,300,1472
2021,Cornwall 061D,E01018990,1798,259,1539
2021,Cornwall 065C,E01018991,1481,225,1256
2021,Cornwall 069A,E01018992,1682,233,1449
2021,Cornwall 069B,E01018993,1446,203,1243
2021,Cornwall 067C,E01018994,1860,288,1572
2021,Cornwall 068A,E01018995,1982,320,1662
2021,Cornwall 067D,E01018996,1448,222,1226
2021,Cornwall 067E,E01018997,1379,326,1053
2021,Cornwall 068B,E01018998,1298,193,1105
2021,Cornwall 068C,E01018999,1517,179,1338
2021,Cornwall 070A,E01019000,1394,193,1201
2021,Cornwall 068D,E01019001,1464,133,1331
2021,Cornwall 070B,E01019002,1177,149,1028
2021,Cornwall 070C,E01019003,1648,230,1418
2021,Cornwall 070D,E01019004,1400,233,1167
2021,Cornwall 069C,E01019005,2065,398,1667
2021,Cornwall 065D,E01019006,1483,169,1314
2021,Cornwall 061E,E01019007,2247,377,1870
2021,Cornwall 054A,E01019008,1265,219,1046
2021,Cornwall 054B,E01019009,1498,277,1221
2021,Cornwall 054C,E01019010,1150,178,972
2021,Cornwall 054D,E01019011,1542,227,1315
2021,Cornwall 054E,E01019012,1210,91,1119
2021,Cornwall 036A,E01019013,2022,375,1647
2021,Cornwall 036B,E01019014,1432,253,1179
2021,Cornwall 036C,E01019015,1295,216,1079
2021,Cornwall 036D,E01019016,1742,364,1378
2021,Cornwall 021A,E01019018,1527,265,1262
2021,Cornwall 021B,E01019019,1739,259,1480
2021,Cornwall 021C,E01019020,1551,225,1326
2021,Cornwall 021D,E01019021,1533,235,1298
2021,Cornwall 021E,E01019022,1731,290,1441
2021,Cornwall 021F,E01019023,1563,353,1210
2021,Cornwall 035A,E01019024,1453,221,1232
2021,Cornwall 035B,E01019025,1462,190,1272
2021,Cornwall 035C,E01019026,1385,168,1217
2021,Cornwall 035D,E01019027,1216,165,1051
2021,Cornwall 020A,E01019028,2052,270,1782
2021,Cornwall 020B,E01019029,1616,205,1411
2021,Cornwall 020C,E01019030,1996,328,1668
2021,Cornwall 020D,E01019031,1640,210,1430
2021,Cornwall 038A,E01019032,1396,201,1195
2021,Cornwall 039A,E01019033,1506,244,1262
2021,Cornwall 038B,E01019034,1490,239,1251
2021,Cornwall 027A,E01019035,1625,214,1411
2021,Cornwall 027B,E01019036,1757,256,1501
2021,Cornwall 027C,E01019037,1549,276,1273
2021,Cornwall 041A,E01019038,1023,108,915
2021,Cornwall 041B,E01019039,1288,184,1104
2021,Cornwall 041C,E01019040,1263,177,1086
2021,Cornwall 039B,E01019041,1757,335,1422
2021,Cornwall 039C,E01019042,1647,307,1340
2021,Cornwall 039D,E01019043,1870,316,1554
2021,Cornwall 039E,E01019044,1443,193,1250
2021,Cornwall 038C,E01019045,2509,489,2020
2021,Cornwall 039F,E01019046,1284,232,1052
2021,Cornwall 038D,E01019047,1455,215,1240
2021,Cornwall 018A,E01019048,1852,239,1613
2021,Cornwall 018C,E01019050,1753,286,1467
2021,Cornwall 018D,E01019051,1557,295,1262
2021,Cornwall 024A,E01019052,1896,347,1549
2021,Cornwall 024B,E01019053,2153,308,1845
2021,Cornwall 024C,E01019054,1864,329,1535
2021,Cornwall 024D,E01019055,1448,301,1147
2021,Cornwall 031A,E01019056,1285,291,994
2021,Cornwall 031B,E01019057,1774,315,1459
2021,Cornwall 031C,E01019058,2090,399,1691
2021,Cornwall 031D,E01019059,1431,213,1218
2021,Cornwall 019A,E01019060,1315,182,1133
2021,Cornwall 019B,E01019061,1762,324,1438
2021,Cornwall 019C,E01019062,1716,341,1375
2021,Cornwall 019D,E01019063,2116,382,1734
2021,Cornwall 019E,E01019064,2096,380,1716
2021,Cornwall 019F,E01019065,1260,217,1043
2021,Cornwall 041D,E01019066,1313,190,1123
2021,Cornwall 041E,E01019067,1330,211,1119
2021,Cornwall 041F,E01019068,1549,180,1369
2021,Cornwall 030A,E01019069,1172,207,965
2021,Cornwall 030B,E01019070,1973,329,1644
2021,Cornwall 030C,E01019071,1695,319,1376
2021,Cornwall 030D,E01019072,1430,285,1145
2021,Cornwall 030E,E01019073,1528,268,1260
2021,Cornwall 027D,E01019074,1791,355,1436
2021,Cornwall 027E,E01019075,1799,330,1469
2021,Cornwall 027F,E01019076,2016,401,1615
2021,Isles of Scilly 001A,E01019077,1958,259,1699
2021,Allerdale 007A,E01019078,1399,213,1186
2021,Allerdale 007B,E01019079,1320,185,1135
2021,Allerdale 007C,E01019080,1821,322,1499
2021,Allerdale 003A,E01019081,1740,332,1408
2021,Allerdale 003B,E01019082,1406,218,1188
2021,Allerdale 002A,E01019083,1742,229,1513
2021,Allerdale 006A,E01019084,1520,261,1259
2021,Allerdale 006B,E01019085,1846,329,1517
2021,Allerdale 006C,E01019086,1029,186,843
2021,Allerdale 007D,E01019087,1530,224,1306
2021,Allerdale 006D,E01019088,1802,202,1600
2021,Allerdale 011A,E01019089,1541,284,1257
2021,Allerdale 007E,E01019090,1369,153,1216
2021,Allerdale 006E,E01019091,1685,242,1443
2021,Allerdale 012A,E01019092,1392,167,1225
2021,Allerdale 004A,E01019093,1481,237,1244
2021,Allerdale 004B,E01019094,2019,363,1656
2021,Allerdale 005A,E01019095,1304,226,1078
2021,Allerdale 004C,E01019096,2061,307,1754
2021,Allerdale 005B,E01019097,1694,337,1357
2021,Allerdale 005C,E01019098,1540,283,1257
2021,Allerdale 005D,E01019099,1627,267,1360
2021,Allerdale 011B,E01019100,1942,323,1619
2021,Allerdale 011C,E01019101,1376,181,1195
2021,Allerdale 003C,E01019102,1542,223,1319
2021,Allerdale 012C,E01019104,1313,186,1127
2021,Allerdale 012E,E01019106,1357,190,1167
2021,Allerdale 002B,E01019107,1495,215,1280
2021,Allerdale 010A,E01019108,1409,297,1112
2021,Allerdale 010B,E01019109,1646,351,1295
2021,Allerdale 010C,E01019110,1494,256,1238
2021,Allerdale 009A,E01019111,1726,373,1353
2021,Allerdale 009B,E01019112,1578,320,1258
2021,Allerdale 009C,E01019113,1550,287,1263
2021,Allerdale 004D,E01019114,1385,193,1192
2021,Allerdale 004E,E01019115,1503,198,1305
2021,Allerdale 008A,E01019116,1101,139,962
2021,Allerdale 010D,E01019117,1286,185,1101
2021,Allerdale 008B,E01019118,1211,169,1042
2021,Allerdale 010E,E01019119,1407,141,1266
2021,Allerdale 009D,E01019120,1483,216,1267
2021,Allerdale 009E,E01019121,1749,201,1548
2021,Allerdale 008C,E01019122,1276,232,1044
2021,Allerdale 008D,E01019123,1684,328,1356
2021,Allerdale 008E,E01019124,1867,261,1606
2021,Allerdale 008F,E01019125,1386,205,1181
2021,Allerdale 001A,E01019126,1550,237,1313
2021,Allerdale 001B,E01019127,1505,144,1361
2021,Allerdale 003D,E01019128,1563,262,1301
2021,Allerdale 011D,E01019129,2032,329,1703
2021,Allerdale 002C,E01019130,1719,276,1443
2021,Allerdale 002D,E01019131,1817,256,1561
2021,Allerdale 001C,E01019132,1729,262,1467
2021,Allerdale 003E,E01019133,1482,202,1280
2021,Allerdale 001D,E01019134,1314,158,1156
2021,Allerdale 001E,E01019135,1494,265,1229
2021,Allerdale 001F,E01019136,1923,383,1540
2021,Allerdale 001G,E01019137,1006,121,885
2021,Barrow-in-Furness 010A,E01019138,1100,149,951
2021,Barrow-in-Furness 010B,E01019139,995,132,863
2021,Barrow-in-Furness 008A,E01019141,1122,157,965
2021,Barrow-in-Furness 008B,E01019142,1233,223,1010
2021,Barrow-in-Furness 008C,E01019143,1382,279,1103
2021,Barrow-in-Furness 001A,E01019144,1335,180,1155
2021,Barrow-in-Furness 001B,E01019145,1899,286,1613
2021,Barrow-in-Furness 001C,E01019146,1265,191,1074
2021,Barrow-in-Furness 001D,E01019147,1408,235,1173
2021,Barrow-in-Furness 002A,E01019148,1278,178,1100
2021,Barrow-in-Furness 002B,E01019149,1399,195,1204
2021,Barrow-in-Furness 002C,E01019150,1408,211,1197
2021,Barrow-in-Furness 002D,E01019151,1400,244,1156
2021,Barrow-in-Furness 003A,E01019152,1262,211,1051
2021,Barrow-in-Furness 003B,E01019153,970,109,861
2021,Barrow-in-Furness 003C,E01019154,1256,146,1110
2021,Barrow-in-Furness 003D,E01019155,1304,122,1182
2021,Barrow-in-Furness 004A,E01019156,1297,214,1083
2021,Barrow-in-Furness 008D,E01019157,1241,179,1062
2021,Barrow-in-Furness 008E,E01019158,1025,210,815
2021,Barrow-in-Furness 004B,E01019159,1099,170,929
2021,Barrow-in-Furness 007B,E01019160,1305,257,1048
2021,Barrow-in-Furness 006A,E01019161,2030,438,1592
2021,Barrow-in-Furness 003E,E01019162,1472,218,1254
2021,Barrow-in-Furness 003F,E01019163,1194,192,1002
2021,Barrow-in-Furness 004C,E01019164,1397,348,1049
2021,Barrow-in-Furness 004D,E01019165,1333,226,1107
2021,Barrow-in-Furness 004E,E01019166,1192,176,1016
2021,Barrow-in-Furness 005A,E01019167,1283,154,1129
2021,Barrow-in-Furness 005B,E01019168,1256,171,1085
2021,Barrow-in-Furness 005C,E01019169,1307,195,1112
2021,Barrow-in-Furness 005D,E01019170,1167,226,941
2021,Barrow-in-Furness 005E,E01019171,1092,167,925
2021,Barrow-in-Furness 007C,E01019172,1191,202,989
2021,Barrow-in-Furness 007D,E01019173,1076,147,929
2021,Barrow-in-Furness 007F,E01019175,1379,288,1091
2021,Barrow-in-Furness 006B,E01019176,1728,292,1436
2021,Barrow-in-Furness 006C,E01019177,1358,294,1064
2021,Barrow-in-Furness 006D,E01019178,1449,185,1264
2021,Barrow-in-Furness 006E,E01019179,1136,148,988
2021,Barrow-in-Furness 009A,E01019180,1629,177,1452
2021,Barrow-in-Furness 009C,E01019182,1331,239,1092
2021,Barrow-in-Furness 009E,E01019184,1259,193,1066
2021,Barrow-in-Furness 010C,E01019185,1299,180,1119
2021,Barrow-in-Furness 010D,E01019186,1147,177,970
2021,Barrow-in-Furness 010E,E01019187,1206,212,994
2021,Carlisle 003A,E01019188,1479,274,1205
2021,Carlisle 003B,E01019189,1311,223,1088
2021,Carlisle 003C,E01019190,1604,222,1382
2021,Carlisle 003D,E01019191,1401,200,1201
2021,Carlisle 005A,E01019192,1299,192,1107
2021,Carlisle 009A,E01019193,1834,424,1410
2021,Carlisle 009B,E01019194,2014,460,1554
2021,Carlisle 005B,E01019195,1315,197,1118
2021,Carlisle 004A,E01019196,1691,258,1433
2021,Carlisle 011A,E01019197,1949,469,1480
2021,Carlisle 011B,E01019198,1238,208,1030
2021,Carlisle 011C,E01019199,963,204,759
2021,Carlisle 002A,E01019200,1536,203,1333
2021,Carlisle 002B,E01019201,1354,196,1158
2021,Carlisle 002C,E01019202,1477,271,1206
2021,Carlisle 005C,E01019203,2107,331,1776
2021,Carlisle 006A,E01019204,984,127,857
2021,Carlisle 008A,E01019205,1525,209,1316
2021,Carlisle 006B,E01019206,1645,326,1319
2021,Carlisle 008B,E01019207,1229,194,1035
2021,Carlisle 012A,E01019208,1358,298,1060
2021,Carlisle 010A,E01019209,1300,239,1061
2021,Carlisle 012B,E01019210,1252,273,979
2021,Carlisle 010B,E01019211,1447,226,1221
2021,Carlisle 013A,E01019212,1623,284,1339
2021,Carlisle 008C,E01019215,1432,239,1193
2021,Carlisle 010C,E01019216,1644,380,1264
2021,Carlisle 010D,E01019217,1507,197,1310
2021,Carlisle 008D,E01019218,1426,293,1133
2021,Carlisle 007A,E01019219,2084,315,1769
2021,Carlisle 010E,E01019220,1458,231,1227
2021,Carlisle 011D,E01019221,1662,313,1349
2021,Carlisle 011E,E01019222,1633,352,1281
2021,Carlisle 013D,E01019223,1332,187,1145
2021,Carlisle 007B,E01019224,1899,281,1618
2021,Carlisle 002D,E01019225,1888,276,1612
2021,Carlisle 001A,E01019226,1094,164,930
2021,Carlisle 001B,E01019227,1336,221,1115
2021,Carlisle 001C,E01019228,1538,228,1310
2021,Carlisle 001D,E01019229,1790,242,1548
2021,Carlisle 009C,E01019230,1488,234,1254
2021,Carlisle 009D,E01019231,1602,268,1334
2021,Carlisle 009E,E01019232,1342,233,1109
2021,Carlisle 008E,E01019233,1239,159,1080
2021,Carlisle 006C,E01019234,1292,201,1091
2021,Carlisle 006D,E01019235,1316,208,1108
2021,Carlisle 010F,E01019236,1541,300,1241
2021,Carlisle 006E,E01019237,1316,304,1012
2021,Carlisle 004B,E01019238,1415,232,1183
2021,Carlisle 007C,E01019239,1408,216,1192
2021,Carlisle 004C,E01019240,2104,390,1714
2021,Carlisle 004D,E01019241,1796,340,1456
2021,Carlisle 006F,E01019242,1197,241,956
2021,Carlisle 004E,E01019243,1363,264,1099
2021,Carlisle 003E,E01019244,1384,210,1174
2021,Carlisle 011F,E01019245,1439,334,1105
2021,Carlisle 012C,E01019246,1149,216,933
2021,Carlisle 012D,E01019247,1306,222,1084
2021,Carlisle 012E,E01019248,1059,237,822
2021,Carlisle 007D,E01019249,1520,181,1339
2021,Carlisle 007E,E01019250,1565,250,1315
2021,Carlisle 004F,E01019251,2060,364,1696
2021,Carlisle 009F,E01019252,1261,174,1087
2021,Carlisle 013E,E01019253,1625,256,1369
2021,Carlisle 005D,E01019254,1254,166,1088
2021,Carlisle 005E,E01019255,1258,199,1059
2021,Copeland 004A,E01019256,1336,166,1170
2021,Copeland 007A,E01019257,1297,183,1114
2021,Copeland 007B,E01019258,1381,204,1177
2021,Copeland 008A,E01019259,1190,178,1012
2021,Copeland 002A,E01019260,1353,257,1096
2021,Copeland 003A,E01019261,1602,242,1360
2021,Copeland 003B,E01019262,1546,220,1326
2021,Copeland 004C,E01019264,1670,270,1400
2021,Copeland 004D,E01019265,1220,158,1062
2021,Copeland 004E,E01019266,1288,193,1095
2021,Copeland 004F,E01019267,1149,210,939
2021,Copeland 001B,E01019269,1443,265,1178
2021,Copeland 001C,E01019270,1223,206,1017
2021,Copeland 006A,E01019271,1236,241,995
2021,Copeland 006B,E01019272,1332,296,1036
2021,Copeland 006C,E01019273,1443,223,1220
2021,Copeland 006D,E01019274,1374,170,1204
2021,Copeland 006E,E01019275,1934,314,1620
2021,Copeland 004H,E01019277,1123,190,933
2021,Copeland 004I,E01019278,1311,216,1095
2021,Copeland 007C,E01019279,1282,156,1126
2021,Copeland 002B,E01019280,1430,103,1327
2021,Copeland 002C,E01019281,1083,123,960
2021,Copeland 002D,E01019282,1134,201,933
2021,Copeland 008B,E01019283,1504,160,1344
2021,Copeland 003C,E01019284,1097,184,913
2021,Copeland 003D,E01019285,1304,253,1051
2021,Copeland 003E,E01019286,1264,180,1084
2021,Copeland 003F,E01019287,1047,147,900
2021,Copeland 003G,E01019288,1269,255,1014
2021,Copeland 008C,E01019289,1224,177,1047
2021,Copeland 008D,E01019290,988,185,803
2021,Copeland 005A,E01019291,1358,255,1103
2021,Copeland 005B,E01019292,1017,125,892
2021,Copeland 008E,E01019293,1219,153,1066
2021,Copeland 005C,E01019294,1305,256,1049
2021,Copeland 005D,E01019295,1327,308,1019
2021,Copeland 005E,E01019296,1317,199,1118
2021,Copeland 008F,E01019298,1382,186,1196
2021,Copeland 008G,E01019299,1787,290,1497
2021,Copeland 007D,E01019300,1572,256,1316
2021,Copeland 005F,E01019301,1461,326,1135
2021,Copeland 005G,E01019302,1397,223,1174
2021,Copeland 007E,E01019303,1438,226,1212
2021,Copeland 007F,E01019304,1091,111,980
2021,Eden 001A,E01019305,1945,220,1725
2021,Eden 006A,E01019306,1202,132,1070
2021,Eden 006B,E01019307,1904,309,1595
2021,Eden 005A,E01019308,1222,159,1063
2021,Eden 007A,E01019309,2275,323,1952
2021,Eden 006C,E01019310,1412,190,1222
2021,Eden 005B,E01019311,1426,220,1206
2021,Eden 004A,E01019312,1559,221,1338
2021,Eden 005C,E01019313,1355,164,1191
2021,Eden 001B,E01019314,1308,184,1124
2021,Eden 002A,E01019315,1807,258,1549
2021,Eden 002B,E01019316,1283,233,1050
2021,Eden 007B,E01019317,1275,170,1105
2021,Eden 007C,E01019318,1220,185,1035
2021,Eden 006D,E01019319,1548,252,1296
2021,Eden 001C,E01019320,1410,226,1184
2021,Eden 001D,E01019321,1538,259,1279
2021,Eden 002C,E01019322,1533,246,1287
2021,Eden 006E,E01019323,1189,147,1042
2021,Eden 006F,E01019324,1285,231,1054
2021,Eden 007D,E01019325,1355,190,1165
2021,Eden 004B,E01019326,2042,304,1738
2021,Eden 003A,E01019327,1728,293,1435
2021,Eden 004C,E01019328,1380,221,1159
2021,Eden 004D,E01019329,1070,130,940
2021,Eden 004E,E01019330,1440,197,1243
2021,Eden 004F,E01019331,1658,253,1405
2021,Eden 003B,E01019332,1257,171,1086
2021,Eden 003C,E01019333,1321,190,1131
2021,Eden 004G,E01019334,1286,210,1076
2021,Eden 003D,E01019335,1396,237,1159
2021,Eden 003E,E01019336,1666,283,1383
2021,Eden 006G,E01019337,1287,190,1097
2021,Eden 002D,E01019338,1363,165,1198
2021,Eden 005D,E01019339,1323,192,1131
2021,Eden 007E,E01019340,1315,192,1123
2021,South Lakeland 011C,E01019343,1462,207,1255
2021,South Lakeland 008A,E01019344,988,136,852
2021,South Lakeland 008B,E01019345,1178,176,1002
2021,South Lakeland 003A,E01019346,1798,239,1559
2021,South Lakeland 011D,E01019347,1678,300,1378
2021,South Lakeland 010A,E01019348,1153,202,951
2021,South Lakeland 013A,E01019349,1827,247,1580
2021,South Lakeland 008C,E01019350,1488,174,1314
2021,South Lakeland 008D,E01019351,1691,224,1467
2021,South Lakeland 010B,E01019352,2095,315,1780
2021,South Lakeland 013B,E01019353,1481,171,1310
2021,South Lakeland 013C,E01019354,1300,89,1211
2021,South Lakeland 013D,E01019355,1392,81,1311
2021,South Lakeland 007A,E01019356,1362,139,1223
2021,South Lakeland 013E,E01019357,1711,234,1477
2021,South Lakeland 005A,E01019358,1716,236,1480
2021,South Lakeland 003B,E01019359,2451,489,1962
2021,South Lakeland 004A,E01019360,1992,267,1725
2021,South Lakeland 006A,E01019361,1722,271,1451
2021,South Lakeland 005B,E01019362,1798,217,1581
2021,South Lakeland 004B,E01019363,1844,258,1586
2021,South Lakeland 004C,E01019364,1948,367,1581
2021,South Lakeland 003C,E01019365,2030,250,1780
2021,South Lakeland 005C,E01019366,1641,224,1417
2021,South Lakeland 006C,E01019368,2114,368,1746
2021,South Lakeland 006D,E01019369,1863,234,1629
2021,South Lakeland 003D,E01019370,2187,329,1858
2021,South Lakeland 004D,E01019371,2162,466,1696
2021,South Lakeland 009A,E01019372,1064,119,945
2021,South Lakeland 009B,E01019373,1396,303,1093
2021,South Lakeland 001A,E01019374,1521,373,1148
2021,South Lakeland 001B,E01019375,1389,127,1262
2021,South Lakeland 001C,E01019376,1255,149,1106
2021,South Lakeland 010C,E01019377,1801,240,1561
2021,South Lakeland 014A,E01019378,1460,203,1257
2021,South Lakeland 014B,E01019379,1423,182,1241
2021,South Lakeland 014C,E01019380,1116,162,954
2021,South Lakeland 007B,E01019381,2086,290,1796
2021,South Lakeland 011E,E01019382,2121,411,1710
2021,South Lakeland 010D,E01019383,2088,266,1822
2021,South Lakeland 009C,E01019384,2309,371,1938
2021,South Lakeland 009D,E01019385,1342,490,852
2021,South Lakeland 007C,E01019386,1663,175,1488
2021,South Lakeland 002A,E01019387,2129,316,1813
2021,South Lakeland 012A,E01019388,1837,266,1571
2021,South Lakeland 012B,E01019389,2192,390,1802
2021,South Lakeland 012C,E01019390,1904,269,1635
2021,South Lakeland 014D,E01019391,1676,241,1435
2021,South Lakeland 012D,E01019392,1783,228,1555
2021,South Lakeland 014E,E01019393,1914,206,1708
2021,South Lakeland 005D,E01019394,2237,323,1914
2021,South Lakeland 001D,E01019395,1812,240,1572
2021,South Lakeland 002B,E01019396,1887,276,1611
2021,South Lakeland 002C,E01019397,1709,215,1494
2021,Amber Valley 001A,E01019400,1633,333,1300
2021,Amber Valley 001B,E01019401,1636,240,1396
2021,Amber Valley 001C,E01019402,1793,287,1506
2021,Amber Valley 003A,E01019403,1369,233,1136
2021,Amber Valley 001D,E01019404,1895,264,1631
2021,Amber Valley 007A,E01019405,1467,195,1272
2021,Amber Valley 002A,E01019406,1020,156,864
2021,Amber Valley 010A,E01019407,1933,218,1715
2021,Amber Valley 009A,E01019408,1558,276,1282
2021,Amber Valley 009B,E01019409,1616,221,1395
2021,Amber Valley 011A,E01019410,1325,184,1141
2021,Amber Valley 011B,E01019411,1323,206,1117
2021,Amber Valley 009C,E01019412,1756,386,1370
2021,Amber Valley 009D,E01019413,1239,225,1014
2021,Amber Valley 007B,E01019414,1548,216,1332
2021,Amber Valley 010B,E01019415,1574,206,1368
2021,Amber Valley 009E,E01019416,1345,181,1164
2021,Amber Valley 010C,E01019417,1896,337,1559
2021,Amber Valley 011C,E01019418,1685,351,1334
2021,Amber Valley 010D,E01019419,1812,218,1594
2021,Amber Valley 005A,E01019420,1318,184,1134
2021,Amber Valley 008A,E01019421,1965,319,1646
2021,Amber Valley 008B,E01019422,1440,193,1247
2021,Amber Valley 002B,E01019423,1469,195,1274
2021,Amber Valley 002C,E01019424,1071,149,922
2021,Amber Valley 016A,E01019425,1593,383,1210
2021,Amber Valley 016B,E01019426,1523,295,1228
2021,Amber Valley 016C,E01019427,1785,441,1344
2021,Amber Valley 007C,E01019428,1358,191,1167
2021,Amber Valley 006A,E01019429,1467,183,1284
2021,Amber Valley 007D,E01019430,1796,271,1525
2021,Amber Valley 012A,E01019431,1313,206,1107
2021,Amber Valley 008C,E01019432,1818,252,1566
2021,Amber Valley 012B,E01019433,1737,291,1446
2021,Amber Valley 013A,E01019434,1106,176,930
2021,Amber Valley 013B,E01019435,1581,289,1292
2021,Amber Valley 013C,E01019436,1303,216,1087
2021,Amber Valley 017A,E01019437,1359,239,1120
2021,Amber Valley 012C,E01019438,1513,268,1245
2021,Amber Valley 013D,E01019439,1495,227,1268
2021,Amber Valley 013E,E01019440,1542,246,1296
2021,Amber Valley 017B,E01019441,1524,284,1240
2021,Amber Valley 005B,E01019442,1388,187,1201
2021,Amber Valley 004A,E01019443,1640,258,1382
2021,Amber Valley 003B,E01019444,1341,267,1074
2021,Amber Valley 005C,E01019445,1413,225,1188
2021,Amber Valley 015A,E01019446,1119,173,946
2021,Amber Valley 011D,E01019447,1426,205,1221
2021,Amber Valley 015B,E01019448,1914,386,1528
2021,Amber Valley 011E,E01019449,1655,258,1397
2021,Amber Valley 015C,E01019450,1415,248,1167
2021,Amber Valley 012D,E01019451,1985,314,1671
2021,Amber Valley 017C,E01019452,1559,304,1255
2021,Amber Valley 017D,E01019453,1889,367,1522
2021,Amber Valley 006B,E01019454,1245,146,1099
2021,Amber Valley 005D,E01019455,1274,141,1133
2021,Amber Valley 005E,E01019456,1749,308,1441
2021,Amber Valley 005F,E01019457,1334,191,1143
2021,Amber Valley 008D,E01019458,1866,331,1535
2021,Amber Valley 008E,E01019459,1265,237,1028
2021,Amber Valley 006C,E01019460,1428,233,1195
2021,Amber Valley 006D,E01019461,1310,191,1119
2021,Amber Valley 006E,E01019462,1115,140,975
2021,Amber Valley 008F,E01019463,1424,342,1082
2021,Amber Valley 012E,E01019464,2396,406,1990
2021,Amber Valley 015D,E01019465,1082,134,948
2021,Amber Valley 015E,E01019467,1459,221,1238
2021,Amber Valley 003C,E01019468,1406,213,1193
2021,Amber Valley 003D,E01019469,1543,356,1187
2021,Amber Valley 004B,E01019470,1550,251,1299
2021,Amber Valley 003E,E01019471,1309,239,1070
2021,Amber Valley 004C,E01019473,1192,139,1053
2021,Amber Valley 004D,E01019474,1140,133,1007
2021,Amber Valley 004E,E01019475,1262,205,1057
2021,Amber Valley 004F,E01019476,1279,158,1121
2021,Amber Valley 002D,E01019477,2236,303,1933
2021,Bolsover 001A,E01019478,1445,228,1217
2021,Bolsover 001B,E01019479,1586,287,1299
2021,Bolsover 008A,E01019480,1465,183,1282
2021,Bolsover 009A,E01019481,1157,229,928
2021,Bolsover 008B,E01019482,1465,185,1280
2021,Bolsover 004A,E01019483,1906,390,1516
2021,Bolsover 004B,E01019484,2123,357,1766
2021,Bolsover 004C,E01019485,1246,201,1045
2021,Bolsover 005A,E01019486,994,129,865
2021,Bolsover 005B,E01019487,1603,281,1322
2021,Bolsover 004D,E01019488,1327,228,1099
2021,Bolsover 005C,E01019489,1181,154,1027
2021,Bolsover 005D,E01019490,1060,160,900
2021,Bolsover 001C,E01019491,2224,356,1868
2021,Bolsover 002A,E01019492,1722,296,1426
2021,Bolsover 001D,E01019493,1450,209,1241
2021,Bolsover 002B,E01019495,1508,251,1257
2021,Bolsover 003A,E01019496,1343,235,1108
2021,Bolsover 003B,E01019497,1586,227,1359
2021,Bolsover 003C,E01019498,1765,402,1363
2021,Bolsover 010A,E01019499,1254,183,1071
2021,Bolsover 010B,E01019500,1422,255,1167
2021,Bolsover 010C,E01019501,1376,164,1212
2021,Bolsover 005E,E01019502,1496,222,1274
2021,Bolsover 007A,E01019503,2468,382,2086
2021,Bolsover 005F,E01019504,1261,194,1067
2021,Bolsover 007B,E01019505,1419,242,1177
2021,Bolsover 007C,E01019506,1419,251,1168
2021,Bolsover 007D,E01019507,1774,218,1556
2021,Bolsover 006A,E01019508,1849,340,1509
2021,Bolsover 006B,E01019509,1251,277,974
2021,Bolsover 006C,E01019510,1287,253,1034
2021,Bolsover 007E,E01019511,2115,345,1770
2021,Bolsover 010D,E01019513,1579,255,1324
2021,Bolsover 009B,E01019514,1487,266,1221
2021,Bolsover 009C,E01019515,1553,309,1244
2021,Bolsover 009D,E01019516,1514,221,1293
2021,Bolsover 010E,E01019517,1604,250,1354
2021,Bolsover 010F,E01019518,1519,223,1296
2021,Bolsover 009E,E01019519,1741,323,1418
2021,Bolsover 008C,E01019520,2032,409,1623
2021,Bolsover 008D,E01019521,1653,247,1406
2021,Bolsover 008E,E01019522,1625,329,1296
2021,Bolsover 003D,E01019523,1048,173,875
2021,Bolsover 002C,E01019524,1312,168,1144
2021,Bolsover 002D,E01019525,1372,211,1161
2021,Chesterfield 001A,E01019526,1212,177,1035
2021,Chesterfield 003A,E01019527,1316,239,1077
2021,Chesterfield 001B,E01019528,1406,174,1232
2021,Chesterfield 003B,E01019529,1351,210,1141
2021,Chesterfield 003C,E01019530,1355,201,1154
2021,Chesterfield 003D,E01019531,1498,306,1192
2021,Chesterfield 005A,E01019532,1140,185,955
2021,Chesterfield 005B,E01019533,1285,141,1144
2021,Chesterfield 005C,E01019534,1343,123,1220
2021,Chesterfield 005D,E01019535,1382,184,1198
2021,Chesterfield 005E,E01019536,1751,341,1410
2021,Chesterfield 007A,E01019537,1562,281,1281
2021,Chesterfield 010A,E01019538,1903,303,1600
2021,Chesterfield 009A,E01019539,1502,214,1288
2021,Chesterfield 009B,E01019540,1348,195,1153
2021,Chesterfield 004A,E01019541,1435,254,1181
2021,Chesterfield 004B,E01019542,1512,227,1285
2021,Chesterfield 004C,E01019543,1731,290,1441
2021,Chesterfield 004D,E01019544,1463,274,1189
2021,Chesterfield 012A,E01019545,1264,159,1105
2021,Chesterfield 012B,E01019546,1326,177,1149
2021,Chesterfield 012C,E01019547,1284,224,1060
2021,Chesterfield 012D,E01019548,2119,392,1727
2021,Chesterfield 006A,E01019549,1331,305,1026
2021,Chesterfield 006B,E01019550,1550,323,1227
2021,Chesterfield 006C,E01019551,1419,166,1253
2021,Chesterfield 006D,E01019552,1235,248,987
2021,Chesterfield 003E,E01019553,1799,351,1448
2021,Chesterfield 010B,E01019554,1260,189,1071
2021,Chesterfield 009C,E01019555,1393,228,1165
2021,Chesterfield 010C,E01019556,1427,276,1151
2021,Chesterfield 008A,E01019557,1444,259,1185
2021,Chesterfield 008B,E01019558,1230,156,1074
2021,Chesterfield 008C,E01019559,1024,135,889
2021,Chesterfield 008D,E01019560,1280,224,1056
2021,Chesterfield 008E,E01019561,1153,159,994
2021,Chesterfield 008F,E01019562,1144,168,976
2021,Chesterfield 002A,E01019563,1623,413,1210
2021,Chesterfield 002B,E01019564,1586,237,1349
2021,Chesterfield 002C,E01019565,1291,205,1086
2021,Chesterfield 002D,E01019566,1655,371,1284
2021,Chesterfield 006E,E01019567,1645,321,1324
2021,Chesterfield 002E,E01019568,1392,371,1021
2021,Chesterfield 007B,E01019569,1438,165,1273
2021,Chesterfield 007C,E01019570,1237,192,1045
2021,Chesterfield 004E,E01019571,1423,269,1154
2021,Chesterfield 001C,E01019572,1263,259,1004
2021,Chesterfield 001D,E01019573,1482,216,1266
2021,Chesterfield 001E,E01019574,1236,180,1056
2021,Chesterfield 013A,E01019575,1521,348,1173
2021,Chesterfield 013B,E01019576,1540,238,1302
2021,Chesterfield 013C,E01019577,1414,169,1245
2021,Chesterfield 013D,E01019578,1446,248,1198
2021,Chesterfield 010D,E01019579,1750,340,1410
2021,Chesterfield 007D,E01019580,1524,269,1255
2021,Chesterfield 007E,E01019581,1277,218,1059
2021,Chesterfield 012E,E01019582,1402,200,1202
2021,Chesterfield 012F,E01019583,1328,192,1136
2021,Chesterfield 012G,E01019585,2138,321,1817
2021,Chesterfield 011A,E01019586,1250,146,1104
2021,Chesterfield 011B,E01019587,1331,211,1120
2021,Chesterfield 011C,E01019588,1282,164,1118
2021,Chesterfield 011D,E01019589,1251,150,1101
2021,Chesterfield 009D,E01019590,1732,219,1513
2021,Chesterfield 009E,E01019591,1444,268,1176
2021,Chesterfield 011E,E01019592,1606,284,1322
2021,Chesterfield 011F,E01019593,1062,169,893
2021,Derbyshire Dales 009A,E01019594,1701,321,1380
2021,Derbyshire Dales 008A,E01019595,1866,247,1619
2021,Derbyshire Dales 009B,E01019596,1762,263,1499
2021,Derbyshire Dales 009C,E01019597,1988,402,1586
2021,Derbyshire Dales 009D,E01019598,1662,303,1359
2021,Derbyshire Dales 011B,E01019599,1320,170,1150
2021,Derbyshire Dales 002A,E01019600,1342,168,1174
2021,Derbyshire Dales 011A,E01019601,1479,207,1272
2021,Derbyshire Dales 001A,E01019602,1713,221,1492
2021,Derbyshire Dales 010A,E01019603,1914,295,1619
2021,Derbyshire Dales 002B,E01019604,1709,233,1476
2021,Derbyshire Dales 008B,E01019605,1721,255,1466
2021,Derbyshire Dales 002C,E01019606,1562,248,1314
2021,Derbyshire Dales 010B,E01019607,1787,251,1536
2021,Derbyshire Dales 011G,E01019608,1628,241,1387
2021,Derbyshire Dales 005A,E01019609,2520,356,2164
2021,Derbyshire Dales 011D,E01019610,1435,190,1245
2021,Derbyshire Dales 008C,E01019611,1513,195,1318
2021,Derbyshire Dales 010C,E01019612,2609,425,2184
2021,Derbyshire Dales 011C,E01019613,1595,214,1381
2021,Derbyshire Dales 001B,E01019614,1566,252,1314
2021,Derbyshire Dales 001C,E01019615,2027,318,1709
2021,Derbyshire Dales 008D,E01019616,1782,248,1534
2021,Derbyshire Dales 011F,E01019617,1468,208,1260
2021,Derbyshire Dales 002D,E01019618,1519,229,1290
2021,Derbyshire Dales 006A,E01019619,1345,159,1186
2021,Derbyshire Dales 006B,E01019620,1406,200,1206
2021,Derbyshire Dales 005B,E01019621,1328,226,1102
2021,Derbyshire Dales 005C,E01019622,1365,177,1188
2021,Derbyshire Dales 006C,E01019623,1314,167,1147
2021,Derbyshire Dales 005D,E01019624,1194,188,1006
2021,Derbyshire Dales 006D,E01019625,1509,347,1162
2021,Derbyshire Dales 006E,E01019626,1341,168,1173
2021,Derbyshire Dales 005E,E01019627,1134,151,983
2021,Derbyshire Dales 005F,E01019628,1497,261,1236
2021,Derbyshire Dales 010D,E01019629,1673,276,1397
2021,Derbyshire Dales 011E,E01019630,1736,270,1466
2021,Derbyshire Dales 001D,E01019631,1693,298,1395
2021,Derbyshire Dales 006F,E01019632,1561,203,1358
2021,Derbyshire Dales 007A,E01019633,1489,254,1235
2021,Derbyshire Dales 007B,E01019634,1505,236,1269
2021,Derbyshire Dales 007C,E01019635,1102,140,962
2021,Derbyshire Dales 007D,E01019636,1523,245,1278
2021,Erewash 016A,E01019638,1220,160,1060
2021,Erewash 016B,E01019639,1456,310,1146
2021,Erewash 016C,E01019640,1325,241,1084
2021,Erewash 011A,E01019641,1386,196,1190
2021,Erewash 013A,E01019642,1292,178,1114
2021,Erewash 013B,E01019643,1530,228,1302
2021,Erewash 001A,E01019644,1340,188,1152
2021,Erewash 016D,E01019645,1588,255,1333
2021,Erewash 001B,E01019646,1324,267,1057
2021,Erewash 012A,E01019647,1866,265,1601
2021,Erewash 010A,E01019648,1418,260,1158
2021,Erewash 010B,E01019649,1633,286,1347
2021,Erewash 010C,E01019650,1563,306,1257
2021,Erewash 010D,E01019651,1364,246,1118
2021,Erewash 011B,E01019652,1496,283,1213
2021,Erewash 011C,E01019653,1375,253,1122
2021,Erewash 013C,E01019654,1445,202,1243
2021,Erewash 013D,E01019655,1461,255,1206
2021,Erewash 008A,E01019656,1162,174,988
2021,Erewash 003A,E01019657,1823,334,1489
2021,Erewash 006A,E01019658,1832,368,1464
2021,Erewash 006B,E01019659,2202,399,1803
2021,Erewash 003B,E01019660,1778,219,1559
2021,Erewash 003C,E01019661,1297,172,1125
2021,Erewash 003D,E01019662,1414,211,1203
2021,Erewash 001C,E01019663,1444,285,1159
2021,Erewash 001D,E01019664,1228,321,907
2021,Erewash 001E,E01019665,1276,176,1100
2021,Erewash 007A,E01019666,1383,291,1092
2021,Erewash 007B,E01019667,1537,336,1201
2021,Erewash 007C,E01019668,1329,218,1111
2021,Erewash 007D,E01019669,1408,177,1231
2021,Erewash 004A,E01019670,1712,316,1396
2021,Erewash 004B,E01019671,1761,252,1509
2021,Erewash 003E,E01019672,1685,261,1424
2021,Erewash 005A,E01019673,1267,202,1065
2021,Erewash 006C,E01019674,1076,145,931
2021,Erewash 012B,E01019675,1442,221,1221
2021,Erewash 014A,E01019676,1361,222,1139
2021,Erewash 014B,E01019677,1327,191,1136
2021,Erewash 014C,E01019678,1597,232,1365
2021,Erewash 012C,E01019679,1541,253,1288
2021,Erewash 014D,E01019680,1835,389,1446
2021,Erewash 014E,E01019681,1398,138,1260
2021,Erewash 012D,E01019682,1593,247,1346
2021,Erewash 009A,E01019683,1242,237,1005
2021,Erewash 009B,E01019684,1567,260,1307
2021,Erewash 009C,E01019685,1413,235,1178
2021,Erewash 009D,E01019686,1272,202,1070
2021,Erewash 009E,E01019687,1375,251,1124
2021,Erewash 006D,E01019688,1290,219,1071
2021,Erewash 006E,E01019689,1408,267,1141
2021,Erewash 003F,E01019690,1179,210,969
2021,Erewash 008B,E01019691,1551,302,1249
2021,Erewash 008C,E01019692,1486,332,1154
2021,Erewash 008D,E01019693,1787,353,1434
2021,Erewash 008E,E01019694,1112,167,945
2021,Erewash 010E,E01019695,1348,204,1144
2021,Erewash 008F,E01019696,1365,182,1183
2021,Erewash 015A,E01019697,1343,230,1113
2021,Erewash 014F,E01019698,1330,172,1158
2021,Erewash 015B,E01019699,1421,287,1134
2021,Erewash 015C,E01019700,2074,291,1783
2021,Erewash 004C,E01019701,2133,343,1790
2021,Erewash 005B,E01019702,1694,232,1462
2021,Erewash 005C,E01019703,1552,294,1258
2021,Erewash 005D,E01019704,1359,155,1204
2021,Erewash 015D,E01019705,1691,289,1402
2021,Erewash 015E,E01019706,1172,200,972
2021,Erewash 011D,E01019707,1308,184,1124
2021,Erewash 011E,E01019708,1749,362,1387
2021,Erewash 015F,E01019709,1231,260,971
2021,High Peak 010A,E01019710,1651,238,1413
2021,High Peak 006A,E01019711,1270,193,1077
2021,High Peak 008A,E01019712,1398,240,1158
2021,High Peak 008B,E01019713,1685,299,1386
2021,High Peak 012A,E01019714,2468,491,1977
2021,High Peak 010B,E01019715,1249,185,1064
2021,High Peak 011A,E01019716,1177,187,990
2021,High Peak 010C,E01019717,1062,146,916
2021,High Peak 013E,E01019718,2050,339,1711
2021,High Peak 013F,E01019719,1924,377,1547
2021,High Peak 013G,E01019720,1360,202,1158
2021,High Peak 013H,E01019721,1408,209,1199
2021,High Peak 010D,E01019722,1726,295,1431
2021,High Peak 010E,E01019723,1679,152,1527
2021,High Peak 011B,E01019724,1119,229,890
2021,High Peak 012B,E01019725,1421,256,1165
2021,High Peak 012C,E01019726,1359,253,1106
2021,High Peak 004A,E01019727,2037,328,1709
2021,High Peak 002A,E01019728,1107,275,832
2021,High Peak 002B,E01019729,1166,297,869
2021,High Peak 002C,E01019730,1790,310,1480
2021,High Peak 002D,E01019731,1195,229,966
2021,High Peak 002E,E01019732,1382,242,1140
2021,High Peak 001A,E01019733,1396,239,1157
2021,High Peak 006B,E01019734,1926,324,1602
2021,High Peak 013A,E01019735,1352,195,1157
2021,High Peak 013B,E01019736,1011,128,883
2021,High Peak 013C,E01019737,1090,123,967
2021,High Peak 003A,E01019738,1377,216,1161
2021,High Peak 003B,E01019739,1741,176,1565
2021,High Peak 003C,E01019740,1098,153,945
2021,High Peak 013I,E01019741,1088,175,913
2021,High Peak 013D,E01019742,991,164,827
2021,High Peak 006C,E01019743,1400,261,1139
2021,High Peak 006D,E01019744,1353,186,1167
2021,High Peak 006E,E01019745,1053,193,860
2021,High Peak 005A,E01019746,1488,242,1246
2021,High Peak 005B,E01019747,1105,148,957
2021,High Peak 005C,E01019748,1393,182,1211
2021,High Peak 004B,E01019749,1112,163,949
2021,High Peak 003D,E01019750,1230,182,1048
2021,High Peak 003E,E01019751,2206,461,1745
2021,High Peak 001B,E01019752,1260,266,994
2021,High Peak 001C,E01019753,1259,165,1094
2021,High Peak 004C,E01019754,1797,254,1543
2021,High Peak 005D,E01019755,1796,259,1537
2021,High Peak 004D,E01019756,1661,360,1301
2021,High Peak 004E,E01019757,1265,232,1033
2021,High Peak 004F,E01019758,1454,240,1214
2021,High Peak 011C,E01019759,1384,262,1122
2021,High Peak 011D,E01019760,1274,192,1082
2021,High Peak 011E,E01019761,1498,438,1060
2021,High Peak 012D,E01019762,1674,247,1427
2021,High Peak 001D,E01019763,2115,383,1732
2021,High Peak 008C,E01019764,1532,267,1265
2021,High Peak 008D,E01019765,1684,241,1443
2021,High Peak 005E,E01019766,1360,189,1171
2021,High Peak 008E,E01019767,1495,260,1235
2021,High Peak 003F,E01019768,2004,329,1675
2021,North East Derbyshire 010A,E01019769,1879,256,1623
2021,North East Derbyshire 005A,E01019770,1904,311,1593
2021,North East Derbyshire 008A,E01019771,2017,293,1724
2021,North East Derbyshire 008B,E01019772,1458,212,1246
2021,North East Derbyshire 010B,E01019774,1723,157,1566
2021,North East Derbyshire 012B,E01019775,2164,389,1775
2021,North East Derbyshire 012C,E01019776,1303,159,1144
2021,North East Derbyshire 012D,E01019777,2224,460,1764
2021,North East Derbyshire 002A,E01019778,1605,233,1372
2021,North East Derbyshire 002B,E01019779,1520,203,1317
2021,North East Derbyshire 004A,E01019780,1338,292,1046
2021,North East Derbyshire 004B,E01019781,1368,208,1160
2021,North East Derbyshire 004C,E01019782,1308,226,1082
2021,North East Derbyshire 006A,E01019783,1183,223,960
2021,North East Derbyshire 006B,E01019784,1165,194,971
2021,North East Derbyshire 006C,E01019785,1180,194,986
2021,North East Derbyshire 004D,E01019786,1487,259,1228
2021,North East Derbyshire 005B,E01019787,1682,291,1391
2021,North East Derbyshire 005C,E01019788,1595,237,1358
2021,North East Derbyshire 002C,E01019790,1728,202,1526
2021,North East Derbyshire 014A,E01019791,1861,305,1556
2021,North East Derbyshire 014B,E01019792,1939,334,1605
2021,North East Derbyshire 006D,E01019793,1351,200,1151
2021,North East Derbyshire 005D,E01019794,1296,177,1119
2021,North East Derbyshire 006E,E01019795,2150,412,1738
2021,North East Derbyshire 009A,E01019796,1108,234,874
2021,North East Derbyshire 009B,E01019797,1686,286,1400
2021,North East Derbyshire 007A,E01019798,1503,233,1270
2021,North East Derbyshire 009C,E01019799,2212,376,1836
2021,North East Derbyshire 009D,E01019800,1690,265,1425
2021,North East Derbyshire 001A,E01019801,1072,150,922
2021,North East Derbyshire 001B,E01019802,1276,156,1120
2021,North East Derbyshire 001C,E01019803,1209,208,1001
2021,North East Derbyshire 001D,E01019804,1193,167,1026
2021,North East Derbyshire 001E,E01019805,1261,204,1057
2021,North East Derbyshire 001F,E01019806,1376,170,1206
2021,North East Derbyshire 001G,E01019807,1360,309,1051
2021,North East Derbyshire 009E,E01019808,1548,326,1222
2021,North East Derbyshire 011A,E01019809,1030,121,909
2021,North East Derbyshire 011B,E01019810,1399,193,1206
2021,North East Derbyshire 011C,E01019811,1393,202,1191
2021,North East Derbyshire 011D,E01019812,1735,274,1461
2021,North East Derbyshire 011E,E01019813,1581,248,1333
2021,North East Derbyshire 013A,E01019814,1825,273,1552
2021,North East Derbyshire 014C,E01019815,2499,524,1975
2021,North East Derbyshire 002D,E01019816,1699,274,1425
2021,North East Derbyshire 013B,E01019817,1244,260,984
2021,North East Derbyshire 013C,E01019818,1552,279,1273
2021,North East Derbyshire 013D,E01019819,1625,243,1382
2021,North East Derbyshire 013E,E01019820,1402,173,1229
2021,North East Derbyshire 007B,E01019821,1210,127,1083
2021,North East Derbyshire 007C,E01019822,1572,240,1332
2021,North East Derbyshire 007D,E01019823,1030,177,853
2021,North East Derbyshire 010C,E01019824,1743,300,1443
2021,North East Derbyshire 011F,E01019825,1316,189,1127
2021,North East Derbyshire 009F,E01019826,1334,218,1116
2021,North East Derbyshire 004E,E01019827,1754,263,1491
2021,North East Derbyshire 008C,E01019828,1352,149,1203
2021,North East Derbyshire 008D,E01019829,1270,161,1109
2021,North East Derbyshire 010D,E01019830,1472,241,1231
2021,North East Derbyshire 010E,E01019831,1284,194,1090
2021,South Derbyshire 004A,E01019832,1597,181,1416
2021,South Derbyshire 004B,E01019833,2027,335,1692
2021,South Derbyshire 004C,E01019834,2318,502,1816
2021,South Derbyshire 012A,E01019837,1904,353,1551
2021,South Derbyshire 012B,E01019838,1424,247,1177
2021,South Derbyshire 001A,E01019839,2708,531,2177
2021,South Derbyshire 002A,E01019840,1676,336,1340
2021,South Derbyshire 002B,E01019841,1773,295,1478
2021,South Derbyshire 013A,E01019842,1554,305,1249
2021,South Derbyshire 006A,E01019843,1476,193,1283
2021,South Derbyshire 007A,E01019844,1445,252,1193
2021,South Derbyshire 001B,E01019845,1189,207,982
2021,South Derbyshire 001C,E01019846,1238,204,1034
2021,South Derbyshire 002C,E01019847,1318,209,1109
2021,South Derbyshire 002D,E01019848,2550,613,1937
2021,South Derbyshire 011A,E01019850,2215,367,1848
2021,South Derbyshire 011B,E01019851,1593,266,1327
2021,South Derbyshire 011C,E01019852,1943,378,1565
2021,South Derbyshire 006B,E01019853,1633,328,1305
2021,South Derbyshire 006C,E01019854,1917,327,1590
2021,South Derbyshire 006D,E01019855,1486,245,1241
2021,South Derbyshire 007B,E01019856,1387,254,1133
2021,South Derbyshire 007C,E01019857,1328,256,1072
2021,South Derbyshire 007D,E01019858,1417,296,1121
2021,South Derbyshire 007E,E01019859,1595,263,1332
2021,South Derbyshire 008A,E01019860,1131,176,955
2021,South Derbyshire 008B,E01019861,1653,263,1390
2021,South Derbyshire 008C,E01019862,1557,261,1296
2021,South Derbyshire 008D,E01019863,1455,321,1134
2021,South Derbyshire 008E,E01019864,1278,233,1045
2021,South Derbyshire 008F,E01019865,1203,211,992
2021,South Derbyshire 001D,E01019866,2177,336,1841
2021,South Derbyshire 005A,E01019867,1669,252,1417
2021,South Derbyshire 005B,E01019868,1926,407,1519
2021,South Derbyshire 005C,E01019869,1475,513,962
2021,South Derbyshire 011D,E01019870,1553,224,1329
2021,South Derbyshire 011E,E01019871,1629,263,1366
2021,South Derbyshire 011F,E01019872,1972,274,1698
2021,South Derbyshire 003A,E01019873,2373,487,1886
2021,South Derbyshire 003B,E01019874,1294,181,1113
2021,South Derbyshire 003C,E01019875,1273,229,1044
2021,South Derbyshire 009A,E01019876,1746,323,1423
2021,South Derbyshire 009B,E01019877,1960,305,1655
2021,South Derbyshire 009C,E01019878,1394,236,1158
2021,South Derbyshire 009D,E01019879,1969,294,1675
2021,South Derbyshire 005D,E01019880,1593,259,1334
2021,South Derbyshire 003E,E01019882,1822,281,1541
2021,South Derbyshire 013C,E01019885,1517,235,1282
2021,East Devon 005B,E01019887,1599,259,1340
2021,East Devon 005C,E01019888,1651,144,1507
2021,East Devon 005D,E01019889,1706,234,1472
2021,East Devon 009A,E01019890,1735,249,1486
2021,East Devon 021B,E01019891,1623,278,1345
2021,East Devon 017A,E01019894,1361,93,1268
2021,East Devon 017B,E01019895,1507,172,1335
2021,East Devon 017C,E01019896,1557,149,1408
2021,East Devon 017D,E01019897,1529,292,1237
2021,East Devon 014A,E01019898,2651,388,2263
2021,East Devon 007A,E01019899,1377,188,1189
2021,East Devon 007B,E01019900,1795,187,1608
2021,East Devon 009B,E01019901,1381,171,1210
2021,East Devon 001A,E01019902,2179,311,1868
2021,East Devon 021A,E01019903,2059,317,1742
2021,East Devon 015A,E01019904,1381,240,1141
2021,East Devon 015B,E01019905,1816,275,1541
2021,East Devon 015C,E01019906,1449,218,1231
2021,East Devon 015D,E01019907,1437,180,1257
2021,East Devon 016A,E01019908,1615,335,1280
2021,East Devon 016B,E01019909,1782,257,1525
2021,East Devon 016C,E01019910,1655,313,1342
2021,East Devon 016D,E01019911,1575,151,1424
2021,East Devon 020A,E01019912,1603,166,1437
2021,East Devon 020B,E01019913,1781,128,1653
2021,East Devon 020C,E01019914,2346,440,1906
2021,East Devon 020D,E01019915,1816,245,1571
2021,East Devon 019A,E01019916,1889,255,1634
2021,East Devon 019B,E01019917,1500,274,1226
2021,East Devon 019C,E01019918,1674,191,1483
2021,East Devon 019D,E01019919,1629,252,1377
2021,East Devon 018A,E01019920,1528,260,1268
2021,East Devon 018B,E01019921,1521,293,1228
2021,East Devon 018C,E01019922,1527,294,1233
2021,East Devon 018D,E01019923,1231,212,1019
2021,East Devon 018E,E01019924,1371,231,1140
2021,East Devon 004A,E01019925,1244,235,1009
2021,East Devon 002A,E01019927,1249,209,1040
2021,East Devon 003A,E01019928,1381,231,1150
2021,East Devon 003B,E01019929,1311,221,1090
2021,East Devon 003C,E01019930,1391,177,1214
2021,East Devon 003D,E01019931,1152,144,1008
2021,East Devon 002B,E01019932,1576,203,1373
2021,East Devon 002C,E01019933,1271,160,1111
2021,East Devon 002D,E01019934,1812,264,1548
2021,East Devon 007C,E01019935,1311,170,1141
2021,East Devon 007D,E01019936,1146,137,1009
2021,East Devon 013A,E01019937,2210,335,1875
2021,East Devon 001B,E01019938,2361,348,2013
2021,East Devon 008A,E01019939,1664,315,1349
2021,East Devon 008B,E01019940,1685,275,1410
2021,East Devon 008C,E01019942,2291,424,1867
2021,East Devon 008D,E01019943,1721,335,1386
2021,East Devon 008E,E01019944,1721,355,1366
2021,East Devon 013B,E01019945,2135,384,1751
2021,East Devon 010A,E01019946,1380,106,1274
2021,East Devon 010B,E01019947,2073,197,1876
2021,East Devon 010C,E01019948,1246,129,1117
2021,East Devon 010D,E01019949,1552,168,1384
2021,East Devon 010E,E01019950,1228,146,1082
2021,East Devon 009C,E01019951,2051,220,1831
2021,East Devon 011A,E01019952,1710,231,1479
2021,East Devon 011B,E01019953,1539,203,1336
2021,East Devon 011C,E01019954,1902,349,1553
2021,East Devon 011D,E01019955,1583,234,1349
2021,East Devon 012A,E01019956,1704,171,1533
2021,East Devon 012B,E01019957,1702,85,1617
2021,East Devon 012C,E01019958,1753,225,1528
2021,East Devon 004D,E01019959,1187,197,990
2021,East Devon 004E,E01019960,1397,258,1139
2021,East Devon 007E,E01019961,2497,377,2120
2021,East Devon 004F,E01019962,2227,348,1879
2021,East Devon 013C,E01019963,1659,285,1374
2021,East Devon 014B,E01019964,1748,208,1540
2021,East Devon 014C,E01019965,1729,302,1427
2021,East Devon 005E,E01019966,1086,141,945
2021,East Devon 001C,E01019967,1286,177,1109
2021,Exeter 014A,E01019968,1415,222,1193
2021,Exeter 014B,E01019969,1229,194,1035
2021,Exeter 014C,E01019970,1180,164,1016
2021,Exeter 014D,E01019971,1472,157,1315
2021,Exeter 014E,E01019972,1341,224,1117
2021,Exeter 012A,E01019973,1420,210,1210
2021,Exeter 012B,E01019974,1304,184,1120
2021,Exeter 010A,E01019975,1254,298,956
2021,Exeter 012C,E01019976,1405,194,1211
2021,Exeter 012D,E01019977,1389,251,1138
2021,Exeter 005A,E01019980,1582,345,1237
2021,Exeter 012E,E01019981,1327,289,1038
2021,Exeter 005B,E01019982,1569,319,1250
2021,Exeter 005C,E01019983,1399,219,1180
2021,Exeter 005D,E01019984,1261,215,1046
2021,Exeter 005E,E01019985,1264,268,996
2021,Exeter 007A,E01019986,1367,280,1087
2021,Exeter 006A,E01019987,1702,641,1061
2021,Exeter 013A,E01019988,1329,202,1127
2021,Exeter 006B,E01019989,1092,180,912
2021,Exeter 002A,E01019990,1362,292,1070
2021,Exeter 002B,E01019991,1440,335,1105
2021,Exeter 003A,E01019992,1531,288,1243
2021,Exeter 002C,E01019993,1111,180,931
2021,Exeter 008A,E01019994,1489,593,896
2021,Exeter 008B,E01019995,2300,1178,1122
2021,Exeter 009A,E01019996,1136,281,855
2021,Exeter 004A,E01019997,1545,834,711
2021,Exeter 001C,E01019998,1305,271,1034
2021,Exeter 001D,E01019999,1329,493,836
2021,Exeter 002D,E01020000,1263,308,955
2021,Exeter 001E,E01020001,1268,216,1052
2021,Exeter 003B,E01020002,2132,433,1699
2021,Exeter 003C,E01020003,1650,296,1354
2021,Exeter 003D,E01020004,2221,367,1854
2021,Exeter 003E,E01020005,1913,404,1509
2021,Exeter 006C,E01020006,2014,549,1465
2021,Exeter 002E,E01020007,1542,997,545
2021,Exeter 006D,E01020008,1760,925,835
2021,Exeter 006E,E01020009,1320,307,1013
2021,Exeter 013B,E01020010,1905,460,1445
2021,Exeter 015A,E01020011,1284,207,1077
2021,Exeter 015B,E01020012,1499,297,1202
2021,Exeter 013C,E01020013,1284,195,1089
2021,Exeter 013D,E01020014,1419,286,1133
2021,Exeter 013E,E01020015,1986,441,1545
2021,Exeter 008D,E01020017,2720,1444,1276
2021,Exeter 008E,E01020018,2091,613,1478
2021,Exeter 004B,E01020019,2030,1417,613
2021,Exeter 004C,E01020020,2148,1481,667
2021,Exeter 004D,E01020021,1904,920,984
2021,Exeter 004E,E01020022,1928,1119,809
2021,Exeter 009B,E01020023,2142,485,1657
2021,Exeter 009C,E01020024,1458,269,1189
2021,Exeter 009D,E01020025,1343,204,1139
2021,Exeter 011A,E01020026,1633,237,1396
2021,Exeter 011B,E01020027,1542,252,1290
2021,Exeter 010B,E01020029,1514,224,1290
2021,Exeter 010C,E01020030,1857,288,1569
2021,Exeter 010D,E01020031,1537,299,1238
2021,Exeter 010E,E01020032,1486,237,1249
2021,Exeter 007B,E01020036,1374,223,1151
2021,Exeter 007C,E01020037,1310,260,1050
2021,Exeter 011E,E01020038,2403,482,1921
2021,Exeter 007D,E01020039,1725,309,1416
2021,Exeter 007E,E01020040,1246,219,1027
2021,Mid Devon 011A,E01020041,2400,479,1921
2021,Mid Devon 011B,E01020042,1595,253,1342
2021,Mid Devon 008A,E01020043,1907,391,1516
2021,Mid Devon 008B,E01020044,1581,251,1330
2021,Mid Devon 006A,E01020045,1683,290,1393
2021,Mid Devon 001A,E01020046,1481,243,1238
2021,Mid Devon 002A,E01020047,2070,234,1836
2021,Mid Devon 005A,E01020048,2083,316,1767
2021,Mid Devon 001B,E01020049,1301,179,1122
2021,Mid Devon 001C,E01020050,2082,250,1832
2021,Mid Devon 002B,E01020051,1636,156,1480
2021,Mid Devon 004A,E01020052,1761,274,1487
2021,Mid Devon 004B,E01020053,1365,271,1094
2021,Mid Devon 007A,E01020054,2414,454,1960
2021,Mid Devon 007B,E01020055,1779,254,1525
2021,Mid Devon 008C,E01020056,2774,520,2254
2021,Mid Devon 007C,E01020057,2181,403,1778
2021,Mid Devon 007D,E01020058,1893,289,1604
2021,Mid Devon 006B,E01020059,2213,432,1781
2021,Mid Devon 011C,E01020060,1663,244,1419
2021,Mid Devon 011D,E01020061,1975,343,1632
2021,Mid Devon 006C,E01020062,1570,222,1348
2021,Mid Devon 003A,E01020063,2355,466,1889
2021,Mid Devon 006D,E01020064,1748,333,1415
2021,Mid Devon 004C,E01020065,1890,512,1378
2021,Mid Devon 004D,E01020067,1791,445,1346
2021,Mid Devon 010A,E01020068,1516,242,1274
2021,Mid Devon 010B,E01020069,1430,218,1212
2021,Mid Devon 010C,E01020070,1791,271,1520
2021,Mid Devon 008D,E01020071,1838,304,1534
2021,Mid Devon 009A,E01020072,1610,257,1353
2021,Mid Devon 009B,E01020073,1688,281,1407
2021,Mid Devon 003B,E01020074,2234,377,1857
2021,Mid Devon 003C,E01020075,1902,352,1550
2021,Mid Devon 009C,E01020076,1725,274,1451
2021,Mid Devon 001D,E01020077,1664,301,1363
2021,Mid Devon 005B,E01020078,1262,235,1027
2021,Mid Devon 005C,E01020079,1242,232,1010
2021,Mid Devon 002D,E01020080,1848,373,1475
2021,Mid Devon 005D,E01020081,1310,233,1077
2021,Mid Devon 009D,E01020082,1215,194,1021
2021,Mid Devon 010D,E01020083,2435,478,1957
2021,North Devon 012A,E01020084,1313,167,1146
2021,North Devon 012B,E01020085,1405,237,1168
2021,North Devon 014A,E01020087,2059,262,1797
2021,North Devon 006A,E01020088,1975,303,1672
2021,North Devon 005A,E01020089,2125,401,1724
2021,North Devon 004A,E01020090,1817,310,1507
2021,North Devon 005B,E01020091,1216,207,1009
2021,North Devon 005C,E01020092,1373,214,1159
2021,North Devon 005D,E01020093,1392,257,1135
2021,North Devon 008A,E01020094,1633,151,1482
2021,North Devon 008B,E01020095,1399,267,1132
2021,North Devon 009A,E01020096,1604,213,1391
2021,North Devon 013A,E01020097,2255,338,1917
2021,North Devon 014B,E01020098,2256,322,1934
2021,North Devon 002A,E01020099,1370,188,1182
2021,North Devon 002B,E01020100,1114,172,942
2021,North Devon 002C,E01020101,1356,223,1133
2021,North Devon 010A,E01020102,1448,246,1202
2021,North Devon 010B,E01020103,1453,349,1104
2021,North Devon 010C,E01020104,1198,277,921
2021,North Devon 011A,E01020105,2110,387,1723
2021,North Devon 011B,E01020106,1269,131,1138
2021,North Devon 011C,E01020107,1571,171,1400
2021,North Devon 004B,E01020108,1970,327,1643
2021,North Devon 004C,E01020109,1291,235,1056
2021,North Devon 005E,E01020110,2682,538,2144
2021,North Devon 001A,E01020111,1274,240,1034
2021,North Devon 001B,E01020112,1410,197,1213
2021,North Devon 003A,E01020113,1357,207,1150
2021,North Devon 001C,E01020114,1125,175,950
2021,North Devon 001D,E01020115,1134,161,973
2021,North Devon 003B,E01020116,1562,301,1261
2021,North Devon 003C,E01020117,1482,215,1267
2021,North Devon 003D,E01020118,1250,250,1000
2021,North Devon 011D,E01020119,1425,154,1271
2021,North Devon 006B,E01020120,2134,376,1758
2021,North Devon 012D,E01020121,1885,327,1558
2021,North Devon 012E,E01020122,2145,360,1785
2021,North Devon 009B,E01020123,1379,239,1140
2021,North Devon 009C,E01020124,1347,164,1183
2021,North Devon 009D,E01020125,1287,166,1121
2021,North Devon 002D,E01020126,1562,136,1426
2021,North Devon 006C,E01020127,2133,382,1751
2021,North Devon 010D,E01020128,1458,277,1181
2021,North Devon 010E,E01020129,1121,209,912
2021,North Devon 010F,E01020130,1392,243,1149
2021,North Devon 013B,E01020131,2228,428,1800
2021,North Devon 007A,E01020132,1633,225,1408
2021,North Devon 007B,E01020133,1424,220,1204
2021,North Devon 007C,E01020134,1065,211,854
2021,North Devon 013C,E01020135,1581,255,1326
2021,North Devon 013D,E01020136,2299,384,1915
2021,North Devon 013E,E01020137,1856,302,1554
2021,North Devon 014C,E01020138,2467,375,2092
2021,North Devon 007D,E01020139,1348,265,1083
2021,North Devon 008C,E01020140,1216,174,1042
2021,North Devon 008D,E01020141,1684,374,1310
2021,South Hams 006A,E01020142,2604,520,2084
2021,South Hams 006B,E01020143,2360,351,2009
2021,South Hams 001A,E01020144,1370,227,1143
2021,South Hams 001B,E01020145,1941,332,1609
2021,South Hams 001C,E01020146,1183,155,1028
2021,South Hams 008A,E01020147,2008,297,1711
2021,South Hams 002A,E01020148,1089,145,944
2021,South Hams 001D,E01020149,1362,233,1129
2021,South Hams 006C,E01020150,2057,362,1695
2021,South Hams 007A,E01020151,1452,120,1332
2021,South Hams 007B,E01020152,1279,79,1200
2021,South Hams 004A,E01020153,1072,98,974
2021,South Hams 007C,E01020154,1312,264,1048
2021,South Hams 007D,E01020155,1038,188,850
2021,South Hams 004B,E01020156,2095,332,1763
2021,South Hams 002B,E01020157,2381,380,2001
2021,South Hams 008B,E01020158,1927,326,1601
2021,South Hams 008C,E01020159,1521,270,1251
2021,South Hams 002C,E01020160,2321,416,1905
2021,South Hams 005A,E01020161,2370,401,1969
2021,South Hams 005B,E01020162,1535,334,1201
2021,South Hams 005C,E01020163,1740,340,1400
2021,South Hams 005D,E01020164,1407,256,1151
2021,South Hams 005E,E01020165,1373,259,1114
2021,South Hams 005F,E01020166,1378,232,1146
2021,South Hams 005G,E01020167,1576,310,1266
2021,South Hams 010A,E01020168,1956,300,1656
2021,South Hams 010B,E01020169,2129,361,1768
2021,South Hams 004C,E01020170,2228,352,1876
2021,South Hams 009A,E01020171,1736,225,1511
2021,South Hams 012A,E01020172,1907,262,1645
2021,South Hams 012B,E01020173,1149,97,1052
2021,South Hams 011A,E01020174,1540,193,1347
2021,South Hams 011B,E01020175,2029,235,1794
2021,South Hams 002D,E01020176,1106,142,964
2021,South Hams 002E,E01020177,1450,260,1190
2021,South Hams 011C,E01020178,2011,273,1738
2021,South Hams 012C,E01020179,1880,244,1636
2021,South Hams 003A,E01020180,2218,412,1806
2021,South Hams 003B,E01020181,1816,284,1532
2021,South Hams 003C,E01020182,1522,313,1209
2021,South Hams 003D,E01020183,1432,158,1274
2021,South Hams 003E,E01020184,1666,214,1452
2021,South Hams 009B,E01020185,1407,193,1214
2021,South Hams 009C,E01020186,1352,124,1228
2021,South Hams 009D,E01020187,2455,492,1963
2021,South Hams 004D,E01020188,2065,294,1771
2021,South Hams 010C,E01020189,1981,320,1661
2021,South Hams 008D,E01020190,2321,438,1883
2021,Teignbridge 013A,E01020191,1941,201,1740
2021,Teignbridge 019A,E01020192,1401,162,1239
2021,Teignbridge 019B,E01020193,1564,270,1294
2021,Teignbridge 013B,E01020194,1411,230,1181
2021,Teignbridge 017A,E01020195,1707,317,1390
2021,Teignbridge 017B,E01020196,1651,287,1364
2021,Teignbridge 017C,E01020197,1240,170,1070
2021,Teignbridge 017D,E01020198,1317,232,1085
2021,Teignbridge 017E,E01020199,1531,272,1259
2021,Teignbridge 011A,E01020200,1043,117,926
2021,Teignbridge 011B,E01020201,1518,162,1356
2021,Teignbridge 007A,E01020202,2284,371,1913
2021,Teignbridge 004A,E01020203,1667,216,1451
2021,Teignbridge 007B,E01020204,1398,240,1158
2021,Teignbridge 003A,E01020205,1381,133,1248
2021,Teignbridge 004B,E01020206,1483,267,1216
2021,Teignbridge 012A,E01020208,1194,221,973
2021,Teignbridge 012B,E01020209,1343,230,1113
2021,Teignbridge 012C,E01020210,1348,186,1162
2021,Teignbridge 014A,E01020211,1467,280,1187
2021,Teignbridge 016A,E01020212,1189,248,941
2021,Teignbridge 016B,E01020213,1374,180,1194
2021,Teignbridge 016C,E01020214,1504,221,1283
2021,Teignbridge 016D,E01020215,1269,162,1107
2021,Teignbridge 015A,E01020216,1541,313,1228
2021,Teignbridge 014B,E01020217,1638,192,1446
2021,Teignbridge 014C,E01020218,1486,217,1269
2021,Teignbridge 012D,E01020219,1995,362,1633
2021,Teignbridge 004C,E01020220,1684,331,1353
2021,Teignbridge 004D,E01020221,1715,303,1412
2021,Teignbridge 004E,E01020222,1117,179,938
2021,Teignbridge 004F,E01020223,1714,278,1436
2021,Teignbridge 014D,E01020224,1135,198,937
2021,Teignbridge 015B,E01020225,1199,179,1020
2021,Teignbridge 015C,E01020226,1455,210,1245
2021,Teignbridge 015D,E01020227,1365,201,1164
2021,Teignbridge 006A,E01020228,1682,151,1531
2021,Teignbridge 005B,E01020230,1765,273,1492
2021,Teignbridge 005C,E01020231,1469,207,1262
2021,Teignbridge 005D,E01020232,1745,330,1415
2021,Teignbridge 006B,E01020233,1795,160,1635
2021,Teignbridge 006C,E01020234,1322,216,1106
2021,Teignbridge 006D,E01020235,1680,191,1489
2021,Teignbridge 007C,E01020236,1155,156,999
2021,Teignbridge 007D,E01020237,1567,250,1317
2021,Teignbridge 019C,E01020238,1168,203,965
2021,Teignbridge 019D,E01020239,1276,182,1094
2021,Teignbridge 002A,E01020240,1785,326,1459
2021,Teignbridge 002B,E01020241,1798,277,1521
2021,Teignbridge 002C,E01020242,1826,392,1434
2021,Teignbridge 001A,E01020243,1190,190,1000
2021,Teignbridge 002D,E01020244,1302,207,1095
2021,Teignbridge 002E,E01020245,1554,224,1330
2021,Teignbridge 018A,E01020246,1287,210,1077
2021,Teignbridge 018B,E01020247,1536,294,1242
2021,Teignbridge 018C,E01020248,1718,264,1454
2021,Teignbridge 018D,E01020249,1343,175,1168
2021,Teignbridge 009A,E01020250,1491,215,1276
2021,Teignbridge 011C,E01020251,1451,223,1228
2021,Teignbridge 009B,E01020252,2038,357,1681
2021,Teignbridge 009C,E01020253,1353,262,1091
2021,Teignbridge 009D,E01020254,1344,268,1076
2021,Teignbridge 009E,E01020255,1342,196,1146
2021,Teignbridge 013D,E01020256,1860,328,1532
2021,Teignbridge 009F,E01020257,1174,179,995
2021,Teignbridge 003B,E01020258,1668,265,1403
2021,Teignbridge 003C,E01020259,1063,118,945
2021,Teignbridge 011D,E01020260,1201,154,1047
2021,Teignbridge 011E,E01020261,1186,177,1009
2021,Teignbridge 001B,E01020262,1341,183,1158
2021,Teignbridge 001C,E01020263,1500,170,1330
2021,Teignbridge 010A,E01020264,1433,163,1270
2021,Teignbridge 008A,E01020265,1746,281,1465
2021,Teignbridge 008B,E01020266,1609,272,1337
2021,Teignbridge 008C,E01020267,1398,196,1202
2021,Teignbridge 008D,E01020268,1720,226,1494
2021,Teignbridge 010B,E01020269,1701,113,1588
2021,Teignbridge 008E,E01020270,1571,261,1310
2021,Teignbridge 010C,E01020271,1437,235,1202
2021,Teignbridge 010D,E01020272,1733,409,1324
2021,Teignbridge 003D,E01020273,1445,236,1209
2021,Teignbridge 001D,E01020274,1259,198,1061
2021,Torridge 001A,E01020275,1158,126,1032
2021,Torridge 001B,E01020276,1446,209,1237
2021,Torridge 004A,E01020277,1974,368,1606
2021,Torridge 004B,E01020278,1577,271,1306
2021,Torridge 004C,E01020279,2623,545,2078
2021,Torridge 003A,E01020280,2049,312,1737
2021,Torridge 003B,E01020281,1986,342,1644
2021,Torridge 003C,E01020282,1487,241,1246
2021,Torridge 004D,E01020283,2299,370,1929
2021,Torridge 004E,E01020284,1979,401,1578
2021,Torridge 004F,E01020285,1818,395,1423
2021,Torridge 009A,E01020286,1765,253,1512
2021,Torridge 007A,E01020287,1470,154,1316
2021,Torridge 005A,E01020288,1576,232,1344
2021,Torridge 009B,E01020289,1543,174,1369
2021,Torridge 009C,E01020290,1714,221,1493
2021,Torridge 008A,E01020291,1603,286,1317
2021,Torridge 005B,E01020292,1515,211,1304
2021,Torridge 008B,E01020293,2400,353,2047
2021,Torridge 008C,E01020294,2171,370,1801
2021,Torridge 005C,E01020295,1679,209,1470
2021,Torridge 005D,E01020296,1452,177,1275
2021,Torridge 001C,E01020297,1441,205,1236
2021,Torridge 002A,E01020298,2079,269,1810
2021,Torridge 001D,E01020299,1754,174,1580
2021,Torridge 002B,E01020300,1750,239,1511
2021,Torridge 009D,E01020301,2004,334,1670
2021,Torridge 008D,E01020302,1758,246,1512
2021,Torridge 007B,E01020303,1655,189,1466
2021,Torridge 006A,E01020304,1599,278,1321
2021,Torridge 006B,E01020305,1024,131,893
2021,Torridge 006C,E01020306,1252,218,1034
2021,Torridge 006D,E01020307,1648,324,1324
2021,Torridge 007C,E01020308,1803,230,1573
2021,Torridge 008E,E01020309,1775,243,1532
2021,Torridge 007D,E01020311,2134,344,1790
2021,West Devon 007A,E01020312,1597,193,1404
2021,West Devon 007B,E01020313,1402,248,1154
2021,West Devon 004A,E01020314,1681,222,1459
2021,West Devon 007C,E01020315,1548,274,1274
2021,West Devon 007D,E01020316,1772,276,1496
2021,West Devon 006A,E01020317,1385,167,1218
2021,West Devon 003A,E01020318,1509,225,1284
2021,West Devon 003B,E01020319,1682,234,1448
2021,West Devon 001A,E01020320,1813,251,1562
2021,West Devon 001B,E01020321,2344,345,1999
2021,West Devon 003C,E01020323,2037,216,1821
2021,West Devon 006B,E01020324,1565,180,1385
2021,West Devon 004B,E01020325,1645,255,1390
2021,West Devon 001D,E01020326,2170,350,1820
2021,West Devon 002A,E01020327,1724,257,1467
2021,West Devon 002B,E01020328,2257,505,1752
2021,West Devon 002C,E01020329,1568,222,1346
2021,West Devon 002D,E01020330,1832,296,1536
2021,West Devon 004C,E01020331,1634,209,1425
2021,West Devon 005A,E01020332,1721,212,1509
2021,West Devon 005B,E01020333,2101,338,1763
2021,West Devon 005C,E01020334,1873,305,1568
2021,West Devon 005D,E01020335,1589,214,1375
2021,West Devon 005E,E01020336,1305,157,1148
2021,West Devon 005F,E01020337,1364,397,967
2021,West Devon 005G,E01020338,2240,418,1822
2021,West Devon 003D,E01020339,1616,240,1376
2021,West Devon 004D,E01020340,1689,257,1432
2021,West Devon 006C,E01020341,1612,216,1396
2021,West Devon 006D,E01020342,1473,280,1193
2021,"Bournemouth, Christchurch and Poole 002A",E01020343,1471,191,1280
2021,"Bournemouth, Christchurch and Poole 002B",E01020344,1402,280,1122
2021,"Bournemouth, Christchurch and Poole 002C",E01020345,1283,155,1128
2021,"Bournemouth, Christchurch and Poole 024A",E01020346,1520,299,1221
2021,"Bournemouth, Christchurch and Poole 024B",E01020347,1597,298,1299
2021,"Bournemouth, Christchurch and Poole 024C",E01020348,1564,332,1232
2021,"Bournemouth, Christchurch and Poole 019A",E01020349,1771,125,1646
2021,"Bournemouth, Christchurch and Poole 019B",E01020350,1916,168,1748
2021,"Bournemouth, Christchurch and Poole 014A",E01020351,1234,245,989
2021,"Bournemouth, Christchurch and Poole 014B",E01020352,1415,307,1108
2021,"Bournemouth, Christchurch and Poole 014C",E01020353,1648,346,1302
2021,"Bournemouth, Christchurch and Poole 033A",E01020354,1392,189,1203
2021,"Bournemouth, Christchurch and Poole 033B",E01020355,1882,196,1686
2021,"Bournemouth, Christchurch and Poole 033C",E01020356,1587,180,1407
2021,"Bournemouth, Christchurch and Poole 019C",E01020357,2131,367,1764
2021,"Bournemouth, Christchurch and Poole 019D",E01020358,1484,172,1312
2021,"Bournemouth, Christchurch and Poole 014D",E01020359,1310,292,1018
2021,"Bournemouth, Christchurch and Poole 031A",E01020360,1645,351,1294
2021,"Bournemouth, Christchurch and Poole 031B",E01020361,1672,369,1303
2021,"Bournemouth, Christchurch and Poole 033D",E01020362,1416,172,1244
2021,"Bournemouth, Christchurch and Poole 024D",E01020363,1081,172,909
2021,"Bournemouth, Christchurch and Poole 031C",E01020364,1526,229,1297
2021,"Bournemouth, Christchurch and Poole 002D",E01020365,1817,230,1587
2021,"Bournemouth, Christchurch and Poole 014E",E01020366,2219,362,1857
2021,"Bournemouth, Christchurch and Poole 031D",E01020367,1747,236,1511
2021,"Bournemouth, Christchurch and Poole 018A",E01020369,1325,186,1139
2021,"Bournemouth, Christchurch and Poole 018B",E01020370,1567,268,1299
2021,"Bournemouth, Christchurch and Poole 018C",E01020371,1622,207,1415
2021,"Bournemouth, Christchurch and Poole 018D",E01020372,1500,210,1290
2021,Dorset 007A,E01020373,1249,248,1001
2021,Dorset 007B,E01020374,1487,198,1289
2021,Dorset 020A,E01020375,1286,158,1128
2021,Dorset 020B,E01020376,1046,128,918
2021,Dorset 017A,E01020377,1513,272,1241
2021,Dorset 020C,E01020378,1473,288,1185
2021,Dorset 017B,E01020379,1441,223,1218
2021,Dorset 017C,E01020380,1576,264,1312
2021,Dorset 017D,E01020381,1191,202,989
2021,Dorset 025A,E01020382,1453,261,1192
2021,Dorset 025B,E01020383,1932,310,1622
2021,Dorset 025C,E01020384,1547,313,1234
2021,Dorset 025D,E01020385,1211,212,999
2021,Dorset 025E,E01020386,1280,205,1075
2021,Dorset 025F,E01020387,1078,154,924
2021,Dorset 025G,E01020388,1400,266,1134
2021,Dorset 007C,E01020389,2088,342,1746
2021,Dorset 018A,E01020390,1300,95,1205
2021,Dorset 018B,E01020391,1424,150,1274
2021,Dorset 018C,E01020392,1705,176,1529
2021,Dorset 018D,E01020393,1420,383,1037
2021,Dorset 018E,E01020394,1671,216,1455
2021,Dorset 024A,E01020395,1881,142,1739
2021,Dorset 013A,E01020396,1080,174,906
2021,Dorset 007D,E01020397,1368,224,1144
2021,Dorset 013B,E01020398,2329,360,1969
2021,Dorset 024B,E01020400,1587,172,1415
2021,Dorset 024C,E01020401,1598,144,1454
2021,Dorset 024D,E01020402,1501,244,1257
2021,Dorset 015A,E01020403,1600,237,1363
2021,Dorset 015B,E01020404,1632,169,1463
2021,Dorset 015C,E01020405,1966,264,1702
2021,Dorset 015D,E01020406,2434,234,2200
2021,Dorset 020D,E01020407,1152,165,987
2021,Dorset 020E,E01020408,1082,127,955
2021,Dorset 013C,E01020409,1261,204,1057
2021,Dorset 013D,E01020410,1222,234,988
2021,Dorset 012A,E01020411,1063,173,890
2021,Dorset 012B,E01020412,1339,237,1102
2021,Dorset 012C,E01020413,1420,229,1191
2021,Dorset 012D,E01020414,1884,314,1570
2021,Dorset 012E,E01020415,1445,243,1202
2021,Dorset 010A,E01020416,1432,252,1180
2021,Dorset 010B,E01020417,1084,181,903
2021,Dorset 010C,E01020418,1498,157,1341
2021,Dorset 010D,E01020419,1936,296,1640
2021,Dorset 010E,E01020420,1382,245,1137
2021,Dorset 016A,E01020421,1244,171,1073
2021,Dorset 016B,E01020422,1568,133,1435
2021,Dorset 016C,E01020423,1420,147,1273
2021,Dorset 016D,E01020424,1346,112,1234
2021,Dorset 016E,E01020425,1583,139,1444
2021,Dorset 021A,E01020426,1757,267,1490
2021,Dorset 021B,E01020427,2037,445,1592
2021,Dorset 021C,E01020428,1878,196,1682
2021,Dorset 021D,E01020429,1912,342,1570
2021,Dorset 014A,E01020430,1389,164,1225
2021,Dorset 014B,E01020431,1173,307,866
2021,Dorset 014C,E01020432,1238,163,1075
2021,Dorset 005A,E01020433,1705,243,1462
2021,Dorset 005B,E01020434,1725,224,1501
2021,Dorset 011A,E01020435,1637,227,1410
2021,Dorset 011B,E01020436,2095,420,1675
2021,Dorset 011C,E01020437,1893,388,1505
2021,Dorset 011D,E01020438,1969,203,1766
2021,Dorset 011E,E01020439,2250,393,1857
2021,Dorset 002A,E01020440,1936,276,1660
2021,Dorset 014D,E01020441,1912,253,1659
2021,Dorset 009A,E01020442,1905,248,1657
2021,Dorset 001A,E01020443,2287,407,1880
2021,Dorset 006A,E01020444,1739,312,1427
2021,Dorset 006B,E01020445,1418,436,982
2021,Dorset 006C,E01020446,1507,187,1320
2021,Dorset 001B,E01020447,1689,210,1479
2021,Dorset 014E,E01020448,1909,244,1665
2021,Dorset 005C,E01020449,1985,249,1736
2021,Dorset 002B,E01020450,2159,374,1785
2021,Dorset 009B,E01020452,2490,887,1603
2021,Dorset 009C,E01020453,1755,263,1492
2021,Dorset 003A,E01020454,1941,214,1727
2021,Dorset 003B,E01020456,1702,319,1383
2021,Dorset 003C,E01020457,1573,248,1325
2021,Dorset 005D,E01020458,2107,304,1803
2021,Dorset 006D,E01020460,2295,247,2048
2021,Dorset 002C,E01020462,1791,214,1577
2021,Dorset 001C,E01020463,1577,225,1352
2021,Dorset 001D,E01020464,1487,214,1273
2021,Dorset 027A,E01020465,1856,279,1577
2021,Dorset 039A,E01020466,1652,208,1444
2021,Dorset 039B,E01020467,1769,229,1540
2021,Dorset 039C,E01020468,1494,173,1321
2021,Dorset 027B,E01020469,1964,408,1556
2021,Dorset 027C,E01020470,1753,247,1506
2021,Dorset 028A,E01020471,1236,261,975
2021,Dorset 028B,E01020472,1415,219,1196
2021,Dorset 028C,E01020473,1521,268,1253
2021,Dorset 028D,E01020474,1885,245,1640
2021,Dorset 028E,E01020475,2200,421,1779
2021,Dorset 033A,E01020476,1163,153,1010
2021,Dorset 033B,E01020477,1354,246,1108
2021,Dorset 042A,E01020478,1073,147,926
2021,Dorset 042B,E01020479,1097,111,986
2021,Dorset 042C,E01020480,1663,157,1506
2021,Dorset 042D,E01020481,1285,106,1179
2021,Dorset 042E,E01020482,1492,193,1299
2021,Dorset 042F,E01020483,1130,214,916
2021,Dorset 042G,E01020484,1379,220,1159
2021,Dorset 033C,E01020485,1408,147,1261
2021,Dorset 033D,E01020486,1616,209,1407
2021,Dorset 033E,E01020487,1170,196,974
2021,Dorset 033F,E01020488,1428,212,1216
2021,Dorset 035A,E01020489,1268,188,1080
2021,Dorset 035B,E01020490,1583,206,1377
2021,Dorset 035C,E01020491,1585,277,1308
2021,Dorset 035D,E01020492,1116,142,974
2021,Dorset 035E,E01020493,2370,590,1780
2021,Dorset 019A,E01020494,1216,182,1034
2021,Dorset 019B,E01020495,1338,162,1176
2021,Dorset 019C,E01020496,1540,175,1365
2021,Dorset 008A,E01020497,1820,290,1530
2021,Dorset 026A,E01020498,1987,277,1710
2021,Dorset 026B,E01020499,1267,215,1052
2021,Dorset 026C,E01020500,1598,178,1420
2021,Dorset 026D,E01020501,1327,191,1136
2021,Dorset 030A,E01020502,1631,254,1377
2021,Dorset 030B,E01020503,1605,168,1437
2021,Dorset 030C,E01020504,2119,173,1946
2021,Dorset 036A,E01020505,1870,275,1595
2021,Dorset 019D,E01020506,1726,209,1517
2021,Dorset 029A,E01020507,1796,185,1611
2021,Dorset 008B,E01020508,2048,303,1745
2021,Dorset 022A,E01020509,2750,420,2330
2021,Dorset 022B,E01020510,2290,350,1940
2021,Dorset 023A,E01020511,1656,210,1446
2021,Dorset 037A,E01020512,2031,257,1774
2021,Dorset 037B,E01020513,1616,262,1354
2021,Dorset 037C,E01020514,1819,321,1498
2021,Dorset 037D,E01020515,1113,170,943
2021,Dorset 037E,E01020516,1458,197,1261
2021,Dorset 029B,E01020517,1734,179,1555
2021,Dorset 034A,E01020518,1531,241,1290
2021,Dorset 034B,E01020519,1655,305,1350
2021,Dorset 034C,E01020520,1403,238,1165
2021,Dorset 034D,E01020523,1191,216,975
2021,Dorset 034E,E01020524,1390,240,1150
2021,Dorset 034F,E01020525,1271,259,1012
2021,Dorset 032A,E01020526,1288,251,1037
2021,Dorset 032B,E01020527,1398,264,1134
2021,Dorset 032C,E01020528,2335,432,1903
2021,Dorset 022C,E01020529,2177,298,1879
2021,Dorset 019E,E01020530,1820,239,1581
2021,Dorset 029C,E01020531,1685,223,1462
2021,Dorset 023B,E01020532,1563,111,1452
2021,Dorset 023C,E01020533,2081,335,1746
2021,Dorset 019F,E01020534,2067,348,1719
2021,Dorset 023D,E01020535,1699,215,1484
2021,Dorset 029D,E01020536,2197,404,1793
2021,Dorset 036B,E01020537,2040,337,1703
2021,Dorset 036C,E01020538,1783,261,1522
2021,Dorset 022D,E01020539,2013,329,1684
2021,Dorset 022E,E01020540,2486,388,2098
2021,Dorset 008C,E01020541,2034,295,1739
2021,Dorset 004A,E01020542,1304,137,1167
2021,Dorset 004B,E01020543,1367,261,1106
2021,Dorset 004C,E01020544,1575,162,1413
2021,Dorset 004D,E01020546,1445,574,871
2021,Dorset 004E,E01020547,1088,169,919
2021,Dorset 036D,E01020549,2033,300,1733
2021,Dorset 008D,E01020550,1633,211,1422
2021,Dorset 038A,E01020551,2066,355,1711
2021,Dorset 038B,E01020552,1655,388,1267
2021,Dorset 044A,E01020553,1403,212,1191
2021,Dorset 044B,E01020554,1675,140,1535
2021,Dorset 044C,E01020555,1372,179,1193
2021,Dorset 044D,E01020556,1527,141,1386
2021,Dorset 040A,E01020557,1505,124,1381
2021,Dorset 040B,E01020558,1744,219,1525
2021,Dorset 040C,E01020559,1709,145,1564
2021,Dorset 040D,E01020560,1776,236,1540
2021,Dorset 040E,E01020561,1873,285,1588
2021,Dorset 048A,E01020562,2089,302,1787
2021,Dorset 047A,E01020563,1597,199,1398
2021,Dorset 048B,E01020564,1501,327,1174
2021,Dorset 048C,E01020565,1429,217,1212
2021,Dorset 048D,E01020566,1971,255,1716
2021,Dorset 047B,E01020569,1654,331,1323
2021,Dorset 038C,E01020570,1508,164,1344
2021,Dorset 038D,E01020571,2019,340,1679
2021,Dorset 043A,E01020572,1853,271,1582
2021,Dorset 043B,E01020573,1748,198,1550
2021,Dorset 041A,E01020574,1839,322,1517
2021,Dorset 041B,E01020575,1699,387,1312
2021,Dorset 041C,E01020576,1633,243,1390
2021,Dorset 043C,E01020577,1772,309,1463
2021,Dorset 043D,E01020578,1994,323,1671
2021,Dorset 041D,E01020579,2075,330,1745
2021,Dorset 041E,E01020580,1457,241,1216
2021,Dorset 044E,E01020581,1753,194,1559
2021,Dorset 044F,E01020582,1444,238,1206
2021,Dorset 045A,E01020583,1810,260,1550
2021,Dorset 045B,E01020584,1602,233,1369
2021,Dorset 045C,E01020585,1438,313,1125
2021,Dorset 046A,E01020586,1212,212,1000
2021,Dorset 046B,E01020587,1406,239,1167
2021,Dorset 046C,E01020588,1412,259,1153
2021,Dorset 046D,E01020589,1355,222,1133
2021,County Durham 015A,E01020590,1202,184,1018
2021,County Durham 015B,E01020591,1367,249,1118
2021,County Durham 011A,E01020592,1392,372,1020
2021,County Durham 011B,E01020593,1158,162,996
2021,County Durham 013A,E01020594,1460,222,1238
2021,County Durham 013B,E01020595,1607,233,1374
2021,County Durham 007A,E01020596,1510,304,1206
2021,County Durham 007B,E01020597,1336,192,1144
2021,County Durham 007C,E01020598,1621,205,1416
2021,County Durham 011C,E01020599,1614,308,1306
2021,County Durham 013C,E01020600,1386,238,1148
2021,County Durham 011D,E01020601,1329,232,1097
2021,County Durham 011E,E01020602,1789,285,1504
2021,County Durham 013D,E01020603,1593,280,1313
2021,County Durham 019A,E01020604,1334,217,1117
2021,County Durham 013E,E01020605,1601,260,1341
2021,County Durham 005A,E01020606,1281,181,1100
2021,County Durham 019B,E01020607,1750,285,1465
2021,County Durham 015C,E01020608,1826,347,1479
2021,County Durham 015D,E01020609,1257,227,1030
2021,County Durham 015E,E01020610,1335,221,1114
2021,County Durham 007D,E01020611,1716,268,1448
2021,County Durham 007E,E01020612,1450,225,1225
2021,County Durham 002A,E01020613,1279,199,1080
2021,County Durham 002B,E01020614,1339,193,1146
2021,County Durham 005B,E01020615,1593,329,1264
2021,County Durham 005C,E01020616,1545,277,1268
2021,County Durham 005D,E01020617,2321,365,1956
2021,County Durham 011F,E01020618,1806,344,1462
2021,County Durham 019C,E01020619,1500,254,1246
2021,County Durham 019D,E01020620,1481,291,1190
2021,County Durham 019E,E01020621,1911,395,1516
2021,County Durham 002C,E01020622,1477,216,1261
2021,County Durham 002D,E01020623,1404,209,1195
2021,County Durham 009A,E01020624,1601,289,1312
2021,County Durham 009B,E01020625,1570,253,1317
2021,County Durham 006A,E01020626,1403,247,1156
2021,County Durham 003A,E01020627,1425,232,1193
2021,County Durham 003B,E01020628,1737,284,1453
2021,County Durham 003C,E01020629,1704,319,1385
2021,County Durham 014A,E01020630,1278,266,1012
2021,County Durham 014B,E01020631,1512,279,1233
2021,County Durham 010A,E01020632,1625,226,1399
2021,County Durham 020A,E01020633,1550,321,1229
2021,County Durham 001A,E01020634,1534,231,1303
2021,County Durham 001B,E01020635,1235,184,1051
2021,County Durham 001C,E01020636,1628,308,1320
2021,County Durham 014C,E01020637,1592,253,1339
2021,County Durham 006B,E01020638,1505,238,1267
2021,County Durham 006C,E01020639,1560,320,1240
2021,County Durham 010B,E01020640,2125,373,1752
2021,County Durham 010C,E01020641,2092,368,1724
2021,County Durham 010D,E01020642,1304,215,1089
2021,County Durham 010E,E01020643,1942,322,1620
2021,County Durham 014E,E01020645,1432,326,1106
2021,County Durham 024A,E01020646,1534,248,1286
2021,County Durham 008A,E01020647,1944,565,1379
2021,County Durham 008B,E01020648,2490,564,1926
2021,County Durham 008C,E01020649,1560,327,1233
2021,County Durham 012A,E01020650,2256,516,1740
2021,County Durham 012B,E01020651,1628,241,1387
2021,County Durham 012C,E01020652,1936,406,1530
2021,County Durham 006D,E01020653,1400,257,1143
2021,County Durham 001D,E01020654,1769,295,1474
2021,County Durham 003D,E01020655,1878,285,1593
2021,County Durham 003E,E01020656,1371,203,1168
2021,County Durham 003F,E01020657,1392,238,1154
2021,County Durham 024B,E01020658,1765,273,1492
2021,County Durham 024C,E01020659,1327,191,1136
2021,County Durham 024D,E01020660,1511,266,1245
2021,County Durham 004A,E01020661,1743,325,1418
2021,County Durham 004B,E01020662,1650,286,1364
2021,County Durham 004C,E01020663,1736,260,1476
2021,County Durham 020B,E01020664,1523,218,1305
2021,County Durham 020C,E01020665,1318,240,1078
2021,County Durham 020D,E01020666,1325,199,1126
2021,County Durham 010F,E01020667,1480,163,1317
2021,County Durham 012D,E01020668,1357,277,1080
2021,County Durham 012E,E01020669,1368,256,1112
2021,County Durham 009C,E01020670,1464,250,1214
2021,County Durham 009D,E01020671,1178,219,959
2021,County Durham 009E,E01020672,1594,277,1317
2021,County Durham 008D,E01020673,1470,244,1226
2021,County Durham 004D,E01020674,1492,284,1208
2021,County Durham 008E,E01020675,1626,247,1379
2021,County Durham 001E,E01020676,1419,216,1203
2021,County Durham 006E,E01020677,1429,253,1176
2021,County Durham 004E,E01020678,1229,211,1018
2021,County Durham 026A,E01020679,1464,260,1204
2021,County Durham 026B,E01020680,1591,287,1304
2021,County Durham 026C,E01020681,1412,251,1161
2021,County Durham 028A,E01020682,1745,252,1493
2021,County Durham 028B,E01020683,1522,279,1243
2021,County Durham 038A,E01020685,1554,247,1307
2021,County Durham 038B,E01020686,1360,232,1128
2021,County Durham 038C,E01020687,1235,169,1066
2021,County Durham 038D,E01020688,1364,238,1126
2021,County Durham 038E,E01020689,1493,301,1192
2021,County Durham 028C,E01020690,1220,160,1060
2021,County Durham 028D,E01020691,1250,215,1035
2021,County Durham 028E,E01020692,1388,169,1219
2021,County Durham 029A,E01020693,1300,374,926
2021,County Durham 041A,E01020694,1379,258,1121
2021,County Durham 044A,E01020695,1980,323,1657
2021,County Durham 041B,E01020696,1178,178,1000
2021,County Durham 041C,E01020697,1458,271,1187
2021,County Durham 044B,E01020698,1500,285,1215
2021,County Durham 044C,E01020699,1347,290,1057
2021,County Durham 044D,E01020700,1461,253,1208
2021,County Durham 044E,E01020701,1274,182,1092
2021,County Durham 033B,E01020702,2646,942,1704
2021,County Durham 030A,E01020703,2545,1992,553
2021,County Durham 033C,E01020704,1815,1120,695
2021,County Durham 031A,E01020705,1567,308,1259
2021,County Durham 031B,E01020706,1756,258,1498
2021,County Durham 023A,E01020708,1167,219,948
2021,County Durham 022A,E01020709,2543,299,2244
2021,County Durham 023B,E01020710,1608,308,1300
2021,County Durham 023C,E01020711,1786,390,1396
2021,County Durham 033D,E01020712,1717,682,1035
2021,County Durham 026D,E01020714,1404,184,1220
2021,County Durham 026E,E01020716,1527,332,1195
2021,County Durham 022B,E01020717,1481,183,1298
2021,County Durham 022C,E01020718,1276,216,1060
2021,County Durham 022D,E01020719,1141,207,934
2021,County Durham 023D,E01020720,1346,264,1082
2021,County Durham 022E,E01020721,1044,185,859
2021,County Durham 029B,E01020722,1900,615,1285
2021,County Durham 029C,E01020723,1669,831,838
2021,County Durham 029D,E01020724,1572,474,1098
2021,County Durham 027A,E01020725,1458,242,1216
2021,County Durham 027B,E01020726,1094,149,945
2021,County Durham 027C,E01020727,1141,200,941
2021,County Durham 027D,E01020729,2086,354,1732
2021,County Durham 027E,E01020730,1531,245,1286
2021,County Durham 027F,E01020731,1384,223,1161
2021,County Durham 041D,E01020732,2226,339,1887
2021,County Durham 035A,E01020733,1055,216,839
2021,County Durham 035B,E01020734,1120,255,865
2021,County Durham 035C,E01020735,1375,274,1101
2021,County Durham 039B,E01020737,1372,193,1179
2021,County Durham 039D,E01020739,1101,152,949
2021,County Durham 017A,E01020740,1324,271,1053
2021,County Durham 017B,E01020741,1042,181,861
2021,County Durham 017C,E01020742,1607,330,1277
2021,County Durham 018A,E01020743,1614,420,1194
2021,County Durham 039E,E01020744,1104,202,902
2021,County Durham 032A,E01020745,1227,248,979
2021,County Durham 037A,E01020746,1050,147,903
2021,County Durham 018B,E01020747,1132,240,892
2021,County Durham 018C,E01020748,1150,294,856
2021,County Durham 018D,E01020749,1281,131,1150
2021,County Durham 016A,E01020750,1046,102,944
2021,County Durham 025A,E01020751,1574,303,1271
2021,County Durham 025B,E01020752,1046,171,875
2021,County Durham 032B,E01020753,1803,315,1488
2021,County Durham 025C,E01020754,1300,203,1097
2021,County Durham 025D,E01020756,1555,261,1294
2021,County Durham 032C,E01020757,1154,254,900
2021,County Durham 032D,E01020758,1285,289,996
2021,County Durham 032E,E01020759,1430,354,1076
2021,County Durham 034A,E01020760,1876,323,1553
2021,County Durham 034B,E01020761,1463,322,1141
2021,County Durham 034C,E01020762,1292,243,1049
2021,County Durham 034D,E01020763,1741,313,1428
2021,County Durham 036A,E01020764,1048,153,895
2021,County Durham 032F,E01020765,1525,326,1199
2021,County Durham 036B,E01020766,1292,177,1115
2021,County Durham 036C,E01020767,1544,273,1271
2021,County Durham 036D,E01020768,1393,259,1134
2021,County Durham 037B,E01020769,1117,243,874
2021,County Durham 035D,E01020770,1069,226,843
2021,County Durham 035E,E01020771,992,196,796
2021,County Durham 043A,E01020772,1942,348,1594
2021,County Durham 018E,E01020773,1428,259,1169
2021,County Durham 018F,E01020775,1533,331,1202
2021,County Durham 021C,E01020776,1656,222,1434
2021,County Durham 037C,E01020777,1414,276,1138
2021,County Durham 037D,E01020778,1138,150,988
2021,County Durham 037E,E01020779,1491,194,1297
2021,County Durham 035F,E01020780,1182,229,953
2021,County Durham 017D,E01020782,1209,156,1053
2021,County Durham 017E,E01020783,1159,205,954
2021,County Durham 017F,E01020784,1411,229,1182
2021,County Durham 016D,E01020786,1480,198,1282
2021,County Durham 016E,E01020787,1715,330,1385
2021,County Durham 040A,E01020788,1309,198,1111
2021,County Durham 040B,E01020789,1615,263,1352
2021,County Durham 040C,E01020790,1279,207,1072
2021,County Durham 040D,E01020791,1183,206,977
2021,County Durham 040E,E01020792,1401,253,1148
2021,County Durham 043B,E01020793,1531,316,1215
2021,County Durham 043C,E01020794,1830,322,1508
2021,County Durham 043D,E01020795,1684,321,1363
2021,County Durham 054A,E01020796,1225,218,1007
2021,County Durham 050A,E01020797,2315,354,1961
2021,County Durham 050B,E01020798,1428,233,1195
2021,County Durham 050C,E01020799,1380,218,1162
2021,County Durham 059A,E01020801,1394,207,1187
2021,County Durham 059B,E01020802,1745,265,1480
2021,County Durham 053D,E01020805,1828,343,1485
2021,County Durham 049A,E01020806,1340,230,1110
2021,County Durham 049B,E01020807,1122,185,937
2021,County Durham 050D,E01020808,1256,186,1070
2021,County Durham 048A,E01020809,1307,268,1039
2021,County Durham 048B,E01020810,1137,202,935
2021,County Durham 048C,E01020811,1143,209,934
2021,County Durham 048D,E01020812,1388,240,1148
2021,County Durham 060A,E01020813,1156,182,974
2021,County Durham 060B,E01020814,1259,202,1057
2021,County Durham 060C,E01020815,1205,195,1010
2021,County Durham 061A,E01020816,1224,283,941
2021,County Durham 047A,E01020817,1156,182,974
2021,County Durham 047B,E01020818,1359,233,1126
2021,County Durham 047C,E01020819,954,197,757
2021,County Durham 049C,E01020820,1804,322,1482
2021,County Durham 052A,E01020821,2047,377,1670
2021,County Durham 052B,E01020822,2015,320,1695
2021,County Durham 052C,E01020823,1699,277,1422
2021,County Durham 063A,E01020824,1391,206,1185
2021,County Durham 062A,E01020825,1639,312,1327
2021,County Durham 063B,E01020826,1444,267,1177
2021,County Durham 048E,E01020827,1697,301,1396
2021,County Durham 054B,E01020828,1549,241,1308
2021,County Durham 054C,E01020829,2221,431,1790
2021,County Durham 054D,E01020830,1773,309,1464
2021,County Durham 062B,E01020831,1278,208,1070
2021,County Durham 063C,E01020832,1372,236,1136
2021,County Durham 062C,E01020833,1156,230,926
2021,County Durham 062D,E01020834,1197,205,992
2021,County Durham 052D,E01020835,1410,225,1185
2021,County Durham 047D,E01020837,1490,156,1334
2021,County Durham 059C,E01020838,1641,309,1332
2021,County Durham 059D,E01020839,1436,237,1199
2021,County Durham 059E,E01020840,2003,402,1601
2021,County Durham 059F,E01020841,1619,333,1286
2021,County Durham 047E,E01020843,1478,213,1265
2021,County Durham 061B,E01020844,1435,337,1098
2021,County Durham 063D,E01020845,1274,272,1002
2021,County Durham 063E,E01020846,1166,203,963
2021,County Durham 061C,E01020847,1347,350,997
2021,County Durham 060D,E01020848,1106,142,964
2021,County Durham 061D,E01020849,1201,277,924
2021,County Durham 060E,E01020850,2299,446,1853
2021,County Durham 060F,E01020851,1315,168,1147
2021,County Durham 067E,E01020852,1591,282,1309
2021,County Durham 067D,E01020853,1717,283,1434
2021,County Durham 067F,E01020854,2485,327,2158
2021,County Durham 067C,E01020855,1121,149,972
2021,County Durham 064A,E01020856,1448,215,1233
2021,County Durham 067B,E01020857,1418,232,1186
2021,County Durham 064B,E01020858,999,159,840
2021,County Durham 064C,E01020859,1158,151,1007
2021,County Durham 064D,E01020860,995,177,818
2021,County Durham 064E,E01020861,1104,159,945
2021,County Durham 064F,E01020862,2271,352,1919
2021,County Durham 067G,E01020863,1281,158,1123
2021,County Durham 064G,E01020864,2015,292,1723
2021,County Durham 064H,E01020867,2091,324,1767
2021,County Durham 055A,E01020868,2010,311,1699
2021,County Durham 055B,E01020869,1279,233,1046
2021,County Durham 056A,E01020870,1277,177,1100
2021,County Durham 056B,E01020871,1303,273,1030
2021,County Durham 056C,E01020872,1669,278,1391
2021,County Durham 051A,E01020873,1285,240,1045
2021,County Durham 055C,E01020874,1518,274,1244
2021,County Durham 051B,E01020875,1308,211,1097
2021,County Durham 045A,E01020876,1626,298,1328
2021,County Durham 046A,E01020877,1454,221,1233
2021,County Durham 045B,E01020878,1671,337,1334
2021,County Durham 046B,E01020879,2075,345,1730
2021,County Durham 055D,E01020880,1488,298,1190
2021,County Durham 055E,E01020881,1412,208,1204
2021,County Durham 057A,E01020882,1399,220,1179
2021,County Durham 056D,E01020883,1530,202,1328
2021,County Durham 058A,E01020884,1232,209,1023
2021,County Durham 058B,E01020885,1119,169,950
2021,County Durham 056E,E01020886,1137,187,950
2021,County Durham 045C,E01020887,1905,340,1565
2021,County Durham 057B,E01020888,1821,293,1528
2021,County Durham 042A,E01020889,1439,181,1258
2021,County Durham 042B,E01020890,1632,220,1412
2021,County Durham 042C,E01020891,1530,194,1336
2021,County Durham 045D,E01020892,1025,156,869
2021,County Durham 046C,E01020893,1818,328,1490
2021,County Durham 045E,E01020894,1138,228,910
2021,County Durham 057C,E01020895,1409,245,1164
2021,County Durham 057D,E01020896,1287,211,1076
2021,County Durham 045F,E01020898,1406,263,1143
2021,County Durham 046D,E01020899,1273,190,1083
2021,County Durham 051C,E01020900,1601,331,1270
2021,County Durham 051D,E01020901,1335,231,1104
2021,County Durham 051E,E01020902,1341,289,1052
2021,County Durham 046E,E01020903,1057,170,887
2021,County Durham 046F,E01020904,1655,291,1364
2021,County Durham 042D,E01020905,1431,238,1193
2021,County Durham 042E,E01020906,1565,234,1331
2021,County Durham 058C,E01020907,1460,284,1176
2021,County Durham 058D,E01020908,1274,274,1000
2021,County Durham 058E,E01020909,1555,433,1122
2021,Eastbourne 010A,E01020910,1939,284,1655
2021,Eastbourne 010B,E01020911,2164,421,1743
2021,Eastbourne 010C,E01020912,2091,413,1678
2021,Eastbourne 013A,E01020913,2239,437,1802
2021,Eastbourne 007A,E01020914,1840,409,1431
2021,Eastbourne 007B,E01020915,1608,261,1347
2021,Eastbourne 010D,E01020916,1714,400,1314
2021,Eastbourne 002A,E01020917,1368,313,1055
2021,Eastbourne 002B,E01020918,1542,355,1187
2021,Eastbourne 002C,E01020919,1484,341,1143
2021,Eastbourne 004A,E01020920,1422,285,1137
2021,Eastbourne 004B,E01020921,1388,255,1133
2021,Eastbourne 004C,E01020922,1360,270,1090
2021,Eastbourne 002D,E01020923,1318,320,998
2021,Eastbourne 001A,E01020924,1307,249,1058
2021,Eastbourne 001B,E01020925,1487,333,1154
2021,Eastbourne 003A,E01020926,1417,233,1184
2021,Eastbourne 001C,E01020927,1341,273,1068
2021,Eastbourne 001D,E01020928,1552,242,1310
2021,Eastbourne 003B,E01020929,1654,359,1295
2021,Eastbourne 001E,E01020930,1315,307,1008
2021,Eastbourne 012A,E01020931,1666,360,1306
2021,Eastbourne 012B,E01020932,1284,45,1239
2021,Eastbourne 011A,E01020935,1993,267,1726
2021,Eastbourne 011B,E01020936,1583,118,1465
2021,Eastbourne 011C,E01020937,1917,468,1449
2021,Eastbourne 009A,E01020938,1526,380,1146
2021,Eastbourne 009B,E01020939,1499,319,1180
2021,Eastbourne 006A,E01020940,1550,371,1179
2021,Eastbourne 006B,E01020941,1642,439,1203
2021,Eastbourne 006C,E01020942,1482,327,1155
2021,Eastbourne 009C,E01020943,1497,273,1224
2021,Eastbourne 012E,E01020944,1448,285,1163
2021,Eastbourne 004D,E01020945,1771,240,1531
2021,Eastbourne 006D,E01020946,1646,225,1421
2021,Eastbourne 006E,E01020947,1486,283,1203
2021,Eastbourne 008A,E01020948,1381,188,1193
2021,Eastbourne 002E,E01020949,1514,261,1253
2021,Eastbourne 004E,E01020950,1495,209,1286
2021,Eastbourne 013B,E01020951,1495,307,1188
2021,Eastbourne 007C,E01020952,1782,381,1401
2021,Eastbourne 007D,E01020953,1436,315,1121
2021,Eastbourne 007E,E01020954,1676,386,1290
2021,Eastbourne 003C,E01020955,1499,323,1176
2021,Eastbourne 003D,E01020956,1537,178,1359
2021,Eastbourne 003E,E01020957,1492,310,1182
2021,Eastbourne 013C,E01020959,1433,289,1144
2021,Eastbourne 014A,E01020960,2366,352,2014
2021,Eastbourne 013D,E01020961,1416,217,1199
2021,Eastbourne 013E,E01020962,1982,279,1703
2021,Eastbourne 008B,E01020963,1888,380,1508
2021,Eastbourne 009D,E01020964,1540,205,1335
2021,Eastbourne 008C,E01020965,1726,214,1512
2021,Eastbourne 008D,E01020966,1661,169,1492
2021,Eastbourne 009E,E01020967,1818,182,1636
2021,Eastbourne 011D,E01020968,1871,248,1623
2021,Hastings 001A,E01020969,1464,271,1193
2021,Hastings 001B,E01020970,2600,449,2151
2021,Hastings 001C,E01020971,2048,423,1625
2021,Hastings 005A,E01020972,1717,447,1270
2021,Hastings 005B,E01020973,1783,386,1397
2021,Hastings 002A,E01020974,1646,280,1366
2021,Hastings 008A,E01020975,1587,245,1342
2021,Hastings 008B,E01020976,1797,276,1521
2021,Hastings 005C,E01020977,1481,280,1201
2021,Hastings 009A,E01020978,1886,305,1581
2021,Hastings 009B,E01020979,1830,224,1606
2021,Hastings 009C,E01020980,1447,233,1214
2021,Hastings 009D,E01020981,1389,227,1162
2021,Hastings 011A,E01020982,1572,203,1369
2021,Hastings 011B,E01020983,1429,200,1229
2021,Hastings 011C,E01020984,1753,252,1501
2021,Hastings 011D,E01020985,1512,172,1340
2021,Hastings 002B,E01020986,1520,253,1267
2021,Hastings 001D,E01020987,1742,348,1394
2021,Hastings 002C,E01020988,1572,185,1387
2021,Hastings 011E,E01020989,1517,203,1314
2021,Hastings 008C,E01020990,1540,306,1234
2021,Hastings 008D,E01020991,1286,157,1129
2021,Hastings 008E,E01020992,1769,337,1432
2021,Hastings 003A,E01020993,1355,311,1044
2021,Hastings 003B,E01020994,1471,388,1083
2021,Hastings 003C,E01020995,1335,291,1044
2021,Hastings 003D,E01020996,1819,410,1409
2021,Hastings 010A,E01020997,1557,276,1281
2021,Hastings 010B,E01020998,1802,208,1594
2021,Hastings 010C,E01020999,1820,246,1574
2021,Hastings 007A,E01021000,1369,240,1129
2021,Hastings 007B,E01021001,1162,213,949
2021,Hastings 007C,E01021002,1364,215,1149
2021,Hastings 007D,E01021003,1400,125,1275
2021,Hastings 004A,E01021004,1751,299,1452
2021,Hastings 004B,E01021005,1580,432,1148
2021,Hastings 004C,E01021006,1612,266,1346
2021,Hastings 002D,E01021007,1562,183,1379
2021,Hastings 002E,E01021008,1512,227,1285
2021,Hastings 002F,E01021009,1867,320,1547
2021,Hastings 006A,E01021010,1463,264,1199
2021,Hastings 006B,E01021011,1512,280,1232
2021,Hastings 006C,E01021012,1634,276,1358
2021,Hastings 004D,E01021013,1697,333,1364
2021,Hastings 007E,E01021014,1683,343,1340
2021,Hastings 005D,E01021015,1637,480,1157
2021,Hastings 010D,E01021016,1731,340,1391
2021,Hastings 010E,E01021017,1512,280,1232
2021,Hastings 010F,E01021018,1796,317,1479
2021,Hastings 003E,E01021019,1578,298,1280
2021,Hastings 006D,E01021020,1899,429,1470
2021,Hastings 006E,E01021021,1801,287,1514
2021,Lewes 001A,E01021022,2123,425,1698
2021,Lewes 002A,E01021023,2732,509,2223
2021,Lewes 001B,E01021024,1045,210,835
2021,Lewes 001C,E01021025,1773,349,1424
2021,Lewes 002B,E01021026,2491,371,2120
2021,Lewes 006A,E01021027,1436,233,1203
2021,Lewes 006B,E01021028,1447,287,1160
2021,Lewes 006C,E01021029,1500,281,1219
2021,Lewes 006D,E01021030,1211,178,1033
2021,Lewes 006E,E01021031,1480,191,1289
2021,Lewes 002C,E01021032,1855,323,1532
2021,Lewes 003A,E01021033,1730,306,1424
2021,Lewes 003B,E01021034,1181,259,922
2021,Lewes 003C,E01021035,1714,203,1511
2021,Lewes 003D,E01021036,1361,255,1106
2021,Lewes 003E,E01021037,1423,343,1080
2021,Lewes 003F,E01021038,1565,282,1283
2021,Lewes 005A,E01021039,1281,207,1074
2021,Lewes 005B,E01021040,1701,245,1456
2021,Lewes 005C,E01021041,1449,325,1124
2021,Lewes 005D,E01021042,1192,282,910
2021,Lewes 005E,E01021043,1431,360,1071
2021,Lewes 009A,E01021044,1979,541,1438
2021,Lewes 008A,E01021045,1835,312,1523
2021,Lewes 008B,E01021046,1412,235,1177
2021,Lewes 008C,E01021047,1435,210,1225
2021,Lewes 008D,E01021048,1558,288,1270
2021,Lewes 009B,E01021049,1335,286,1049
2021,Lewes 009C,E01021050,1257,263,994
2021,Lewes 009D,E01021051,1080,204,876
2021,Lewes 001D,E01021052,1174,204,970
2021,Lewes 001E,E01021053,1194,203,991
2021,Lewes 004A,E01021054,1399,231,1168
2021,Lewes 004B,E01021055,1681,321,1360
2021,Lewes 004C,E01021056,1690,251,1439
2021,Lewes 004D,E01021057,1469,271,1198
2021,Lewes 010A,E01021058,1890,334,1556
2021,Lewes 010B,E01021059,1689,218,1471
2021,Lewes 010C,E01021060,2186,404,1782
2021,Lewes 007A,E01021061,1425,217,1208
2021,Lewes 010D,E01021062,1604,320,1284
2021,Lewes 007B,E01021063,1609,268,1341
2021,Lewes 007C,E01021064,1693,237,1456
2021,Lewes 007D,E01021065,1104,144,960
2021,Lewes 007E,E01021066,1443,252,1191
2021,Lewes 002D,E01021067,1027,170,857
2021,Lewes 002E,E01021068,1137,288,849
2021,Lewes 011A,E01021069,1492,194,1298
2021,Lewes 013A,E01021070,1535,199,1336
2021,Lewes 013B,E01021071,1787,208,1579
2021,Lewes 012A,E01021072,1522,164,1358
2021,Lewes 012B,E01021073,1399,201,1198
2021,Lewes 012C,E01021074,1676,294,1382
2021,Lewes 011B,E01021075,1746,302,1444
2021,Lewes 012D,E01021076,1794,379,1415
2021,Lewes 011C,E01021077,1430,192,1238
2021,Lewes 012E,E01021078,1337,208,1129
2021,Lewes 013C,E01021079,1469,144,1325
2021,Lewes 013D,E01021080,1447,220,1227
2021,Lewes 011D,E01021081,1508,155,1353
2021,Lewes 011E,E01021082,1573,145,1428
2021,Lewes 011F,E01021083,1237,158,1079
2021,Rother 006A,E01021084,1805,383,1422
2021,Rother 006B,E01021085,1628,292,1336
2021,Rother 006C,E01021086,1734,375,1359
2021,Rother 005A,E01021087,1864,298,1566
2021,Rother 005B,E01021088,1542,176,1366
2021,Rother 005C,E01021089,1493,264,1229
2021,Rother 011A,E01021090,1575,300,1275
2021,Rother 011B,E01021091,1967,256,1711
2021,Rother 011C,E01021092,2043,249,1794
2021,Rother 009A,E01021093,1411,131,1280
2021,Rother 010A,E01021094,1454,110,1344
2021,Rother 009B,E01021095,1225,75,1150
2021,Rother 006D,E01021096,1247,208,1039
2021,Rother 006E,E01021097,1381,236,1145
2021,Rother 003A,E01021098,1693,254,1439
2021,Rother 003B,E01021099,1652,232,1420
2021,Rother 003C,E01021100,1618,276,1342
2021,Rother 004A,E01021101,1614,175,1439
2021,Rother 004B,E01021102,1429,197,1232
2021,Rother 002A,E01021103,1378,174,1204
2021,Rother 003D,E01021104,1427,209,1218
2021,Rother 003E,E01021105,1209,170,1039
2021,Rother 010B,E01021106,1678,140,1538
2021,Rother 010C,E01021107,1509,160,1349
2021,Rother 010D,E01021108,1420,227,1193
2021,Rother 005D,E01021109,1770,328,1442
2021,Rother 005E,E01021110,2257,172,2085
2021,Rother 007A,E01021111,1049,120,929
2021,Rother 008A,E01021112,1344,183,1161
2021,Rother 007B,E01021113,1611,294,1317
2021,Rother 002B,E01021114,1688,257,1431
2021,Rother 002C,E01021115,1556,175,1381
2021,Rother 002D,E01021116,1517,231,1286
2021,Rother 004C,E01021117,1503,188,1315
2021,Rother 004D,E01021118,1731,228,1503
2021,Rother 004E,E01021119,1060,235,825
2021,Rother 008B,E01021120,1497,176,1321
2021,Rother 011D,E01021121,1520,163,1357
2021,Rother 011E,E01021122,1466,133,1333
2021,Rother 009C,E01021123,1493,173,1320
2021,Rother 009D,E01021124,2058,217,1841
2021,Rother 009E,E01021125,1252,111,1141
2021,Rother 008C,E01021126,1494,206,1288
2021,Rother 008D,E01021127,1526,255,1271
2021,Rother 008E,E01021128,1846,230,1616
2021,Rother 009F,E01021129,1683,188,1495
2021,Rother 010E,E01021130,1443,188,1255
2021,Rother 007C,E01021131,1453,326,1127
2021,Rother 001A,E01021132,1419,258,1161
2021,Rother 001B,E01021133,1527,269,1258
2021,Rother 001C,E01021134,1416,255,1161
2021,Rother 007D,E01021135,1814,435,1379
2021,Rother 007E,E01021136,1268,310,958
2021,Rother 007F,E01021137,1563,319,1244
2021,Rother 009G,E01021138,1116,126,990
2021,Rother 001D,E01021139,1328,281,1047
2021,Rother 001E,E01021140,1670,255,1415
2021,Rother 001F,E01021141,1445,260,1185
2021,Wealden 018A,E01021142,1112,82,1030
2021,Wealden 018B,E01021143,1138,145,993
2021,Wealden 008A,E01021144,1662,278,1384
2021,Wealden 008B,E01021145,2142,369,1773
2021,Wealden 013A,E01021146,2153,362,1791
2021,Wealden 013B,E01021147,1608,231,1377
2021,Wealden 013C,E01021148,1442,262,1180
2021,Wealden 011A,E01021149,1352,203,1149
2021,Wealden 010A,E01021150,1369,233,1136
2021,Wealden 006A,E01021151,1784,316,1468
2021,Wealden 006B,E01021152,1736,296,1440
2021,Wealden 006C,E01021153,1876,316,1560
2021,Wealden 006D,E01021154,1377,252,1125
2021,Wealden 006E,E01021155,1152,202,950
2021,Wealden 003A,E01021156,1836,317,1519
2021,Wealden 003B,E01021157,1725,284,1441
2021,Wealden 003C,E01021158,2190,473,1717
2021,Wealden 004A,E01021159,2280,303,1977
2021,Wealden 004B,E01021160,1626,197,1429
2021,Wealden 004C,E01021161,1558,276,1282
2021,Wealden 004D,E01021162,1565,241,1324
2021,Wealden 007A,E01021163,2046,307,1739
2021,Wealden 007B,E01021164,1758,309,1449
2021,Wealden 013D,E01021165,1246,226,1020
2021,Wealden 018C,E01021166,2170,231,1939
2021,Wealden 001A,E01021167,2182,398,1784
2021,Wealden 001B,E01021168,1581,318,1263
2021,Wealden 001C,E01021169,1195,196,999
2021,Wealden 008C,E01021170,2680,424,2256
2021,Wealden 002A,E01021171,1934,353,1581
2021,Wealden 002B,E01021172,1662,318,1344
2021,Wealden 002C,E01021173,1418,233,1185
2021,Wealden 015A,E01021174,1972,366,1606
2021,Wealden 015B,E01021175,1376,226,1150
2021,Wealden 015C,E01021176,1467,184,1283
2021,Wealden 015D,E01021177,1390,173,1217
2021,Wealden 017A,E01021178,1523,291,1232
2021,Wealden 017B,E01021179,1570,325,1245
2021,Wealden 016A,E01021180,1397,174,1223
2021,Wealden 016B,E01021181,1375,249,1126
2021,Wealden 016C,E01021182,1506,221,1285
2021,Wealden 016D,E01021183,1206,239,967
2021,Wealden 017C,E01021184,1490,184,1306
2021,Wealden 017D,E01021185,1379,273,1106
2021,Wealden 001D,E01021186,1200,219,981
2021,Wealden 007C,E01021187,1354,183,1171
2021,Wealden 014A,E01021188,1094,159,935
2021,Wealden 011B,E01021189,1295,195,1100
2021,Wealden 011C,E01021190,1402,191,1211
2021,Wealden 010B,E01021191,1570,172,1398
2021,Wealden 010C,E01021192,1451,230,1221
2021,Wealden 010D,E01021193,1690,291,1399
2021,Wealden 010E,E01021194,1610,300,1310
2021,Wealden 018E,E01021196,1962,344,1618
2021,Wealden 014B,E01021198,1518,259,1259
2021,Wealden 014C,E01021199,1274,152,1122
2021,Wealden 011D,E01021200,1336,216,1120
2021,Wealden 011E,E01021201,1634,284,1350
2021,Wealden 005A,E01021202,1189,261,928
2021,Wealden 005B,E01021203,1518,286,1232
2021,Wealden 014D,E01021204,1158,217,941
2021,Wealden 014E,E01021205,1187,171,1016
2021,Wealden 020A,E01021206,1474,167,1307
2021,Wealden 020B,E01021207,1352,164,1188
2021,Wealden 020C,E01021208,2462,513,1949
2021,Wealden 020D,E01021209,2250,369,1881
2021,Wealden 020E,E01021210,1554,328,1226
2021,Wealden 020F,E01021211,1469,132,1337
2021,Wealden 019B,E01021213,1735,279,1456
2021,Wealden 019C,E01021214,1690,234,1456
2021,Wealden 019D,E01021215,1293,173,1120
2021,Wealden 019E,E01021216,1073,149,924
2021,Wealden 008D,E01021217,1235,171,1064
2021,Wealden 002D,E01021218,1135,187,948
2021,Wealden 009A,E01021219,1266,224,1042
2021,Wealden 009B,E01021220,1558,217,1341
2021,Wealden 012A,E01021221,1239,230,1009
2021,Wealden 012B,E01021222,1417,229,1188
2021,Wealden 009C,E01021223,1048,172,876
2021,Wealden 009D,E01021224,1453,302,1151
2021,Wealden 009E,E01021225,1532,282,1250
2021,Wealden 009F,E01021226,1252,255,997
2021,Wealden 012C,E01021227,1915,365,1550
2021,Wealden 012D,E01021228,1613,298,1315
2021,Wealden 005C,E01021229,1769,301,1468
2021,Wealden 005D,E01021230,1669,276,1393
2021,Wealden 005E,E01021231,1660,279,1381
2021,Wealden 021A,E01021232,1625,214,1411
2021,Wealden 021B,E01021233,1444,224,1220
2021,Wealden 021C,E01021234,1399,172,1227
2021,Wealden 021D,E01021235,1290,116,1174
2021,Wealden 021E,E01021236,1519,206,1313
2021,Basildon 001A,E01021237,1314,287,1027
2021,Basildon 001B,E01021238,1288,269,1019
2021,Basildon 003A,E01021239,1384,294,1090
2021,Basildon 003B,E01021240,1668,257,1411
2021,Basildon 003C,E01021241,1596,308,1288
2021,Basildon 001C,E01021242,1174,223,951
2021,Basildon 003D,E01021243,1567,268,1299
2021,Basildon 004A,E01021244,1477,251,1226
2021,Basildon 002A,E01021245,1363,271,1092
2021,Basildon 002B,E01021246,1358,216,1142
2021,Basildon 003E,E01021247,1427,246,1181
2021,Basildon 002C,E01021248,1424,280,1144
2021,Basildon 002D,E01021249,1458,255,1203
2021,Basildon 001D,E01021250,1453,256,1197
2021,Basildon 001E,E01021251,1504,292,1212
2021,Basildon 002E,E01021252,1304,212,1092
2021,Basildon 004B,E01021253,1677,305,1372
2021,Basildon 009A,E01021254,1442,236,1206
2021,Basildon 004C,E01021255,1460,266,1194
2021,Basildon 004D,E01021256,1410,208,1202
2021,Basildon 009B,E01021257,1480,265,1215
2021,Basildon 004E,E01021258,1609,281,1328
2021,Basildon 009C,E01021259,1461,285,1176
2021,Basildon 009D,E01021260,1758,273,1485
2021,Basildon 010A,E01021261,1615,272,1343
2021,Basildon 010B,E01021262,1481,240,1241
2021,Basildon 010C,E01021263,1761,284,1477
2021,Basildon 006A,E01021264,1423,240,1183
2021,Basildon 012A,E01021265,1665,364,1301
2021,Basildon 015A,E01021266,1661,363,1298
2021,Basildon 012B,E01021267,1847,358,1489
2021,Basildon 015B,E01021268,1567,324,1243
2021,Basildon 012C,E01021269,1962,427,1535
2021,Basildon 012D,E01021270,2031,491,1540
2021,Basildon 013A,E01021271,1706,522,1184
2021,Basildon 012E,E01021272,1531,328,1203
2021,Basildon 014A,E01021273,1781,377,1404
2021,Basildon 010D,E01021274,1803,333,1470
2021,Basildon 014B,E01021275,1578,219,1359
2021,Basildon 014C,E01021276,1433,258,1175
2021,Basildon 014D,E01021277,1343,234,1109
2021,Basildon 010E,E01021279,1539,327,1212
2021,Basildon 021A,E01021280,1379,272,1107
2021,Basildon 021B,E01021281,1391,209,1182
2021,Basildon 021C,E01021282,1475,224,1251
2021,Basildon 021D,E01021283,1476,303,1173
2021,Basildon 021E,E01021284,1440,258,1182
2021,Basildon 021F,E01021285,1323,247,1076
2021,Basildon 016A,E01021286,1851,500,1351
2021,Basildon 017A,E01021287,1491,289,1202
2021,Basildon 016B,E01021288,1632,557,1075
2021,Basildon 016C,E01021289,1800,424,1376
2021,Basildon 016D,E01021290,1740,448,1292
2021,Basildon 016E,E01021291,1980,421,1559
2021,Basildon 017B,E01021292,1607,366,1241
2021,Basildon 017C,E01021293,1719,389,1330
2021,Basildon 020A,E01021294,1645,306,1339
2021,Basildon 020B,E01021295,1570,317,1253
2021,Basildon 020D,E01021297,2044,379,1665
2021,Basildon 017D,E01021298,1477,280,1197
2021,Basildon 020E,E01021299,1479,217,1262
2021,Basildon 022A,E01021300,1968,406,1562
2021,Basildon 011A,E01021301,1433,348,1085
2021,Basildon 013B,E01021302,1544,409,1135
2021,Basildon 011B,E01021303,1308,227,1081
2021,Basildon 013C,E01021304,1349,246,1103
2021,Basildon 013D,E01021305,1350,269,1081
2021,Basildon 013E,E01021306,1397,326,1071
2021,Basildon 011C,E01021307,1297,229,1068
2021,Basildon 011D,E01021308,1152,209,943
2021,Basildon 011E,E01021309,1272,223,1049
2021,Basildon 022B,E01021310,1252,154,1098
2021,Basildon 022C,E01021311,1327,233,1094
2021,Basildon 011F,E01021312,1568,230,1338
2021,Basildon 018A,E01021313,1399,188,1211
2021,Basildon 018B,E01021314,1342,302,1040
2021,Basildon 018C,E01021315,1443,288,1155
2021,Basildon 018D,E01021316,1618,278,1340
2021,Basildon 018E,E01021317,1533,360,1173
2021,Basildon 015C,E01021318,2373,461,1912
2021,Basildon 017E,E01021319,2217,491,1726
2021,Basildon 015D,E01021320,1617,356,1261
2021,Basildon 015E,E01021321,1583,323,1260
2021,Basildon 019A,E01021322,1527,354,1173
2021,Basildon 019B,E01021323,1672,462,1210
2021,Basildon 019C,E01021324,1672,416,1256
2021,Basildon 019D,E01021325,1511,448,1063
2021,Basildon 022D,E01021326,1744,420,1324
2021,Basildon 019E,E01021327,1625,322,1303
2021,Basildon 022E,E01021328,1469,316,1153
2021,Basildon 006B,E01021329,1437,244,1193
2021,Basildon 006C,E01021330,1530,245,1285
2021,Basildon 008A,E01021331,1745,283,1462
2021,Basildon 006D,E01021332,1363,195,1168
2021,Basildon 006E,E01021333,1496,216,1280
2021,Basildon 005A,E01021334,1645,220,1425
2021,Basildon 007A,E01021335,1316,244,1072
2021,Basildon 005B,E01021336,1624,239,1385
2021,Basildon 007B,E01021337,1430,223,1207
2021,Basildon 005C,E01021338,1974,404,1570
2021,Basildon 005D,E01021339,1367,206,1161
2021,Basildon 007C,E01021340,1702,304,1398
2021,Basildon 007D,E01021341,1600,280,1320
2021,Basildon 008B,E01021342,1565,316,1249
2021,Basildon 008C,E01021343,1634,326,1308
2021,Basildon 008D,E01021344,2104,419,1685
2021,Basildon 007E,E01021345,1931,463,1468
2021,Basildon 008E,E01021346,1997,343,1654
2021,Braintree 013A,E01021347,2558,556,2002
2021,Braintree 018A,E01021348,1522,264,1258
2021,Braintree 007A,E01021349,1321,290,1031
2021,Braintree 009A,E01021350,1740,273,1467
2021,Braintree 007B,E01021351,1517,343,1174
2021,Braintree 007C,E01021352,1471,273,1198
2021,Braintree 009B,E01021353,1650,294,1356
2021,Braintree 008A,E01021354,1157,235,922
2021,Braintree 007D,E01021355,1954,279,1675
2021,Braintree 007E,E01021356,1440,246,1194
2021,Braintree 008B,E01021357,1463,199,1264
2021,Braintree 008C,E01021358,2362,555,1807
2021,Braintree 008D,E01021359,1967,379,1588
2021,Braintree 012A,E01021360,1759,333,1426
2021,Braintree 012B,E01021361,1651,284,1367
2021,Braintree 015A,E01021362,2124,373,1751
2021,Braintree 010A,E01021364,1593,293,1300
2021,Braintree 009D,E01021365,2308,317,1991
2021,Braintree 010B,E01021366,1559,266,1293
2021,Braintree 012C,E01021367,1397,287,1110
2021,Braintree 011A,E01021368,1464,237,1227
2021,Braintree 012D,E01021369,2643,655,1988
2021,Braintree 011B,E01021370,1619,344,1275
2021,Braintree 013B,E01021371,1610,267,1343
2021,Braintree 011C,E01021372,1978,363,1615
2021,Braintree 011E,E01021374,1434,267,1167
2021,Braintree 001A,E01021375,1045,178,867
2021,Braintree 001B,E01021376,1361,220,1141
2021,Braintree 014A,E01021377,1717,305,1412
2021,Braintree 014B,E01021378,1497,233,1264
2021,Braintree 014C,E01021379,1722,291,1431
2021,Braintree 012E,E01021380,2507,343,2164
2021,Braintree 007F,E01021381,1180,160,1020
2021,Braintree 003A,E01021382,1828,266,1562
2021,Braintree 010C,E01021383,2139,493,1646
2021,Braintree 013C,E01021384,2174,496,1678
2021,Braintree 013D,E01021385,1207,266,941
2021,Braintree 013E,E01021386,1536,346,1190
2021,Braintree 004A,E01021387,2009,296,1713
2021,Braintree 004B,E01021388,1668,320,1348
2021,Braintree 006A,E01021389,2063,343,1720
2021,Braintree 006B,E01021390,1755,298,1457
2021,Braintree 004C,E01021391,1559,358,1201
2021,Braintree 004D,E01021392,1649,255,1394
2021,Braintree 004E,E01021393,1494,287,1207
2021,Braintree 018B,E01021394,1364,180,1184
2021,Braintree 018C,E01021395,1418,234,1184
2021,Braintree 018D,E01021396,1324,182,1142
2021,Braintree 003B,E01021397,2274,368,1906
2021,Braintree 002A,E01021398,1415,197,1218
2021,Braintree 003C,E01021399,1605,309,1296
2021,Braintree 003D,E01021400,1665,274,1391
2021,Braintree 014D,E01021401,1525,269,1256
2021,Braintree 014E,E01021402,1940,352,1588
2021,Braintree 014F,E01021403,1522,277,1245
2021,Braintree 005A,E01021404,2112,288,1824
2021,Braintree 010D,E01021405,2238,383,1855
2021,Braintree 002B,E01021406,2199,268,1931
2021,Braintree 002C,E01021407,2127,346,1781
2021,Braintree 006C,E01021408,1728,263,1465
2021,Braintree 006D,E01021409,1740,318,1422
2021,Braintree 006E,E01021410,1746,335,1411
2021,Braintree 005B,E01021411,1299,187,1112
2021,Braintree 005C,E01021412,1370,201,1169
2021,Braintree 005D,E01021413,1238,181,1057
2021,Braintree 001C,E01021414,2140,334,1806
2021,Braintree 017A,E01021415,1508,171,1337
2021,Braintree 017B,E01021416,1848,210,1638
2021,Braintree 015B,E01021417,1447,241,1206
2021,Braintree 015C,E01021418,1420,353,1067
2021,Braintree 015D,E01021419,1632,285,1347
2021,Braintree 017C,E01021420,1626,269,1357
2021,Braintree 017E,E01021422,1651,256,1395
2021,Braintree 016A,E01021423,1488,338,1150
2021,Braintree 018E,E01021424,2103,424,1679
2021,Braintree 016B,E01021425,1388,293,1095
2021,Braintree 015E,E01021426,1176,193,983
2021,Braintree 016C,E01021427,1264,256,1008
2021,Braintree 015F,E01021428,1351,155,1196
2021,Braintree 016D,E01021429,1236,268,968
2021,Braintree 001D,E01021430,2202,400,1802
2021,Brentwood 004A,E01021431,1541,308,1233
2021,Brentwood 004B,E01021432,1732,390,1342
2021,Brentwood 007A,E01021433,2047,311,1736
2021,Brentwood 004C,E01021434,1543,322,1221
2021,Brentwood 008A,E01021435,1777,356,1421
2021,Brentwood 008B,E01021437,1656,348,1308
2021,Brentwood 006A,E01021438,2082,403,1679
2021,Brentwood 001A,E01021441,1404,245,1159
2021,Brentwood 001B,E01021442,1232,204,1028
2021,Brentwood 001C,E01021443,1496,244,1252
2021,Brentwood 001D,E01021444,1623,298,1325
2021,Brentwood 009A,E01021445,2066,334,1732
2021,Brentwood 009B,E01021446,1545,230,1315
2021,Brentwood 005A,E01021447,2405,479,1926
2021,Brentwood 003A,E01021448,1448,282,1166
2021,Brentwood 003B,E01021449,1578,275,1303
2021,Brentwood 003C,E01021450,1891,351,1540
2021,Brentwood 003D,E01021451,1443,348,1095
2021,Brentwood 003E,E01021452,1391,238,1153
2021,Brentwood 005B,E01021453,1185,197,988
2021,Brentwood 009C,E01021454,1105,181,924
2021,Brentwood 005C,E01021455,1326,270,1056
2021,Brentwood 009D,E01021456,1163,235,928
2021,Brentwood 002A,E01021457,1441,245,1196
2021,Brentwood 002B,E01021458,1643,227,1416
2021,Brentwood 002C,E01021459,1229,196,1033
2021,Brentwood 002D,E01021460,1732,321,1411
2021,Brentwood 004D,E01021461,1379,260,1119
2021,Brentwood 006B,E01021462,1354,231,1123
2021,Brentwood 006C,E01021463,1521,280,1241
2021,Brentwood 004E,E01021464,1493,273,1220
2021,Brentwood 005D,E01021465,1820,336,1484
2021,Brentwood 005E,E01021466,1668,346,1322
2021,Brentwood 005F,E01021467,1691,319,1372
2021,Brentwood 006D,E01021468,1890,345,1545
2021,Brentwood 001E,E01021469,1118,168,950
2021,Brentwood 001F,E01021470,1019,167,852
2021,Brentwood 001G,E01021471,1553,253,1300
2021,Brentwood 008C,E01021472,1679,208,1471
2021,Brentwood 008D,E01021473,1440,243,1197
2021,Brentwood 008E,E01021474,1457,281,1176
2021,Brentwood 007E,E01021475,1453,257,1196
2021,Castle Point 003A,E01021476,1879,356,1523
2021,Castle Point 003B,E01021477,1462,230,1232
2021,Castle Point 003C,E01021478,1709,323,1386
2021,Castle Point 004A,E01021479,1460,261,1199
2021,Castle Point 007A,E01021480,1670,280,1390
2021,Castle Point 004B,E01021481,1551,287,1264
2021,Castle Point 006A,E01021482,1489,243,1246
2021,Castle Point 004C,E01021483,1728,301,1427
2021,Castle Point 011A,E01021484,1293,176,1117
2021,Castle Point 010A,E01021485,1173,214,959
2021,Castle Point 010B,E01021486,1232,320,912
2021,Castle Point 008A,E01021487,1271,161,1110
2021,Castle Point 010C,E01021488,1433,225,1208
2021,Castle Point 012A,E01021489,1333,200,1133
2021,Castle Point 012B,E01021490,1353,227,1126
2021,Castle Point 012C,E01021491,1586,216,1370
2021,Castle Point 009A,E01021492,1557,241,1316
2021,Castle Point 009B,E01021493,1452,175,1277
2021,Castle Point 008B,E01021494,1345,233,1112
2021,Castle Point 009C,E01021495,2004,131,1873
2021,Castle Point 009D,E01021496,1387,235,1152
2021,Castle Point 012D,E01021497,1457,213,1244
2021,Castle Point 011B,E01021498,1555,255,1300
2021,Castle Point 011C,E01021499,1521,200,1321
2021,Castle Point 012E,E01021500,2259,302,1957
2021,Castle Point 011D,E01021501,1335,171,1164
2021,Castle Point 011E,E01021502,1931,336,1595
2021,Castle Point 010D,E01021503,1376,270,1106
2021,Castle Point 008C,E01021504,1391,355,1036
2021,Castle Point 008D,E01021505,1366,303,1063
2021,Castle Point 008E,E01021506,1194,250,944
2021,Castle Point 010E,E01021507,1412,322,1090
2021,Castle Point 010F,E01021508,1247,289,958
2021,Castle Point 002A,E01021509,1363,175,1188
2021,Castle Point 002B,E01021510,1403,206,1197
2021,Castle Point 002C,E01021511,1880,374,1506
2021,Castle Point 004D,E01021512,1450,213,1237
2021,Castle Point 001A,E01021513,1536,256,1280
2021,Castle Point 001B,E01021514,1449,270,1179
2021,Castle Point 001C,E01021515,1257,233,1024
2021,Castle Point 003D,E01021516,1273,192,1081
2021,Castle Point 005A,E01021517,1591,231,1360
2021,Castle Point 006B,E01021518,1998,318,1680
2021,Castle Point 005B,E01021519,1466,208,1258
2021,Castle Point 006C,E01021520,1457,209,1248
2021,Castle Point 007B,E01021521,1342,185,1157
2021,Castle Point 007C,E01021522,1770,313,1457
2021,Castle Point 007D,E01021523,1339,186,1153
2021,Castle Point 007E,E01021524,1545,243,1302
2021,Castle Point 001D,E01021525,1547,281,1266
2021,Castle Point 004E,E01021526,1519,245,1274
2021,Castle Point 001E,E01021527,1613,291,1322
2021,Castle Point 002D,E01021528,1496,207,1289
2021,Castle Point 006D,E01021529,1426,297,1129
2021,Castle Point 005C,E01021530,1371,200,1171
2021,Castle Point 002E,E01021531,1434,241,1193
2021,Castle Point 005D,E01021532,1344,144,1200
2021,Chelmsford 016A,E01021533,2190,366,1824
2021,Chelmsford 016B,E01021535,1683,294,1389
2021,Chelmsford 005A,E01021536,1521,263,1258
2021,Chelmsford 005B,E01021537,2234,541,1693
2021,Chelmsford 001A,E01021538,2776,611,2165
2021,Chelmsford 001B,E01021539,1338,261,1077
2021,Chelmsford 001C,E01021540,2024,403,1621
2021,Chelmsford 002A,E01021542,2260,457,1803
2021,Chelmsford 002B,E01021543,1646,270,1376
2021,Chelmsford 008A,E01021544,1205,164,1041
2021,Chelmsford 008B,E01021545,1465,309,1156
2021,Chelmsford 008C,E01021546,1357,241,1116
2021,Chelmsford 008D,E01021547,1394,191,1203
2021,Chelmsford 013A,E01021548,1173,173,1000
2021,Chelmsford 003A,E01021550,1700,326,1374
2021,Chelmsford 011A,E01021551,1336,198,1138
2021,Chelmsford 017A,E01021552,1464,242,1222
2021,Chelmsford 017B,E01021553,1256,201,1055
2021,Chelmsford 017C,E01021554,1311,242,1069
2021,Chelmsford 017D,E01021555,1297,235,1062
2021,Chelmsford 012A,E01021556,2020,370,1650
2021,Chelmsford 015A,E01021557,1202,229,973
2021,Chelmsford 015B,E01021558,1125,191,934
2021,Chelmsford 017E,E01021559,1335,232,1103
2021,Chelmsford 013B,E01021560,1640,265,1375
2021,Chelmsford 013C,E01021561,1757,322,1435
2021,Chelmsford 014A,E01021562,1630,264,1366
2021,Chelmsford 014B,E01021563,1621,299,1322
2021,Chelmsford 013D,E01021564,1440,238,1202
2021,Chelmsford 014C,E01021565,1548,358,1190
2021,Chelmsford 014D,E01021566,1587,300,1287
2021,Chelmsford 005D,E01021568,1544,249,1295
2021,Chelmsford 016C,E01021569,1676,335,1341
2021,Chelmsford 016D,E01021570,1871,295,1576
2021,Chelmsford 013E,E01021571,1474,254,1220
2021,Chelmsford 016E,E01021572,1429,300,1129
2021,Chelmsford 009A,E01021573,1665,342,1323
2021,Chelmsford 009B,E01021575,1605,254,1351
2021,Chelmsford 006A,E01021576,1598,429,1169
2021,Chelmsford 012B,E01021577,1451,296,1155
2021,Chelmsford 023D,E01021578,1695,252,1443
2021,Chelmsford 012C,E01021579,1688,326,1362
2021,Chelmsford 012D,E01021580,1413,357,1056
2021,Chelmsford 023C,E01021582,1960,261,1699
2021,Chelmsford 015C,E01021583,1501,313,1188
2021,Chelmsford 012E,E01021584,1213,249,964
2021,Chelmsford 015D,E01021585,1208,220,988
2021,Chelmsford 015E,E01021586,1457,286,1171
2021,Chelmsford 002C,E01021587,1408,226,1182
2021,Chelmsford 006B,E01021588,1304,254,1050
2021,Chelmsford 006C,E01021589,1478,300,1178
2021,Chelmsford 002D,E01021590,1342,260,1082
2021,Chelmsford 002E,E01021591,1534,302,1232
2021,Chelmsford 006D,E01021592,1559,340,1219
2021,Chelmsford 021A,E01021593,1549,218,1331
2021,Chelmsford 021C,E01021595,1760,234,1526
2021,Chelmsford 006E,E01021596,1513,356,1157
2021,Chelmsford 003B,E01021597,1450,345,1105
2021,Chelmsford 003C,E01021598,1504,344,1160
2021,Chelmsford 009C,E01021599,1749,331,1418
2021,Chelmsford 003D,E01021600,1079,201,878
2021,Chelmsford 003E,E01021601,1434,296,1138
2021,Chelmsford 018B,E01021602,1656,249,1407
2021,Chelmsford 018D,E01021604,2228,408,1820
2021,Chelmsford 020A,E01021605,1123,194,929
2021,Chelmsford 020B,E01021606,1533,290,1243
2021,Chelmsford 020C,E01021607,1377,235,1142
2021,Chelmsford 020D,E01021608,1061,157,904
2021,Chelmsford 020E,E01021609,1292,224,1068
2021,Chelmsford 020F,E01021610,1170,190,980
2021,Chelmsford 019A,E01021611,1327,258,1069
2021,Chelmsford 019B,E01021612,1386,217,1169
2021,Chelmsford 019C,E01021613,1748,307,1441
2021,Chelmsford 019D,E01021614,1692,346,1346
2021,Chelmsford 019E,E01021615,1437,270,1167
2021,Chelmsford 004B,E01021617,1243,208,1035
2021,Chelmsford 007A,E01021618,1372,230,1142
2021,Chelmsford 004C,E01021619,1362,242,1120
2021,Chelmsford 004D,E01021620,1373,239,1134
2021,Chelmsford 007B,E01021621,1457,323,1134
2021,Chelmsford 007C,E01021622,1460,273,1187
2021,Chelmsford 004E,E01021623,1157,235,922
2021,Chelmsford 004F,E01021624,1181,202,979
2021,Chelmsford 007D,E01021625,1394,266,1128
2021,Chelmsford 007E,E01021626,1412,287,1125
2021,Chelmsford 022B,E01021627,1535,197,1338
2021,Chelmsford 008E,E01021628,1738,376,1362
2021,Chelmsford 008F,E01021629,1695,386,1309
2021,Chelmsford 009E,E01021631,1807,440,1367
2021,Chelmsford 011B,E01021632,1479,230,1249
2021,Chelmsford 011C,E01021633,1292,370,922
2021,Chelmsford 011D,E01021634,1399,248,1151
2021,Chelmsford 011E,E01021635,1323,182,1141
2021,Chelmsford 011F,E01021636,1092,194,898
2021,Colchester 018A,E01021637,1136,214,922
2021,Colchester 018B,E01021638,1865,457,1408
2021,Colchester 018C,E01021639,2143,500,1643
2021,Colchester 018D,E01021640,1139,220,919
2021,Colchester 018E,E01021641,1433,294,1139
2021,Colchester 018F,E01021642,2058,452,1606
2021,Colchester 019A,E01021643,2350,430,1920
2021,Colchester 019B,E01021644,1663,283,1380
2021,Colchester 019C,E01021645,1414,263,1151
2021,Colchester 007A,E01021646,2013,319,1694
2021,Colchester 007B,E01021647,2183,446,1737
2021,Colchester 007C,E01021648,2243,426,1817
2021,Colchester 007E,E01021650,2035,349,1686
2021,Colchester 013A,E01021651,2270,465,1805
2021,Colchester 013B,E01021652,1504,351,1153
2021,Colchester 013C,E01021653,1253,322,931
2021,Colchester 001A,E01021655,1330,239,1091
2021,Colchester 001B,E01021656,1572,262,1310
2021,Colchester 016A,E01021657,1997,349,1648
2021,Colchester 016B,E01021658,1025,199,826
2021,Colchester 001C,E01021659,2023,357,1666
2021,Colchester 003A,E01021660,1441,252,1189
2021,Colchester 001D,E01021661,1888,383,1505
2021,Colchester 010B,E01021662,1472,236,1236
2021,Colchester 010C,E01021663,1086,177,909
2021,Colchester 016C,E01021664,1863,473,1390
2021,Colchester 016D,E01021665,1341,283,1058
2021,Colchester 016E,E01021666,1238,215,1023
2021,Colchester 016F,E01021667,1418,278,1140
2021,Colchester 002A,E01021668,1481,271,1210
2021,Colchester 002B,E01021669,1357,258,1099
2021,Colchester 002C,E01021670,1359,304,1055
2021,Colchester 002D,E01021671,1388,252,1136
2021,Colchester 009A,E01021673,1401,239,1162
2021,Colchester 009B,E01021674,1313,296,1017
2021,Colchester 009C,E01021675,1273,260,1013
2021,Colchester 009D,E01021676,1579,324,1255
2021,Colchester 010D,E01021677,1159,194,965
2021,Colchester 010E,E01021678,1356,233,1123
2021,Colchester 011A,E01021683,2025,399,1626
2021,Colchester 011B,E01021684,1430,261,1169
2021,Colchester 011E,E01021687,1692,365,1327
2021,Colchester 011F,E01021688,1657,383,1274
2021,Colchester 014A,E01021689,1448,295,1153
2021,Colchester 014B,E01021690,1242,244,998
2021,Colchester 014C,E01021691,1477,266,1211
2021,Colchester 014D,E01021692,1374,238,1136
2021,Colchester 014E,E01021693,1657,282,1375
2021,Colchester 019D,E01021694,1417,216,1201
2021,Colchester 019E,E01021695,1130,163,967
2021,Colchester 008A,E01021696,1447,431,1016
2021,Colchester 008B,E01021697,1614,405,1209
2021,Colchester 008C,E01021698,1496,763,733
2021,Colchester 008D,E01021699,1390,456,934
2021,Colchester 008E,E01021700,1303,481,822
2021,Colchester 022D,E01021702,1250,204,1046
2021,Colchester 022E,E01021703,1239,341,898
2021,Colchester 022F,E01021704,1427,274,1153
2021,Colchester 022G,E01021705,1870,370,1500
2021,Colchester 022H,E01021706,1291,284,1007
2021,Colchester 022I,E01021707,1310,212,1098
2021,Colchester 022A,E01021708,1378,190,1188
2021,Colchester 022B,E01021709,1442,209,1233
2021,Colchester 022C,E01021710,2180,382,1798
2021,Colchester 015A,E01021711,1312,280,1032
2021,Colchester 015C,E01021713,1235,306,929
2021,Colchester 015D,E01021714,1731,375,1356
2021,Colchester 015E,E01021715,1427,298,1129
2021,Colchester 013D,E01021717,2555,595,1960
2021,Colchester 012A,E01021718,1740,347,1393
2021,Colchester 012B,E01021719,1536,241,1295
2021,Colchester 012C,E01021720,1543,246,1297
2021,Colchester 012D,E01021721,1879,389,1490
2021,Colchester 012E,E01021722,2372,532,1840
2021,Colchester 020A,E01021723,1800,269,1531
2021,Colchester 020B,E01021724,1605,251,1354
2021,Colchester 020C,E01021725,1405,208,1197
2021,Colchester 020D,E01021726,1441,277,1164
2021,Colchester 020E,E01021727,1458,194,1264
2021,Colchester 003B,E01021728,1606,283,1323
2021,Colchester 003C,E01021729,1569,313,1256
2021,Colchester 003D,E01021730,1679,279,1400
2021,Colchester 021A,E01021731,1379,162,1217
2021,Colchester 021B,E01021732,1462,229,1233
2021,Colchester 021C,E01021733,1507,202,1305
2021,Colchester 021D,E01021734,1326,167,1159
2021,Colchester 021E,E01021735,1327,157,1170
2021,Colchester 017A,E01021736,2335,1594,741
2021,Colchester 017B,E01021737,1089,192,897
2021,Colchester 017C,E01021738,2103,379,1724
2021,Colchester 017D,E01021739,1464,260,1204
2021,Colchester 017E,E01021740,1628,308,1320
2021,Epping Forest 002A,E01021741,2181,342,1839
2021,Epping Forest 015A,E01021742,1252,282,970
2021,Epping Forest 015B,E01021743,1598,224,1374
2021,Epping Forest 015C,E01021744,1555,280,1275
2021,Epping Forest 015D,E01021745,1567,304,1263
2021,Epping Forest 015E,E01021746,1812,328,1484
2021,Epping Forest 015F,E01021747,1579,280,1299
2021,Epping Forest 015G,E01021748,1654,313,1341
2021,Epping Forest 016A,E01021749,2223,375,1848
2021,Epping Forest 016B,E01021750,1605,328,1277
2021,Epping Forest 016C,E01021751,1347,289,1058
2021,Epping Forest 016D,E01021752,1431,255,1176
2021,Epping Forest 004A,E01021753,1519,267,1252
2021,Epping Forest 004B,E01021754,1473,241,1232
2021,Epping Forest 004C,E01021755,1149,187,962
2021,Epping Forest 006A,E01021756,1482,239,1243
2021,Epping Forest 006B,E01021757,1646,185,1461
2021,Epping Forest 006C,E01021758,1443,235,1208
2021,Epping Forest 006D,E01021759,1480,296,1184
2021,Epping Forest 005A,E01021760,1442,250,1192
2021,Epping Forest 005B,E01021761,1974,371,1603
2021,Epping Forest 005C,E01021762,1408,252,1156
2021,Epping Forest 005D,E01021763,1878,371,1507
2021,Epping Forest 017A,E01021764,1712,434,1278
2021,Epping Forest 017B,E01021765,1901,395,1506
2021,Epping Forest 017C,E01021766,1601,364,1237
2021,Epping Forest 017D,E01021767,1845,330,1515
2021,Epping Forest 001A,E01021768,2231,389,1842
2021,Epping Forest 003A,E01021769,2341,397,1944
2021,Epping Forest 010A,E01021770,1939,308,1631
2021,Epping Forest 013A,E01021771,1593,360,1233
2021,Epping Forest 013B,E01021772,1446,274,1172
2021,Epping Forest 013C,E01021773,1465,321,1144
2021,Epping Forest 011A,E01021774,1429,305,1124
2021,Epping Forest 011B,E01021775,1533,337,1196
2021,Epping Forest 011C,E01021776,1609,324,1285
2021,Epping Forest 011D,E01021777,1365,265,1100
2021,Epping Forest 011E,E01021778,1458,339,1119
2021,Epping Forest 011F,E01021779,1479,319,1160
2021,Epping Forest 014A,E01021780,1317,280,1037
2021,Epping Forest 014B,E01021781,1437,245,1192
2021,Epping Forest 014C,E01021782,1344,219,1125
2021,Epping Forest 013D,E01021783,1477,218,1259
2021,Epping Forest 013E,E01021784,1432,261,1171
2021,Epping Forest 014D,E01021785,1585,336,1249
2021,Epping Forest 012A,E01021786,1215,200,1015
2021,Epping Forest 012B,E01021787,1513,230,1283
2021,Epping Forest 012C,E01021788,1546,275,1271
2021,Epping Forest 012D,E01021789,1543,291,1252
2021,Epping Forest 012E,E01021790,1934,518,1416
2021,Epping Forest 012F,E01021791,1587,246,1341
2021,Epping Forest 002B,E01021792,1314,196,1118
2021,Epping Forest 002C,E01021793,1595,222,1373
2021,Epping Forest 002D,E01021794,1171,182,989
2021,Epping Forest 001B,E01021795,2076,312,1764
2021,Epping Forest 003B,E01021796,2302,361,1941
2021,Epping Forest 001C,E01021797,1284,206,1078
2021,Epping Forest 001D,E01021798,1465,262,1203
2021,Epping Forest 001E,E01021799,1754,314,1440
2021,Epping Forest 003C,E01021800,2384,399,1985
2021,Epping Forest 002E,E01021801,2149,336,1813
2021,Epping Forest 004D,E01021802,2545,583,1962
2021,Epping Forest 010B,E01021803,1266,219,1047
2021,Epping Forest 010C,E01021804,1426,201,1225
2021,Epping Forest 010D,E01021805,1307,276,1031
2021,Epping Forest 009A,E01021806,2628,437,2191
2021,Epping Forest 008A,E01021807,1445,276,1169
2021,Epping Forest 008B,E01021808,1479,349,1130
2021,Epping Forest 008C,E01021809,1333,217,1116
2021,Epping Forest 008D,E01021810,1691,314,1377
2021,Epping Forest 007A,E01021811,1311,250,1061
2021,Epping Forest 009B,E01021812,1212,156,1056
2021,Epping Forest 007B,E01021813,1342,194,1148
2021,Epping Forest 007C,E01021814,1727,315,1412
2021,Epping Forest 007D,E01021815,1516,346,1170
2021,Epping Forest 007E,E01021816,1365,230,1135
2021,Epping Forest 008E,E01021817,2500,490,2010
2021,Epping Forest 009C,E01021818,1895,263,1632
2021,Harlow 006A,E01021819,1586,349,1237
2021,Harlow 006B,E01021820,1472,277,1195
2021,Harlow 008A,E01021821,1339,267,1072
2021,Harlow 006C,E01021822,1558,347,1211
2021,Harlow 006D,E01021823,1729,378,1351
2021,Harlow 005A,E01021824,1652,384,1268
2021,Harlow 005B,E01021825,1522,341,1181
2021,Harlow 005C,E01021826,1449,247,1202
2021,Harlow 005D,E01021827,1551,298,1253
2021,Harlow 005E,E01021828,2206,503,1703
2021,Harlow 009A,E01021829,1405,258,1147
2021,Harlow 009B,E01021830,1202,203,999
2021,Harlow 007A,E01021831,1318,243,1075
2021,Harlow 009C,E01021832,1163,193,970
2021,Harlow 009D,E01021833,1137,183,954
2021,Harlow 008B,E01021834,1487,340,1147
2021,Harlow 008C,E01021835,1431,291,1140
2021,Harlow 008D,E01021836,1445,307,1138
2021,Harlow 008E,E01021837,1429,235,1194
2021,Harlow 010A,E01021838,1423,270,1153
2021,Harlow 004A,E01021839,1892,369,1523
2021,Harlow 004B,E01021840,1662,358,1304
2021,Harlow 004C,E01021841,1476,348,1128
2021,Harlow 004D,E01021842,1590,380,1210
2021,Harlow 004E,E01021843,2694,586,2108
2021,Harlow 002A,E01021844,1339,303,1036
2021,Harlow 002B,E01021845,1519,356,1163
2021,Harlow 002C,E01021846,1369,313,1056
2021,Harlow 002D,E01021847,1400,287,1113
2021,Harlow 002E,E01021848,1829,382,1447
2021,Harlow 003A,E01021849,1601,345,1256
2021,Harlow 003B,E01021850,1396,309,1087
2021,Harlow 003C,E01021851,1675,394,1281
2021,Harlow 003D,E01021852,1551,295,1256
2021,Harlow 003E,E01021853,1712,304,1408
2021,Harlow 001A,E01021854,2066,338,1728
2021,Harlow 001B,E01021855,1460,259,1201
2021,Harlow 001C,E01021856,1423,246,1177
2021,Harlow 010B,E01021858,1517,316,1201
2021,Harlow 010C,E01021859,1508,367,1141
2021,Harlow 010D,E01021860,1491,323,1168
2021,Harlow 010E,E01021861,1331,300,1031
2021,Harlow 011A,E01021862,1475,343,1132
2021,Harlow 011B,E01021863,1645,394,1251
2021,Harlow 011C,E01021864,1450,378,1072
2021,Harlow 009E,E01021865,1301,243,1058
2021,Harlow 011D,E01021866,1248,204,1044
2021,Harlow 011E,E01021867,1422,242,1180
2021,Harlow 007B,E01021868,1553,324,1229
2021,Harlow 007C,E01021869,1338,301,1037
2021,Harlow 006E,E01021870,1284,242,1042
2021,Harlow 007D,E01021871,1395,286,1109
2021,Maldon 007A,E01021873,1301,179,1122
2021,Maldon 007B,E01021874,1428,238,1190
2021,Maldon 007C,E01021875,1434,152,1282
2021,Maldon 008C,E01021878,1306,174,1132
2021,Maldon 008D,E01021879,1369,215,1154
2021,Maldon 008E,E01021880,1532,188,1344
2021,Maldon 008F,E01021881,1099,146,953
2021,Maldon 002A,E01021882,2075,325,1750
2021,Maldon 002B,E01021883,1600,318,1282
2021,Maldon 003A,E01021884,1303,203,1100
2021,Maldon 003B,E01021885,1070,148,922
2021,Maldon 003C,E01021886,1534,252,1282
2021,Maldon 003D,E01021887,2230,381,1849
2021,Maldon 003E,E01021888,2265,450,1815
2021,Maldon 004A,E01021889,2363,414,1949
2021,Maldon 004B,E01021890,1720,222,1498
2021,Maldon 004C,E01021891,1467,139,1328
2021,Maldon 004D,E01021892,1007,174,833
2021,Maldon 005A,E01021893,1418,246,1172
2021,Maldon 005B,E01021894,1183,224,959
2021,Maldon 005C,E01021895,1111,197,914
2021,Maldon 005D,E01021896,1701,268,1433
2021,Maldon 005E,E01021897,1053,134,919
2021,Maldon 005F,E01021898,1223,156,1067
2021,Maldon 007D,E01021899,1350,249,1101
2021,Maldon 007E,E01021900,1074,188,886
2021,Maldon 006A,E01021901,1855,293,1562
2021,Maldon 007F,E01021902,1801,275,1526
2021,Maldon 007G,E01021903,1606,252,1354
2021,Maldon 006B,E01021904,1884,347,1537
2021,Maldon 006C,E01021905,1190,209,981
2021,Maldon 006D,E01021906,1472,207,1265
2021,Maldon 006E,E01021907,2220,329,1891
2021,Maldon 001A,E01021908,2005,355,1650
2021,Maldon 001B,E01021909,1436,226,1210
2021,Maldon 001C,E01021910,1557,253,1304
2021,Maldon 001D,E01021911,1254,163,1091
2021,Maldon 002C,E01021912,2019,327,1692
2021,Maldon 002D,E01021913,1551,276,1275
2021,Rochford 002A,E01021914,1933,273,1660
2021,Rochford 004A,E01021915,1312,214,1098
2021,Rochford 004B,E01021916,1121,238,883
2021,Rochford 010A,E01021917,1654,259,1395
2021,Rochford 005A,E01021918,1401,251,1150
2021,Rochford 005B,E01021919,1285,208,1077
2021,Rochford 006A,E01021920,2063,405,1658
2021,Rochford 010B,E01021921,1392,247,1145
2021,Rochford 010C,E01021922,1496,219,1277
2021,Rochford 010D,E01021923,1269,238,1031
2021,Rochford 010E,E01021924,1711,329,1382
2021,Rochford 005C,E01021925,1594,259,1335
2021,Rochford 006B,E01021926,1963,387,1576
2021,Rochford 002B,E01021927,1183,190,993
2021,Rochford 002C,E01021928,1423,206,1217
2021,Rochford 002D,E01021929,1526,297,1229
2021,Rochford 007A,E01021930,1253,178,1075
2021,Rochford 002E,E01021931,1514,255,1259
2021,Rochford 007B,E01021932,1449,252,1197
2021,Rochford 012E,E01021933,1900,421,1479
2021,Rochford 012D,E01021934,1311,180,1131
2021,Rochford 012C,E01021935,1252,198,1054
2021,Rochford 012B,E01021936,1593,226,1367
2021,Rochford 012A,E01021937,1492,231,1261
2021,Rochford 011B,E01021938,1453,207,1246
2021,Rochford 011D,E01021939,1600,273,1327
2021,Rochford 011A,E01021940,1906,323,1583
2021,Rochford 011C,E01021941,2193,408,1785
2021,Rochford 001A,E01021942,1614,105,1509
2021,Rochford 001B,E01021943,1599,241,1358
2021,Rochford 001C,E01021944,1608,265,1343
2021,Rochford 001D,E01021945,1537,258,1279
2021,Rochford 009A,E01021946,1420,231,1189
2021,Rochford 009B,E01021947,1173,186,987
2021,Rochford 009C,E01021948,1204,221,983
2021,Rochford 009D,E01021949,1397,266,1131
2021,Rochford 008A,E01021950,1372,239,1133
2021,Rochford 008B,E01021951,1218,229,989
2021,Rochford 007C,E01021952,1408,216,1192
2021,Rochford 004C,E01021953,1240,294,946
2021,Rochford 007D,E01021954,2611,508,2103
2021,Rochford 004D,E01021955,1634,246,1388
2021,Rochford 007E,E01021956,1396,236,1160
2021,Rochford 006C,E01021957,1603,303,1300
2021,Rochford 006D,E01021958,1139,202,937
2021,Rochford 006E,E01021959,1553,307,1246
2021,Rochford 005D,E01021960,1968,349,1619
2021,Rochford 005E,E01021961,1526,223,1303
2021,Rochford 008C,E01021962,1172,215,957
2021,Rochford 008D,E01021963,1312,252,1060
2021,Rochford 008E,E01021964,1530,271,1259
2021,Rochford 009E,E01021965,2268,379,1889
2021,Rochford 008F,E01021966,1657,240,1417
2021,Tendring 009A,E01021967,2326,357,1969
2021,Tendring 017A,E01021968,1803,412,1391
2021,Tendring 017B,E01021969,1396,298,1098
2021,Tendring 016A,E01021970,1717,339,1378
2021,Tendring 005A,E01021971,1549,277,1272
2021,Tendring 005B,E01021972,1315,231,1084
2021,Tendring 007A,E01021973,1222,193,1029
2021,Tendring 007B,E01021974,1270,230,1040
2021,Tendring 013A,E01021975,1471,253,1218
2021,Tendring 013B,E01021976,1453,183,1270
2021,Tendring 013C,E01021977,2627,488,2139
2021,Tendring 003A,E01021978,2338,386,1952
2021,Tendring 011A,E01021979,1437,233,1204
2021,Tendring 011B,E01021980,1628,229,1399
2021,Tendring 011C,E01021981,1867,294,1573
2021,Tendring 011D,E01021982,1951,358,1593
2021,Tendring 009B,E01021983,1427,211,1216
2021,Tendring 010A,E01021984,2113,185,1928
2021,Tendring 006A,E01021985,1278,135,1143
2021,Tendring 006B,E01021986,1420,151,1269
2021,Tendring 008A,E01021987,1269,170,1099
2021,Tendring 018A,E01021988,1908,208,1700
2021,Tendring 018B,E01021989,1429,112,1317
2021,Tendring 018C,E01021990,1588,170,1418
2021,Tendring 004A,E01021991,1005,157,848
2021,Tendring 004B,E01021992,1138,201,937
2021,Tendring 009C,E01021993,2401,398,2003
2021,Tendring 008B,E01021994,1140,85,1055
2021,Tendring 008C,E01021995,1304,183,1121
2021,Tendring 008D,E01021996,1262,168,1094
2021,Tendring 001A,E01021997,1252,206,1046
2021,Tendring 001B,E01021998,1381,242,1139
2021,Tendring 001C,E01021999,1611,276,1335
2021,Tendring 002A,E01022000,1563,285,1278
2021,Tendring 001D,E01022001,1820,326,1494
2021,Tendring 004C,E01022002,1862,347,1515
2021,Tendring 004D,E01022004,1686,209,1477
2021,Tendring 004E,E01022005,1722,258,1464
2021,Tendring 002C,E01022006,1694,321,1373
2021,Tendring 002D,E01022007,1756,419,1337
2021,Tendring 012A,E01022008,2062,195,1867
2021,Tendring 008E,E01022009,1477,192,1285
2021,Tendring 008F,E01022010,1672,213,1459
2021,Tendring 008G,E01022011,1843,281,1562
2021,Tendring 008H,E01022012,1928,187,1741
2021,Tendring 003B,E01022013,1793,283,1510
2021,Tendring 003C,E01022014,1419,261,1158
2021,Tendring 003D,E01022015,1305,229,1076
2021,Tendring 007C,E01022016,1764,212,1552
2021,Tendring 007D,E01022017,1635,246,1389
2021,Tendring 007E,E01022018,1712,244,1468
2021,Tendring 003E,E01022019,1642,231,1411
2021,Tendring 003F,E01022020,1621,220,1401
2021,Tendring 003G,E01022021,1400,221,1179
2021,Tendring 013D,E01022022,1442,278,1164
2021,Tendring 015A,E01022023,1387,244,1143
2021,Tendring 015B,E01022024,1413,265,1148
2021,Tendring 016B,E01022025,1830,238,1592
2021,Tendring 016C,E01022026,1604,322,1282
2021,Tendring 016D,E01022027,1599,228,1371
2021,Tendring 004F,E01022028,1345,233,1112
2021,Tendring 015C,E01022030,1502,226,1276
2021,Tendring 015D,E01022031,1238,300,938
2021,Tendring 015E,E01022032,1738,353,1385
2021,Tendring 012B,E01022033,1449,125,1324
2021,Tendring 012C,E01022034,1496,144,1352
2021,Tendring 012D,E01022035,1423,129,1294
2021,Tendring 017C,E01022036,1158,156,1002
2021,Tendring 017D,E01022037,1336,103,1233
2021,Tendring 017E,E01022038,1364,223,1141
2021,Tendring 010B,E01022039,1436,243,1193
2021,Tendring 010C,E01022040,1717,188,1529
2021,Tendring 010D,E01022041,1460,193,1267
2021,Tendring 014A,E01022042,1461,275,1186
2021,Tendring 014B,E01022043,1778,388,1390
2021,Tendring 013E,E01022044,1586,224,1362
2021,Tendring 018D,E01022045,1622,210,1412
2021,Tendring 011E,E01022046,1648,217,1431
2021,Tendring 018E,E01022047,1401,178,1223
2021,Tendring 014C,E01022048,1447,143,1304
2021,Tendring 014D,E01022049,1431,244,1187
2021,Tendring 014E,E01022050,1745,181,1564
2021,Tendring 005C,E01022051,1489,225,1264
2021,Tendring 005D,E01022052,1482,263,1219
2021,Tendring 009D,E01022053,1962,316,1646
2021,Tendring 006C,E01022054,1495,182,1313
2021,Tendring 006D,E01022055,1473,176,1297
2021,Tendring 006E,E01022056,1624,282,1342
2021,Uttlesford 001A,E01022057,1697,318,1379
2021,Uttlesford 008A,E01022058,1579,266,1313
2021,Uttlesford 009A,E01022059,1560,274,1286
2021,Uttlesford 009B,E01022060,1984,422,1562
2021,Uttlesford 003A,E01022061,1524,261,1263
2021,Uttlesford 005A,E01022062,2342,403,1939
2021,Uttlesford 005B,E01022063,2260,421,1839
2021,Uttlesford 008B,E01022064,1852,284,1568
2021,Uttlesford 007B,E01022067,1835,205,1630
2021,Uttlesford 007C,E01022068,1850,351,1499
2021,Uttlesford 008D,E01022069,1531,200,1331
2021,Uttlesford 009C,E01022070,1910,375,1535
2021,Uttlesford 003B,E01022071,1629,299,1330
2021,Uttlesford 003C,E01022072,1977,376,1601
2021,Uttlesford 003D,E01022073,1927,315,1612
2021,Uttlesford 002A,E01022074,1406,316,1090
2021,Uttlesford 001B,E01022075,1748,365,1383
2021,Uttlesford 002B,E01022076,1597,180,1417
2021,Uttlesford 001C,E01022077,1920,346,1574
2021,Uttlesford 002C,E01022078,1426,291,1135
2021,Uttlesford 002D,E01022079,2036,351,1685
2021,Uttlesford 002E,E01022080,1369,258,1111
2021,Uttlesford 002F,E01022081,2459,487,1972
2021,Uttlesford 002G,E01022082,2131,452,1679
2021,Uttlesford 005C,E01022083,1720,272,1448
2021,Uttlesford 005D,E01022084,1859,353,1506
2021,Uttlesford 005E,E01022085,1605,280,1325
2021,Uttlesford 006A,E01022086,1638,351,1287
2021,Uttlesford 005F,E01022087,2598,552,2046
2021,Uttlesford 008E,E01022088,1643,291,1352
2021,Uttlesford 005G,E01022089,1549,312,1237
2021,Uttlesford 004A,E01022092,1780,292,1488
2021,Uttlesford 004B,E01022093,2131,396,1735
2021,Uttlesford 001D,E01022094,1873,382,1491
2021,Uttlesford 006D,E01022095,1668,283,1385
2021,Uttlesford 009D,E01022096,1983,340,1643
2021,Uttlesford 004C,E01022097,1865,350,1515
2021,Uttlesford 003E,E01022098,1495,249,1246
2021,Uttlesford 004D,E01022099,2125,428,1697
2021,Cheltenham 008A,E01022100,1576,263,1313
2021,Cheltenham 008B,E01022101,1655,267,1388
2021,Cheltenham 008C,E01022102,1906,197,1709
2021,Cheltenham 012B,E01022104,1604,343,1261
2021,Cheltenham 012C,E01022105,1420,319,1101
2021,Cheltenham 010A,E01022106,1621,283,1338
2021,Cheltenham 010B,E01022107,1488,246,1242
2021,Cheltenham 010C,E01022108,1611,259,1352
2021,Cheltenham 012D,E01022109,1529,363,1166
2021,Cheltenham 012E,E01022110,1337,331,1006
2021,Cheltenham 012F,E01022111,1458,360,1098
2021,Cheltenham 012G,E01022112,1303,350,953
2021,Cheltenham 014A,E01022113,1697,349,1348
2021,Cheltenham 014B,E01022114,1537,325,1212
2021,Cheltenham 014C,E01022115,1504,219,1285
2021,Cheltenham 009A,E01022116,1467,470,997
2021,Cheltenham 009B,E01022117,1605,102,1503
2021,Cheltenham 014D,E01022118,1397,266,1131
2021,Cheltenham 009C,E01022119,1146,211,935
2021,Cheltenham 005A,E01022120,1521,319,1202
2021,Cheltenham 005B,E01022121,1649,404,1245
2021,Cheltenham 003A,E01022122,1354,300,1054
2021,Cheltenham 010D,E01022123,2071,339,1732
2021,Cheltenham 009D,E01022124,1179,105,1074
2021,Cheltenham 009E,E01022125,1135,159,976
2021,Cheltenham 009F,E01022126,1332,101,1231
2021,Cheltenham 009G,E01022127,1783,653,1130
2021,Cheltenham 015A,E01022128,1473,281,1192
2021,Cheltenham 015B,E01022129,2257,443,1814
2021,Cheltenham 015C,E01022130,1526,266,1260
2021,Cheltenham 006A,E01022131,1252,256,996
2021,Cheltenham 006B,E01022132,1393,284,1109
2021,Cheltenham 006C,E01022133,1356,364,992
2021,Cheltenham 006D,E01022134,1496,231,1265
2021,Cheltenham 011A,E01022135,1627,494,1133
2021,Cheltenham 011B,E01022136,1301,139,1162
2021,Cheltenham 011C,E01022137,1480,171,1309
2021,Cheltenham 011D,E01022138,1638,414,1224
2021,Cheltenham 004A,E01022139,1803,602,1201
2021,Cheltenham 008D,E01022140,1344,171,1173
2021,Cheltenham 008E,E01022141,1355,149,1206
2021,Cheltenham 008F,E01022142,1315,175,1140
2021,Cheltenham 002A,E01022143,2022,589,1433
2021,Cheltenham 002B,E01022144,1336,181,1155
2021,Cheltenham 002C,E01022145,1171,199,972
2021,Cheltenham 002D,E01022146,1299,142,1157
2021,Cheltenham 005C,E01022147,1568,295,1273
2021,Cheltenham 007A,E01022148,1522,236,1286
2021,Cheltenham 007B,E01022149,1404,276,1128
2021,Cheltenham 007C,E01022150,1447,210,1237
2021,Cheltenham 004B,E01022151,1601,555,1046
2021,Cheltenham 004C,E01022152,1181,338,843
2021,Cheltenham 004D,E01022153,1420,365,1055
2021,Cheltenham 004E,E01022154,1774,688,1086
2021,Cheltenham 007D,E01022155,1483,268,1215
2021,Cheltenham 007E,E01022156,1781,337,1444
2021,Cheltenham 005D,E01022157,1364,257,1107
2021,Cheltenham 005E,E01022159,1543,357,1186
2021,Cheltenham 003B,E01022160,2079,435,1644
2021,Cheltenham 003C,E01022161,1377,259,1118
2021,Cheltenham 003D,E01022162,1501,228,1273
2021,Cheltenham 001A,E01022163,1361,228,1133
2021,Cheltenham 001B,E01022164,1326,262,1064
2021,Cheltenham 001C,E01022165,1394,150,1244
2021,Cheltenham 001D,E01022166,1155,163,992
2021,Cheltenham 013A,E01022167,1207,206,1001
2021,Cheltenham 013B,E01022168,1082,233,849
2021,Cheltenham 013C,E01022169,1420,288,1132
2021,Cheltenham 013D,E01022170,1303,220,1083
2021,Cheltenham 013E,E01022171,1232,246,986
2021,Cheltenham 013F,E01022172,1407,181,1226
2021,Cheltenham 013G,E01022173,1254,244,1010
2021,Cheltenham 011E,E01022174,1294,224,1070
2021,Cotswold 005A,E01022175,1730,223,1507
2021,Cotswold 011A,E01022176,1777,291,1486
2021,Cotswold 002A,E01022177,1863,194,1669
2021,Cotswold 002B,E01022178,1247,178,1069
2021,Cotswold 001A,E01022179,1889,279,1610
2021,Cotswold 003B,E01022181,1733,268,1465
2021,Cotswold 001B,E01022182,1636,234,1402
2021,Cotswold 001C,E01022183,1498,215,1283
2021,Cotswold 001D,E01022184,1488,184,1304
2021,Cotswold 001E,E01022185,1866,315,1551
2021,Cotswold 004A,E01022186,1568,274,1294
2021,Cotswold 004B,E01022187,1861,414,1447
2021,Cotswold 006A,E01022188,1971,423,1548
2021,Cotswold 006B,E01022189,1195,212,983
2021,Cotswold 006C,E01022190,1394,308,1086
2021,Cotswold 008A,E01022191,1267,177,1090
2021,Cotswold 008B,E01022192,1232,285,947
2021,Cotswold 008C,E01022193,1014,178,836
2021,Cotswold 007A,E01022194,1686,195,1491
2021,Cotswold 007B,E01022195,1555,400,1155
2021,Cotswold 006D,E01022196,1690,303,1387
2021,Cotswold 006E,E01022197,1747,290,1457
2021,Cotswold 008D,E01022198,1193,217,976
2021,Cotswold 007C,E01022199,1557,191,1366
2021,Cotswold 007D,E01022200,1099,189,910
2021,Cotswold 004C,E01022201,1731,253,1478
2021,Cotswold 009A,E01022202,1309,285,1024
2021,Cotswold 009B,E01022203,2054,360,1694
2021,Cotswold 009C,E01022204,1328,225,1103
2021,Cotswold 002C,E01022205,1725,236,1489
2021,Cotswold 005B,E01022207,1632,256,1376
2021,Cotswold 009D,E01022208,1591,267,1324
2021,Cotswold 009E,E01022209,1137,191,946
2021,Cotswold 009F,E01022210,1405,142,1263
2021,Cotswold 002D,E01022211,1868,203,1665
2021,Cotswold 005C,E01022213,1899,329,1570
2021,Cotswold 005D,E01022215,1661,234,1427
2021,Cotswold 004D,E01022216,1841,301,1540
2021,Cotswold 011C,E01022217,1203,194,1009
2021,Cotswold 011D,E01022218,1141,210,931
2021,Cotswold 011E,E01022219,1418,204,1214
2021,Cotswold 011F,E01022220,1535,185,1350
2021,Cotswold 010A,E01022221,1995,372,1623
2021,Cotswold 003D,E01022222,1836,241,1595
2021,Cotswold 010C,E01022224,1485,205,1280
2021,Cotswold 008E,E01022225,2419,352,2067
2021,Forest of Dean 009A,E01022226,1365,197,1168
2021,Forest of Dean 009B,E01022227,1513,200,1313
2021,Forest of Dean 005A,E01022228,1603,218,1385
2021,Forest of Dean 007A,E01022229,1516,245,1271
2021,Forest of Dean 005B,E01022230,1752,251,1501
2021,Forest of Dean 008A,E01022231,1587,293,1294
2021,Forest of Dean 008B,E01022232,1510,240,1270
2021,Forest of Dean 001A,E01022233,1805,254,1551
2021,Forest of Dean 006A,E01022234,1491,168,1323
2021,Forest of Dean 001B,E01022235,1738,289,1449
2021,Forest of Dean 004A,E01022236,1951,328,1623
2021,Forest of Dean 004B,E01022237,1402,260,1142
2021,Forest of Dean 004C,E01022238,1451,285,1166
2021,Forest of Dean 004D,E01022239,1526,242,1284
2021,Forest of Dean 004E,E01022240,1994,286,1708
2021,Forest of Dean 007B,E01022241,1761,208,1553
2021,Forest of Dean 007C,E01022242,1716,280,1436
2021,Forest of Dean 007D,E01022243,1343,261,1082
2021,Forest of Dean 007E,E01022244,1476,251,1225
2021,Forest of Dean 007F,E01022245,1275,220,1055
2021,Forest of Dean 007G,E01022246,1253,205,1048
2021,Forest of Dean 001C,E01022247,2554,1194,1360
2021,Forest of Dean 010A,E01022248,1618,226,1392
2021,Forest of Dean 004F,E01022249,1971,269,1702
2021,Forest of Dean 004G,E01022250,2022,407,1615
2021,Forest of Dean 003A,E01022251,1373,243,1130
2021,Forest of Dean 003B,E01022252,1719,251,1468
2021,Forest of Dean 006B,E01022253,1618,243,1375
2021,Forest of Dean 009C,E01022254,2341,474,1867
2021,Forest of Dean 009D,E01022255,2109,325,1784
2021,Forest of Dean 009E,E01022256,1671,267,1404
2021,Forest of Dean 009F,E01022257,1703,226,1477
2021,Forest of Dean 003C,E01022258,1169,229,940
2021,Forest of Dean 003D,E01022259,1465,224,1241
2021,Forest of Dean 003E,E01022260,1793,309,1484
2021,Forest of Dean 002A,E01022261,2238,404,1834
2021,Forest of Dean 002B,E01022262,2073,307,1766
2021,Forest of Dean 006C,E01022263,1823,255,1568
2021,Forest of Dean 008C,E01022264,1475,228,1247
2021,Forest of Dean 005C,E01022265,1639,206,1433
2021,Forest of Dean 005D,E01022266,1340,205,1135
2021,Forest of Dean 002C,E01022267,1720,250,1470
2021,Forest of Dean 008D,E01022268,1596,237,1359
2021,Forest of Dean 008E,E01022269,1805,251,1554
2021,Forest of Dean 001D,E01022270,1891,303,1588
2021,Forest of Dean 001E,E01022271,1642,253,1389
2021,Forest of Dean 010B,E01022272,1283,227,1056
2021,Forest of Dean 010C,E01022273,1323,189,1134
2021,Forest of Dean 010D,E01022274,1151,186,965
2021,Forest of Dean 010E,E01022275,1881,326,1555
2021,Gloucester 010A,E01022276,1491,234,1257
2021,Gloucester 010B,E01022277,1384,206,1178
2021,Gloucester 007A,E01022278,1533,281,1252
2021,Gloucester 007B,E01022279,1403,310,1093
2021,Gloucester 010C,E01022280,1405,236,1169
2021,Gloucester 010D,E01022281,1605,292,1313
2021,Gloucester 007C,E01022282,2545,550,1995
2021,Gloucester 006A,E01022283,1405,205,1200
2021,Gloucester 007D,E01022284,1194,223,971
2021,Gloucester 007E,E01022285,1337,289,1048
2021,Gloucester 007F,E01022286,1612,379,1233
2021,Gloucester 007G,E01022287,1856,364,1492
2021,Gloucester 005A,E01022288,1882,443,1439
2021,Gloucester 005B,E01022289,1649,386,1263
2021,Gloucester 005C,E01022290,1327,339,988
2021,Gloucester 005D,E01022291,1693,417,1276
2021,Gloucester 005E,E01022292,1449,384,1065
2021,Gloucester 008A,E01022293,1523,322,1201
2021,Gloucester 008B,E01022294,1644,364,1280
2021,Gloucester 003A,E01022295,1301,218,1083
2021,Gloucester 003B,E01022296,1450,302,1148
2021,Gloucester 003C,E01022297,1289,228,1061
2021,Gloucester 003D,E01022298,1544,291,1253
2021,Gloucester 013A,E01022299,1260,156,1104
2021,Gloucester 013B,E01022300,1240,131,1109
2021,Gloucester 013C,E01022301,1465,315,1150
2021,Gloucester 013D,E01022302,1456,237,1219
2021,Gloucester 006B,E01022303,1341,212,1129
2021,Gloucester 006C,E01022304,1691,266,1425
2021,Gloucester 006D,E01022305,1298,168,1130
2021,Gloucester 010E,E01022306,1268,205,1063
2021,Gloucester 010F,E01022307,1463,270,1193
2021,Gloucester 006E,E01022308,1350,208,1142
2021,Gloucester 002A,E01022309,1466,363,1103
2021,Gloucester 002B,E01022310,1742,464,1278
2021,Gloucester 002C,E01022311,1901,315,1586
2021,Gloucester 002D,E01022312,2215,409,1806
2021,Gloucester 001A,E01022313,1545,252,1293
2021,Gloucester 002E,E01022314,1597,271,1326
2021,Gloucester 001B,E01022315,1416,213,1203
2021,Gloucester 001C,E01022316,1464,233,1231
2021,Gloucester 001D,E01022317,1446,295,1151
2021,Gloucester 001E,E01022318,1634,402,1232
2021,Gloucester 011A,E01022319,1428,353,1075
2021,Gloucester 011B,E01022320,1585,280,1305
2021,Gloucester 011C,E01022321,1557,280,1277
2021,Gloucester 011D,E01022322,1296,254,1042
2021,Gloucester 008C,E01022323,1680,438,1242
2021,Gloucester 011E,E01022324,1530,333,1197
2021,Gloucester 011F,E01022325,1218,195,1023
2021,Gloucester 009A,E01022326,1256,272,984
2021,Gloucester 009B,E01022327,1419,285,1134
2021,Gloucester 008D,E01022328,1323,304,1019
2021,Gloucester 008E,E01022329,1560,417,1143
2021,Gloucester 009C,E01022330,1410,302,1108
2021,Gloucester 009D,E01022331,1270,274,996
2021,Gloucester 004A,E01022332,1739,386,1353
2021,Gloucester 009E,E01022333,1438,295,1143
2021,Gloucester 009F,E01022334,1821,353,1468
2021,Gloucester 015A,E01022335,1388,225,1163
2021,Gloucester 015B,E01022336,1098,174,924
2021,Gloucester 015D,E01022338,1223,199,1024
2021,Gloucester 014A,E01022339,1656,344,1312
2021,Gloucester 014B,E01022340,1283,200,1083
2021,Gloucester 014C,E01022341,2333,429,1904
2021,Gloucester 014D,E01022342,1595,310,1285
2021,Gloucester 012A,E01022343,1359,227,1132
2021,Gloucester 012B,E01022344,1473,260,1213
2021,Gloucester 012C,E01022345,1597,280,1317
2021,Gloucester 012D,E01022346,1445,289,1156
2021,Stroud 010A,E01022350,2088,363,1725
2021,Stroud 012A,E01022351,1532,265,1267
2021,Stroud 012B,E01022352,1256,151,1105
2021,Stroud 012C,E01022353,1517,223,1294
2021,Stroud 002A,E01022354,2154,359,1795
2021,Stroud 004A,E01022355,1599,311,1288
2021,Stroud 004B,E01022356,2384,402,1982
2021,Stroud 004C,E01022357,1813,316,1497
2021,Stroud 004D,E01022358,1497,281,1216
2021,Stroud 011A,E01022359,1462,227,1235
2021,Stroud 011B,E01022360,1422,186,1236
2021,Stroud 011C,E01022361,1140,172,968
2021,Stroud 011D,E01022362,1097,128,969
2021,Stroud 011E,E01022363,1921,302,1619
2021,Stroud 011F,E01022364,1068,178,890
2021,Stroud 008A,E01022366,1614,310,1304
2021,Stroud 008B,E01022367,1560,291,1269
2021,Stroud 008C,E01022368,1312,203,1109
2021,Stroud 008D,E01022369,1541,296,1245
2021,Stroud 009A,E01022370,1280,215,1065
2021,Stroud 009B,E01022371,1063,173,890
2021,Stroud 014A,E01022372,2290,410,1880
2021,Stroud 014B,E01022373,1602,264,1338
2021,Stroud 014C,E01022374,1959,322,1637
2021,Stroud 014D,E01022375,1170,298,872
2021,Stroud 003A,E01022376,2599,441,2158
2021,Stroud 004E,E01022377,2036,357,1679
2021,Stroud 001A,E01022378,2072,364,1708
2021,Stroud 001B,E01022379,1345,227,1118
2021,Stroud 015A,E01022381,2119,440,1679
2021,Stroud 010B,E01022382,1571,277,1294
2021,Stroud 010C,E01022383,1428,246,1182
2021,Stroud 010D,E01022384,1364,199,1165
2021,Stroud 013A,E01022385,1574,315,1259
2021,Stroud 013B,E01022386,1486,167,1319
2021,Stroud 013C,E01022387,1460,227,1233
2021,Stroud 013D,E01022388,1708,329,1379
2021,Stroud 004F,E01022389,1650,257,1393
2021,Stroud 002B,E01022390,1153,165,988
2021,Stroud 002C,E01022391,1578,235,1343
2021,Stroud 002D,E01022392,1576,246,1330
2021,Stroud 007A,E01022393,1360,239,1121
2021,Stroud 007B,E01022394,1450,265,1185
2021,Stroud 007C,E01022395,1434,233,1201
2021,Stroud 003B,E01022396,1730,277,1453
2021,Stroud 003C,E01022397,1955,369,1586
2021,Stroud 003D,E01022398,1128,148,980
2021,Stroud 006B,E01022399,2017,374,1643
2021,Stroud 005A,E01022400,1862,296,1566
2021,Stroud 005B,E01022401,1297,211,1086
2021,Stroud 005C,E01022402,1418,215,1203
2021,Stroud 005D,E01022403,1461,261,1200
2021,Stroud 005E,E01022404,1657,379,1278
2021,Stroud 009C,E01022405,1962,350,1612
2021,Stroud 009D,E01022406,1210,176,1034
2021,Stroud 009E,E01022407,1286,181,1105
2021,Stroud 007D,E01022408,988,167,821
2021,Stroud 007E,E01022409,1239,235,1004
2021,Stroud 006C,E01022410,2107,348,1759
2021,Stroud 006D,E01022411,1981,319,1662
2021,Stroud 012D,E01022413,1939,324,1615
2021,Stroud 006E,E01022414,2345,384,1961
2021,Stroud 015B,E01022415,1498,245,1253
2021,Stroud 015C,E01022416,1441,290,1151
2021,Stroud 015D,E01022417,1711,278,1433
2021,Stroud 015E,E01022418,1562,250,1312
2021,Tewkesbury 009A,E01022421,1618,286,1332
2021,Tewkesbury 009C,E01022423,2101,336,1765
2021,Tewkesbury 009D,E01022424,1544,307,1237
2021,Tewkesbury 007A,E01022425,1146,240,906
2021,Tewkesbury 007B,E01022426,1366,195,1171
2021,Tewkesbury 007C,E01022427,1343,200,1143
2021,Tewkesbury 007D,E01022428,1803,399,1404
2021,Tewkesbury 007E,E01022429,1477,257,1220
2021,Tewkesbury 007F,E01022430,1405,243,1162
2021,Tewkesbury 007G,E01022431,1801,272,1529
2021,Tewkesbury 011E,E01022432,1868,268,1600
2021,Tewkesbury 011C,E01022433,1886,308,1578
2021,Tewkesbury 004A,E01022434,2028,355,1673
2021,Tewkesbury 010D,E01022437,1392,308,1084
2021,Tewkesbury 010E,E01022438,1221,187,1034
2021,Tewkesbury 010C,E01022439,2426,466,1960
2021,Tewkesbury 006A,E01022440,2195,401,1794
2021,Tewkesbury 004B,E01022441,1492,212,1280
2021,Tewkesbury 006B,E01022442,1585,205,1380
2021,Tewkesbury 006C,E01022443,1414,245,1169
2021,Tewkesbury 006D,E01022444,1569,273,1296
2021,Tewkesbury 004C,E01022445,1370,209,1161
2021,Tewkesbury 007H,E01022447,1350,291,1059
2021,Tewkesbury 008B,E01022448,2051,365,1686
2021,Tewkesbury 003A,E01022449,1972,260,1712
2021,Tewkesbury 001B,E01022450,1965,352,1613
2021,Tewkesbury 001C,E01022451,1393,204,1189
2021,Tewkesbury 001D,E01022452,1259,233,1026
2021,Tewkesbury 004D,E01022453,2261,418,1843
2021,Tewkesbury 008C,E01022454,2398,451,1947
2021,Tewkesbury 001E,E01022455,1771,248,1523
2021,Tewkesbury 002A,E01022456,1220,187,1033
2021,Tewkesbury 002B,E01022457,1279,213,1066
2021,Tewkesbury 002C,E01022458,1277,236,1041
2021,Tewkesbury 002D,E01022459,1419,112,1307
2021,Tewkesbury 002E,E01022460,1805,296,1509
2021,Tewkesbury 002F,E01022461,1287,180,1107
2021,Tewkesbury 002G,E01022462,1856,238,1618
2021,Tewkesbury 003B,E01022463,1369,155,1214
2021,Tewkesbury 003C,E01022464,1492,213,1279
2021,Tewkesbury 003D,E01022465,1694,268,1426
2021,Tewkesbury 003E,E01022466,2166,399,1767
2021,Basingstoke and Deane 017A,E01022467,1536,254,1282
2021,Basingstoke and Deane 017B,E01022468,1811,242,1569
2021,Basingstoke and Deane 017C,E01022469,1492,237,1255
2021,Basingstoke and Deane 008A,E01022470,1757,292,1465
2021,Basingstoke and Deane 008B,E01022471,1418,244,1174
2021,Basingstoke and Deane 004A,E01022472,1212,204,1008
2021,Basingstoke and Deane 004B,E01022473,1159,194,965
2021,Basingstoke and Deane 019A,E01022474,1652,373,1279
2021,Basingstoke and Deane 016A,E01022475,1548,251,1297
2021,Basingstoke and Deane 016B,E01022476,1643,285,1358
2021,Basingstoke and Deane 019B,E01022477,1298,193,1105
2021,Basingstoke and Deane 019C,E01022478,1362,271,1091
2021,Basingstoke and Deane 019D,E01022479,1367,265,1102
2021,Basingstoke and Deane 016C,E01022480,1253,276,977
2021,Basingstoke and Deane 012A,E01022481,1876,338,1538
2021,Basingstoke and Deane 012B,E01022482,1561,273,1288
2021,Basingstoke and Deane 013A,E01022484,1300,310,990
2021,Basingstoke and Deane 013B,E01022485,1129,264,865
2021,Basingstoke and Deane 013C,E01022486,2087,493,1594
2021,Basingstoke and Deane 013D,E01022487,1251,319,932
2021,Basingstoke and Deane 003A,E01022488,1333,261,1072
2021,Basingstoke and Deane 003B,E01022489,1491,285,1206
2021,Basingstoke and Deane 005A,E01022490,1742,299,1443
2021,Basingstoke and Deane 005B,E01022491,1899,399,1500
2021,Basingstoke and Deane 005C,E01022492,1436,259,1177
2021,Basingstoke and Deane 002A,E01022493,1314,243,1071
2021,Basingstoke and Deane 008C,E01022494,2302,410,1892
2021,Basingstoke and Deane 006A,E01022495,1347,208,1139
2021,Basingstoke and Deane 006C,E01022497,1249,192,1057
2021,Basingstoke and Deane 006D,E01022498,1423,232,1191
2021,Basingstoke and Deane 003C,E01022499,1551,349,1202
2021,Basingstoke and Deane 003D,E01022500,1322,229,1093
2021,Basingstoke and Deane 011B,E01022502,1502,219,1283
2021,Basingstoke and Deane 012D,E01022503,1652,225,1427
2021,Basingstoke and Deane 016D,E01022504,1601,236,1365
2021,Basingstoke and Deane 016E,E01022505,1671,284,1387
2021,Basingstoke and Deane 011C,E01022506,1268,203,1065
2021,Basingstoke and Deane 011D,E01022507,1489,272,1217
2021,Basingstoke and Deane 019E,E01022509,1310,215,1095
2021,Basingstoke and Deane 021B,E01022510,1519,296,1223
2021,Basingstoke and Deane 021C,E01022511,1166,228,938
2021,Basingstoke and Deane 021D,E01022512,1255,268,987
2021,Basingstoke and Deane 003E,E01022513,1557,299,1258
2021,Basingstoke and Deane 020A,E01022514,1538,210,1328
2021,Basingstoke and Deane 018A,E01022515,1276,104,1172
2021,Basingstoke and Deane 018B,E01022516,1439,229,1210
2021,Basingstoke and Deane 018C,E01022517,1179,181,998
2021,Basingstoke and Deane 018D,E01022518,1859,372,1487
2021,Basingstoke and Deane 018E,E01022519,1222,186,1036
2021,Basingstoke and Deane 004C,E01022520,1667,251,1416
2021,Basingstoke and Deane 004D,E01022521,1503,204,1299
2021,Basingstoke and Deane 004E,E01022522,1691,327,1364
2021,Basingstoke and Deane 008D,E01022523,2388,543,1845
2021,Basingstoke and Deane 009A,E01022524,1812,325,1487
2021,Basingstoke and Deane 009B,E01022525,1565,252,1313
2021,Basingstoke and Deane 009D,E01022527,1523,256,1267
2021,Basingstoke and Deane 015A,E01022528,1201,188,1013
2021,Basingstoke and Deane 015B,E01022529,1516,237,1279
2021,Basingstoke and Deane 015C,E01022530,1380,251,1129
2021,Basingstoke and Deane 015D,E01022531,1354,187,1167
2021,Basingstoke and Deane 022A,E01022532,2122,403,1719
2021,Basingstoke and Deane 022B,E01022533,1625,298,1327
2021,Basingstoke and Deane 022C,E01022534,1820,303,1517
2021,Basingstoke and Deane 022D,E01022535,1529,224,1305
2021,Basingstoke and Deane 002B,E01022536,1318,190,1128
2021,Basingstoke and Deane 002C,E01022537,1221,166,1055
2021,Basingstoke and Deane 007B,E01022539,1184,251,933
2021,Basingstoke and Deane 007C,E01022540,2371,562,1809
2021,Basingstoke and Deane 007E,E01022542,1152,261,891
2021,Basingstoke and Deane 007F,E01022543,1536,299,1237
2021,Basingstoke and Deane 005E,E01022547,1711,292,1419
2021,Basingstoke and Deane 014A,E01022548,1304,188,1116
2021,Basingstoke and Deane 014B,E01022549,1534,282,1252
2021,Basingstoke and Deane 014C,E01022550,1614,283,1331
2021,Basingstoke and Deane 014D,E01022551,1432,217,1215
2021,Basingstoke and Deane 014E,E01022552,1492,314,1178
2021,Basingstoke and Deane 001A,E01022553,1357,211,1146
2021,Basingstoke and Deane 001B,E01022554,1698,309,1389
2021,Basingstoke and Deane 001C,E01022555,1376,210,1166
2021,Basingstoke and Deane 001D,E01022556,1761,363,1398
2021,Basingstoke and Deane 002D,E01022557,1416,246,1170
2021,Basingstoke and Deane 002E,E01022558,1166,165,1001
2021,Basingstoke and Deane 002F,E01022559,1202,171,1031
2021,Basingstoke and Deane 001E,E01022560,1113,187,926
2021,Basingstoke and Deane 017D,E01022561,1421,240,1181
2021,Basingstoke and Deane 017E,E01022562,1370,241,1129
2021,Basingstoke and Deane 020B,E01022563,1769,315,1454
2021,Basingstoke and Deane 020C,E01022564,2023,398,1625
2021,Basingstoke and Deane 020D,E01022565,1776,326,1450
2021,Basingstoke and Deane 010B,E01022566,1195,203,992
2021,Basingstoke and Deane 010C,E01022567,1242,265,977
2021,Basingstoke and Deane 010D,E01022568,1286,203,1083
2021,Basingstoke and Deane 013E,E01022569,1405,228,1177
2021,Basingstoke and Deane 010E,E01022570,1453,204,1249
2021,East Hampshire 003A,E01022571,1060,179,881
2021,East Hampshire 003B,E01022572,1118,162,956
2021,East Hampshire 003C,E01022573,2291,349,1942
2021,East Hampshire 002A,E01022574,1488,204,1284
2021,East Hampshire 002B,E01022575,1460,359,1101
2021,East Hampshire 002C,E01022576,1482,162,1320
2021,East Hampshire 003D,E01022577,1387,176,1211
2021,East Hampshire 002D,E01022579,1750,364,1386
2021,East Hampshire 003F,E01022580,1144,134,1010
2021,East Hampshire 001A,E01022581,1746,338,1408
2021,East Hampshire 001B,E01022582,1430,286,1144
2021,East Hampshire 009A,E01022583,1762,363,1399
2021,East Hampshire 009B,E01022584,1759,312,1447
2021,East Hampshire 009C,E01022585,1834,330,1504
2021,East Hampshire 009D,E01022586,1983,409,1574
2021,East Hampshire 009E,E01022587,1986,415,1571
2021,East Hampshire 013A,E01022588,2498,490,2008
2021,East Hampshire 013B,E01022589,1937,366,1571
2021,East Hampshire 013C,E01022590,1450,224,1226
2021,East Hampshire 007A,E01022591,2485,367,2118
2021,East Hampshire 011A,E01022592,2195,353,1842
2021,East Hampshire 007B,E01022593,1398,241,1157
2021,East Hampshire 007C,E01022594,1828,333,1495
2021,East Hampshire 007D,E01022595,2356,511,1845
2021,East Hampshire 007E,E01022596,1817,304,1513
2021,East Hampshire 011B,E01022597,2779,753,2026
2021,East Hampshire 017A,E01022599,1293,174,1119
2021,East Hampshire 017B,E01022600,1439,198,1241
2021,East Hampshire 017C,E01022601,1311,183,1128
2021,East Hampshire 017D,E01022602,1298,204,1094
2021,East Hampshire 004A,E01022603,1341,280,1061
2021,East Hampshire 001C,E01022604,1338,237,1101
2021,East Hampshire 001D,E01022605,2018,438,1580
2021,East Hampshire 014A,E01022606,2363,384,1979
2021,East Hampshire 013D,E01022607,1131,171,960
2021,East Hampshire 013E,E01022608,1279,204,1075
2021,East Hampshire 016A,E01022610,1767,304,1463
2021,East Hampshire 014B,E01022611,1471,246,1225
2021,East Hampshire 014C,E01022613,1363,246,1117
2021,East Hampshire 014D,E01022614,1065,190,875
2021,East Hampshire 006A,E01022615,2578,399,2179
2021,East Hampshire 010A,E01022616,1606,287,1319
2021,East Hampshire 010B,E01022617,1664,292,1372
2021,East Hampshire 010C,E01022618,1749,311,1438
2021,East Hampshire 011C,E01022619,1149,184,965
2021,East Hampshire 012A,E01022620,1110,204,906
2021,East Hampshire 012B,E01022621,1367,309,1058
2021,East Hampshire 012C,E01022622,2128,434,1694
2021,East Hampshire 012D,E01022623,2156,443,1713
2021,East Hampshire 011D,E01022624,2161,347,1814
2021,East Hampshire 011E,E01022625,2513,430,2083
2021,East Hampshire 007F,E01022627,2220,391,1829
2021,East Hampshire 016B,E01022628,1364,222,1142
2021,East Hampshire 016C,E01022629,1488,183,1305
2021,East Hampshire 008A,E01022630,2169,347,1822
2021,East Hampshire 010D,E01022631,1203,197,1006
2021,East Hampshire 010E,E01022632,1087,186,901
2021,East Hampshire 006B,E01022633,1206,168,1038
2021,East Hampshire 004B,E01022634,1056,156,900
2021,East Hampshire 006C,E01022635,1352,295,1057
2021,East Hampshire 006D,E01022636,1240,197,1043
2021,East Hampshire 004C,E01022639,1496,291,1205
2021,East Hampshire 004D,E01022640,2424,460,1964
2021,East Hampshire 006E,E01022641,1188,203,985
2021,East Hampshire 008D,E01022642,987,159,828
2021,Eastleigh 005A,E01022643,1447,223,1224
2021,Eastleigh 005B,E01022644,1158,201,957
2021,Eastleigh 008A,E01022645,1079,120,959
2021,Eastleigh 005C,E01022646,1401,215,1186
2021,Eastleigh 005D,E01022647,1657,300,1357
2021,Eastleigh 004A,E01022648,1575,221,1354
2021,Eastleigh 005E,E01022649,1445,313,1132
2021,Eastleigh 005F,E01022650,1141,217,924
2021,Eastleigh 012A,E01022651,1646,250,1396
2021,Eastleigh 011A,E01022652,1666,304,1362
2021,Eastleigh 013A,E01022654,1233,197,1036
2021,Eastleigh 013B,E01022655,1376,328,1048
2021,Eastleigh 013C,E01022656,2247,403,1844
2021,Eastleigh 013D,E01022657,2560,480,2080
2021,Eastleigh 013E,E01022658,1620,226,1394
2021,Eastleigh 002A,E01022659,1427,280,1147
2021,Eastleigh 002B,E01022660,1393,271,1122
2021,Eastleigh 003A,E01022661,1600,176,1424
2021,Eastleigh 003B,E01022662,1304,229,1075
2021,Eastleigh 003C,E01022663,1534,277,1257
2021,Eastleigh 003D,E01022664,1457,261,1196
2021,Eastleigh 003E,E01022665,1302,172,1130
2021,Eastleigh 007A,E01022666,1954,299,1655
2021,Eastleigh 004B,E01022667,1958,411,1547
2021,Eastleigh 007B,E01022669,1649,287,1362
2021,Eastleigh 007C,E01022670,1372,261,1111
2021,Eastleigh 007D,E01022671,1392,229,1163
2021,Eastleigh 004C,E01022672,1407,240,1167
2021,Eastleigh 004D,E01022673,2123,413,1710
2021,Eastleigh 004E,E01022674,1407,200,1207
2021,Eastleigh 002C,E01022675,1277,184,1093
2021,Eastleigh 002D,E01022676,1747,308,1439
2021,Eastleigh 006C,E01022678,1892,358,1534
2021,Eastleigh 007E,E01022679,1813,347,1466
2021,Eastleigh 006D,E01022680,1629,291,1338
2021,Eastleigh 006E,E01022681,1676,373,1303
2021,Eastleigh 008B,E01022682,1756,294,1462
2021,Eastleigh 008C,E01022683,2113,481,1632
2021,Eastleigh 008D,E01022684,1354,213,1141
2021,Eastleigh 008E,E01022685,1073,144,929
2021,Eastleigh 008F,E01022686,1897,353,1544
2021,Eastleigh 008G,E01022687,1585,292,1293
2021,Eastleigh 015A,E01022688,2115,292,1823
2021,Eastleigh 015B,E01022689,1823,275,1548
2021,Eastleigh 015C,E01022690,1782,342,1440
2021,Eastleigh 010B,E01022691,1419,300,1119
2021,Eastleigh 010D,E01022693,1378,317,1061
2021,Eastleigh 010E,E01022694,1655,417,1238
2021,Eastleigh 011B,E01022695,1182,165,1017
2021,Eastleigh 012B,E01022696,1437,219,1218
2021,Eastleigh 012C,E01022697,1523,268,1255
2021,Eastleigh 012D,E01022698,1880,342,1538
2021,Eastleigh 012E,E01022699,1635,304,1331
2021,Eastleigh 011C,E01022700,1460,308,1152
2021,Eastleigh 011D,E01022701,1008,175,833
2021,Eastleigh 012F,E01022702,1224,230,994
2021,Eastleigh 011E,E01022703,1355,227,1128
2021,Eastleigh 002E,E01022704,1781,397,1384
2021,Eastleigh 001A,E01022705,1593,306,1287
2021,Eastleigh 001B,E01022706,1644,374,1270
2021,Eastleigh 001C,E01022707,1860,427,1433
2021,Eastleigh 001D,E01022708,1680,376,1304
2021,Eastleigh 001E,E01022709,1673,365,1308
2021,Eastleigh 014A,E01022710,1996,268,1728
2021,Eastleigh 014B,E01022711,1684,312,1372
2021,Eastleigh 014C,E01022712,1537,261,1276
2021,Eastleigh 009A,E01022713,1951,295,1656
2021,Eastleigh 009B,E01022714,1555,220,1335
2021,Eastleigh 009C,E01022715,1821,291,1530
2021,Eastleigh 009D,E01022716,1386,188,1198
2021,Eastleigh 009E,E01022717,1117,163,954
2021,Eastleigh 009F,E01022718,1471,270,1201
2021,Eastleigh 009G,E01022719,1531,199,1332
2021,Fareham 004A,E01022720,1429,256,1173
2021,Fareham 008A,E01022721,1467,206,1261
2021,Fareham 008B,E01022722,1558,244,1314
2021,Fareham 008C,E01022723,1434,187,1247
2021,Fareham 008D,E01022724,1308,222,1086
2021,Fareham 004B,E01022725,1226,176,1050
2021,Fareham 004C,E01022726,1377,197,1180
2021,Fareham 004D,E01022727,1450,214,1236
2021,Fareham 011A,E01022728,1559,232,1327
2021,Fareham 004E,E01022729,1097,190,907
2021,Fareham 003A,E01022730,1430,207,1223
2021,Fareham 003B,E01022731,1187,188,999
2021,Fareham 003C,E01022732,1378,253,1125
2021,Fareham 003D,E01022733,1569,228,1341
2021,Fareham 003E,E01022734,1327,247,1080
2021,Fareham 011B,E01022735,1658,282,1376
2021,Fareham 011C,E01022736,1481,266,1215
2021,Fareham 008E,E01022737,1474,228,1246
2021,Fareham 011D,E01022738,953,132,821
2021,Fareham 011E,E01022739,1461,343,1118
2021,Fareham 009A,E01022740,1508,213,1295
2021,Fareham 009B,E01022741,1353,247,1106
2021,Fareham 009C,E01022742,1622,109,1513
2021,Fareham 004F,E01022743,1747,240,1507
2021,Fareham 014A,E01022744,1254,164,1090
2021,Fareham 014B,E01022745,1499,235,1264
2021,Fareham 014C,E01022746,1604,261,1343
2021,Fareham 014D,E01022747,1154,167,987
2021,Fareham 014E,E01022748,1326,212,1114
2021,Fareham 002A,E01022749,1265,204,1061
2021,Fareham 005A,E01022750,1361,172,1189
2021,Fareham 005B,E01022751,1484,238,1246
2021,Fareham 005C,E01022752,1304,217,1087
2021,Fareham 002B,E01022753,1093,187,906
2021,Fareham 002C,E01022754,2169,354,1815
2021,Fareham 006A,E01022755,1571,312,1259
2021,Fareham 006B,E01022756,1669,313,1356
2021,Fareham 005D,E01022757,1479,268,1211
2021,Fareham 001A,E01022758,2064,430,1634
2021,Fareham 010A,E01022759,1502,234,1268
2021,Fareham 012A,E01022760,1456,243,1213
2021,Fareham 012B,E01022761,1367,176,1191
2021,Fareham 012C,E01022762,1380,212,1168
2021,Fareham 010B,E01022763,1468,175,1293
2021,Fareham 012D,E01022764,1473,160,1313
2021,Fareham 010C,E01022765,1686,265,1421
2021,Fareham 008F,E01022766,1207,160,1047
2021,Fareham 012E,E01022767,1240,250,990
2021,Fareham 010D,E01022768,1290,206,1084
2021,Fareham 008G,E01022769,1234,220,1014
2021,Fareham 010E,E01022770,1848,319,1529
2021,Fareham 001B,E01022771,1591,412,1179
2021,Fareham 001C,E01022772,2397,583,1814
2021,Fareham 001D,E01022773,1628,309,1319
2021,Fareham 001E,E01022774,2021,406,1615
2021,Fareham 013B,E01022776,1441,208,1233
2021,Fareham 013C,E01022777,1523,203,1320
2021,Fareham 013D,E01022778,1347,199,1148
2021,Fareham 002D,E01022780,1615,323,1292
2021,Fareham 007A,E01022781,1293,247,1046
2021,Fareham 007B,E01022782,1524,205,1319
2021,Fareham 009D,E01022783,1378,178,1200
2021,Fareham 009E,E01022784,1293,224,1069
2021,Fareham 007C,E01022785,1362,210,1152
2021,Fareham 007D,E01022786,2030,372,1658
2021,Fareham 002E,E01022787,1301,212,1089
2021,Fareham 002F,E01022788,1183,219,964
2021,Fareham 007E,E01022789,1422,240,1182
2021,Fareham 005E,E01022790,1628,258,1370
2021,Fareham 006C,E01022791,1794,284,1510
2021,Fareham 006D,E01022792,1542,245,1297
2021,Fareham 006E,E01022793,1846,337,1509
2021,Gosport 009A,E01022794,1445,215,1230
2021,Gosport 009B,E01022795,1484,214,1270
2021,Gosport 009C,E01022796,1301,220,1081
2021,Gosport 010A,E01022797,1085,166,919
2021,Gosport 010B,E01022798,1417,172,1245
2021,Gosport 010C,E01022799,1349,216,1133
2021,Gosport 001A,E01022800,1475,288,1187
2021,Gosport 001B,E01022801,1382,275,1107
2021,Gosport 001C,E01022802,1451,255,1196
2021,Gosport 001D,E01022803,1514,273,1241
2021,Gosport 002A,E01022804,1496,237,1259
2021,Gosport 002B,E01022805,1298,202,1096
2021,Gosport 007A,E01022806,1276,204,1072
2021,Gosport 005A,E01022807,1283,187,1096
2021,Gosport 008A,E01022810,1415,185,1230
2021,Gosport 010D,E01022812,1129,201,928
2021,Gosport 003A,E01022813,1269,219,1050
2021,Gosport 003B,E01022814,1549,248,1301
2021,Gosport 003C,E01022815,1441,264,1177
2021,Gosport 005B,E01022816,1295,218,1077
2021,Gosport 005C,E01022817,1634,317,1317
2021,Gosport 005D,E01022818,1374,283,1091
2021,Gosport 004A,E01022819,1503,342,1161
2021,Gosport 004B,E01022820,1554,440,1114
2021,Gosport 003D,E01022823,1411,211,1200
2021,Gosport 003E,E01022825,1257,206,1051
2021,Gosport 006A,E01022826,1426,206,1220
2021,Gosport 006C,E01022828,1239,103,1136
2021,Gosport 006D,E01022829,2453,446,2007
2021,Gosport 006E,E01022830,1301,155,1146
2021,Gosport 010E,E01022831,1260,187,1073
2021,Gosport 007D,E01022832,1538,306,1232
2021,Gosport 008C,E01022833,1596,314,1282
2021,Gosport 002C,E01022834,1203,147,1056
2021,Gosport 002D,E01022835,1272,197,1075
2021,Gosport 001E,E01022836,1360,176,1184
2021,Gosport 009D,E01022837,1463,280,1183
2021,Gosport 009E,E01022838,1234,224,1010
2021,Gosport 007E,E01022839,1223,168,1055
2021,Gosport 002E,E01022840,1427,286,1141
2021,Gosport 004E,E01022841,1414,269,1145
2021,Gosport 004F,E01022842,1482,384,1098
2021,Gosport 008D,E01022843,1425,316,1109
2021,Gosport 010F,E01022845,1305,187,1118
2021,Hart 003A,E01022846,2434,326,2108
2021,Hart 003B,E01022847,1706,274,1432
2021,Hart 003C,E01022848,1456,229,1227
2021,Hart 009A,E01022849,1601,323,1278
2021,Hart 009B,E01022850,1411,283,1128
2021,Hart 009C,E01022851,1566,306,1260
2021,Hart 010A,E01022852,1688,301,1387
2021,Hart 009D,E01022853,1792,368,1424
2021,Hart 010B,E01022854,1528,288,1240
2021,Hart 010C,E01022855,1155,238,917
2021,Hart 010D,E01022856,1607,313,1294
2021,Hart 004A,E01022858,1181,226,955
2021,Hart 002A,E01022859,1618,349,1269
2021,Hart 005A,E01022860,1943,266,1677
2021,Hart 007A,E01022861,1563,299,1264
2021,Hart 005B,E01022862,2122,301,1821
2021,Hart 007B,E01022863,1521,304,1217
2021,Hart 008A,E01022864,1405,267,1138
2021,Hart 007C,E01022865,1572,298,1274
2021,Hart 005D,E01022867,1502,226,1276
2021,Hart 007D,E01022868,1619,307,1312
2021,Hart 009E,E01022869,1456,275,1181
2021,Hart 007E,E01022870,1323,222,1101
2021,Hart 008B,E01022871,1259,246,1013
2021,Hart 008C,E01022872,1710,341,1369
2021,Hart 003D,E01022874,1230,213,1017
2021,Hart 003E,E01022875,1352,309,1043
2021,Hart 003F,E01022876,1451,267,1184
2021,Hart 003G,E01022877,1360,221,1139
2021,Hart 004B,E01022878,1617,277,1340
2021,Hart 004C,E01022879,2032,327,1705
2021,Hart 004D,E01022880,1994,407,1587
2021,Hart 006A,E01022881,2615,552,2063
2021,Hart 006B,E01022882,2307,477,1830
2021,Hart 006C,E01022883,1313,249,1064
2021,Hart 006D,E01022884,1504,269,1235
2021,Hart 006E,E01022885,1341,274,1067
2021,Hart 008E,E01022887,1478,215,1263
2021,Hart 011B,E01022888,2046,338,1708
2021,Hart 011C,E01022889,1448,260,1188
2021,Hart 001A,E01022890,1406,234,1172
2021,Hart 001B,E01022891,1749,294,1455
2021,Hart 001C,E01022892,1821,251,1570
2021,Hart 001D,E01022893,1717,293,1424
2021,Hart 001E,E01022894,1331,217,1114
2021,Hart 002B,E01022895,1593,252,1341
2021,Hart 002C,E01022896,1437,258,1179
2021,Hart 002D,E01022897,1518,265,1253
2021,Hart 002E,E01022898,1413,288,1125
2021,Havant 018A,E01022899,1291,278,1013
2021,Havant 010A,E01022900,1665,346,1319
2021,Havant 006A,E01022901,1706,361,1345
2021,Havant 006B,E01022902,1406,293,1113
2021,Havant 008A,E01022903,1584,317,1267
2021,Havant 010B,E01022904,1978,390,1588
2021,Havant 010C,E01022905,1590,294,1296
2021,Havant 008B,E01022906,1332,283,1049
2021,Havant 018B,E01022907,1477,198,1279
2021,Havant 010D,E01022908,1389,237,1152
2021,Havant 018C,E01022909,1683,274,1409
2021,Havant 018D,E01022910,1394,213,1181
2021,Havant 018E,E01022911,1463,226,1237
2021,Havant 009A,E01022913,1191,275,916
2021,Havant 009B,E01022914,1206,239,967
2021,Havant 009C,E01022915,1411,327,1084
2021,Havant 009D,E01022916,1492,305,1187
2021,Havant 009E,E01022917,1093,206,887
2021,Havant 020A,E01022918,1441,210,1231
2021,Havant 019A,E01022919,1489,245,1244
2021,Havant 020B,E01022920,1523,216,1307
2021,Havant 020C,E01022921,1448,223,1225
2021,Havant 004A,E01022922,1373,225,1148
2021,Havant 013A,E01022924,1462,207,1255
2021,Havant 013B,E01022925,2073,419,1654
2021,Havant 013C,E01022926,1665,315,1350
2021,Havant 013D,E01022927,1567,205,1362
2021,Havant 013E,E01022928,1656,174,1482
2021,Havant 013F,E01022929,1427,129,1298
2021,Havant 003A,E01022930,1658,155,1503
2021,Havant 003B,E01022931,1538,237,1301
2021,Havant 019B,E01022933,1450,318,1132
2021,Havant 019C,E01022934,1678,350,1328
2021,Havant 003C,E01022935,1414,184,1230
2021,Havant 017A,E01022936,1418,118,1300
2021,Havant 015A,E01022937,1257,198,1059
2021,Havant 017B,E01022938,1649,237,1412
2021,Havant 017C,E01022939,1490,196,1294
2021,Havant 016A,E01022940,1503,174,1329
2021,Havant 017D,E01022941,1415,146,1269
2021,Havant 016B,E01022942,1400,168,1232
2021,Havant 015B,E01022943,1350,89,1261
2021,Havant 015C,E01022944,1243,165,1078
2021,Havant 016C,E01022945,2164,265,1899
2021,Havant 015D,E01022946,1937,280,1657
2021,Havant 011A,E01022947,1561,248,1313
2021,Havant 011B,E01022948,1566,244,1322
2021,Havant 011C,E01022949,1401,224,1177
2021,Havant 011D,E01022950,1707,281,1426
2021,Havant 011E,E01022951,1322,202,1120
2021,Havant 011F,E01022952,1372,208,1164
2021,Havant 014B,E01022954,1509,190,1319
2021,Havant 014C,E01022955,1519,233,1286
2021,Havant 014D,E01022956,1091,208,883
2021,Havant 014E,E01022957,1252,215,1037
2021,Havant 014F,E01022958,2167,422,1745
2021,Havant 005A,E01022959,1369,322,1047
2021,Havant 007A,E01022960,1214,245,969
2021,Havant 007B,E01022961,1212,256,956
2021,Havant 005B,E01022962,2001,370,1631
2021,Havant 007C,E01022963,1370,210,1160
2021,Havant 007D,E01022964,1272,234,1038
2021,Havant 005C,E01022965,1324,247,1077
2021,Havant 006C,E01022966,1257,296,961
2021,Havant 006D,E01022967,1068,269,799
2021,Havant 008C,E01022968,1310,327,983
2021,Havant 008D,E01022969,1684,450,1234
2021,Havant 010E,E01022970,1752,472,1280
2021,Havant 004B,E01022971,1388,168,1220
2021,Havant 004C,E01022972,1747,301,1446
2021,Havant 005D,E01022973,2046,255,1791
2021,Havant 004D,E01022974,1284,165,1119
2021,Havant 003D,E01022975,1897,312,1585
2021,Havant 003E,E01022976,1371,173,1198
2021,New Forest 006A,E01022977,1397,196,1201
2021,New Forest 006B,E01022978,1535,232,1303
2021,New Forest 006C,E01022979,1091,128,963
2021,New Forest 006D,E01022980,1439,227,1212
2021,New Forest 022A,E01022981,1864,116,1748
2021,New Forest 022B,E01022982,1851,156,1695
2021,New Forest 022C,E01022983,1578,139,1439
2021,New Forest 018A,E01022984,1421,161,1260
2021,New Forest 018B,E01022985,1134,160,974
2021,New Forest 021A,E01022986,1377,176,1201
2021,New Forest 022D,E01022987,1977,179,1798
2021,New Forest 021B,E01022988,1386,232,1154
2021,New Forest 015A,E01022989,1720,254,1466
2021,New Forest 017A,E01022990,1501,315,1186
2021,New Forest 015B,E01022991,2062,299,1763
2021,New Forest 007A,E01022992,1126,146,980
2021,New Forest 007B,E01022993,1295,141,1154
2021,New Forest 016A,E01022994,1454,223,1231
2021,New Forest 016B,E01022995,1361,279,1082
2021,New Forest 016C,E01022996,1157,165,992
2021,New Forest 016D,E01022997,1270,174,1096
2021,New Forest 015C,E01022998,1689,250,1439
2021,New Forest 017B,E01022999,2012,320,1692
2021,New Forest 015D,E01023000,1685,261,1424
2021,New Forest 019A,E01023001,1921,324,1597
2021,New Forest 019B,E01023002,1603,246,1357
2021,New Forest 011A,E01023003,1667,244,1423
2021,New Forest 011B,E01023004,1726,296,1430
2021,New Forest 011C,E01023005,1401,172,1229
2021,New Forest 011D,E01023006,1295,348,947
2021,New Forest 008A,E01023007,1051,145,906
2021,New Forest 009A,E01023008,1537,119,1418
2021,New Forest 009B,E01023009,1378,233,1145
2021,New Forest 008B,E01023010,1316,256,1060
2021,New Forest 001A,E01023011,1449,219,1230
2021,New Forest 001B,E01023012,1305,138,1167
2021,New Forest 014A,E01023013,1331,200,1131
2021,New Forest 014B,E01023014,1591,216,1375
2021,New Forest 014C,E01023015,1348,191,1157
2021,New Forest 014D,E01023016,1306,139,1167
2021,New Forest 020A,E01023017,1877,329,1548
2021,New Forest 020B,E01023018,1413,227,1186
2021,New Forest 020C,E01023019,1312,193,1119
2021,New Forest 018C,E01023020,1377,159,1218
2021,New Forest 001C,E01023021,1489,271,1218
2021,New Forest 001D,E01023022,1745,223,1522
2021,New Forest 001E,E01023023,1605,245,1360
2021,New Forest 001F,E01023024,1637,257,1380
2021,New Forest 001G,E01023025,1278,148,1130
2021,New Forest 010A,E01023026,1143,164,979
2021,New Forest 014E,E01023027,1353,227,1126
2021,New Forest 011E,E01023028,1927,361,1566
2021,New Forest 013A,E01023029,1574,447,1127
2021,New Forest 013B,E01023030,1196,239,957
2021,New Forest 014F,E01023031,1137,144,993
2021,New Forest 013C,E01023032,1264,202,1062
2021,New Forest 013D,E01023033,1229,244,985
2021,New Forest 018D,E01023034,1735,269,1466
2021,New Forest 018E,E01023035,1693,236,1457
2021,New Forest 018F,E01023036,1952,233,1719
2021,New Forest 011F,E01023037,1892,305,1587
2021,New Forest 009C,E01023038,1336,184,1152
2021,New Forest 009D,E01023039,1344,201,1143
2021,New Forest 009E,E01023040,1396,178,1218
2021,New Forest 017C,E01023041,1556,208,1348
2021,New Forest 017D,E01023042,1588,118,1470
2021,New Forest 017E,E01023043,1586,211,1375
2021,New Forest 023A,E01023044,1076,122,954
2021,New Forest 007C,E01023045,1520,248,1272
2021,New Forest 007D,E01023046,1410,181,1229
2021,New Forest 008C,E01023047,1164,186,978
2021,New Forest 008D,E01023048,1260,231,1029
2021,New Forest 008E,E01023049,1395,250,1145
2021,New Forest 008F,E01023050,1630,353,1277
2021,New Forest 023B,E01023051,1452,231,1221
2021,New Forest 023C,E01023052,1690,119,1571
2021,New Forest 023D,E01023053,1652,161,1491
2021,New Forest 021C,E01023054,1736,194,1542
2021,New Forest 020D,E01023055,1257,287,970
2021,New Forest 021D,E01023056,1428,126,1302
2021,New Forest 021E,E01023057,1684,214,1470
2021,New Forest 019C,E01023058,1349,222,1127
2021,New Forest 023E,E01023059,1671,193,1478
2021,New Forest 019D,E01023060,1487,242,1245
2021,New Forest 019E,E01023061,1374,239,1135
2021,New Forest 010B,E01023062,1431,273,1158
2021,New Forest 016E,E01023063,1412,331,1081
2021,New Forest 010C,E01023064,1292,244,1048
2021,New Forest 012A,E01023065,1541,286,1255
2021,New Forest 010D,E01023066,1645,274,1371
2021,New Forest 010E,E01023067,1448,281,1167
2021,New Forest 012B,E01023068,1219,233,986
2021,New Forest 012C,E01023069,1790,304,1486
2021,New Forest 012D,E01023070,1738,212,1526
2021,New Forest 012E,E01023071,1388,225,1163
2021,New Forest 005A,E01023072,1191,199,992
2021,New Forest 003A,E01023073,1195,202,993
2021,New Forest 004A,E01023074,1295,184,1111
2021,New Forest 005B,E01023075,1287,228,1059
2021,New Forest 002A,E01023076,1364,170,1194
2021,New Forest 004B,E01023077,1605,275,1330
2021,New Forest 004C,E01023078,1387,194,1193
2021,New Forest 004D,E01023079,1656,286,1370
2021,New Forest 003B,E01023080,1370,271,1099
2021,New Forest 003C,E01023081,1919,389,1530
2021,New Forest 002B,E01023082,1294,210,1084
2021,New Forest 002C,E01023083,1386,232,1154
2021,New Forest 005C,E01023084,1407,258,1149
2021,New Forest 004E,E01023085,1392,259,1133
2021,New Forest 005D,E01023086,1465,281,1184
2021,New Forest 005E,E01023087,1324,239,1085
2021,New Forest 002D,E01023088,1510,293,1217
2021,New Forest 003D,E01023089,1404,194,1210
2021,New Forest 003E,E01023090,1721,303,1418
2021,Rushmoor 006A,E01023091,1694,400,1294
2021,Rushmoor 005A,E01023092,1335,236,1099
2021,Rushmoor 005B,E01023093,1229,202,1027
2021,Rushmoor 006B,E01023094,1245,221,1024
2021,Rushmoor 006C,E01023095,1801,346,1455
2021,Rushmoor 004A,E01023096,2207,378,1829
2021,Rushmoor 004B,E01023097,1454,209,1245
2021,Rushmoor 006D,E01023098,1593,232,1361
2021,Rushmoor 001A,E01023099,1546,281,1265
2021,Rushmoor 003A,E01023100,1136,218,918
2021,Rushmoor 003B,E01023101,1190,199,991
2021,Rushmoor 003C,E01023102,1358,224,1134
2021,Rushmoor 004C,E01023103,1489,221,1268
2021,Rushmoor 001B,E01023104,1558,257,1301
2021,Rushmoor 002A,E01023105,1530,275,1255
2021,Rushmoor 001C,E01023106,1413,242,1171
2021,Rushmoor 012A,E01023107,1410,263,1147
2021,Rushmoor 012B,E01023108,1461,273,1188
2021,Rushmoor 011A,E01023109,1482,260,1222
2021,Rushmoor 012C,E01023110,1740,348,1392
2021,Rushmoor 004D,E01023111,1748,276,1472
2021,Rushmoor 004E,E01023112,1211,286,925
2021,Rushmoor 007A,E01023113,1783,257,1526
2021,Rushmoor 007B,E01023114,1385,330,1055
2021,Rushmoor 011B,E01023115,1376,241,1135
2021,Rushmoor 011C,E01023116,1832,293,1539
2021,Rushmoor 011D,E01023117,1691,295,1396
2021,Rushmoor 009A,E01023118,1788,277,1511
2021,Rushmoor 002B,E01023119,1180,263,917
2021,Rushmoor 002C,E01023120,1657,315,1342
2021,Rushmoor 001D,E01023121,1871,337,1534
2021,Rushmoor 002D,E01023122,1410,307,1103
2021,Rushmoor 012D,E01023123,1488,289,1199
2021,Rushmoor 009B,E01023124,1224,212,1012
2021,Rushmoor 009C,E01023125,2217,377,1840
2021,Rushmoor 010A,E01023128,1318,201,1117
2021,Rushmoor 010B,E01023129,1340,204,1136
2021,Rushmoor 010C,E01023130,1339,259,1080
2021,Rushmoor 010D,E01023131,1432,226,1206
2021,Rushmoor 005C,E01023132,1467,248,1219
2021,Rushmoor 005D,E01023133,1208,226,982
2021,Rushmoor 003D,E01023134,1629,277,1352
2021,Rushmoor 005E,E01023135,2312,488,1824
2021,Rushmoor 007C,E01023136,2572,467,2105
2021,Rushmoor 007D,E01023137,1284,255,1029
2021,Rushmoor 007E,E01023138,1374,199,1175
2021,Rushmoor 007F,E01023139,1178,205,973
2021,Rushmoor 007G,E01023140,1787,306,1481
2021,Rushmoor 008A,E01023141,1920,334,1586
2021,Rushmoor 008D,E01023144,1806,248,1558
2021,Rushmoor 010E,E01023145,2135,270,1865
2021,Rushmoor 002E,E01023146,1304,274,1030
2021,Rushmoor 003E,E01023147,1463,232,1231
2021,Rushmoor 006E,E01023148,1259,179,1080
2021,Rushmoor 006F,E01023149,1279,182,1097
2021,Test Valley 011A,E01023150,1618,204,1414
2021,Test Valley 011B,E01023151,1319,146,1173
2021,Test Valley 011C,E01023152,1616,152,1464
2021,Test Valley 002A,E01023153,1623,308,1315
2021,Test Valley 002B,E01023154,1524,357,1167
2021,Test Valley 002C,E01023156,1305,372,933
2021,Test Valley 002D,E01023157,1254,269,985
2021,Test Valley 012A,E01023158,2327,397,1930
2021,Test Valley 007A,E01023159,2241,378,1863
2021,Test Valley 008A,E01023160,1451,317,1134
2021,Test Valley 013A,E01023162,1782,292,1490
2021,Test Valley 013B,E01023163,1567,228,1339
2021,Test Valley 013C,E01023164,1481,223,1258
2021,Test Valley 001A,E01023165,2041,360,1681
2021,Test Valley 009A,E01023166,1513,236,1277
2021,Test Valley 009B,E01023167,1496,194,1302
2021,Test Valley 008B,E01023168,1374,172,1202
2021,Test Valley 001B,E01023169,2017,300,1717
2021,Test Valley 015A,E01023170,2384,423,1961
2021,Test Valley 015B,E01023171,1739,308,1431
2021,Test Valley 015C,E01023172,1431,224,1207
2021,Test Valley 015D,E01023173,1353,216,1137
2021,Test Valley 010A,E01023174,1563,250,1313
2021,Test Valley 010B,E01023175,1477,199,1278
2021,Test Valley 010C,E01023176,1479,203,1276
2021,Test Valley 009C,E01023177,2169,378,1791
2021,Test Valley 008C,E01023178,2194,400,1794
2021,Test Valley 004A,E01023179,1761,352,1409
2021,Test Valley 005B,E01023180,1579,275,1304
2021,Test Valley 001C,E01023181,1263,232,1031
2021,Test Valley 001D,E01023182,1417,233,1184
2021,Test Valley 004B,E01023183,1337,256,1081
2021,Test Valley 009D,E01023184,1341,197,1144
2021,Test Valley 009E,E01023185,1156,185,971
2021,Test Valley 005C,E01023186,1584,276,1308
2021,Test Valley 006A,E01023187,1491,236,1255
2021,Test Valley 006B,E01023188,1199,203,996
2021,Test Valley 005D,E01023189,1811,244,1567
2021,Test Valley 004C,E01023190,1171,169,1002
2021,Test Valley 012B,E01023191,1733,291,1442
2021,Test Valley 012C,E01023192,1782,364,1418
2021,Test Valley 012D,E01023193,1762,307,1455
2021,Test Valley 012E,E01023194,1371,180,1191
2021,Test Valley 007B,E01023195,1923,386,1537
2021,Test Valley 005E,E01023196,1626,239,1387
2021,Test Valley 007C,E01023197,1371,232,1139
2021,Test Valley 007D,E01023198,1391,200,1191
2021,Test Valley 012F,E01023200,1440,236,1204
2021,Test Valley 018A,E01023202,1875,191,1684
2021,Test Valley 004D,E01023203,1364,190,1174
2021,Test Valley 004E,E01023204,1513,242,1271
2021,Test Valley 002E,E01023205,1228,320,908
2021,Test Valley 011D,E01023206,1113,162,951
2021,Test Valley 010D,E01023207,1478,246,1232
2021,Test Valley 010E,E01023208,1033,188,845
2021,Test Valley 010F,E01023209,1193,206,987
2021,Test Valley 014A,E01023210,1430,342,1088
2021,Test Valley 014B,E01023211,1790,487,1303
2021,Test Valley 014C,E01023212,1347,209,1138
2021,Test Valley 014D,E01023213,1214,222,992
2021,Test Valley 014E,E01023214,1214,223,991
2021,Test Valley 018C,E01023215,1612,265,1347
2021,Test Valley 006C,E01023216,1808,275,1533
2021,Test Valley 006D,E01023217,1521,203,1318
2021,Test Valley 006E,E01023218,1449,242,1207
2021,Test Valley 018B,E01023219,1337,208,1129
2021,Winchester 012A,E01023220,1875,310,1565
2021,Winchester 012B,E01023221,1759,229,1530
2021,Winchester 012C,E01023222,1509,233,1276
2021,Winchester 012D,E01023223,1471,264,1207
2021,Winchester 004A,E01023225,2152,374,1778
2021,Winchester 010A,E01023226,1595,389,1206
2021,Winchester 010B,E01023227,1923,386,1537
2021,Winchester 010C,E01023228,2165,415,1750
2021,Winchester 009A,E01023229,2009,397,1612
2021,Winchester 010D,E01023230,2032,424,1608
2021,Winchester 014B,E01023231,1786,278,1508
2021,Winchester 014C,E01023232,2684,535,2149
2021,Winchester 014D,E01023233,1735,273,1462
2021,Winchester 014E,E01023234,1477,236,1241
2021,Winchester 011A,E01023235,2028,326,1702
2021,Winchester 002A,E01023236,1942,383,1559
2021,Winchester 002B,E01023237,1366,254,1112
2021,Winchester 002C,E01023238,1701,264,1437
2021,Winchester 002D,E01023239,1599,306,1293
2021,Winchester 003A,E01023240,2053,401,1652
2021,Winchester 003B,E01023241,1803,238,1565
2021,Winchester 009B,E01023242,1158,276,882
2021,Winchester 009C,E01023243,1190,219,971
2021,Winchester 009D,E01023244,1532,286,1246
2021,Winchester 013A,E01023245,2580,414,2166
2021,Winchester 010E,E01023246,1557,283,1274
2021,Winchester 005A,E01023247,1523,277,1246
2021,Winchester 003C,E01023248,1656,360,1296
2021,Winchester 005B,E01023249,1272,257,1015
2021,Winchester 005C,E01023250,1783,440,1343
2021,Winchester 006A,E01023251,1155,187,968
2021,Winchester 007A,E01023252,1755,266,1489
2021,Winchester 003D,E01023253,1928,427,1501
2021,Winchester 007B,E01023254,1726,318,1408
2021,Winchester 006B,E01023255,1620,428,1192
2021,Winchester 006C,E01023256,1471,440,1031
2021,Winchester 006D,E01023257,1522,271,1251
2021,Winchester 006E,E01023258,1514,487,1027
2021,Winchester 009E,E01023259,1993,610,1383
2021,Winchester 008A,E01023260,1248,510,738
2021,Winchester 008B,E01023261,1570,611,959
2021,Winchester 008C,E01023262,1511,763,748
2021,Winchester 007C,E01023263,2005,841,1164
2021,Winchester 007D,E01023264,1729,670,1059
2021,Winchester 007E,E01023265,1760,349,1411
2021,Winchester 008D,E01023266,2207,1232,975
2021,Winchester 007F,E01023267,1325,434,891
2021,Winchester 005D,E01023268,1159,308,851
2021,Winchester 005E,E01023269,2424,1127,1297
2021,Winchester 005F,E01023270,1459,301,1158
2021,Winchester 013B,E01023271,1215,210,1005
2021,Winchester 012E,E01023272,1490,262,1228
2021,Winchester 012F,E01023273,1578,289,1289
2021,Winchester 003E,E01023274,2515,701,1814
2021,Winchester 011B,E01023275,1621,352,1269
2021,Winchester 011C,E01023276,1659,320,1339
2021,Winchester 011D,E01023277,1198,180,1018
2021,Winchester 004B,E01023278,1474,227,1247
2021,Winchester 004C,E01023279,1389,238,1151
2021,Winchester 004D,E01023280,1508,284,1224
2021,Winchester 004E,E01023281,1690,245,1445
2021,Winchester 011E,E01023282,2049,359,1690
2021,Winchester 013E,E01023285,1523,282,1241
2021,Winchester 001A,E01023286,1423,243,1180
2021,Winchester 001B,E01023287,2766,548,2218
2021,Winchester 001C,E01023288,1367,240,1127
2021,Broxbourne 004A,E01023289,1496,314,1182
2021,Broxbourne 004B,E01023290,1584,297,1287
2021,Broxbourne 004C,E01023291,1552,257,1295
2021,Broxbourne 004D,E01023292,1488,274,1214
2021,Broxbourne 011A,E01023293,1645,333,1312
2021,Broxbourne 011B,E01023294,1765,354,1411
2021,Broxbourne 011C,E01023295,1318,230,1088
2021,Broxbourne 011D,E01023296,1819,400,1419
2021,Broxbourne 010A,E01023297,1288,247,1041
2021,Broxbourne 010B,E01023298,1472,232,1240
2021,Broxbourne 010C,E01023299,1623,309,1314
2021,Broxbourne 010D,E01023300,1484,349,1135
2021,Broxbourne 010E,E01023301,1695,344,1351
2021,Broxbourne 008A,E01023302,1378,263,1115
2021,Broxbourne 008B,E01023303,1452,262,1190
2021,Broxbourne 008C,E01023304,1454,249,1205
2021,Broxbourne 008D,E01023305,1323,265,1058
2021,Broxbourne 008E,E01023306,1391,231,1160
2021,Broxbourne 006A,E01023307,1458,284,1174
2021,Broxbourne 006B,E01023308,1589,287,1302
2021,Broxbourne 006C,E01023309,1562,288,1274
2021,Broxbourne 006D,E01023310,2659,619,2040
2021,Broxbourne 007A,E01023311,1719,282,1437
2021,Broxbourne 007B,E01023312,1500,226,1274
2021,Broxbourne 007C,E01023313,1560,251,1309
2021,Broxbourne 009A,E01023314,1514,309,1205
2021,Broxbourne 007D,E01023315,1671,331,1340
2021,Broxbourne 001A,E01023316,1311,227,1084
2021,Broxbourne 001B,E01023317,2531,574,1957
2021,Broxbourne 001C,E01023318,1547,319,1228
2021,Broxbourne 001D,E01023319,1495,221,1274
2021,Broxbourne 003A,E01023320,2088,328,1760
2021,Broxbourne 003B,E01023321,1896,266,1630
2021,Broxbourne 003C,E01023322,1817,366,1451
2021,Broxbourne 003D,E01023323,1613,288,1325
2021,Broxbourne 009B,E01023324,1263,269,994
2021,Broxbourne 009C,E01023325,1321,231,1090
2021,Broxbourne 009D,E01023326,1511,313,1198
2021,Broxbourne 002A,E01023327,1277,253,1024
2021,Broxbourne 002B,E01023328,1294,281,1013
2021,Broxbourne 002C,E01023329,1261,230,1031
2021,Broxbourne 002D,E01023330,1591,324,1267
2021,Broxbourne 002E,E01023331,1618,344,1274
2021,Broxbourne 012A,E01023332,2230,431,1799
2021,Broxbourne 012B,E01023333,1981,375,1606
2021,Broxbourne 012C,E01023334,1679,287,1392
2021,Broxbourne 012D,E01023335,1702,322,1380
2021,Broxbourne 013A,E01023336,1997,437,1560
2021,Broxbourne 013B,E01023337,1867,373,1494
2021,Broxbourne 013D,E01023339,1513,342,1171
2021,Broxbourne 005A,E01023340,1692,379,1313
2021,Broxbourne 005B,E01023341,1712,334,1378
2021,Broxbourne 005D,E01023343,1974,521,1453
2021,Broxbourne 005E,E01023344,1570,252,1318
2021,Dacorum 013A,E01023345,1810,291,1519
2021,Dacorum 013B,E01023346,2467,617,1850
2021,Dacorum 013C,E01023347,1358,223,1135
2021,Dacorum 013D,E01023348,1437,312,1125
2021,Dacorum 015A,E01023349,1795,388,1407
2021,Dacorum 015B,E01023350,1702,363,1339
2021,Dacorum 015C,E01023351,1601,327,1274
2021,Dacorum 004A,E01023352,2306,419,1887
2021,Dacorum 018B,E01023354,2243,412,1831
2021,Dacorum 006A,E01023355,1501,283,1218
2021,Dacorum 006B,E01023356,1083,205,878
2021,Dacorum 020A,E01023357,1576,357,1219
2021,Dacorum 020B,E01023358,1441,382,1059
2021,Dacorum 020C,E01023359,1736,432,1304
2021,Dacorum 020D,E01023360,1458,325,1133
2021,Dacorum 009A,E01023361,1581,172,1409
2021,Dacorum 009B,E01023362,1766,310,1456
2021,Dacorum 009C,E01023363,1445,288,1157
2021,Dacorum 009D,E01023364,1254,266,988
2021,Dacorum 014A,E01023365,1259,236,1023
2021,Dacorum 014B,E01023366,1441,315,1126
2021,Dacorum 014C,E01023367,1175,276,899
2021,Dacorum 014D,E01023368,1653,344,1309
2021,Dacorum 012A,E01023369,1435,322,1113
2021,Dacorum 012B,E01023370,1579,325,1254
2021,Dacorum 012C,E01023371,1639,385,1254
2021,Dacorum 012D,E01023372,1458,366,1092
2021,Dacorum 021A,E01023373,2094,202,1892
2021,Dacorum 021B,E01023374,1318,223,1095
2021,Dacorum 021C,E01023375,1499,286,1213
2021,Dacorum 021D,E01023376,1183,243,940
2021,Dacorum 021E,E01023377,1316,252,1064
2021,Dacorum 021F,E01023378,1701,317,1384
2021,Dacorum 018C,E01023379,1515,251,1264
2021,Dacorum 018D,E01023380,1110,213,897
2021,Dacorum 018E,E01023381,1316,245,1071
2021,Dacorum 018F,E01023382,1446,276,1170
2021,Dacorum 016A,E01023383,1385,265,1120
2021,Dacorum 016B,E01023384,1839,384,1455
2021,Dacorum 016C,E01023385,1503,251,1252
2021,Dacorum 019A,E01023386,1370,235,1135
2021,Dacorum 019B,E01023387,1277,270,1007
2021,Dacorum 019C,E01023388,1426,271,1155
2021,Dacorum 019D,E01023389,1571,280,1291
2021,Dacorum 010A,E01023390,1981,436,1545
2021,Dacorum 010B,E01023391,1608,300,1308
2021,Dacorum 011A,E01023392,1551,330,1221
2021,Dacorum 007A,E01023393,1568,269,1299
2021,Dacorum 007B,E01023394,1343,260,1083
2021,Dacorum 007C,E01023395,1588,349,1239
2021,Dacorum 007D,E01023396,1502,334,1168
2021,Dacorum 007E,E01023397,1305,331,974
2021,Dacorum 010C,E01023399,1595,219,1376
2021,Dacorum 015E,E01023400,1949,278,1671
2021,Dacorum 008A,E01023401,1639,315,1324
2021,Dacorum 008B,E01023402,1595,339,1256
2021,Dacorum 008C,E01023403,1403,239,1164
2021,Dacorum 008D,E01023404,1240,348,892
2021,Dacorum 008E,E01023405,1474,334,1140
2021,Dacorum 022A,E01023406,1837,289,1548
2021,Dacorum 022B,E01023407,1621,313,1308
2021,Dacorum 022C,E01023408,1526,284,1242
2021,Dacorum 017A,E01023409,1790,359,1431
2021,Dacorum 017B,E01023410,1269,170,1099
2021,Dacorum 017C,E01023411,1483,366,1117
2021,Dacorum 017D,E01023412,1224,200,1024
2021,Dacorum 017E,E01023413,1238,248,990
2021,Dacorum 020E,E01023414,2182,336,1846
2021,Dacorum 020F,E01023415,1341,271,1070
2021,Dacorum 006C,E01023416,1432,229,1203
2021,Dacorum 006D,E01023417,1287,218,1069
2021,Dacorum 003A,E01023418,1367,298,1069
2021,Dacorum 003B,E01023419,1922,395,1527
2021,Dacorum 003C,E01023420,1438,268,1170
2021,Dacorum 004B,E01023421,1489,281,1208
2021,Dacorum 004C,E01023422,1277,244,1033
2021,Dacorum 002A,E01023423,1389,245,1144
2021,Dacorum 002B,E01023424,1480,278,1202
2021,Dacorum 002C,E01023425,1312,271,1041
2021,Dacorum 002D,E01023426,1554,363,1191
2021,Dacorum 011B,E01023427,1672,370,1302
2021,Dacorum 011C,E01023428,1375,203,1172
2021,Dacorum 011D,E01023429,1742,339,1403
2021,Dacorum 001A,E01023430,1193,252,941
2021,Dacorum 001B,E01023431,1297,220,1077
2021,Dacorum 001C,E01023432,1566,317,1249
2021,Dacorum 001D,E01023433,1410,258,1152
2021,Dacorum 005A,E01023434,1534,318,1216
2021,Dacorum 005B,E01023435,1360,252,1108
2021,Dacorum 005C,E01023436,1159,216,943
2021,Dacorum 005D,E01023437,1293,274,1019
2021,East Hertfordshire 005A,E01023438,1450,305,1145
2021,East Hertfordshire 005B,E01023439,1361,268,1093
2021,East Hertfordshire 005C,E01023440,1660,341,1319
2021,East Hertfordshire 005D,E01023441,1448,439,1009
2021,East Hertfordshire 005E,E01023442,2140,484,1656
2021,East Hertfordshire 007A,E01023443,1335,228,1107
2021,East Hertfordshire 007B,E01023444,1777,290,1487
2021,East Hertfordshire 007C,E01023445,1636,305,1331
2021,East Hertfordshire 007E,E01023447,1239,272,967
2021,East Hertfordshire 007F,E01023448,1411,320,1091
2021,East Hertfordshire 004A,E01023449,1737,330,1407
2021,East Hertfordshire 004C,E01023451,2188,425,1763
2021,East Hertfordshire 003A,E01023452,1235,271,964
2021,East Hertfordshire 003B,E01023453,1934,455,1479
2021,East Hertfordshire 003C,E01023454,2042,424,1618
2021,East Hertfordshire 003D,E01023455,1294,254,1040
2021,East Hertfordshire 008A,E01023456,1278,278,1000
2021,East Hertfordshire 008B,E01023457,1384,270,1114
2021,East Hertfordshire 008C,E01023458,1325,274,1051
2021,East Hertfordshire 008D,E01023459,1227,209,1018
2021,East Hertfordshire 008E,E01023460,1470,345,1125
2021,East Hertfordshire 008F,E01023461,1496,383,1113
2021,East Hertfordshire 001A,E01023462,1345,228,1117
2021,East Hertfordshire 003E,E01023463,1297,240,1057
2021,East Hertfordshire 001C,E01023465,1548,247,1301
2021,East Hertfordshire 001D,E01023466,2013,371,1642
2021,East Hertfordshire 019E,E01023467,2267,332,1935
2021,East Hertfordshire 018A,E01023468,1242,223,1019
2021,East Hertfordshire 018B,E01023469,1391,265,1126
2021,East Hertfordshire 014A,E01023470,1682,208,1474
2021,East Hertfordshire 014B,E01023471,1337,275,1062
2021,East Hertfordshire 014C,E01023472,1290,260,1030
2021,East Hertfordshire 014D,E01023473,1662,331,1331
2021,East Hertfordshire 014E,E01023474,1459,290,1169
2021,East Hertfordshire 017A,E01023475,1359,297,1062
2021,East Hertfordshire 017B,E01023476,1632,324,1308
2021,East Hertfordshire 017C,E01023477,2050,398,1652
2021,East Hertfordshire 017E,E01023479,1481,214,1267
2021,East Hertfordshire 018C,E01023480,1582,294,1288
2021,East Hertfordshire 018D,E01023481,1780,727,1053
2021,East Hertfordshire 016A,E01023482,1824,446,1378
2021,East Hertfordshire 016B,E01023483,2244,456,1788
2021,East Hertfordshire 016C,E01023484,1510,301,1209
2021,East Hertfordshire 010A,E01023485,2170,364,1806
2021,East Hertfordshire 010B,E01023486,2535,464,2071
2021,East Hertfordshire 015A,E01023487,1446,264,1182
2021,East Hertfordshire 015B,E01023488,1509,323,1186
2021,East Hertfordshire 015C,E01023489,1294,193,1101
2021,East Hertfordshire 015D,E01023490,1213,270,943
2021,East Hertfordshire 009A,E01023491,1297,228,1069
2021,East Hertfordshire 009B,E01023492,2027,353,1674
2021,East Hertfordshire 003F,E01023493,2401,460,1941
2021,East Hertfordshire 019A,E01023494,1522,257,1265
2021,East Hertfordshire 019D,E01023495,1280,224,1056
2021,East Hertfordshire 009C,E01023496,1354,289,1065
2021,East Hertfordshire 009D,E01023497,1606,304,1302
2021,East Hertfordshire 011A,E01023499,2045,443,1602
2021,East Hertfordshire 011B,E01023500,1604,262,1342
2021,East Hertfordshire 011C,E01023501,1474,244,1230
2021,East Hertfordshire 011D,E01023502,1660,300,1360
2021,East Hertfordshire 011E,E01023503,1518,273,1245
2021,East Hertfordshire 018E,E01023504,1361,280,1081
2021,East Hertfordshire 018F,E01023505,1585,267,1318
2021,East Hertfordshire 006B,E01023506,1501,290,1211
2021,East Hertfordshire 006C,E01023507,1628,298,1330
2021,East Hertfordshire 019B,E01023509,1290,253,1037
2021,East Hertfordshire 013A,E01023510,1532,300,1232
2021,East Hertfordshire 013B,E01023511,1549,175,1374
2021,East Hertfordshire 012A,E01023512,1929,311,1618
2021,East Hertfordshire 012B,E01023513,1411,303,1108
2021,East Hertfordshire 012C,E01023514,2037,277,1760
2021,East Hertfordshire 013C,E01023515,1580,296,1284
2021,East Hertfordshire 013D,E01023516,1837,281,1556
2021,East Hertfordshire 013E,E01023517,1449,220,1229
2021,East Hertfordshire 012D,E01023518,2015,448,1567
2021,East Hertfordshire 012E,E01023519,1647,348,1299
2021,East Hertfordshire 012F,E01023520,1537,302,1235
2021,Hertsmere 005A,E01023523,1683,376,1307
2021,Hertsmere 005B,E01023524,1390,298,1092
2021,Hertsmere 005C,E01023525,1658,317,1341
2021,Hertsmere 005D,E01023526,1677,327,1350
2021,Hertsmere 005E,E01023527,1401,327,1074
2021,Hertsmere 010A,E01023528,1381,253,1128
2021,Hertsmere 007A,E01023529,1437,327,1110
2021,Hertsmere 007B,E01023530,1182,271,911
2021,Hertsmere 007C,E01023531,1858,463,1395
2021,Hertsmere 007D,E01023532,1529,308,1221
2021,Hertsmere 007E,E01023533,1542,369,1173
2021,Hertsmere 006A,E01023534,1734,417,1317
2021,Hertsmere 006B,E01023535,1700,366,1334
2021,Hertsmere 006C,E01023536,1523,362,1161
2021,Hertsmere 006D,E01023537,2556,555,2001
2021,Hertsmere 006E,E01023538,1979,365,1614
2021,Hertsmere 011B,E01023540,1727,404,1323
2021,Hertsmere 011C,E01023541,2298,527,1771
2021,Hertsmere 011D,E01023542,1837,457,1380
2021,Hertsmere 011E,E01023543,1344,282,1062
2021,Hertsmere 009A,E01023544,1097,212,885
2021,Hertsmere 009B,E01023545,1684,271,1413
2021,Hertsmere 009C,E01023546,1863,405,1458
2021,Hertsmere 009D,E01023547,1739,393,1346
2021,Hertsmere 013A,E01023548,1960,324,1636
2021,Hertsmere 013B,E01023549,1659,245,1414
2021,Hertsmere 013C,E01023550,1673,341,1332
2021,Hertsmere 013D,E01023551,1478,290,1188
2021,Hertsmere 008A,E01023552,1626,332,1294
2021,Hertsmere 008B,E01023553,1960,531,1429
2021,Hertsmere 008C,E01023554,1619,336,1283
2021,Hertsmere 008D,E01023555,1835,363,1472
2021,Hertsmere 013E,E01023556,1768,427,1341
2021,Hertsmere 013F,E01023557,1462,276,1186
2021,Hertsmere 012A,E01023558,1726,346,1380
2021,Hertsmere 012B,E01023559,1562,258,1304
2021,Hertsmere 012C,E01023560,1803,459,1344
2021,Hertsmere 012D,E01023561,1592,382,1210
2021,Hertsmere 012E,E01023562,1728,315,1413
2021,Hertsmere 012F,E01023563,1731,327,1404
2021,Hertsmere 010B,E01023564,1642,343,1299
2021,Hertsmere 010C,E01023565,1741,421,1320
2021,Hertsmere 010D,E01023566,1474,330,1144
2021,Hertsmere 002A,E01023567,1963,459,1504
2021,Hertsmere 002B,E01023568,1502,251,1251
2021,Hertsmere 002C,E01023569,1644,467,1177
2021,Hertsmere 002D,E01023570,1394,312,1082
2021,Hertsmere 003A,E01023571,1524,292,1232
2021,Hertsmere 003B,E01023572,1507,285,1222
2021,Hertsmere 003C,E01023573,1256,329,927
2021,Hertsmere 003D,E01023574,1556,380,1176
2021,Hertsmere 003E,E01023575,1499,319,1180
2021,Hertsmere 001A,E01023576,1417,217,1200
2021,Hertsmere 001B,E01023577,1627,262,1365
2021,Hertsmere 001C,E01023578,1631,290,1341
2021,Hertsmere 001D,E01023579,1359,291,1068
2021,Hertsmere 001E,E01023580,1589,283,1306
2021,Hertsmere 004A,E01023581,1221,271,950
2021,Hertsmere 004B,E01023582,1554,350,1204
2021,Hertsmere 004C,E01023583,1317,258,1059
2021,Hertsmere 004D,E01023584,1022,206,816
2021,North Hertfordshire 016A,E01023585,1113,217,896
2021,North Hertfordshire 016B,E01023586,1574,307,1267
2021,North Hertfordshire 004A,E01023587,995,151,844
2021,North Hertfordshire 004B,E01023588,1335,202,1133
2021,North Hertfordshire 004C,E01023589,1628,219,1409
2021,North Hertfordshire 004D,E01023590,1710,289,1421
2021,North Hertfordshire 004E,E01023591,1495,251,1244
2021,North Hertfordshire 004F,E01023592,1546,394,1152
2021,North Hertfordshire 004G,E01023593,1415,299,1116
2021,North Hertfordshire 014A,E01023594,2246,385,1861
2021,North Hertfordshire 015A,E01023595,1459,246,1213
2021,North Hertfordshire 015B,E01023596,1080,205,875
2021,North Hertfordshire 016C,E01023597,1196,184,1012
2021,North Hertfordshire 016D,E01023598,1450,269,1181
2021,North Hertfordshire 017B,E01023600,1322,205,1117
2021,North Hertfordshire 010A,E01023601,2080,276,1804
2021,North Hertfordshire 010B,E01023602,1430,264,1166
2021,North Hertfordshire 010C,E01023603,1455,304,1151
2021,North Hertfordshire 010D,E01023604,1312,247,1065
2021,North Hertfordshire 010E,E01023605,1345,236,1109
2021,North Hertfordshire 013A,E01023606,1627,324,1303
2021,North Hertfordshire 013B,E01023607,1410,282,1128
2021,North Hertfordshire 013C,E01023608,1530,328,1202
2021,North Hertfordshire 013D,E01023609,1569,274,1295
2021,North Hertfordshire 013E,E01023610,1286,289,997
2021,North Hertfordshire 012A,E01023611,1562,342,1220
2021,North Hertfordshire 012B,E01023612,1717,302,1415
2021,North Hertfordshire 012C,E01023613,1516,313,1203
2021,North Hertfordshire 012D,E01023614,1966,402,1564
2021,North Hertfordshire 012E,E01023615,1788,339,1449
2021,North Hertfordshire 012F,E01023616,2362,326,2036
2021,North Hertfordshire 011A,E01023617,1467,279,1188
2021,North Hertfordshire 011B,E01023618,1635,324,1311
2021,North Hertfordshire 011C,E01023619,1608,288,1320
2021,North Hertfordshire 011D,E01023620,1278,298,980
2021,North Hertfordshire 011E,E01023621,1275,262,1013
2021,North Hertfordshire 014B,E01023622,1090,226,864
2021,North Hertfordshire 014C,E01023623,1503,273,1230
2021,North Hertfordshire 014D,E01023624,1318,250,1068
2021,North Hertfordshire 014E,E01023625,1042,195,847
2021,North Hertfordshire 015C,E01023626,2180,447,1733
2021,North Hertfordshire 015D,E01023627,1790,265,1525
2021,North Hertfordshire 015E,E01023628,1743,295,1448
2021,North Hertfordshire 015F,E01023629,1598,274,1324
2021,North Hertfordshire 006A,E01023630,1743,385,1358
2021,North Hertfordshire 006B,E01023631,1569,331,1238
2021,North Hertfordshire 006C,E01023632,1772,326,1446
2021,North Hertfordshire 006D,E01023633,1238,225,1013
2021,North Hertfordshire 006E,E01023634,1229,163,1066
2021,North Hertfordshire 003A,E01023635,1406,266,1140
2021,North Hertfordshire 003B,E01023636,1753,341,1412
2021,North Hertfordshire 003C,E01023637,1712,273,1439
2021,North Hertfordshire 003D,E01023638,1546,300,1246
2021,North Hertfordshire 009A,E01023639,1210,176,1034
2021,North Hertfordshire 009B,E01023640,1170,219,951
2021,North Hertfordshire 009C,E01023641,1265,245,1020
2021,North Hertfordshire 009D,E01023642,1210,190,1020
2021,North Hertfordshire 009E,E01023643,1208,231,977
2021,North Hertfordshire 008A,E01023644,1649,240,1409
2021,North Hertfordshire 008B,E01023645,1503,267,1236
2021,North Hertfordshire 008C,E01023646,1372,360,1012
2021,North Hertfordshire 008D,E01023647,1402,247,1155
2021,North Hertfordshire 008E,E01023648,1154,210,944
2021,North Hertfordshire 007A,E01023649,1211,132,1079
2021,North Hertfordshire 007B,E01023650,1530,358,1172
2021,North Hertfordshire 007C,E01023651,1178,208,970
2021,North Hertfordshire 007D,E01023652,1399,312,1087
2021,North Hertfordshire 014F,E01023653,2398,452,1946
2021,North Hertfordshire 002A,E01023654,1476,225,1251
2021,North Hertfordshire 002B,E01023655,1924,326,1598
2021,North Hertfordshire 002C,E01023656,2132,324,1808
2021,North Hertfordshire 002D,E01023657,2423,451,1972
2021,North Hertfordshire 002E,E01023658,1638,318,1320
2021,North Hertfordshire 002F,E01023659,1270,206,1064
2021,North Hertfordshire 001A,E01023660,2242,270,1972
2021,North Hertfordshire 001B,E01023661,1286,258,1028
2021,North Hertfordshire 001C,E01023662,1886,363,1523
2021,North Hertfordshire 016E,E01023663,1992,349,1643
2021,St Albans 013A,E01023664,1812,503,1309
2021,St Albans 013B,E01023665,1638,382,1256
2021,St Albans 011A,E01023666,1847,319,1528
2021,St Albans 013C,E01023667,1363,293,1070
2021,St Albans 013D,E01023668,1337,374,963
2021,St Albans 009A,E01023669,1641,454,1187
2021,St Albans 009B,E01023670,1954,400,1554
2021,St Albans 009C,E01023671,1848,435,1413
2021,St Albans 009D,E01023672,1822,482,1340
2021,St Albans 010A,E01023673,1379,374,1005
2021,St Albans 011B,E01023674,1706,377,1329
2021,St Albans 011C,E01023675,1322,314,1008
2021,St Albans 011D,E01023676,2384,389,1995
2021,St Albans 021B,E01023677,1179,306,873
2021,St Albans 021D,E01023678,1843,412,1431
2021,St Albans 021A,E01023680,1408,387,1021
2021,St Albans 016A,E01023681,1469,314,1155
2021,St Albans 016B,E01023682,1718,380,1338
2021,St Albans 016C,E01023683,1592,418,1174
2021,St Albans 016D,E01023684,1498,282,1216
2021,St Albans 002A,E01023685,1613,424,1189
2021,St Albans 002B,E01023686,1504,405,1099
2021,St Albans 002C,E01023687,1421,338,1083
2021,St Albans 002D,E01023688,1461,346,1115
2021,St Albans 002E,E01023689,1443,468,975
2021,St Albans 001A,E01023690,1649,444,1205
2021,St Albans 001B,E01023691,1422,397,1025
2021,St Albans 001C,E01023692,1198,305,893
2021,St Albans 001D,E01023693,1438,340,1098
2021,St Albans 001E,E01023694,1632,447,1185
2021,St Albans 005A,E01023695,1535,357,1178
2021,St Albans 005B,E01023696,1752,429,1323
2021,St Albans 005C,E01023697,1757,375,1382
2021,St Albans 005D,E01023698,1418,271,1147
2021,St Albans 003A,E01023699,1547,373,1174
2021,St Albans 003B,E01023700,1325,344,981
2021,St Albans 003C,E01023701,1848,296,1552
2021,St Albans 003D,E01023702,1552,398,1154
2021,St Albans 003E,E01023703,1400,378,1022
2021,St Albans 018A,E01023704,1434,206,1228
2021,St Albans 018B,E01023705,1676,421,1255
2021,St Albans 018C,E01023706,1580,272,1308
2021,St Albans 018E,E01023708,1500,294,1206
2021,St Albans 008A,E01023709,1640,394,1246
2021,St Albans 008B,E01023710,1530,400,1130
2021,St Albans 008C,E01023711,1558,369,1189
2021,St Albans 008D,E01023712,1894,448,1446
2021,St Albans 007A,E01023713,1921,513,1408
2021,St Albans 010B,E01023714,1721,435,1286
2021,St Albans 010C,E01023715,1513,430,1083
2021,St Albans 010D,E01023716,1920,376,1544
2021,St Albans 020A,E01023717,1275,249,1026
2021,St Albans 019A,E01023718,1701,319,1382
2021,St Albans 019B,E01023719,1148,221,927
2021,St Albans 019C,E01023720,1909,365,1544
2021,St Albans 019D,E01023721,1336,244,1092
2021,St Albans 006A,E01023722,1391,253,1138
2021,St Albans 006B,E01023723,1594,361,1233
2021,St Albans 006C,E01023724,1586,273,1313
2021,St Albans 006D,E01023725,1474,337,1137
2021,St Albans 012A,E01023726,1890,243,1647
2021,St Albans 012B,E01023727,2074,265,1809
2021,St Albans 012C,E01023728,2056,374,1682
2021,St Albans 020B,E01023730,1692,358,1334
2021,St Albans 020C,E01023731,1482,255,1227
2021,St Albans 020D,E01023732,1563,241,1322
2021,St Albans 020E,E01023733,1805,310,1495
2021,St Albans 007B,E01023734,1545,336,1209
2021,St Albans 007C,E01023735,1599,291,1308
2021,St Albans 007D,E01023736,1544,281,1263
2021,St Albans 017A,E01023737,1267,308,959
2021,St Albans 017B,E01023738,1530,364,1166
2021,St Albans 017C,E01023739,1467,390,1077
2021,St Albans 017D,E01023740,1358,204,1154
2021,St Albans 017E,E01023741,1476,306,1170
2021,St Albans 014A,E01023742,1790,412,1378
2021,St Albans 014B,E01023743,1927,333,1594
2021,St Albans 014C,E01023744,1501,299,1202
2021,St Albans 014D,E01023745,1698,285,1413
2021,St Albans 004A,E01023746,1485,367,1118
2021,St Albans 004B,E01023747,1720,372,1348
2021,St Albans 004C,E01023748,1353,255,1098
2021,St Albans 004D,E01023749,1783,396,1387
2021,Stevenage 009A,E01023750,1153,162,991
2021,Stevenage 009B,E01023751,1146,217,929
2021,Stevenage 009C,E01023752,1358,326,1032
2021,Stevenage 009D,E01023753,1586,267,1319
2021,Stevenage 009E,E01023754,1260,324,936
2021,Stevenage 008A,E01023755,1582,303,1279
2021,Stevenage 008B,E01023756,1584,376,1208
2021,Stevenage 008C,E01023757,1859,422,1437
2021,Stevenage 007A,E01023759,1407,323,1084
2021,Stevenage 007B,E01023760,1455,302,1153
2021,Stevenage 007C,E01023761,2024,446,1578
2021,Stevenage 007D,E01023762,1493,318,1175
2021,Stevenage 012A,E01023763,1453,267,1186
2021,Stevenage 012B,E01023764,1205,159,1046
2021,Stevenage 012C,E01023765,1495,314,1181
2021,Stevenage 012D,E01023766,1491,336,1155
2021,Stevenage 013D,E01023767,1414,201,1213
2021,Stevenage 013B,E01023769,1649,320,1329
2021,Stevenage 013C,E01023770,1434,230,1204
2021,Stevenage 003A,E01023771,1517,258,1259
2021,Stevenage 003B,E01023772,1682,278,1404
2021,Stevenage 003C,E01023773,1260,306,954
2021,Stevenage 003D,E01023774,1576,319,1257
2021,Stevenage 006A,E01023775,2179,348,1831
2021,Stevenage 002A,E01023776,2501,426,2075
2021,Stevenage 002B,E01023777,1733,294,1439
2021,Stevenage 002C,E01023778,1643,383,1260
2021,Stevenage 006B,E01023779,1642,344,1298
2021,Stevenage 006C,E01023780,1361,263,1098
2021,Stevenage 006D,E01023781,1786,378,1408
2021,Stevenage 006E,E01023782,1312,211,1101
2021,Stevenage 011A,E01023783,1606,292,1314
2021,Stevenage 011B,E01023784,1504,257,1247
2021,Stevenage 011C,E01023785,1805,434,1371
2021,Stevenage 011D,E01023786,1741,358,1383
2021,Stevenage 001A,E01023787,1391,323,1068
2021,Stevenage 001B,E01023788,1491,336,1155
2021,Stevenage 001D,E01023790,1607,376,1231
2021,Stevenage 010A,E01023791,1578,309,1269
2021,Stevenage 010B,E01023792,1546,406,1140
2021,Stevenage 010C,E01023793,1441,347,1094
2021,Stevenage 010D,E01023794,1527,316,1211
2021,Stevenage 005A,E01023795,1557,270,1287
2021,Stevenage 005B,E01023796,1441,213,1228
2021,Stevenage 005C,E01023797,1271,263,1008
2021,Stevenage 005D,E01023798,1435,236,1199
2021,Stevenage 002D,E01023799,1292,249,1043
2021,Stevenage 002E,E01023800,2076,312,1764
2021,Stevenage 002F,E01023801,2261,518,1743
2021,Three Rivers 001A,E01023802,1597,277,1320
2021,Three Rivers 001B,E01023803,1495,288,1207
2021,Three Rivers 001C,E01023804,1415,295,1120
2021,Three Rivers 010A,E01023805,1669,408,1261
2021,Three Rivers 012A,E01023806,2144,464,1680
2021,Three Rivers 001D,E01023807,1520,289,1231
2021,Three Rivers 010B,E01023809,1737,303,1434
2021,Three Rivers 010C,E01023810,1750,280,1470
2021,Three Rivers 010D,E01023811,1427,232,1195
2021,Three Rivers 004A,E01023812,1499,302,1197
2021,Three Rivers 004B,E01023813,1589,318,1271
2021,Three Rivers 004C,E01023814,1044,218,826
2021,Three Rivers 005A,E01023815,1505,377,1128
2021,Three Rivers 005B,E01023816,1238,292,946
2021,Three Rivers 005C,E01023817,1317,234,1083
2021,Three Rivers 005D,E01023818,1416,343,1073
2021,Three Rivers 006A,E01023819,1552,308,1244
2021,Three Rivers 006B,E01023820,1294,261,1033
2021,Three Rivers 006C,E01023821,1218,278,940
2021,Three Rivers 006D,E01023822,1310,262,1048
2021,Three Rivers 003A,E01023823,1563,330,1233
2021,Three Rivers 003B,E01023824,2083,469,1614
2021,Three Rivers 006E,E01023825,2206,455,1751
2021,Three Rivers 006F,E01023826,1559,388,1171
2021,Three Rivers 008A,E01023827,2276,535,1741
2021,Three Rivers 008B,E01023828,1554,384,1170
2021,Three Rivers 002A,E01023829,1676,409,1267
2021,Three Rivers 002B,E01023830,1358,177,1181
2021,Three Rivers 003C,E01023831,1974,414,1560
2021,Three Rivers 002C,E01023832,1975,495,1480
2021,Three Rivers 002E,E01023834,1677,361,1316
2021,Three Rivers 009A,E01023835,1349,293,1056
2021,Three Rivers 009B,E01023836,1277,230,1047
2021,Three Rivers 009C,E01023837,1531,342,1189
2021,Three Rivers 009D,E01023838,1230,261,969
2021,Three Rivers 011A,E01023839,2182,469,1713
2021,Three Rivers 011B,E01023840,1697,221,1476
2021,Three Rivers 011C,E01023841,1685,305,1380
2021,Three Rivers 012B,E01023842,1615,367,1248
2021,Three Rivers 012C,E01023843,1980,434,1546
2021,Three Rivers 012D,E01023844,1581,306,1275
2021,Three Rivers 008C,E01023845,1745,369,1376
2021,Three Rivers 008D,E01023846,1553,339,1214
2021,Three Rivers 007A,E01023847,1754,353,1401
2021,Three Rivers 007B,E01023848,1731,428,1303
2021,Three Rivers 011D,E01023849,1398,236,1162
2021,Three Rivers 007C,E01023850,1510,173,1337
2021,Three Rivers 004D,E01023851,1839,322,1517
2021,Three Rivers 007D,E01023852,1421,284,1137
2021,Three Rivers 007E,E01023853,2097,477,1620
2021,Three Rivers 003D,E01023854,1866,303,1563
2021,Watford 006A,E01023855,2087,460,1627
2021,Watford 006B,E01023856,2399,465,1934
2021,Watford 006C,E01023857,1724,434,1290
2021,Watford 006D,E01023858,1833,325,1508
2021,Watford 009B,E01023860,1937,320,1617
2021,Watford 009D,E01023862,2481,480,2001
2021,Watford 011A,E01023863,1723,346,1377
2021,Watford 011B,E01023864,1602,361,1241
2021,Watford 011C,E01023865,1861,468,1393
2021,Watford 011D,E01023866,1550,415,1135
2021,Watford 004A,E01023868,1791,434,1357
2021,Watford 004B,E01023869,1393,305,1088
2021,Watford 004C,E01023870,1635,473,1162
2021,Watford 004D,E01023871,1703,410,1293
2021,Watford 004E,E01023872,1617,378,1239
2021,Watford 003A,E01023873,1266,309,957
2021,Watford 003B,E01023874,1242,271,971
2021,Watford 003C,E01023875,2070,365,1705
2021,Watford 003D,E01023876,1652,440,1212
2021,Watford 003E,E01023877,1648,369,1279
2021,Watford 007A,E01023878,2019,349,1670
2021,Watford 007C,E01023880,2084,280,1804
2021,Watford 007D,E01023881,1601,348,1253
2021,Watford 012A,E01023882,1539,274,1265
2021,Watford 012B,E01023883,1690,375,1315
2021,Watford 012C,E01023884,1840,328,1512
2021,Watford 012D,E01023885,1673,308,1365
2021,Watford 008A,E01023886,2744,673,2071
2021,Watford 008B,E01023887,1714,408,1306
2021,Watford 008C,E01023888,1606,344,1262
2021,Watford 008D,E01023889,1753,380,1373
2021,Watford 002A,E01023890,1266,255,1011
2021,Watford 002B,E01023891,1399,365,1034
2021,Watford 002C,E01023892,1254,283,971
2021,Watford 002D,E01023893,1608,277,1331
2021,Watford 002E,E01023894,1328,268,1060
2021,Watford 005A,E01023895,1554,255,1299
2021,Watford 005B,E01023896,1242,230,1012
2021,Watford 005C,E01023897,1516,286,1230
2021,Watford 005D,E01023898,1503,337,1166
2021,Watford 010A,E01023899,1618,382,1236
2021,Watford 010B,E01023900,1761,448,1313
2021,Watford 010C,E01023901,1959,454,1505
2021,Watford 010D,E01023902,1627,350,1277
2021,Watford 010E,E01023903,1576,351,1225
2021,Watford 001A,E01023904,2021,500,1521
2021,Watford 001B,E01023905,1918,404,1514
2021,Watford 001C,E01023906,1454,302,1152
2021,Watford 001D,E01023907,1799,349,1450
2021,Welwyn Hatfield 015A,E01023908,1636,337,1299
2021,Welwyn Hatfield 015B,E01023909,1281,357,924
2021,Welwyn Hatfield 015C,E01023910,1362,219,1143
2021,Welwyn Hatfield 015D,E01023911,1605,332,1273
2021,Welwyn Hatfield 004A,E01023912,1448,265,1183
2021,Welwyn Hatfield 004B,E01023913,1229,250,979
2021,Welwyn Hatfield 004C,E01023914,1576,299,1277
2021,Welwyn Hatfield 004D,E01023915,1485,340,1145
2021,Welwyn Hatfield 006A,E01023916,1590,335,1255
2021,Welwyn Hatfield 006B,E01023917,1682,287,1395
2021,Welwyn Hatfield 006C,E01023918,1799,208,1591
2021,Welwyn Hatfield 006D,E01023919,1550,351,1199
2021,Welwyn Hatfield 012A,E01023920,1539,349,1190
2021,Welwyn Hatfield 012B,E01023921,2200,720,1480
2021,Welwyn Hatfield 012C,E01023922,1753,638,1115
2021,Welwyn Hatfield 012D,E01023923,2183,658,1525
2021,Welwyn Hatfield 011A,E01023924,1705,385,1320
2021,Welwyn Hatfield 011B,E01023925,1638,300,1338
2021,Welwyn Hatfield 011C,E01023926,1783,253,1530
2021,Welwyn Hatfield 011D,E01023927,1739,402,1337
2021,Welwyn Hatfield 010A,E01023929,1659,373,1286
2021,Welwyn Hatfield 010B,E01023930,1566,346,1220
2021,Welwyn Hatfield 013A,E01023932,1743,534,1209
2021,Welwyn Hatfield 017A,E01023933,1419,350,1069
2021,Welwyn Hatfield 013B,E01023934,1300,454,846
2021,Welwyn Hatfield 013C,E01023935,2575,1774,801
2021,Welwyn Hatfield 013D,E01023936,2054,653,1401
2021,Welwyn Hatfield 013E,E01023937,2264,1524,740
2021,Welwyn Hatfield 010D,E01023938,2332,1108,1224
2021,Welwyn Hatfield 009A,E01023939,1118,195,923
2021,Welwyn Hatfield 009B,E01023940,1710,397,1313
2021,Welwyn Hatfield 009D,E01023942,1649,424,1225
2021,Welwyn Hatfield 008A,E01023943,1497,348,1149
2021,Welwyn Hatfield 008B,E01023944,2047,459,1588
2021,Welwyn Hatfield 008C,E01023945,1588,361,1227
2021,Welwyn Hatfield 008D,E01023946,2086,418,1668
2021,Welwyn Hatfield 016A,E01023947,1664,286,1378
2021,Welwyn Hatfield 016B,E01023948,1704,306,1398
2021,Welwyn Hatfield 016C,E01023949,2020,368,1652
2021,Welwyn Hatfield 005A,E01023950,1511,244,1267
2021,Welwyn Hatfield 005B,E01023951,1594,248,1346
2021,Welwyn Hatfield 005C,E01023952,1525,194,1331
2021,Welwyn Hatfield 005D,E01023953,1305,224,1081
2021,Welwyn Hatfield 007B,E01023955,1384,341,1043
2021,Welwyn Hatfield 007C,E01023956,1269,311,958
2021,Welwyn Hatfield 007D,E01023957,1360,315,1045
2021,Welwyn Hatfield 007E,E01023958,1393,342,1051
2021,Welwyn Hatfield 003A,E01023959,1291,223,1068
2021,Welwyn Hatfield 003B,E01023960,1563,358,1205
2021,Welwyn Hatfield 003C,E01023961,1331,290,1041
2021,Welwyn Hatfield 003D,E01023962,1421,335,1086
2021,Welwyn Hatfield 017B,E01023963,2259,406,1853
2021,Welwyn Hatfield 001A,E01023965,1396,259,1137
2021,Welwyn Hatfield 001B,E01023966,1652,313,1339
2021,Welwyn Hatfield 001C,E01023967,1338,233,1105
2021,Welwyn Hatfield 002B,E01023968,1302,177,1125
2021,Welwyn Hatfield 002C,E01023969,1388,230,1158
2021,Welwyn Hatfield 002D,E01023970,1842,394,1448
2021,Welwyn Hatfield 001D,E01023971,1592,291,1301
2021,Ashford 006A,E01023972,1329,271,1058
2021,Ashford 005A,E01023973,2548,620,1928
2021,Ashford 007A,E01023974,1372,301,1071
2021,Ashford 007B,E01023975,2019,473,1546
2021,Ashford 008A,E01023976,1717,296,1421
2021,Ashford 007C,E01023977,1343,273,1070
2021,Ashford 011A,E01023978,1276,181,1095
2021,Ashford 011B,E01023979,1260,240,1020
2021,Ashford 015A,E01023980,1074,193,881
2021,Ashford 015B,E01023981,1503,288,1215
2021,Ashford 003A,E01023983,1409,242,1167
2021,Ashford 015C,E01023984,1174,322,852
2021,Ashford 002A,E01023985,1127,128,999
2021,Ashford 002B,E01023986,1471,258,1213
2021,Ashford 001B,E01023987,968,161,807
2021,Ashford 001C,E01023988,1511,308,1203
2021,Ashford 002C,E01023989,1269,251,1018
2021,Ashford 002D,E01023990,1246,217,1029
2021,Ashford 016C,E01023992,1726,360,1366
2021,Ashford 016D,E01023993,1384,296,1088
2021,Ashford 006B,E01023995,1113,195,918
2021,Ashford 006C,E01023996,1210,246,964
2021,Ashford 014A,E01023997,1501,246,1255
2021,Ashford 014B,E01023998,1131,160,971
2021,Ashford 003B,E01023999,2193,377,1816
2021,Ashford 009A,E01024001,1492,271,1221
2021,Ashford 005B,E01024002,1344,261,1083
2021,Ashford 006D,E01024003,1746,251,1495
2021,Ashford 006E,E01024004,2114,376,1738
2021,Ashford 006F,E01024005,1504,310,1194
2021,Ashford 009B,E01024006,1205,208,997
2021,Ashford 009D,E01024008,1901,416,1485
2021,Ashford 013A,E01024009,1341,164,1177
2021,Ashford 013B,E01024010,1336,208,1128
2021,Ashford 013C,E01024011,1242,184,1058
2021,Ashford 013D,E01024012,1041,163,878
2021,Ashford 010A,E01024013,1796,332,1464
2021,Ashford 010B,E01024014,1838,304,1534
2021,Ashford 010C,E01024015,1549,249,1300
2021,Ashford 007D,E01024016,1259,202,1057
2021,Ashford 007E,E01024017,1769,329,1440
2021,Ashford 008B,E01024019,1597,444,1153
2021,Ashford 008C,E01024020,1874,565,1309
2021,Ashford 015E,E01024021,1374,217,1157
2021,Ashford 015D,E01024022,1494,231,1263
2021,Ashford 005C,E01024023,2480,526,1954
2021,Ashford 013E,E01024024,2145,245,1900
2021,Ashford 013F,E01024025,1297,146,1151
2021,Ashford 014C,E01024026,1193,191,1002
2021,Ashford 007F,E01024028,1548,322,1226
2021,Ashford 005E,E01024029,2377,430,1947
2021,Ashford 012B,E01024031,1591,216,1375
2021,Ashford 011C,E01024032,1995,326,1669
2021,Ashford 002E,E01024033,1756,300,1456
2021,Ashford 002F,E01024035,1020,151,869
2021,Ashford 011D,E01024036,1399,271,1128
2021,Ashford 014D,E01024037,1893,375,1518
2021,Ashford 012C,E01024038,1997,243,1754
2021,Ashford 012D,E01024039,1554,251,1303
2021,Ashford 001D,E01024040,1243,232,1011
2021,Ashford 001E,E01024041,1125,200,925
2021,Canterbury 018A,E01024042,1392,234,1158
2021,Canterbury 018B,E01024043,1299,200,1099
2021,Canterbury 016A,E01024044,2404,1040,1364
2021,Canterbury 016B,E01024045,1568,376,1192
2021,Canterbury 016C,E01024046,1838,365,1473
2021,Canterbury 014A,E01024047,1885,729,1156
2021,Canterbury 016D,E01024048,1419,756,663
2021,Canterbury 014B,E01024049,1309,314,995
2021,Canterbury 017A,E01024052,2279,545,1734
2021,Canterbury 017B,E01024053,1996,455,1541
2021,Canterbury 017C,E01024054,1735,282,1453
2021,Canterbury 007A,E01024055,1531,217,1314
2021,Canterbury 005A,E01024056,1864,272,1592
2021,Canterbury 005B,E01024057,1725,221,1504
2021,Canterbury 005C,E01024058,1531,285,1246
2021,Canterbury 004A,E01024059,1413,205,1208
2021,Canterbury 008A,E01024060,1424,236,1188
2021,Canterbury 007B,E01024061,1398,312,1086
2021,Canterbury 009A,E01024062,2084,411,1673
2021,Canterbury 007C,E01024063,1524,274,1250
2021,Canterbury 003A,E01024064,2487,517,1970
2021,Canterbury 004B,E01024065,1933,358,1575
2021,Canterbury 003B,E01024066,1504,301,1203
2021,Canterbury 012C,E01024067,1177,210,967
2021,Canterbury 012D,E01024068,1536,363,1173
2021,Canterbury 008B,E01024069,1168,225,943
2021,Canterbury 008C,E01024070,1206,163,1043
2021,Canterbury 007D,E01024071,1592,294,1298
2021,Canterbury 008D,E01024072,1047,135,912
2021,Canterbury 006A,E01024073,2393,525,1868
2021,Canterbury 006B,E01024074,1385,255,1130
2021,Canterbury 006C,E01024075,1518,237,1281
2021,Canterbury 006D,E01024076,1726,314,1412
2021,Canterbury 006E,E01024077,2046,447,1599
2021,Canterbury 001A,E01024078,1679,277,1402
2021,Canterbury 003C,E01024079,1516,234,1282
2021,Canterbury 001B,E01024080,1274,204,1070
2021,Canterbury 001C,E01024081,1464,186,1278
2021,Canterbury 001D,E01024082,1339,245,1094
2021,Canterbury 003D,E01024083,1320,222,1098
2021,Canterbury 010A,E01024084,1223,215,1008
2021,Canterbury 010B,E01024085,1569,264,1305
2021,Canterbury 010C,E01024086,2107,438,1669
2021,Canterbury 010D,E01024087,1307,190,1117
2021,Canterbury 018C,E01024088,1503,293,1210
2021,Canterbury 018D,E01024089,1105,206,899
2021,Canterbury 014C,E01024090,2741,1507,1234
2021,Canterbury 011A,E01024091,1316,333,983
2021,Canterbury 014D,E01024092,1489,588,901
2021,Canterbury 014E,E01024093,1762,625,1137
2021,Canterbury 002A,E01024094,2566,400,2166
2021,Canterbury 001E,E01024095,1411,244,1167
2021,Canterbury 002B,E01024096,1652,210,1442
2021,Canterbury 002C,E01024097,1535,190,1345
2021,Canterbury 002D,E01024098,1492,206,1286
2021,Canterbury 013A,E01024099,1356,633,723
2021,Canterbury 013B,E01024100,1461,775,686
2021,Canterbury 013C,E01024101,1670,728,942
2021,Canterbury 013D,E01024102,1713,728,985
2021,Canterbury 013E,E01024103,1543,664,879
2021,Canterbury 020A,E01024104,2028,718,1310
2021,Canterbury 009B,E01024105,1475,202,1273
2021,Canterbury 008E,E01024106,1506,220,1286
2021,Canterbury 009C,E01024107,1402,263,1139
2021,Canterbury 009D,E01024108,1153,210,943
2021,Canterbury 009E,E01024109,2269,396,1873
2021,Canterbury 011B,E01024110,1432,195,1237
2021,Canterbury 011C,E01024111,1471,333,1138
2021,Canterbury 011D,E01024112,1516,258,1258
2021,Canterbury 011E,E01024113,1384,256,1128
2021,Canterbury 005D,E01024114,1682,264,1418
2021,Canterbury 005E,E01024115,1377,185,1192
2021,Canterbury 007E,E01024116,1436,224,1212
2021,Canterbury 004C,E01024117,1468,210,1258
2021,Canterbury 003E,E01024118,1720,262,1458
2021,Canterbury 004D,E01024119,1483,334,1149
2021,Canterbury 004E,E01024120,1600,170,1430
2021,Canterbury 020B,E01024121,1634,666,968
2021,Canterbury 020C,E01024122,1412,411,1001
2021,Canterbury 012E,E01024123,1544,490,1054
2021,Canterbury 020D,E01024124,1261,496,765
2021,Canterbury 020E,E01024126,1383,375,1008
2021,Canterbury 017D,E01024127,1636,292,1344
2021,Canterbury 019A,E01024128,1612,427,1185
2021,Canterbury 019B,E01024129,1660,631,1029
2021,Canterbury 016E,E01024131,2338,1139,1199
2021,Dartford 012A,E01024132,1232,259,973
2021,Dartford 008A,E01024133,1284,295,989
2021,Dartford 012B,E01024134,1545,292,1253
2021,Dartford 012C,E01024135,1384,275,1109
2021,Dartford 008B,E01024136,1424,277,1147
2021,Dartford 008C,E01024137,1799,447,1352
2021,Dartford 008D,E01024138,1804,413,1391
2021,Dartford 008E,E01024139,1715,339,1376
2021,Dartford 002C,E01024143,2423,462,1961
2021,Dartford 007A,E01024144,1429,299,1130
2021,Dartford 007B,E01024145,1592,320,1272
2021,Dartford 007C,E01024146,1366,263,1103
2021,Dartford 007D,E01024147,1678,334,1344
2021,Dartford 010A,E01024150,1450,204,1246
2021,Dartford 010B,E01024151,1415,208,1207
2021,Dartford 010C,E01024152,2563,614,1949
2021,Dartford 010D,E01024153,1346,239,1107
2021,Dartford 001C,E01024154,1259,315,944
2021,Dartford 001D,E01024155,2270,598,1672
2021,Dartford 005A,E01024156,1562,303,1259
2021,Dartford 013A,E01024157,1733,253,1480
2021,Dartford 013B,E01024158,1920,381,1539
2021,Dartford 013C,E01024159,1513,202,1311
2021,Dartford 013D,E01024160,1367,213,1154
2021,Dartford 005B,E01024161,1904,410,1494
2021,Dartford 005C,E01024162,1923,369,1554
2021,Dartford 005D,E01024163,1770,357,1413
2021,Dartford 005E,E01024164,1836,406,1430
2021,Dartford 009A,E01024165,1563,381,1182
2021,Dartford 009B,E01024166,1621,405,1216
2021,Dartford 009C,E01024167,1932,426,1506
2021,Dartford 009D,E01024168,1193,274,919
2021,Dartford 006A,E01024169,2130,485,1645
2021,Dartford 006B,E01024170,1471,329,1142
2021,Dartford 006C,E01024171,1462,294,1168
2021,Dartford 006D,E01024172,2029,359,1670
2021,Dartford 011A,E01024173,1727,297,1430
2021,Dartford 012D,E01024174,1083,189,894
2021,Dartford 012E,E01024175,1219,260,959
2021,Dartford 004B,E01024176,1689,334,1355
2021,Dartford 004C,E01024177,1388,332,1056
2021,Dartford 004D,E01024178,1586,367,1219
2021,Dartford 002D,E01024179,2597,601,1996
2021,Dartford 003A,E01024180,2182,447,1735
2021,Dartford 003B,E01024181,1934,419,1515
2021,Dartford 003C,E01024182,1692,328,1364
2021,Dartford 003D,E01024183,1378,315,1063
2021,Dartford 003E,E01024184,2017,496,1521
2021,Dartford 003F,E01024185,2163,507,1656
2021,Dartford 007E,E01024186,1275,256,1019
2021,Dartford 011B,E01024187,1116,204,912
2021,Dartford 011C,E01024188,1404,296,1108
2021,Dartford 011D,E01024189,1471,229,1242
2021,Dover 006A,E01024190,1441,240,1201
2021,Dover 006C,E01024192,1813,416,1397
2021,Dover 011A,E01024193,1444,292,1152
2021,Dover 011B,E01024194,1391,287,1104
2021,Dover 011C,E01024195,1369,289,1080
2021,Dover 011D,E01024196,1397,337,1060
2021,Dover 011E,E01024197,1486,295,1191
2021,Dover 014A,E01024198,2388,259,2129
2021,Dover 008A,E01024200,1612,186,1426
2021,Dover 005A,E01024201,1407,245,1162
2021,Dover 002A,E01024202,1761,290,1471
2021,Dover 008B,E01024203,1553,246,1307
2021,Dover 006D,E01024204,1552,315,1237
2021,Dover 008C,E01024205,1497,248,1249
2021,Dover 001A,E01024206,1916,290,1626
2021,Dover 001B,E01024207,1785,319,1466
2021,Dover 001C,E01024208,1573,287,1286
2021,Dover 001D,E01024209,1700,286,1414
2021,Dover 014B,E01024212,1366,227,1139
2021,Dover 014C,E01024213,1326,222,1104
2021,Dover 013A,E01024214,1606,304,1302
2021,Dover 013B,E01024215,1520,344,1176
2021,Dover 013C,E01024216,1444,286,1158
2021,Dover 007A,E01024218,1278,303,975
2021,Dover 003A,E01024219,1262,169,1093
2021,Dover 003B,E01024220,1504,213,1291
2021,Dover 003C,E01024221,1445,223,1222
2021,Dover 007B,E01024222,1528,298,1230
2021,Dover 005C,E01024223,1452,265,1187
2021,Dover 007C,E01024224,1464,244,1220
2021,Dover 005D,E01024225,1549,317,1232
2021,Dover 005E,E01024226,1452,218,1234
2021,Dover 003D,E01024227,1340,194,1146
2021,Dover 004A,E01024228,1187,108,1079
2021,Dover 003E,E01024229,1329,193,1136
2021,Dover 004B,E01024230,1225,130,1095
2021,Dover 004C,E01024231,1253,157,1096
2021,Dover 009A,E01024232,1913,248,1665
2021,Dover 010C,E01024233,1501,253,1248
2021,Dover 014D,E01024234,1351,217,1134
2021,Dover 010D,E01024235,1511,193,1318
2021,Dover 009B,E01024236,1677,261,1416
2021,Dover 009C,E01024237,1524,182,1342
2021,Dover 012B,E01024238,1862,745,1117
2021,Dover 012C,E01024239,1672,274,1398
2021,Dover 011F,E01024240,1715,466,1249
2021,Dover 011G,E01024241,2031,491,1540
2021,Dover 002B,E01024242,1684,234,1450
2021,Dover 002C,E01024243,1639,326,1313
2021,Dover 002D,E01024244,1643,137,1506
2021,Dover 002E,E01024245,1888,323,1565
2021,Dover 013D,E01024246,2016,439,1577
2021,Dover 012D,E01024247,1961,294,1667
2021,Dover 011H,E01024248,1906,451,1455
2021,Dover 013E,E01024249,1932,303,1629
2021,Dover 007D,E01024250,1581,252,1329
2021,Dover 007E,E01024251,1533,166,1367
2021,Dover 004D,E01024252,2225,254,1971
2021,Dover 009D,E01024253,1627,167,1460
2021,Dover 010E,E01024254,2208,466,1742
2021,Dover 008D,E01024255,1698,234,1464
2021,Dover 010F,E01024256,1677,252,1425
2021,Gravesham 002A,E01024257,1788,331,1457
2021,Gravesham 003A,E01024258,1543,254,1289
2021,Gravesham 005A,E01024259,1466,269,1197
2021,Gravesham 005B,E01024260,1645,229,1416
2021,Gravesham 003B,E01024261,2095,291,1804
2021,Gravesham 004A,E01024262,1657,334,1323
2021,Gravesham 004B,E01024263,1499,345,1154
2021,Gravesham 009A,E01024264,1583,358,1225
2021,Gravesham 010A,E01024265,1254,220,1034
2021,Gravesham 010B,E01024266,1094,212,882
2021,Gravesham 010C,E01024267,1431,229,1202
2021,Gravesham 012A,E01024268,1484,226,1258
2021,Gravesham 012B,E01024269,1786,266,1520
2021,Gravesham 012C,E01024270,1386,220,1166
2021,Gravesham 012D,E01024271,1349,243,1106
2021,Gravesham 012E,E01024272,1417,233,1184
2021,Gravesham 013A,E01024273,1555,280,1275
2021,Gravesham 013B,E01024274,1381,214,1167
2021,Gravesham 013C,E01024275,1316,252,1064
2021,Gravesham 001A,E01024276,2466,563,1903
2021,Gravesham 001B,E01024277,1853,455,1398
2021,Gravesham 001C,E01024278,1845,518,1327
2021,Gravesham 001D,E01024279,1508,345,1163
2021,Gravesham 006B,E01024281,1358,303,1055
2021,Gravesham 004C,E01024282,1526,382,1144
2021,Gravesham 004D,E01024283,1212,256,956
2021,Gravesham 004E,E01024284,1531,368,1163
2021,Gravesham 006C,E01024285,1296,229,1067
2021,Gravesham 009B,E01024286,1454,242,1212
2021,Gravesham 006D,E01024287,1409,294,1115
2021,Gravesham 006E,E01024288,1290,207,1083
2021,Gravesham 002C,E01024290,1634,322,1312
2021,Gravesham 002D,E01024291,1675,332,1343
2021,Gravesham 005C,E01024292,1517,308,1209
2021,Gravesham 003C,E01024293,1694,429,1265
2021,Gravesham 003D,E01024294,2694,813,1881
2021,Gravesham 002E,E01024295,1887,345,1542
2021,Gravesham 003E,E01024296,2719,604,2115
2021,Gravesham 008A,E01024297,1456,277,1179
2021,Gravesham 008B,E01024298,1310,219,1091
2021,Gravesham 008C,E01024299,1331,244,1087
2021,Gravesham 010D,E01024300,1327,222,1105
2021,Gravesham 010E,E01024301,1189,215,974
2021,Gravesham 013D,E01024302,1437,244,1193
2021,Gravesham 011A,E01024303,1435,309,1126
2021,Gravesham 011B,E01024304,1580,293,1287
2021,Gravesham 011C,E01024305,1595,447,1148
2021,Gravesham 011D,E01024306,1690,509,1181
2021,Gravesham 011E,E01024307,1470,284,1186
2021,Gravesham 007A,E01024308,1431,375,1056
2021,Gravesham 008D,E01024309,1294,364,930
2021,Gravesham 007B,E01024310,1489,328,1161
2021,Gravesham 007C,E01024311,1318,355,963
2021,Gravesham 008E,E01024312,1293,317,976
2021,Gravesham 005D,E01024313,1488,295,1193
2021,Gravesham 007D,E01024314,1219,251,968
2021,Gravesham 007E,E01024315,1614,373,1241
2021,Gravesham 009C,E01024316,2328,485,1843
2021,Gravesham 005E,E01024317,1545,277,1268
2021,Gravesham 005F,E01024318,1459,292,1167
2021,Gravesham 009D,E01024319,1511,335,1176
2021,Maidstone 003A,E01024320,1638,284,1354
2021,Maidstone 003B,E01024321,1636,260,1376
2021,Maidstone 003C,E01024322,1157,215,942
2021,Maidstone 003D,E01024323,1697,322,1375
2021,Maidstone 003E,E01024324,1363,239,1124
2021,Maidstone 014A,E01024325,2294,320,1974
2021,Maidstone 007A,E01024326,1777,298,1479
2021,Maidstone 007B,E01024327,1526,295,1231
2021,Maidstone 007C,E01024328,1628,276,1352
2021,Maidstone 007D,E01024329,1486,251,1235
2021,Maidstone 005A,E01024330,1561,346,1215
2021,Maidstone 012A,E01024331,1550,311,1239
2021,Maidstone 015A,E01024332,1205,164,1041
2021,Maidstone 001A,E01024333,1221,231,990
2021,Maidstone 001C,E01024335,1610,305,1305
2021,Maidstone 005B,E01024336,1844,377,1467
2021,Maidstone 005C,E01024337,1394,242,1152
2021,Maidstone 006A,E01024339,2143,355,1788
2021,Maidstone 006B,E01024340,2456,418,2038
2021,Maidstone 003F,E01024341,1785,290,1495
2021,Maidstone 016A,E01024342,2081,375,1706
2021,Maidstone 016B,E01024343,1306,212,1094
2021,Maidstone 016C,E01024344,1580,226,1354
2021,Maidstone 018A,E01024345,1556,243,1313
2021,Maidstone 014B,E01024346,1273,184,1089
2021,Maidstone 001E,E01024347,1765,294,1471
2021,Maidstone 005D,E01024348,1323,273,1050
2021,Maidstone 007E,E01024349,1249,244,1005
2021,Maidstone 015B,E01024350,1908,365,1543
2021,Maidstone 005E,E01024351,1536,274,1262
2021,Maidstone 004A,E01024352,1729,278,1451
2021,Maidstone 002A,E01024353,1933,371,1562
2021,Maidstone 002B,E01024354,1344,208,1136
2021,Maidstone 002C,E01024355,1899,345,1554
2021,Maidstone 006C,E01024356,1680,321,1359
2021,Maidstone 008A,E01024357,1590,296,1294
2021,Maidstone 008B,E01024358,1777,338,1439
2021,Maidstone 009A,E01024360,1469,273,1196
2021,Maidstone 011A,E01024361,1646,259,1387
2021,Maidstone 011B,E01024362,1815,276,1539
2021,Maidstone 017A,E01024364,1637,250,1387
2021,Maidstone 017B,E01024365,2370,424,1946
2021,Maidstone 017C,E01024366,1721,268,1453
2021,Maidstone 008C,E01024367,1645,352,1293
2021,Maidstone 008E,E01024369,1475,272,1203
2021,Maidstone 010A,E01024371,1709,338,1371
2021,Maidstone 009B,E01024372,2063,318,1745
2021,Maidstone 006E,E01024373,2092,381,1711
2021,Maidstone 009C,E01024374,1786,523,1263
2021,Maidstone 015C,E01024375,2294,333,1961
2021,Maidstone 016D,E01024376,2439,445,1994
2021,Maidstone 014C,E01024377,1634,272,1362
2021,Maidstone 014D,E01024378,1457,247,1210
2021,Maidstone 018B,E01024379,1737,310,1427
2021,Maidstone 018C,E01024380,2147,394,1753
2021,Maidstone 018D,E01024381,1877,305,1572
2021,Maidstone 004C,E01024382,1908,264,1644
2021,Maidstone 004D,E01024383,2606,337,2269
2021,Maidstone 004E,E01024384,1828,353,1475
2021,Maidstone 002D,E01024385,1588,332,1256
2021,Maidstone 002E,E01024386,1807,341,1466
2021,Maidstone 011D,E01024387,2578,394,2184
2021,Maidstone 013B,E01024390,1670,396,1274
2021,Maidstone 013C,E01024391,1340,323,1017
2021,Maidstone 010B,E01024392,1590,339,1251
2021,Maidstone 010C,E01024393,1565,305,1260
2021,Maidstone 012B,E01024394,1402,248,1154
2021,Maidstone 010D,E01024395,1350,274,1076
2021,Maidstone 010E,E01024396,1479,303,1176
2021,Maidstone 013D,E01024397,1329,300,1029
2021,Maidstone 013E,E01024398,1585,297,1288
2021,Maidstone 013F,E01024399,1245,197,1048
2021,Maidstone 013G,E01024400,1347,236,1111
2021,Maidstone 009D,E01024401,1826,339,1487
2021,Maidstone 012C,E01024402,1464,266,1198
2021,Maidstone 009E,E01024403,2169,401,1768
2021,Maidstone 012D,E01024404,1584,304,1280
2021,Maidstone 012E,E01024405,2559,523,2036
2021,Maidstone 019A,E01024406,1730,325,1405
2021,Maidstone 019B,E01024407,1736,319,1417
2021,Maidstone 019C,E01024408,1485,253,1232
2021,Maidstone 019D,E01024409,1405,213,1192
2021,Maidstone 015E,E01024410,1602,199,1403
2021,Maidstone 017D,E01024411,1373,305,1068
2021,Sevenoaks 016A,E01024413,1507,282,1225
2021,Sevenoaks 016B,E01024414,1483,297,1186
2021,Sevenoaks 016C,E01024415,1251,230,1021
2021,Sevenoaks 011A,E01024416,1611,390,1221
2021,Sevenoaks 013A,E01024417,1536,292,1244
2021,Sevenoaks 011B,E01024418,1361,346,1015
2021,Sevenoaks 013B,E01024419,1721,315,1406
2021,Sevenoaks 015A,E01024420,2019,323,1696
2021,Sevenoaks 003A,E01024421,1887,303,1584
2021,Sevenoaks 008B,E01024423,1592,306,1286
2021,Sevenoaks 011C,E01024424,1315,364,951
2021,Sevenoaks 014A,E01024425,1984,345,1639
2021,Sevenoaks 014B,E01024426,1893,314,1579
2021,Sevenoaks 014C,E01024427,1291,279,1012
2021,Sevenoaks 014D,E01024428,1246,246,1000
2021,Sevenoaks 014E,E01024429,1539,311,1228
2021,Sevenoaks 014F,E01024430,1286,203,1083
2021,Sevenoaks 005A,E01024431,1785,292,1493
2021,Sevenoaks 005B,E01024432,1441,238,1203
2021,Sevenoaks 005C,E01024433,1377,217,1160
2021,Sevenoaks 005D,E01024434,1827,301,1526
2021,Sevenoaks 007A,E01024435,1560,270,1290
2021,Sevenoaks 007B,E01024436,1427,149,1278
2021,Sevenoaks 007C,E01024437,1416,238,1178
2021,Sevenoaks 007D,E01024438,1371,189,1182
2021,Sevenoaks 008C,E01024439,1578,271,1307
2021,Sevenoaks 008D,E01024440,1846,329,1517
2021,Sevenoaks 004A,E01024441,1507,213,1294
2021,Sevenoaks 004B,E01024442,1487,226,1261
2021,Sevenoaks 004C,E01024443,1469,175,1294
2021,Sevenoaks 004D,E01024444,1214,231,983
2021,Sevenoaks 001A,E01024445,1292,191,1101
2021,Sevenoaks 001B,E01024446,1340,183,1157
2021,Sevenoaks 001C,E01024447,1255,223,1032
2021,Sevenoaks 009A,E01024448,1219,246,973
2021,Sevenoaks 009B,E01024449,1397,276,1121
2021,Sevenoaks 009C,E01024450,1471,293,1178
2021,Sevenoaks 015B,E01024451,2353,500,1853
2021,Sevenoaks 008E,E01024452,1426,240,1186
2021,Sevenoaks 009D,E01024453,1614,363,1251
2021,Sevenoaks 009E,E01024454,1489,315,1174
2021,Sevenoaks 015C,E01024455,1151,221,930
2021,Sevenoaks 015D,E01024456,1220,258,962
2021,Sevenoaks 010A,E01024457,1226,261,965
2021,Sevenoaks 012A,E01024458,1374,324,1050
2021,Sevenoaks 012B,E01024459,1492,322,1170
2021,Sevenoaks 010B,E01024460,1606,376,1230
2021,Sevenoaks 010C,E01024461,2302,460,1842
2021,Sevenoaks 012C,E01024462,1588,382,1206
2021,Sevenoaks 011D,E01024463,1511,384,1127
2021,Sevenoaks 011E,E01024464,1613,384,1229
2021,Sevenoaks 010D,E01024465,1341,239,1102
2021,Sevenoaks 010E,E01024466,1295,307,988
2021,Sevenoaks 011F,E01024467,1668,442,1226
2021,Sevenoaks 010F,E01024468,1463,321,1142
2021,Sevenoaks 012D,E01024469,1694,263,1431
2021,Sevenoaks 012E,E01024470,1567,380,1187
2021,Sevenoaks 012F,E01024471,1939,581,1358
2021,Sevenoaks 001D,E01024472,1419,311,1108
2021,Sevenoaks 003B,E01024473,1490,275,1215
2021,Sevenoaks 003C,E01024474,1541,249,1292
2021,Sevenoaks 003D,E01024475,1487,226,1261
2021,Sevenoaks 002A,E01024476,1619,377,1242
2021,Sevenoaks 002B,E01024477,1456,321,1135
2021,Sevenoaks 002C,E01024478,1456,296,1160
2021,Sevenoaks 001E,E01024479,1455,236,1219
2021,Sevenoaks 002D,E01024480,1716,357,1359
2021,Sevenoaks 002E,E01024481,1537,303,1234
2021,Sevenoaks 002F,E01024482,1478,293,1185
2021,Sevenoaks 013C,E01024483,1460,216,1244
2021,Sevenoaks 013D,E01024484,1178,198,980
2021,Sevenoaks 013E,E01024485,1615,330,1285
2021,Folkestone and Hythe 011A,E01024486,1898,200,1698
2021,Folkestone and Hythe 011B,E01024487,1238,156,1082
2021,Folkestone and Hythe 011C,E01024488,1210,100,1110
2021,Folkestone and Hythe 009A,E01024489,1540,124,1416
2021,Folkestone and Hythe 001A,E01024490,1927,252,1675
2021,Folkestone and Hythe 005A,E01024491,1402,282,1120
2021,Folkestone and Hythe 002A,E01024492,1517,282,1235
2021,Folkestone and Hythe 005B,E01024493,1442,285,1157
2021,Folkestone and Hythe 005C,E01024494,1841,324,1517
2021,Folkestone and Hythe 005D,E01024495,2112,485,1627
2021,Folkestone and Hythe 003A,E01024496,1403,291,1112
2021,Folkestone and Hythe 003B,E01024497,1502,305,1197
2021,Folkestone and Hythe 003C,E01024498,1510,362,1148
2021,Folkestone and Hythe 004A,E01024499,1536,363,1173
2021,Folkestone and Hythe 004B,E01024500,1169,281,888
2021,Folkestone and Hythe 004C,E01024501,1372,307,1065
2021,Folkestone and Hythe 004D,E01024502,1336,321,1015
2021,Folkestone and Hythe 003D,E01024503,1593,281,1312
2021,Folkestone and Hythe 014A,E01024504,1716,323,1393
2021,Folkestone and Hythe 004E,E01024505,1723,410,1313
2021,Folkestone and Hythe 014B,E01024507,1812,356,1456
2021,Folkestone and Hythe 015A,E01024508,1892,212,1680
2021,Folkestone and Hythe 015B,E01024509,1407,108,1299
2021,Folkestone and Hythe 015C,E01024510,1489,182,1307
2021,Folkestone and Hythe 006A,E01024511,1707,311,1396
2021,Folkestone and Hythe 006B,E01024512,1626,308,1318
2021,Folkestone and Hythe 006C,E01024513,1537,294,1243
2021,Folkestone and Hythe 006D,E01024514,1237,281,956
2021,Folkestone and Hythe 006E,E01024515,1716,282,1434
2021,Folkestone and Hythe 006F,E01024516,1318,232,1086
2021,Folkestone and Hythe 015D,E01024517,1594,244,1350
2021,Folkestone and Hythe 003E,E01024518,1574,289,1285
2021,Folkestone and Hythe 006G,E01024519,1725,207,1518
2021,Folkestone and Hythe 005E,E01024520,1433,275,1158
2021,Folkestone and Hythe 006H,E01024521,1552,182,1370
2021,Folkestone and Hythe 010A,E01024522,1336,145,1191
2021,Folkestone and Hythe 008A,E01024523,1520,223,1297
2021,Folkestone and Hythe 010B,E01024524,1379,151,1228
2021,Folkestone and Hythe 010C,E01024525,1471,182,1289
2021,Folkestone and Hythe 008B,E01024526,1422,169,1253
2021,Folkestone and Hythe 008C,E01024527,1596,184,1412
2021,Folkestone and Hythe 005F,E01024528,1191,184,1007
2021,Folkestone and Hythe 010D,E01024529,1387,167,1220
2021,Folkestone and Hythe 009B,E01024530,1767,298,1469
2021,Folkestone and Hythe 010E,E01024531,1359,222,1137
2021,Folkestone and Hythe 013A,E01024532,1258,193,1065
2021,Folkestone and Hythe 013B,E01024533,1108,124,984
2021,Folkestone and Hythe 013C,E01024534,1405,293,1112
2021,Folkestone and Hythe 013D,E01024535,2305,383,1922
2021,Folkestone and Hythe 009C,E01024536,1823,272,1551
2021,Folkestone and Hythe 012A,E01024537,1581,183,1398
2021,Folkestone and Hythe 012B,E01024538,1704,182,1522
2021,Folkestone and Hythe 012C,E01024539,1968,342,1626
2021,Folkestone and Hythe 012D,E01024540,1725,221,1504
2021,Folkestone and Hythe 002B,E01024541,2404,602,1802
2021,Folkestone and Hythe 002C,E01024542,1837,329,1508
2021,Folkestone and Hythe 001B,E01024544,1312,143,1169
2021,Folkestone and Hythe 001C,E01024545,1384,208,1176
2021,Folkestone and Hythe 009D,E01024546,1653,285,1368
2021,Folkestone and Hythe 001D,E01024547,1268,180,1088
2021,Folkestone and Hythe 011D,E01024548,1257,240,1017
2021,Folkestone and Hythe 011E,E01024549,1217,202,1015
2021,Folkestone and Hythe 008D,E01024550,1959,288,1671
2021,Swale 015A,E01024551,2072,379,1693
2021,Swale 015B,E01024552,2144,448,1696
2021,Swale 015C,E01024553,1908,206,1702
2021,Swale 009A,E01024554,2504,364,2140
2021,Swale 017A,E01024555,1283,209,1074
2021,Swale 017B,E01024556,1179,203,976
2021,Swale 017C,E01024557,1425,251,1174
2021,Swale 017D,E01024558,1663,274,1389
2021,Swale 010A,E01024559,1315,194,1121
2021,Swale 012A,E01024560,1316,316,1000
2021,Swale 009B,E01024561,1686,333,1353
2021,Swale 012B,E01024562,1595,324,1271
2021,Swale 015D,E01024563,1585,345,1240
2021,Swale 014A,E01024564,1178,195,983
2021,Swale 016A,E01024565,1211,169,1042
2021,Swale 016B,E01024566,1460,233,1227
2021,Swale 012C,E01024569,1769,312,1457
2021,Swale 008A,E01024570,1773,326,1447
2021,Swale 008B,E01024571,1911,297,1614
2021,Swale 008C,E01024572,1270,206,1064
2021,Swale 008D,E01024573,1248,189,1059
2021,Swale 008E,E01024575,1141,171,970
2021,Swale 007B,E01024576,1553,266,1287
2021,Swale 007C,E01024577,1282,235,1047
2021,Swale 007D,E01024578,1554,310,1244
2021,Swale 006A,E01024580,1936,257,1679
2021,Swale 006B,E01024581,1327,256,1071
2021,Swale 009E,E01024582,1455,213,1242
2021,Swale 007F,E01024583,1661,345,1316
2021,Swale 010B,E01024584,1631,293,1338
2021,Swale 003A,E01024585,1337,200,1137
2021,Swale 006C,E01024586,1581,223,1358
2021,Swale 003B,E01024587,1806,257,1549
2021,Swale 003C,E01024588,1605,232,1373
2021,Swale 003D,E01024589,1584,210,1374
2021,Swale 010C,E01024590,1439,344,1095
2021,Swale 011A,E01024591,2465,626,1839
2021,Swale 011B,E01024592,1183,171,1012
2021,Swale 011C,E01024593,1310,321,989
2021,Swale 005A,E01024594,1376,206,1170
2021,Swale 004A,E01024595,1515,265,1250
2021,Swale 005B,E01024596,1577,278,1299
2021,Swale 005C,E01024597,1708,393,1315
2021,Swale 004B,E01024598,1604,282,1322
2021,Swale 010D,E01024599,1889,371,1518
2021,Swale 011D,E01024600,1392,262,1130
2021,Swale 011E,E01024601,1603,243,1360
2021,Swale 015E,E01024602,1345,193,1152
2021,Swale 014B,E01024603,1179,200,979
2021,Swale 014C,E01024604,1130,252,878
2021,Swale 014D,E01024605,1232,171,1061
2021,Swale 013A,E01024606,1309,261,1048
2021,Swale 010E,E01024608,1946,390,1556
2021,Swale 001A,E01024609,1312,265,1047
2021,Swale 001B,E01024610,1642,434,1208
2021,Swale 001C,E01024611,1563,397,1166
2021,Swale 001D,E01024612,1562,339,1223
2021,Swale 002A,E01024613,1538,324,1214
2021,Swale 002B,E01024614,1480,384,1096
2021,Swale 002C,E01024615,1386,294,1092
2021,Swale 002D,E01024616,1685,363,1322
2021,Swale 004D,E01024619,1365,180,1185
2021,Swale 005D,E01024620,1525,236,1289
2021,Swale 004E,E01024621,1310,273,1037
2021,Swale 016C,E01024622,1666,257,1409
2021,Swale 016D,E01024623,1980,400,1580
2021,Swale 016E,E01024624,2667,476,2191
2021,Swale 015F,E01024625,1816,294,1522
2021,Swale 014E,E01024626,1900,396,1504
2021,Swale 014F,E01024627,1848,369,1479
2021,Swale 013C,E01024628,1473,249,1224
2021,Swale 013D,E01024629,1096,175,921
2021,Swale 012D,E01024630,1598,242,1356
2021,Swale 013E,E01024631,1620,280,1340
2021,Swale 012E,E01024632,1442,204,1238
2021,Thanet 006A,E01024633,1540,363,1177
2021,Thanet 006B,E01024634,1302,275,1027
2021,Thanet 009A,E01024635,1596,299,1297
2021,Thanet 008A,E01024636,2059,192,1867
2021,Thanet 008B,E01024637,1727,218,1509
2021,Thanet 008C,E01024638,1617,199,1418
2021,Thanet 008D,E01024639,1590,209,1381
2021,Thanet 008E,E01024640,1609,243,1366
2021,Thanet 007A,E01024641,1456,229,1227
2021,Thanet 009B,E01024642,1379,173,1206
2021,Thanet 010A,E01024643,1135,184,951
2021,Thanet 009C,E01024644,1331,185,1146
2021,Thanet 015A,E01024645,1494,292,1202
2021,Thanet 016A,E01024646,1846,273,1573
2021,Thanet 015B,E01024647,1490,297,1193
2021,Thanet 016B,E01024648,1442,234,1208
2021,Thanet 016C,E01024649,1708,242,1466
2021,Thanet 017A,E01024650,1433,203,1230
2021,Thanet 017B,E01024651,1431,184,1247
2021,Thanet 017C,E01024652,1824,273,1551
2021,Thanet 002A,E01024653,1597,268,1329
2021,Thanet 002B,E01024654,1525,205,1320
2021,Thanet 002C,E01024655,1474,218,1256
2021,Thanet 002D,E01024656,1611,203,1408
2021,Thanet 001A,E01024657,2239,462,1777
2021,Thanet 001B,E01024658,2095,371,1724
2021,Thanet 001C,E01024659,1567,262,1305
2021,Thanet 001D,E01024660,1695,310,1385
2021,Thanet 004A,E01024661,1433,302,1131
2021,Thanet 006C,E01024662,1463,287,1176
2021,Thanet 006D,E01024663,1440,412,1028
2021,Thanet 004B,E01024664,1475,310,1165
2021,Thanet 004C,E01024665,1458,312,1146
2021,Thanet 006E,E01024666,1501,326,1175
2021,Thanet 016D,E01024667,1647,267,1380
2021,Thanet 015C,E01024668,1280,348,932
2021,Thanet 012A,E01024669,1625,368,1257
2021,Thanet 015D,E01024670,1604,337,1267
2021,Thanet 016E,E01024671,1545,228,1317
2021,Thanet 005A,E01024672,1411,253,1158
2021,Thanet 005B,E01024673,1781,316,1465
2021,Thanet 005C,E01024674,1553,288,1265
2021,Thanet 002E,E01024675,2124,300,1824
2021,Thanet 003A,E01024676,1973,354,1619
2021,Thanet 003B,E01024677,1689,362,1327
2021,Thanet 017D,E01024679,1224,140,1084
2021,Thanet 017E,E01024680,1597,280,1317
2021,Thanet 015E,E01024681,1770,395,1375
2021,Thanet 013A,E01024682,2087,596,1491
2021,Thanet 013B,E01024683,1579,366,1213
2021,Thanet 013C,E01024684,1634,348,1286
2021,Thanet 013D,E01024685,1697,318,1379
2021,Thanet 011A,E01024686,1593,282,1311
2021,Thanet 013E,E01024687,1366,304,1062
2021,Thanet 011B,E01024688,1641,245,1396
2021,Thanet 011C,E01024689,1193,205,988
2021,Thanet 011D,E01024690,1402,210,1192
2021,Thanet 011E,E01024691,1183,223,960
2021,Thanet 009D,E01024692,1626,255,1371
2021,Thanet 009E,E01024693,1332,236,1096
2021,Thanet 004D,E01024694,1561,298,1263
2021,Thanet 003C,E01024695,1243,283,960
2021,Thanet 004E,E01024696,1446,261,1185
2021,Thanet 003D,E01024697,1127,248,879
2021,Thanet 012B,E01024698,1367,260,1107
2021,Thanet 012C,E01024699,1759,403,1356
2021,Thanet 012D,E01024700,1682,316,1366
2021,Thanet 014B,E01024702,1304,199,1105
2021,Thanet 014C,E01024703,1791,307,1484
2021,Thanet 014D,E01024704,1715,276,1439
2021,Thanet 010B,E01024705,1041,112,929
2021,Thanet 010C,E01024706,1359,254,1105
2021,Thanet 010D,E01024707,1333,242,1091
2021,Thanet 010E,E01024708,1922,297,1625
2021,Thanet 012E,E01024709,1344,211,1133
2021,Thanet 003E,E01024710,1400,161,1239
2021,Thanet 005D,E01024711,1378,244,1134
2021,Thanet 005E,E01024712,1555,259,1296
2021,Thanet 007B,E01024713,1734,365,1369
2021,Thanet 007C,E01024714,1628,183,1445
2021,Thanet 007D,E01024715,1830,220,1610
2021,Thanet 007E,E01024716,2002,376,1626
2021,Tonbridge and Malling 005A,E01024717,2109,396,1713
2021,Tonbridge and Malling 005B,E01024718,1283,219,1064
2021,Tonbridge and Malling 001A,E01024719,2158,373,1785
2021,Tonbridge and Malling 001B,E01024720,1292,205,1087
2021,Tonbridge and Malling 001C,E01024721,1282,234,1048
2021,Tonbridge and Malling 001D,E01024722,1307,256,1051
2021,Tonbridge and Malling 006A,E01024723,1549,313,1236
2021,Tonbridge and Malling 006B,E01024724,1994,387,1607
2021,Tonbridge and Malling 006C,E01024725,1996,389,1607
2021,Tonbridge and Malling 006D,E01024726,1767,342,1425
2021,Tonbridge and Malling 001F,E01024728,1672,283,1389
2021,Tonbridge and Malling 011A,E01024729,1625,354,1271
2021,Tonbridge and Malling 009A,E01024730,1301,201,1100
2021,Tonbridge and Malling 009B,E01024731,1102,175,927
2021,Tonbridge and Malling 012A,E01024732,1979,676,1303
2021,Tonbridge and Malling 012B,E01024733,1694,339,1355
2021,Tonbridge and Malling 010A,E01024734,1564,243,1321
2021,Tonbridge and Malling 005C,E01024735,1433,235,1198
2021,Tonbridge and Malling 005D,E01024736,1691,326,1365
2021,Tonbridge and Malling 005E,E01024737,2251,450,1801
2021,Tonbridge and Malling 014A,E01024740,1898,293,1605
2021,Tonbridge and Malling 003A,E01024741,1488,426,1062
2021,Tonbridge and Malling 014B,E01024742,1709,369,1340
2021,Tonbridge and Malling 008A,E01024743,1777,303,1474
2021,Tonbridge and Malling 008B,E01024744,1877,305,1572
2021,Tonbridge and Malling 008C,E01024745,1787,407,1380
2021,Tonbridge and Malling 007A,E01024746,1037,181,856
2021,Tonbridge and Malling 008D,E01024747,1444,259,1185
2021,Tonbridge and Malling 011B,E01024748,1326,245,1081
2021,Tonbridge and Malling 011C,E01024749,1499,338,1161
2021,Tonbridge and Malling 011D,E01024750,1457,271,1186
2021,Tonbridge and Malling 011E,E01024751,1464,261,1203
2021,Tonbridge and Malling 010B,E01024752,1586,346,1240
2021,Tonbridge and Malling 010C,E01024753,1516,323,1193
2021,Tonbridge and Malling 010D,E01024754,1660,349,1311
2021,Tonbridge and Malling 006E,E01024755,1930,428,1502
2021,Tonbridge and Malling 012C,E01024756,1447,284,1163
2021,Tonbridge and Malling 013A,E01024757,1538,286,1252
2021,Tonbridge and Malling 013B,E01024758,1597,318,1279
2021,Tonbridge and Malling 007C,E01024760,1431,377,1054
2021,Tonbridge and Malling 003B,E01024761,2025,339,1686
2021,Tonbridge and Malling 003C,E01024762,2057,359,1698
2021,Tonbridge and Malling 003D,E01024763,1289,248,1041
2021,Tonbridge and Malling 003E,E01024764,1259,197,1062
2021,Tonbridge and Malling 003F,E01024765,1242,190,1052
2021,Tonbridge and Malling 012E,E01024767,1938,429,1509
2021,Tonbridge and Malling 012F,E01024768,1733,299,1434
2021,Tonbridge and Malling 002C,E01024771,1803,369,1434
2021,Tonbridge and Malling 002D,E01024772,1583,288,1295
2021,Tonbridge and Malling 002E,E01024773,1633,219,1414
2021,Tonbridge and Malling 009C,E01024775,1547,376,1171
2021,Tonbridge and Malling 009D,E01024776,1315,317,998
2021,Tonbridge and Malling 009E,E01024777,1108,208,900
2021,Tonbridge and Malling 013C,E01024778,1721,336,1385
2021,Tonbridge and Malling 013D,E01024779,1716,294,1422
2021,Tonbridge and Malling 013E,E01024780,1478,323,1155
2021,Tonbridge and Malling 007D,E01024781,1900,354,1546
2021,Tonbridge and Malling 003G,E01024782,1153,195,958
2021,Tonbridge and Malling 014C,E01024783,1515,229,1286
2021,Tonbridge and Malling 003H,E01024785,1442,264,1178
2021,Tonbridge and Malling 006F,E01024786,1866,359,1507
2021,Tunbridge Wells 013A,E01024787,1176,215,961
2021,Tunbridge Wells 013B,E01024788,1351,263,1088
2021,Tunbridge Wells 014A,E01024789,2234,756,1478
2021,Tunbridge Wells 013C,E01024790,1141,355,786
2021,Tunbridge Wells 013D,E01024791,1318,255,1063
2021,Tunbridge Wells 011A,E01024792,1783,352,1431
2021,Tunbridge Wells 004A,E01024793,1641,237,1404
2021,Tunbridge Wells 011B,E01024794,1611,322,1289
2021,Tunbridge Wells 010A,E01024795,1457,349,1108
2021,Tunbridge Wells 010B,E01024796,1302,230,1072
2021,Tunbridge Wells 012A,E01024797,1568,238,1330
2021,Tunbridge Wells 001A,E01024798,2254,441,1813
2021,Tunbridge Wells 007A,E01024799,2051,336,1715
2021,Tunbridge Wells 007B,E01024800,1561,359,1202
2021,Tunbridge Wells 008B,E01024802,1719,237,1482
2021,Tunbridge Wells 013E,E01024803,2204,427,1777
2021,Tunbridge Wells 011C,E01024804,1353,263,1090
2021,Tunbridge Wells 011D,E01024805,1561,309,1252
2021,Tunbridge Wells 011E,E01024806,1577,374,1203
2021,Tunbridge Wells 014B,E01024807,1525,260,1265
2021,Tunbridge Wells 014C,E01024808,1653,294,1359
2021,Tunbridge Wells 014D,E01024809,1340,228,1112
2021,Tunbridge Wells 014E,E01024810,1581,330,1251
2021,Tunbridge Wells 001B,E01024811,1137,179,958
2021,Tunbridge Wells 001C,E01024812,1333,228,1105
2021,Tunbridge Wells 001D,E01024813,1509,232,1277
2021,Tunbridge Wells 001E,E01024814,1210,209,1001
2021,Tunbridge Wells 001F,E01024815,1145,212,933
2021,Tunbridge Wells 001G,E01024816,1420,293,1127
2021,Tunbridge Wells 012B,E01024817,1639,298,1341
2021,Tunbridge Wells 012C,E01024818,1713,324,1389
2021,Tunbridge Wells 012D,E01024819,1452,177,1275
2021,Tunbridge Wells 012E,E01024820,1602,374,1228
2021,Tunbridge Wells 009A,E01024821,1962,314,1648
2021,Tunbridge Wells 009B,E01024822,2113,421,1692
2021,Tunbridge Wells 008C,E01024823,1758,263,1495
2021,Tunbridge Wells 009C,E01024824,1583,338,1245
2021,Tunbridge Wells 004B,E01024825,1300,235,1065
2021,Tunbridge Wells 004C,E01024826,1333,224,1109
2021,Tunbridge Wells 004D,E01024827,1440,301,1139
2021,Tunbridge Wells 004E,E01024828,1506,297,1209
2021,Tunbridge Wells 006A,E01024829,1530,334,1196
2021,Tunbridge Wells 010C,E01024830,1794,318,1476
2021,Tunbridge Wells 010D,E01024831,1265,244,1021
2021,Tunbridge Wells 009D,E01024832,1536,310,1226
2021,Tunbridge Wells 008D,E01024833,2352,401,1951
2021,Tunbridge Wells 009E,E01024834,2049,447,1602
2021,Tunbridge Wells 007C,E01024835,1922,443,1479
2021,Tunbridge Wells 003A,E01024836,1621,365,1256
2021,Tunbridge Wells 002A,E01024837,1770,453,1317
2021,Tunbridge Wells 007D,E01024838,1647,376,1271
2021,Tunbridge Wells 003B,E01024839,2619,474,2145
2021,Tunbridge Wells 005A,E01024840,1734,453,1281
2021,Tunbridge Wells 005B,E01024841,1840,398,1442
2021,Tunbridge Wells 005C,E01024842,1553,281,1272
2021,Tunbridge Wells 005D,E01024843,1352,304,1048
2021,Tunbridge Wells 002B,E01024844,1471,301,1170
2021,Tunbridge Wells 003C,E01024845,1304,305,999
2021,Tunbridge Wells 002C,E01024846,1552,341,1211
2021,Tunbridge Wells 003D,E01024847,1486,302,1184
2021,Tunbridge Wells 003E,E01024848,1288,210,1078
2021,Tunbridge Wells 002D,E01024849,1546,334,1212
2021,Tunbridge Wells 002E,E01024850,1314,273,1041
2021,Tunbridge Wells 006B,E01024851,1589,334,1255
2021,Tunbridge Wells 006C,E01024852,1330,331,999
2021,Tunbridge Wells 006D,E01024853,1299,262,1037
2021,Tunbridge Wells 006E,E01024854,1565,366,1199
2021,Burnley 007A,E01024855,1361,221,1140
2021,Burnley 003A,E01024856,1894,554,1340
2021,Burnley 007B,E01024857,1459,335,1124
2021,Burnley 007C,E01024858,1581,394,1187
2021,Burnley 001A,E01024859,1368,238,1130
2021,Burnley 009A,E01024860,1320,201,1119
2021,Burnley 001B,E01024861,1185,170,1015
2021,Burnley 001C,E01024862,1403,220,1183
2021,Burnley 008A,E01024863,1483,377,1106
2021,Burnley 007D,E01024864,1489,292,1197
2021,Burnley 008B,E01024865,1351,221,1130
2021,Burnley 008C,E01024866,1646,258,1388
2021,Burnley 008D,E01024867,1313,189,1124
2021,Burnley 009B,E01024868,1118,165,953
2021,Burnley 009C,E01024869,1370,158,1212
2021,Burnley 009D,E01024870,1114,146,968
2021,Burnley 014D,E01024871,1236,202,1034
2021,Burnley 010A,E01024872,1469,339,1130
2021,Burnley 014E,E01024873,1287,224,1063
2021,Burnley 011A,E01024874,995,144,851
2021,Burnley 003B,E01024875,1780,607,1173
2021,Burnley 003C,E01024876,1756,514,1242
2021,Burnley 003D,E01024877,1912,548,1364
2021,Burnley 003E,E01024878,1821,613,1208
2021,Burnley 005A,E01024879,1498,323,1175
2021,Burnley 005B,E01024880,1390,203,1187
2021,Burnley 006A,E01024881,1331,285,1046
2021,Burnley 006B,E01024882,1324,241,1083
2021,Burnley 004A,E01024883,1461,319,1142
2021,Burnley 004B,E01024884,1579,297,1282
2021,Burnley 004C,E01024885,1524,251,1273
2021,Burnley 004D,E01024886,1414,298,1116
2021,Burnley 011B,E01024887,1481,306,1175
2021,Burnley 011C,E01024888,1783,310,1473
2021,Burnley 004E,E01024889,1224,215,1009
2021,Burnley 004F,E01024890,1552,388,1164
2021,Burnley 001D,E01024891,1858,451,1407
2021,Burnley 001E,E01024892,1482,334,1148
2021,Burnley 002A,E01024893,1706,400,1306
2021,Burnley 001F,E01024894,1281,313,968
2021,Burnley 003F,E01024895,1690,433,1257
2021,Burnley 002B,E01024896,1324,264,1060
2021,Burnley 002C,E01024897,1475,291,1184
2021,Burnley 002D,E01024898,1726,410,1316
2021,Burnley 010B,E01024899,1574,365,1209
2021,Burnley 010C,E01024900,1586,412,1174
2021,Burnley 011D,E01024901,1649,266,1383
2021,Burnley 006C,E01024902,1828,331,1497
2021,Burnley 014F,E01024903,1189,336,853
2021,Burnley 014A,E01024904,1750,310,1440
2021,Burnley 014G,E01024905,1203,202,1001
2021,Burnley 014B,E01024906,2074,426,1648
2021,Burnley 010D,E01024907,1283,260,1023
2021,Burnley 010E,E01024908,1401,286,1115
2021,Burnley 010F,E01024909,1584,307,1277
2021,Burnley 014C,E01024910,1346,267,1079
2021,Burnley 006D,E01024911,1741,318,1423
2021,Burnley 005C,E01024912,1306,171,1135
2021,Burnley 005D,E01024913,1205,244,961
2021,Burnley 005E,E01024914,1352,204,1148
2021,Chorley 014A,E01024915,2532,508,2024
2021,Chorley 014B,E01024916,1645,228,1417
2021,Chorley 014C,E01024917,1651,292,1359
2021,Chorley 014D,E01024918,1675,240,1435
2021,Chorley 008B,E01024920,1828,229,1599
2021,Chorley 002A,E01024921,1934,266,1668
2021,Chorley 013A,E01024922,1353,243,1110
2021,Chorley 011A,E01024923,1243,192,1051
2021,Chorley 011B,E01024924,1388,200,1188
2021,Chorley 009A,E01024925,1628,354,1274
2021,Chorley 009B,E01024926,2284,515,1769
2021,Chorley 009C,E01024927,1533,269,1264
2021,Chorley 009D,E01024928,1364,224,1140
2021,Chorley 006B,E01024930,1367,238,1129
2021,Chorley 006C,E01024931,1327,242,1085
2021,Chorley 006E,E01024933,1253,187,1066
2021,Chorley 008C,E01024934,1590,251,1339
2021,Chorley 008D,E01024935,1298,167,1131
2021,Chorley 010A,E01024936,1569,230,1339
2021,Chorley 006F,E01024937,1449,206,1243
2021,Chorley 010B,E01024938,2003,402,1601
2021,Chorley 010C,E01024939,2209,448,1761
2021,Chorley 010D,E01024940,1597,272,1325
2021,Chorley 010E,E01024941,1770,320,1450
2021,Chorley 012A,E01024942,1500,243,1257
2021,Chorley 012B,E01024943,2230,496,1734
2021,Chorley 012C,E01024944,2072,469,1603
2021,Chorley 003A,E01024946,1166,186,980
2021,Chorley 003B,E01024947,1247,258,989
2021,Chorley 004A,E01024948,1582,268,1314
2021,Chorley 004C,E01024950,1286,248,1038
2021,Chorley 001A,E01024951,1088,268,820
2021,Chorley 001B,E01024952,1147,163,984
2021,Chorley 001C,E01024953,1300,261,1039
2021,Chorley 001D,E01024954,1479,219,1260
2021,Chorley 003C,E01024955,1319,184,1135
2021,Chorley 003D,E01024956,1797,263,1534
2021,Chorley 003E,E01024957,2429,515,1914
2021,Chorley 003F,E01024958,1218,244,974
2021,Chorley 013B,E01024959,1876,370,1506
2021,Chorley 013C,E01024960,1677,339,1338
2021,Chorley 013D,E01024961,1501,228,1273
2021,Chorley 013E,E01024962,1465,177,1288
2021,Chorley 011C,E01024963,1435,244,1191
2021,Chorley 007A,E01024964,1511,248,1263
2021,Chorley 011D,E01024965,1373,193,1180
2021,Chorley 011E,E01024966,1808,365,1443
2021,Chorley 005A,E01024967,1169,148,1021
2021,Chorley 005B,E01024968,2068,447,1621
2021,Chorley 005C,E01024969,1329,233,1096
2021,Chorley 005D,E01024970,1300,234,1066
2021,Chorley 005E,E01024971,1301,214,1087
2021,Chorley 005F,E01024972,1138,156,982
2021,Chorley 014E,E01024973,2043,291,1752
2021,Chorley 007B,E01024974,1549,288,1261
2021,Chorley 007C,E01024975,3019,267,2752
2021,Chorley 007D,E01024976,1570,265,1305
2021,Chorley 004D,E01024977,2550,456,2094
2021,Chorley 002B,E01024978,1239,219,1020
2021,Chorley 002C,E01024979,1308,188,1120
2021,Chorley 002D,E01024980,1284,229,1055
2021,Fylde 008A,E01024981,1305,147,1158
2021,Fylde 008B,E01024982,1321,158,1163
2021,Fylde 008C,E01024983,1387,302,1085
2021,Fylde 006A,E01024984,1389,167,1222
2021,Fylde 006B,E01024985,1357,228,1129
2021,Fylde 006C,E01024986,1579,119,1460
2021,Fylde 006D,E01024987,1273,185,1088
2021,Fylde 006E,E01024988,1549,144,1405
2021,Fylde 006F,E01024989,1445,264,1181
2021,Fylde 009A,E01024990,1383,131,1252
2021,Fylde 009B,E01024991,1034,89,945
2021,Fylde 009C,E01024992,1378,123,1255
2021,Fylde 001A,E01024993,1556,209,1347
2021,Fylde 008D,E01024994,1523,176,1347
2021,Fylde 008E,E01024995,1344,169,1175
2021,Fylde 006G,E01024996,1151,111,1040
2021,Fylde 007A,E01024997,1380,145,1235
2021,Fylde 003A,E01024998,1663,330,1333
2021,Fylde 007B,E01024999,1384,212,1172
2021,Fylde 007C,E01025000,1187,135,1052
2021,Fylde 005A,E01025001,2041,304,1737
2021,Fylde 005B,E01025002,1334,245,1089
2021,Fylde 008F,E01025003,1651,239,1412
2021,Fylde 004A,E01025004,1272,199,1073
2021,Fylde 005C,E01025005,1398,140,1258
2021,Fylde 004B,E01025006,1162,222,940
2021,Fylde 002A,E01025007,1879,384,1495
2021,Fylde 002B,E01025008,1072,172,900
2021,Fylde 002C,E01025009,1476,201,1275
2021,Fylde 003B,E01025010,1637,196,1441
2021,Fylde 002D,E01025011,1465,243,1222
2021,Fylde 002E,E01025012,2603,531,2072
2021,Fylde 002F,E01025013,1618,324,1294
2021,Fylde 003C,E01025014,1677,276,1401
2021,Fylde 003D,E01025015,1438,233,1205
2021,Fylde 005D,E01025016,2270,370,1900
2021,Fylde 008G,E01025017,1397,199,1198
2021,Fylde 005E,E01025018,1190,175,1015
2021,Fylde 002G,E01025019,1796,278,1518
2021,Fylde 009D,E01025020,1326,248,1078
2021,Fylde 009E,E01025021,1295,209,1086
2021,Fylde 009F,E01025022,1788,301,1487
2021,Fylde 004C,E01025023,1217,160,1057
2021,Fylde 004D,E01025024,2081,334,1747
2021,Fylde 004E,E01025025,1486,319,1167
2021,Fylde 001B,E01025026,1368,206,1162
2021,Fylde 001C,E01025027,1716,336,1380
2021,Fylde 001D,E01025028,1522,298,1224
2021,Fylde 007D,E01025029,2478,387,2091
2021,Fylde 007E,E01025030,1934,411,1523
2021,Fylde 001E,E01025031,1884,281,1603
2021,Hyndburn 002A,E01025032,1357,273,1084
2021,Hyndburn 002B,E01025033,2108,483,1625
2021,Hyndburn 002C,E01025034,1649,358,1291
2021,Hyndburn 008A,E01025035,1356,216,1140
2021,Hyndburn 008B,E01025036,1598,291,1307
2021,Hyndburn 008C,E01025037,1477,334,1143
2021,Hyndburn 008D,E01025038,1256,196,1060
2021,Hyndburn 008E,E01025039,1149,173,976
2021,Hyndburn 008F,E01025040,1350,212,1138
2021,Hyndburn 006A,E01025041,1578,428,1150
2021,Hyndburn 006B,E01025042,2182,757,1425
2021,Hyndburn 005A,E01025044,1113,278,835
2021,Hyndburn 005B,E01025045,1152,307,845
2021,Hyndburn 005C,E01025046,1212,198,1014
2021,Hyndburn 002D,E01025048,1408,200,1208
2021,Hyndburn 002E,E01025049,1392,274,1118
2021,Hyndburn 002F,E01025050,1455,245,1210
2021,Hyndburn 004A,E01025051,1558,332,1226
2021,Hyndburn 004B,E01025052,1462,237,1225
2021,Hyndburn 002G,E01025053,1459,286,1173
2021,Hyndburn 009A,E01025054,1503,239,1264
2021,Hyndburn 007A,E01025055,1349,271,1078
2021,Hyndburn 009B,E01025056,1237,149,1088
2021,Hyndburn 004C,E01025057,1553,351,1202
2021,Hyndburn 004D,E01025058,1374,238,1136
2021,Hyndburn 004E,E01025059,1694,318,1376
2021,Hyndburn 001A,E01025060,1362,362,1000
2021,Hyndburn 001B,E01025061,1533,205,1328
2021,Hyndburn 001C,E01025062,1566,344,1222
2021,Hyndburn 001D,E01025063,1445,238,1207
2021,Hyndburn 001E,E01025064,1509,221,1288
2021,Hyndburn 001F,E01025065,1509,275,1234
2021,Hyndburn 001G,E01025066,1483,298,1185
2021,Hyndburn 004F,E01025067,1381,296,1085
2021,Hyndburn 004G,E01025068,1464,346,1118
2021,Hyndburn 004H,E01025069,1300,269,1031
2021,Hyndburn 003A,E01025070,1118,247,871
2021,Hyndburn 003B,E01025071,1253,211,1042
2021,Hyndburn 003C,E01025072,1413,273,1140
2021,Hyndburn 003D,E01025073,1224,186,1038
2021,Hyndburn 003E,E01025074,1283,207,1076
2021,Hyndburn 007B,E01025075,1618,302,1316
2021,Hyndburn 007C,E01025076,1196,194,1002
2021,Hyndburn 007D,E01025077,1346,234,1112
2021,Hyndburn 007E,E01025078,1342,225,1117
2021,Hyndburn 009C,E01025079,1501,217,1284
2021,Hyndburn 009D,E01025080,1397,202,1195
2021,Hyndburn 005D,E01025081,1533,232,1301
2021,Hyndburn 006E,E01025082,1585,424,1161
2021,Hyndburn 006F,E01025083,1945,536,1409
2021,Hyndburn 006G,E01025084,1608,488,1120
2021,Lancaster 004A,E01025085,1381,233,1148
2021,Lancaster 004B,E01025086,1318,142,1176
2021,Lancaster 004C,E01025087,1274,151,1123
2021,Lancaster 001A,E01025088,996,167,829
2021,Lancaster 003A,E01025089,1382,194,1188
2021,Lancaster 003B,E01025090,1543,204,1339
2021,Lancaster 013A,E01025091,1582,345,1237
2021,Lancaster 013B,E01025092,1218,252,966
2021,Lancaster 014A,E01025093,2157,1269,888
2021,Lancaster 014B,E01025094,1305,453,852
2021,Lancaster 013C,E01025095,2797,522,2275
2021,Lancaster 001B,E01025096,1542,275,1267
2021,Lancaster 001C,E01025097,1415,276,1139
2021,Lancaster 001D,E01025098,1292,183,1109
2021,Lancaster 014C,E01025099,1892,718,1174
2021,Lancaster 017A,E01025100,2268,440,1828
2021,Lancaster 017B,E01025101,1284,316,968
2021,Lancaster 017C,E01025102,1491,518,973
2021,Lancaster 017D,E01025103,1198,241,957
2021,Lancaster 019A,E01025105,5692,4708,984
2021,Lancaster 019B,E01025106,1958,409,1549
2021,Lancaster 019C,E01025107,1521,250,1271
2021,Lancaster 005A,E01025108,1415,274,1141
2021,Lancaster 005B,E01025109,1327,225,1102
2021,Lancaster 009A,E01025110,1438,264,1174
2021,Lancaster 008A,E01025111,1706,330,1376
2021,Lancaster 006A,E01025112,1472,280,1192
2021,Lancaster 008B,E01025113,1427,272,1155
2021,Lancaster 016A,E01025114,1452,202,1250
2021,Lancaster 016B,E01025115,1415,270,1145
2021,Lancaster 009B,E01025116,1300,192,1108
2021,Lancaster 009C,E01025117,1355,313,1042
2021,Lancaster 008C,E01025118,1020,218,802
2021,Lancaster 008D,E01025119,1272,225,1047
2021,Lancaster 009D,E01025120,1320,279,1041
2021,Lancaster 016C,E01025121,1926,339,1587
2021,Lancaster 016D,E01025122,1587,259,1328
2021,Lancaster 016E,E01025123,2460,540,1920
2021,Lancaster 016F,E01025124,1456,328,1128
2021,Lancaster 013D,E01025126,1997,529,1468
2021,Lancaster 018A,E01025127,1295,227,1068
2021,Lancaster 015B,E01025128,1269,436,833
2021,Lancaster 002A,E01025130,2188,366,1822
2021,Lancaster 005C,E01025131,1479,249,1230
2021,Lancaster 002B,E01025132,1345,215,1130
2021,Lancaster 005D,E01025133,1525,254,1271
2021,Lancaster 006B,E01025136,1439,367,1072
2021,Lancaster 020A,E01025137,1357,238,1119
2021,Lancaster 006C,E01025138,1272,294,978
2021,Lancaster 006D,E01025139,1466,250,1216
2021,Lancaster 006E,E01025140,1362,194,1168
2021,Lancaster 018B,E01025141,1293,299,994
2021,Lancaster 019D,E01025142,1422,238,1184
2021,Lancaster 018C,E01025143,1342,301,1041
2021,Lancaster 017E,E01025144,1702,547,1155
2021,Lancaster 018D,E01025145,1374,474,900
2021,Lancaster 017F,E01025146,1883,411,1472
2021,Lancaster 015D,E01025147,1423,446,977
2021,Lancaster 001E,E01025148,2057,275,1782
2021,Lancaster 011A,E01025149,2057,441,1616
2021,Lancaster 011B,E01025150,1451,280,1171
2021,Lancaster 011C,E01025151,1517,336,1181
2021,Lancaster 011D,E01025152,1465,329,1136
2021,Lancaster 020F,E01025153,1198,223,975
2021,Lancaster 011E,E01025154,1270,244,1026
2021,Lancaster 020G,E01025155,1206,212,994
2021,Lancaster 020H,E01025156,1282,402,880
2021,Lancaster 020I,E01025157,1142,171,971
2021,Lancaster 003C,E01025158,1367,184,1183
2021,Lancaster 003D,E01025159,1302,192,1110
2021,Lancaster 003E,E01025160,1387,234,1153
2021,Lancaster 004D,E01025161,1054,78,976
2021,Lancaster 020B,E01025162,1351,185,1166
2021,Lancaster 020C,E01025163,1271,182,1089
2021,Lancaster 020D,E01025164,1349,177,1172
2021,Lancaster 020E,E01025165,1377,293,1084
2021,Lancaster 002C,E01025166,1138,166,972
2021,Lancaster 002D,E01025167,1101,151,950
2021,Lancaster 001F,E01025168,1021,135,886
2021,Lancaster 001G,E01025169,1233,189,1044
2021,Lancaster 010A,E01025170,1532,184,1348
2021,Lancaster 010B,E01025171,1843,377,1466
2021,Lancaster 010C,E01025172,1317,215,1102
2021,Lancaster 010D,E01025173,1535,279,1256
2021,Pendle 008A,E01025174,1360,253,1107
2021,Pendle 008B,E01025175,1428,233,1195
2021,Pendle 008C,E01025176,1888,302,1586
2021,Pendle 008D,E01025177,1580,202,1378
2021,Pendle 006A,E01025178,1769,281,1488
2021,Pendle 006B,E01025179,1425,241,1184
2021,Pendle 006C,E01025180,1770,281,1489
2021,Pendle 009A,E01025181,1679,510,1169
2021,Pendle 009B,E01025182,1768,466,1302
2021,Pendle 009C,E01025183,1814,477,1337
2021,Pendle 009D,E01025184,1877,620,1257
2021,Pendle 013A,E01025185,2029,548,1481
2021,Pendle 013B,E01025186,1843,460,1383
2021,Pendle 012A,E01025187,1429,359,1070
2021,Pendle 010A,E01025188,2124,578,1546
2021,Pendle 010B,E01025189,1669,441,1228
2021,Pendle 012B,E01025190,1608,336,1272
2021,Pendle 001A,E01025191,1222,221,1001
2021,Pendle 001B,E01025192,1463,309,1154
2021,Pendle 001C,E01025193,1290,203,1087
2021,Pendle 001D,E01025194,1262,234,1028
2021,Pendle 002A,E01025195,1191,184,1007
2021,Pendle 002B,E01025196,1487,226,1261
2021,Pendle 002C,E01025197,1226,174,1052
2021,Pendle 002D,E01025198,1412,271,1141
2021,Pendle 003A,E01025199,1729,289,1440
2021,Pendle 003B,E01025200,1436,243,1193
2021,Pendle 003C,E01025201,1388,216,1172
2021,Pendle 003D,E01025202,1351,245,1106
2021,Pendle 006D,E01025203,1673,259,1414
2021,Pendle 008E,E01025204,1644,182,1462
2021,Pendle 014E,E01025205,1158,262,896
2021,Pendle 014A,E01025206,1158,176,982
2021,Pendle 014G,E01025207,1131,173,958
2021,Pendle 014F,E01025208,1179,193,986
2021,Pendle 012C,E01025209,1616,348,1268
2021,Pendle 010C,E01025210,1818,429,1389
2021,Pendle 008F,E01025211,1495,221,1274
2021,Pendle 013C,E01025212,1517,355,1162
2021,Pendle 013D,E01025213,1417,360,1057
2021,Pendle 013E,E01025214,1415,289,1126
2021,Pendle 013F,E01025215,1492,448,1044
2021,Pendle 012D,E01025216,2175,592,1583
2021,Pendle 010D,E01025217,1493,400,1093
2021,Pendle 010E,E01025218,1251,367,884
2021,Pendle 010F,E01025219,1266,287,979
2021,Pendle 014C,E01025220,1444,386,1058
2021,Pendle 014B,E01025221,1379,355,1024
2021,Pendle 014D,E01025222,1412,228,1184
2021,Pendle 014H,E01025223,1337,252,1085
2021,Pendle 011A,E01025224,2321,701,1620
2021,Pendle 011B,E01025225,1690,452,1238
2021,Pendle 007A,E01025226,1479,291,1188
2021,Pendle 007B,E01025227,1831,349,1482
2021,Pendle 007C,E01025228,1774,304,1470
2021,Pendle 011C,E01025229,2676,906,1770
2021,Pendle 011D,E01025230,2052,665,1387
2021,Preston 013A,E01025231,1342,201,1141
2021,Preston 013B,E01025232,1432,281,1151
2021,Preston 008A,E01025233,1227,255,972
2021,Preston 007A,E01025234,1430,342,1088
2021,Preston 007B,E01025235,1664,339,1325
2021,Preston 009A,E01025236,1464,436,1028
2021,Preston 007C,E01025237,1448,308,1140
2021,Preston 007D,E01025238,1386,354,1032
2021,Preston 006A,E01025239,1354,217,1137
2021,Preston 008B,E01025240,1519,246,1273
2021,Preston 006B,E01025241,1584,307,1277
2021,Preston 006C,E01025242,1632,404,1228
2021,Preston 006D,E01025243,2022,511,1511
2021,Preston 015A,E01025244,1640,519,1121
2021,Preston 007E,E01025245,2552,736,1816
2021,Preston 011A,E01025246,1668,501,1167
2021,Preston 016A,E01025247,1562,404,1158
2021,Preston 016B,E01025248,1222,359,863
2021,Preston 016C,E01025249,976,164,812
2021,Preston 016D,E01025250,1560,444,1116
2021,Preston 006E,E01025251,1391,355,1036
2021,Preston 007F,E01025252,1384,227,1157
2021,Preston 004A,E01025253,1675,370,1305
2021,Preston 004B,E01025254,1095,180,915
2021,Preston 004C,E01025255,1394,281,1113
2021,Preston 003A,E01025256,1370,270,1100
2021,Preston 002A,E01025257,1425,283,1142
2021,Preston 003B,E01025258,1411,248,1163
2021,Preston 003C,E01025259,2659,587,2072
2021,Preston 005A,E01025260,1437,290,1147
2021,Preston 008C,E01025261,1377,221,1156
2021,Preston 005B,E01025262,1339,210,1129
2021,Preston 005C,E01025263,1333,254,1079
2021,Preston 005D,E01025264,1321,274,1047
2021,Preston 013C,E01025265,1330,230,1100
2021,Preston 008D,E01025266,1097,174,923
2021,Preston 013D,E01025267,1269,238,1031
2021,Preston 013E,E01025268,1677,318,1359
2021,Preston 013F,E01025269,1667,431,1236
2021,Preston 010A,E01025270,1537,285,1252
2021,Preston 013G,E01025271,1444,326,1118
2021,Preston 010B,E01025272,2466,483,1983
2021,Preston 010C,E01025273,1223,221,1002
2021,Preston 011B,E01025274,1813,688,1125
2021,Preston 011C,E01025275,1533,418,1115
2021,Preston 012A,E01025276,1589,443,1146
2021,Preston 002B,E01025277,2321,521,1800
2021,Preston 001A,E01025278,2650,545,2105
2021,Preston 001B,E01025279,2338,403,1935
2021,Preston 002D,E01025281,2003,410,1593
2021,Preston 001C,E01025282,1786,285,1501
2021,Preston 009B,E01025283,1630,505,1125
2021,Preston 009C,E01025284,1588,296,1292
2021,Preston 009D,E01025285,1346,353,993
2021,Preston 009E,E01025286,1719,495,1224
2021,Preston 009F,E01025287,1832,421,1411
2021,Preston 010D,E01025288,1626,256,1370
2021,Preston 017A,E01025289,1318,298,1020
2021,Preston 017B,E01025290,1713,525,1188
2021,Preston 017C,E01025291,1289,228,1061
2021,Preston 015B,E01025292,2359,1634,725
2021,Preston 015C,E01025293,2052,562,1490
2021,Preston 011D,E01025294,1687,492,1195
2021,Preston 014A,E01025295,2572,480,2092
2021,Preston 014B,E01025296,1896,576,1320
2021,Preston 014C,E01025297,2101,515,1586
2021,Preston 014D,E01025298,1614,455,1159
2021,Preston 003D,E01025299,1438,303,1135
2021,Preston 004D,E01025300,1105,162,943
2021,Preston 003E,E01025301,1019,216,803
2021,Preston 003F,E01025302,1129,187,942
2021,Preston 004E,E01025303,1252,235,1017
2021,Preston 016E,E01025304,1770,507,1263
2021,Preston 016F,E01025305,1542,377,1165
2021,Preston 017D,E01025306,1866,501,1365
2021,Preston 012B,E01025308,1575,445,1130
2021,Preston 008E,E01025309,1139,232,907
2021,Preston 012C,E01025310,1468,325,1143
2021,Preston 012D,E01025311,1138,217,921
2021,Preston 012E,E01025312,1487,313,1174
2021,Preston 012F,E01025313,1871,1044,827
2021,Preston 012G,E01025314,2621,1651,970
2021,Ribble Valley 001A,E01025315,1624,516,1108
2021,Ribble Valley 006A,E01025316,1569,249,1320
2021,Ribble Valley 006B,E01025317,1019,168,851
2021,Ribble Valley 007A,E01025318,1099,203,896
2021,Ribble Valley 007B,E01025319,1967,384,1583
2021,Ribble Valley 001B,E01025320,1285,208,1077
2021,Ribble Valley 005A,E01025321,1279,218,1061
2021,Ribble Valley 004A,E01025322,1369,203,1166
2021,Ribble Valley 008A,E01025323,1101,176,925
2021,Ribble Valley 008B,E01025324,1387,232,1155
2021,Ribble Valley 006C,E01025325,1440,247,1193
2021,Ribble Valley 004B,E01025326,1598,197,1401
2021,Ribble Valley 004C,E01025327,1240,209,1031
2021,Ribble Valley 006D,E01025328,1420,226,1194
2021,Ribble Valley 003A,E01025329,2142,479,1663
2021,Ribble Valley 003B,E01025330,1458,250,1208
2021,Ribble Valley 001C,E01025331,1387,234,1153
2021,Ribble Valley 007C,E01025333,1254,214,1040
2021,Ribble Valley 002A,E01025334,1960,309,1651
2021,Ribble Valley 003C,E01025335,1249,179,1070
2021,Ribble Valley 008D,E01025336,1072,167,905
2021,Ribble Valley 008E,E01025337,1417,207,1210
2021,Ribble Valley 003D,E01025338,1476,212,1264
2021,Ribble Valley 003E,E01025339,2182,390,1792
2021,Ribble Valley 005B,E01025340,1354,218,1136
2021,Ribble Valley 005C,E01025341,1192,201,991
2021,Ribble Valley 004D,E01025342,1459,225,1234
2021,Ribble Valley 005D,E01025343,1502,230,1272
2021,Ribble Valley 002B,E01025344,1272,197,1075
2021,Ribble Valley 002C,E01025345,1461,288,1173
2021,Ribble Valley 002D,E01025346,1401,244,1157
2021,Ribble Valley 002E,E01025347,1681,305,1376
2021,Ribble Valley 001D,E01025348,1534,174,1360
2021,Ribble Valley 001E,E01025349,1361,215,1146
2021,Ribble Valley 007D,E01025350,1553,246,1307
2021,Ribble Valley 007E,E01025351,2590,463,2127
2021,Ribble Valley 008F,E01025352,1433,236,1197
2021,Ribble Valley 005E,E01025354,2152,368,1784
2021,Rossendale 001A,E01025355,2296,500,1796
2021,Rossendale 004A,E01025356,1406,279,1127
2021,Rossendale 008A,E01025357,1288,214,1074
2021,Rossendale 008B,E01025358,2145,375,1770
2021,Rossendale 009A,E01025359,1658,280,1378
2021,Rossendale 009B,E01025360,1892,292,1600
2021,Rossendale 001B,E01025361,1935,308,1627
2021,Rossendale 001C,E01025362,1940,396,1544
2021,Rossendale 002A,E01025363,1306,216,1090
2021,Rossendale 002B,E01025364,1329,274,1055
2021,Rossendale 008C,E01025365,1384,214,1170
2021,Rossendale 002C,E01025366,1463,385,1078
2021,Rossendale 003A,E01025367,1773,351,1422
2021,Rossendale 003B,E01025368,1584,326,1258
2021,Rossendale 003C,E01025369,1241,270,971
2021,Rossendale 010F,E01025370,1211,205,1006
2021,Rossendale 010A,E01025371,1333,218,1115
2021,Rossendale 004C,E01025373,1548,271,1277
2021,Rossendale 010B,E01025374,1383,232,1151
2021,Rossendale 009C,E01025375,1542,245,1297
2021,Rossendale 009D,E01025376,2322,473,1849
2021,Rossendale 007A,E01025377,1500,300,1200
2021,Rossendale 007B,E01025378,1488,232,1256
2021,Rossendale 007C,E01025379,1374,236,1138
2021,Rossendale 007D,E01025380,1448,282,1166
2021,Rossendale 003D,E01025381,1494,391,1103
2021,Rossendale 003E,E01025382,1644,319,1325
2021,Rossendale 003F,E01025383,2753,578,2175
2021,Rossendale 008D,E01025384,1186,170,1016
2021,Rossendale 004D,E01025385,1142,254,888
2021,Rossendale 004F,E01025387,1763,378,1385
2021,Rossendale 010G,E01025388,1393,248,1145
2021,Rossendale 010H,E01025389,1339,319,1020
2021,Rossendale 010I,E01025390,1030,152,878
2021,Rossendale 010C,E01025391,1437,327,1110
2021,Rossendale 010D,E01025392,1164,175,989
2021,Rossendale 001D,E01025393,1353,215,1138
2021,Rossendale 010E,E01025394,1443,278,1165
2021,Rossendale 002D,E01025395,1495,243,1252
2021,Rossendale 002E,E01025396,1261,224,1037
2021,Rossendale 002F,E01025397,1602,406,1196
2021,Rossendale 002G,E01025398,1276,316,960
2021,South Ribble 008A,E01025399,1351,279,1072
2021,South Ribble 008B,E01025400,2007,381,1626
2021,South Ribble 008C,E01025401,1510,210,1300
2021,South Ribble 008D,E01025402,1783,405,1378
2021,South Ribble 004A,E01025403,2072,462,1610
2021,South Ribble 007A,E01025404,1141,163,978
2021,South Ribble 007B,E01025405,1176,149,1027
2021,South Ribble 007C,E01025406,1086,143,943
2021,South Ribble 007D,E01025407,1784,377,1407
2021,South Ribble 003A,E01025408,1321,157,1164
2021,South Ribble 003B,E01025409,1217,192,1025
2021,South Ribble 003C,E01025410,1278,254,1024
2021,South Ribble 005A,E01025411,2079,391,1688
2021,South Ribble 006A,E01025412,1338,211,1127
2021,South Ribble 002A,E01025413,1597,244,1353
2021,South Ribble 002B,E01025414,1451,172,1279
2021,South Ribble 015A,E01025415,1890,331,1559
2021,South Ribble 014A,E01025416,1454,248,1206
2021,South Ribble 012A,E01025417,1416,218,1198
2021,South Ribble 012B,E01025418,1344,226,1118
2021,South Ribble 012C,E01025419,1478,251,1227
2021,South Ribble 013A,E01025421,2284,472,1812
2021,South Ribble 013B,E01025422,1333,194,1139
2021,South Ribble 015B,E01025423,1205,258,947
2021,South Ribble 001A,E01025424,1219,223,996
2021,South Ribble 001B,E01025425,1225,215,1010
2021,South Ribble 001C,E01025426,1186,231,955
2021,South Ribble 006B,E01025427,1325,220,1105
2021,South Ribble 006C,E01025428,1419,291,1128
2021,South Ribble 006D,E01025429,1253,291,962
2021,South Ribble 013C,E01025431,1849,347,1502
2021,South Ribble 013D,E01025433,1498,240,1258
2021,South Ribble 016C,E01025434,1777,239,1538
2021,South Ribble 015C,E01025435,1364,200,1164
2021,South Ribble 011A,E01025436,2172,348,1824
2021,South Ribble 011B,E01025437,1864,310,1554
2021,South Ribble 011C,E01025438,1283,206,1077
2021,South Ribble 010A,E01025439,1385,226,1159
2021,South Ribble 011D,E01025440,1295,189,1106
2021,South Ribble 011E,E01025441,1359,203,1156
2021,South Ribble 009A,E01025442,968,160,808
2021,South Ribble 009B,E01025443,1228,140,1088
2021,South Ribble 009C,E01025444,1182,187,995
2021,South Ribble 017A,E01025445,1483,417,1066
2021,South Ribble 015D,E01025446,1364,186,1178
2021,South Ribble 017B,E01025447,1071,228,843
2021,South Ribble 005B,E01025448,1460,212,1248
2021,South Ribble 014B,E01025451,1794,325,1469
2021,South Ribble 014C,E01025452,1574,319,1255
2021,South Ribble 010B,E01025453,1678,325,1353
2021,South Ribble 010C,E01025454,1248,238,1010
2021,South Ribble 010D,E01025455,1540,258,1282
2021,South Ribble 002C,E01025456,1137,156,981
2021,South Ribble 004B,E01025457,1294,228,1066
2021,South Ribble 002D,E01025458,1508,265,1243
2021,South Ribble 017C,E01025459,1606,276,1330
2021,South Ribble 017D,E01025460,1805,276,1529
2021,South Ribble 009D,E01025461,1861,345,1516
2021,South Ribble 009E,E01025462,1907,347,1560
2021,South Ribble 004C,E01025463,1313,198,1115
2021,South Ribble 004D,E01025464,1163,165,998
2021,South Ribble 004E,E01025465,968,152,816
2021,South Ribble 001D,E01025466,1465,277,1188
2021,South Ribble 003D,E01025467,1823,289,1534
2021,West Lancashire 009A,E01025468,1608,292,1316
2021,West Lancashire 009B,E01025469,1547,229,1318
2021,West Lancashire 009C,E01025470,1798,336,1462
2021,West Lancashire 010A,E01025471,1400,358,1042
2021,West Lancashire 012A,E01025472,1385,259,1126
2021,West Lancashire 012B,E01025473,1309,220,1089
2021,West Lancashire 003A,E01025474,1229,215,1014
2021,West Lancashire 012C,E01025475,1376,213,1163
2021,West Lancashire 012D,E01025476,1362,192,1170
2021,West Lancashire 012E,E01025477,1108,202,906
2021,West Lancashire 012F,E01025478,1218,245,973
2021,West Lancashire 008A,E01025479,2079,321,1758
2021,West Lancashire 010B,E01025480,1321,333,988
2021,West Lancashire 010C,E01025481,1503,333,1170
2021,West Lancashire 010D,E01025482,1441,378,1063
2021,West Lancashire 004A,E01025483,2303,426,1877
2021,West Lancashire 004B,E01025484,2047,357,1690
2021,West Lancashire 004C,E01025485,1586,298,1288
2021,West Lancashire 004D,E01025486,1552,318,1234
2021,West Lancashire 004E,E01025487,1671,306,1365
2021,West Lancashire 007A,E01025488,2770,1414,1356
2021,West Lancashire 007B,E01025489,1306,301,1005
2021,West Lancashire 007C,E01025490,2662,1930,732
2021,West Lancashire 008B,E01025491,2567,1506,1061
2021,West Lancashire 013A,E01025492,1204,239,965
2021,West Lancashire 014A,E01025493,1464,371,1093
2021,West Lancashire 014B,E01025494,1637,376,1261
2021,West Lancashire 003B,E01025495,2092,327,1765
2021,West Lancashire 001A,E01025496,1195,206,989
2021,West Lancashire 001B,E01025497,1413,249,1164
2021,West Lancashire 001C,E01025498,1387,243,1144
2021,West Lancashire 006A,E01025499,1284,279,1005
2021,West Lancashire 007D,E01025500,1650,427,1223
2021,West Lancashire 006B,E01025501,1064,175,889
2021,West Lancashire 006C,E01025502,1504,309,1195
2021,West Lancashire 014C,E01025503,1309,320,989
2021,West Lancashire 014D,E01025504,1070,299,771
2021,West Lancashire 014E,E01025505,1307,195,1112
2021,West Lancashire 008C,E01025506,1945,257,1688
2021,West Lancashire 002A,E01025507,1907,241,1666
2021,West Lancashire 002B,E01025508,1360,219,1141
2021,West Lancashire 002C,E01025509,1201,170,1031
2021,West Lancashire 005A,E01025510,1272,210,1062
2021,West Lancashire 005B,E01025511,1073,181,892
2021,West Lancashire 005C,E01025512,1152,185,967
2021,West Lancashire 002D,E01025513,2075,311,1764
2021,West Lancashire 003C,E01025514,2338,359,1979
2021,West Lancashire 003D,E01025515,1547,189,1358
2021,West Lancashire 006D,E01025516,1401,246,1155
2021,West Lancashire 006E,E01025517,2029,492,1537
2021,West Lancashire 007E,E01025518,1522,671,851
2021,West Lancashire 006F,E01025519,1132,192,940
2021,West Lancashire 010E,E01025520,1146,230,916
2021,West Lancashire 010F,E01025521,1501,355,1146
2021,West Lancashire 009D,E01025522,1070,159,911
2021,West Lancashire 011A,E01025523,1625,363,1262
2021,West Lancashire 011B,E01025524,1402,232,1170
2021,West Lancashire 011C,E01025525,1544,312,1232
2021,West Lancashire 011D,E01025526,1510,204,1306
2021,West Lancashire 013B,E01025527,1382,272,1110
2021,West Lancashire 013C,E01025528,1789,469,1320
2021,West Lancashire 013D,E01025529,1773,387,1386
2021,West Lancashire 001D,E01025530,1526,225,1301
2021,West Lancashire 002E,E01025531,1096,127,969
2021,West Lancashire 001E,E01025532,1637,282,1355
2021,West Lancashire 001F,E01025533,1463,223,1240
2021,West Lancashire 015A,E01025534,1660,315,1345
2021,West Lancashire 015B,E01025535,1553,272,1281
2021,West Lancashire 015C,E01025536,1363,258,1105
2021,West Lancashire 015D,E01025537,1487,207,1280
2021,West Lancashire 005D,E01025538,1448,208,1240
2021,West Lancashire 005E,E01025539,1349,269,1080
2021,West Lancashire 015E,E01025540,1174,191,983
2021,Wyre 011A,E01025541,2233,466,1767
2021,Wyre 010A,E01025542,1696,242,1454
2021,Wyre 011B,E01025543,1598,335,1263
2021,Wyre 011C,E01025544,1341,190,1151
2021,Wyre 013A,E01025545,2335,387,1948
2021,Wyre 013B,E01025546,1506,264,1242
2021,Wyre 006A,E01025547,2374,680,1694
2021,Wyre 007A,E01025548,1617,192,1425
2021,Wyre 006B,E01025549,2339,399,1940
2021,Wyre 012A,E01025550,1455,204,1251
2021,Wyre 013C,E01025551,1153,208,945
2021,Wyre 012B,E01025552,1178,221,957
2021,Wyre 007B,E01025553,2616,492,2124
2021,Wyre 008A,E01025554,1378,131,1247
2021,Wyre 010B,E01025555,1307,153,1154
2021,Wyre 008B,E01025556,1470,271,1199
2021,Wyre 005A,E01025557,1419,207,1212
2021,Wyre 007C,E01025558,1563,158,1405
2021,Wyre 007D,E01025559,1939,312,1627
2021,Wyre 007E,E01025560,1251,131,1120
2021,Wyre 009A,E01025561,1489,246,1243
2021,Wyre 009B,E01025562,2397,372,2025
2021,Wyre 004A,E01025563,1100,113,987
2021,Wyre 004B,E01025564,1732,298,1434
2021,Wyre 004C,E01025565,1627,248,1379
2021,Wyre 014A,E01025566,1911,256,1655
2021,Wyre 013D,E01025567,1588,244,1344
2021,Wyre 014B,E01025568,1806,288,1518
2021,Wyre 014C,E01025569,1844,247,1597
2021,Wyre 008C,E01025570,1191,121,1070
2021,Wyre 008D,E01025571,1310,226,1084
2021,Wyre 008E,E01025572,1280,132,1148
2021,Wyre 001A,E01025573,1265,217,1048
2021,Wyre 001B,E01025574,1326,210,1116
2021,Wyre 005B,E01025575,1712,312,1400
2021,Wyre 011D,E01025576,2317,377,1940
2021,Wyre 011E,E01025577,1346,252,1094
2021,Wyre 005C,E01025578,1505,342,1163
2021,Wyre 005D,E01025579,1241,328,913
2021,Wyre 005E,E01025580,1218,222,996
2021,Wyre 001C,E01025581,1339,269,1070
2021,Wyre 001D,E01025582,1156,203,953
2021,Wyre 001E,E01025583,1216,234,982
2021,Wyre 001F,E01025584,1423,170,1253
2021,Wyre 009C,E01025585,2530,420,2110
2021,Wyre 004D,E01025586,1448,182,1266
2021,Wyre 004E,E01025587,1577,214,1363
2021,Wyre 004F,E01025588,1315,103,1212
2021,Wyre 004G,E01025589,1120,194,926
2021,Wyre 003A,E01025590,1523,325,1198
2021,Wyre 003B,E01025591,1490,135,1355
2021,Wyre 003C,E01025592,1206,317,889
2021,Wyre 003D,E01025593,1608,314,1294
2021,Wyre 012C,E01025594,1450,172,1278
2021,Wyre 012D,E01025595,1381,203,1178
2021,Wyre 012E,E01025596,2012,395,1617
2021,Wyre 012F,E01025597,1027,165,862
2021,Wyre 013E,E01025598,1378,193,1185
2021,Wyre 014D,E01025599,983,146,837
2021,Wyre 014E,E01025600,1436,254,1182
2021,Wyre 010C,E01025601,1365,187,1178
2021,Wyre 010D,E01025602,1561,243,1318
2021,Wyre 010E,E01025603,1352,151,1201
2021,Wyre 008F,E01025604,1375,209,1166
2021,Wyre 002A,E01025605,1348,207,1141
2021,Wyre 002B,E01025606,1229,321,908
2021,Wyre 002C,E01025607,1484,284,1200
2021,Wyre 002D,E01025608,1520,281,1239
2021,Wyre 006C,E01025609,2224,320,1904
2021,Blaby 008A,E01025610,1488,279,1209
2021,Blaby 008B,E01025611,1486,251,1235
2021,Blaby 008C,E01025612,1945,334,1611
2021,Blaby 010A,E01025613,1433,233,1200
2021,Blaby 010B,E01025614,1542,276,1266
2021,Blaby 009A,E01025615,2208,500,1708
2021,Blaby 011A,E01025616,1913,403,1510
2021,Blaby 011B,E01025617,1995,335,1660
2021,Blaby 011C,E01025618,1594,267,1327
2021,Blaby 011D,E01025619,2070,381,1689
2021,Blaby 010C,E01025620,1151,205,946
2021,Blaby 010D,E01025621,1236,200,1036
2021,Blaby 013A,E01025622,1622,262,1360
2021,Blaby 013B,E01025623,1647,275,1372
2021,Blaby 013C,E01025624,2362,481,1881
2021,Blaby 006A,E01025625,1160,210,950
2021,Blaby 006B,E01025626,2313,386,1927
2021,Blaby 006C,E01025627,2278,467,1811
2021,Blaby 013D,E01025629,1492,272,1220
2021,Blaby 013E,E01025630,1754,326,1428
2021,Blaby 002A,E01025631,1446,303,1143
2021,Blaby 002B,E01025632,1292,257,1035
2021,Blaby 002C,E01025633,1759,338,1421
2021,Blaby 003A,E01025634,1896,390,1506
2021,Blaby 002D,E01025635,1196,199,997
2021,Blaby 005A,E01025636,1277,190,1087
2021,Blaby 005B,E01025637,1266,248,1018
2021,Blaby 003B,E01025638,1420,207,1213
2021,Blaby 003C,E01025639,1247,223,1024
2021,Blaby 003D,E01025640,1526,316,1210
2021,Blaby 007A,E01025641,1817,317,1500
2021,Blaby 007B,E01025642,1761,312,1449
2021,Blaby 007C,E01025643,1549,303,1246
2021,Blaby 010E,E01025644,1646,326,1320
2021,Blaby 003E,E01025645,1117,198,919
2021,Blaby 009B,E01025646,1532,234,1298
2021,Blaby 009C,E01025647,1449,238,1211
2021,Blaby 009D,E01025648,1970,372,1598
2021,Blaby 007D,E01025649,1740,306,1434
2021,Blaby 007E,E01025650,1372,249,1123
2021,Blaby 006D,E01025651,1470,240,1230
2021,Blaby 005C,E01025652,1288,249,1039
2021,Blaby 005D,E01025653,1532,325,1207
2021,Blaby 005E,E01025654,1226,243,983
2021,Blaby 005F,E01025655,1586,293,1293
2021,Blaby 005G,E01025656,1283,255,1028
2021,Blaby 006E,E01025657,1872,349,1523
2021,Blaby 008D,E01025658,1687,304,1383
2021,Blaby 008E,E01025659,1824,247,1577
2021,Blaby 006F,E01025660,1592,297,1295
2021,Blaby 012A,E01025661,2278,462,1816
2021,Blaby 012B,E01025662,1829,324,1505
2021,Blaby 012C,E01025663,1500,250,1250
2021,Blaby 012D,E01025664,1299,197,1102
2021,Blaby 012E,E01025665,1765,266,1499
2021,Blaby 004A,E01025666,1469,284,1185
2021,Blaby 004B,E01025667,1171,214,957
2021,Blaby 004C,E01025668,2132,466,1666
2021,Blaby 004D,E01025669,2034,423,1611
2021,Charnwood 022A,E01025670,1212,244,968
2021,Charnwood 022B,E01025671,2211,379,1832
2021,Charnwood 022C,E01025672,2160,421,1739
2021,Charnwood 022D,E01025673,1658,226,1432
2021,Charnwood 011A,E01025674,1805,283,1522
2021,Charnwood 011B,E01025675,1432,231,1201
2021,Charnwood 011C,E01025676,2353,522,1831
2021,Charnwood 011D,E01025677,1387,231,1156
2021,Charnwood 020A,E01025678,1674,281,1393
2021,Charnwood 019B,E01025680,1563,281,1282
2021,Charnwood 019C,E01025681,1661,259,1402
2021,Charnwood 019D,E01025682,1380,245,1135
2021,Charnwood 020B,E01025683,1552,290,1262
2021,Charnwood 020C,E01025684,1780,325,1455
2021,Charnwood 015A,E01025685,1245,181,1064
2021,Charnwood 015B,E01025686,1481,290,1191
2021,Charnwood 016A,E01025687,1548,228,1320
2021,Charnwood 016B,E01025688,1652,458,1194
2021,Charnwood 007A,E01025689,2987,1750,1237
2021,Charnwood 007B,E01025690,4174,3298,876
2021,Charnwood 001B,E01025692,1922,358,1564
2021,Charnwood 001C,E01025693,2222,344,1878
2021,Charnwood 004A,E01025695,1375,260,1115
2021,Charnwood 004B,E01025696,1256,201,1055
2021,Charnwood 004C,E01025697,1282,214,1068
2021,Charnwood 004D,E01025698,1413,227,1186
2021,Charnwood 002A,E01025699,1422,219,1203
2021,Charnwood 002B,E01025700,2077,476,1601
2021,Charnwood 002C,E01025701,1598,339,1259
2021,Charnwood 009A,E01025702,1133,153,980
2021,Charnwood 002D,E01025703,1985,556,1429
2021,Charnwood 002E,E01025704,1592,531,1061
2021,Charnwood 002F,E01025705,1519,434,1085
2021,Charnwood 002G,E01025706,1736,383,1353
2021,Charnwood 007C,E01025707,1566,637,929
2021,Charnwood 010A,E01025708,1245,245,1000
2021,Charnwood 007D,E01025709,2250,1387,863
2021,Charnwood 010B,E01025710,1188,228,960
2021,Charnwood 010C,E01025711,1408,251,1157
2021,Charnwood 010D,E01025712,1437,244,1193
2021,Charnwood 010E,E01025713,1446,499,947
2021,Charnwood 009B,E01025715,1481,317,1164
2021,Charnwood 009C,E01025716,1499,359,1140
2021,Charnwood 009E,E01025718,1418,622,796
2021,Charnwood 009F,E01025719,1499,458,1041
2021,Charnwood 003A,E01025720,2514,1755,759
2021,Charnwood 003B,E01025721,2032,1290,742
2021,Charnwood 003C,E01025722,1059,210,849
2021,Charnwood 003D,E01025723,2349,1505,844
2021,Charnwood 003E,E01025724,1805,1202,603
2021,Charnwood 003F,E01025725,1217,281,936
2021,Charnwood 014A,E01025726,1791,318,1473
2021,Charnwood 014B,E01025727,1477,302,1175
2021,Charnwood 014C,E01025728,1900,347,1553
2021,Charnwood 014D,E01025729,1455,235,1220
2021,Charnwood 015C,E01025730,2749,548,2201
2021,Charnwood 015D,E01025731,1753,260,1493
2021,Charnwood 012A,E01025732,1809,337,1472
2021,Charnwood 012B,E01025733,1714,290,1424
2021,Charnwood 012C,E01025734,1640,310,1330
2021,Charnwood 012D,E01025735,1793,278,1515
2021,Charnwood 016C,E01025736,1381,192,1189
2021,Charnwood 014E,E01025737,2666,522,2144
2021,Charnwood 016D,E01025738,1500,236,1264
2021,Charnwood 014F,E01025739,2161,405,1756
2021,Charnwood 006A,E01025740,1439,177,1262
2021,Charnwood 006B,E01025741,1395,201,1194
2021,Charnwood 006C,E01025742,1583,257,1326
2021,Charnwood 006D,E01025743,2180,382,1798
2021,Charnwood 005A,E01025744,2502,406,2096
2021,Charnwood 005B,E01025745,1372,205,1167
2021,Charnwood 005C,E01025746,1892,328,1564
2021,Charnwood 005D,E01025747,1708,329,1379
2021,Charnwood 013A,E01025748,2029,327,1702
2021,Charnwood 013B,E01025749,2067,477,1590
2021,Charnwood 013C,E01025750,1794,339,1455
2021,Charnwood 013D,E01025751,2011,379,1632
2021,Charnwood 018A,E01025752,2761,616,2145
2021,Charnwood 018B,E01025753,1537,277,1260
2021,Charnwood 018C,E01025754,1161,162,999
2021,Charnwood 018D,E01025755,1381,209,1172
2021,Charnwood 017A,E01025756,1771,291,1480
2021,Charnwood 017B,E01025757,1253,228,1025
2021,Charnwood 017C,E01025758,1625,275,1350
2021,Charnwood 017D,E01025759,1353,177,1176
2021,Charnwood 008A,E01025760,1305,223,1082
2021,Charnwood 008B,E01025761,1811,360,1451
2021,Charnwood 021A,E01025762,1516,265,1251
2021,Charnwood 021B,E01025763,1637,275,1362
2021,Charnwood 021C,E01025764,1337,274,1063
2021,Charnwood 021D,E01025765,1451,210,1241
2021,Charnwood 021E,E01025766,1947,429,1518
2021,Charnwood 021F,E01025767,1502,277,1225
2021,Charnwood 008C,E01025768,1405,267,1138
2021,Charnwood 008D,E01025769,1499,304,1195
2021,Harborough 002A,E01025770,1759,275,1484
2021,Harborough 004A,E01025772,2135,434,1701
2021,Harborough 004B,E01025773,1502,336,1166
2021,Harborough 004C,E01025774,1574,317,1257
2021,Harborough 004D,E01025775,2077,339,1738
2021,Harborough 004E,E01025776,1877,318,1559
2021,Harborough 006A,E01025777,2244,378,1866
2021,Harborough 005B,E01025778,1898,401,1497
2021,Harborough 005C,E01025779,1402,232,1170
2021,Harborough 005D,E01025780,1398,241,1157
2021,Harborough 003A,E01025781,1644,312,1332
2021,Harborough 003B,E01025782,1327,235,1092
2021,Harborough 003C,E01025783,2227,490,1737
2021,Harborough 005E,E01025784,1362,230,1132
2021,Harborough 003E,E01025786,2128,472,1656
2021,Harborough 003F,E01025787,1595,229,1366
2021,Harborough 005F,E01025788,1278,202,1076
2021,Harborough 007A,E01025789,1955,201,1754
2021,Harborough 010A,E01025790,2438,468,1970
2021,Harborough 010B,E01025791,2777,585,2192
2021,Harborough 010C,E01025792,2086,313,1773
2021,Harborough 007B,E01025794,1779,372,1407
2021,Harborough 008A,E01025795,1746,353,1393
2021,Harborough 008B,E01025796,1878,346,1532
2021,Harborough 007C,E01025797,2048,388,1660
2021,Harborough 009A,E01025798,2210,376,1834
2021,Harborough 009B,E01025799,2169,518,1651
2021,Harborough 009C,E01025800,1344,159,1185
2021,Harborough 008C,E01025801,1173,155,1018
2021,Harborough 007D,E01025802,1299,180,1119
2021,Harborough 007E,E01025803,1659,304,1355
2021,Harborough 009D,E01025804,1893,296,1597
2021,Harborough 008D,E01025806,1496,276,1220
2021,Harborough 009E,E01025807,1303,270,1033
2021,Harborough 006B,E01025808,2827,474,2353
2021,Harborough 002B,E01025809,2301,413,1888
2021,Harborough 006C,E01025810,2268,332,1936
2021,Harborough 011A,E01025812,1670,265,1405
2021,Harborough 011B,E01025813,1966,320,1646
2021,Harborough 011C,E01025814,1656,306,1350
2021,Harborough 002C,E01025815,2120,369,1751
2021,Harborough 006D,E01025816,2455,421,2034
2021,Hinckley and Bosworth 008A,E01025817,2175,333,1842
2021,Hinckley and Bosworth 008B,E01025818,1455,258,1197
2021,Hinckley and Bosworth 004A,E01025819,1601,220,1381
2021,Hinckley and Bosworth 004B,E01025820,1511,261,1250
2021,Hinckley and Bosworth 007A,E01025821,1641,222,1419
2021,Hinckley and Bosworth 007B,E01025822,1444,268,1176
2021,Hinckley and Bosworth 007C,E01025823,1525,302,1223
2021,Hinckley and Bosworth 007D,E01025824,1425,255,1170
2021,Hinckley and Bosworth 007E,E01025825,1360,210,1150
2021,Hinckley and Bosworth 007F,E01025826,1320,220,1100
2021,Hinckley and Bosworth 013A,E01025827,1366,185,1181
2021,Hinckley and Bosworth 013B,E01025828,1461,240,1221
2021,Hinckley and Bosworth 013C,E01025829,1461,305,1156
2021,Hinckley and Bosworth 013D,E01025830,1502,241,1261
2021,Hinckley and Bosworth 014A,E01025831,1194,178,1016
2021,Hinckley and Bosworth 014B,E01025832,1813,325,1488
2021,Hinckley and Bosworth 014C,E01025833,1935,374,1561
2021,Hinckley and Bosworth 014D,E01025834,1477,283,1194
2021,Hinckley and Bosworth 014E,E01025835,2372,370,2002
2021,Hinckley and Bosworth 014F,E01025836,1137,146,991
2021,Hinckley and Bosworth 004C,E01025837,2047,372,1675
2021,Hinckley and Bosworth 004D,E01025838,1472,221,1251
2021,Hinckley and Bosworth 006A,E01025839,1559,226,1333
2021,Hinckley and Bosworth 006B,E01025840,1589,248,1341
2021,Hinckley and Bosworth 006C,E01025841,1825,285,1540
2021,Hinckley and Bosworth 006D,E01025842,1852,399,1453
2021,Hinckley and Bosworth 006E,E01025843,1708,225,1483
2021,Hinckley and Bosworth 006F,E01025844,1524,281,1243
2021,Hinckley and Bosworth 003A,E01025845,1426,191,1235
2021,Hinckley and Bosworth 002A,E01025846,1989,397,1592
2021,Hinckley and Bosworth 002B,E01025847,1561,286,1275
2021,Hinckley and Bosworth 002C,E01025848,1513,215,1298
2021,Hinckley and Bosworth 012A,E01025849,2016,350,1666
2021,Hinckley and Bosworth 010A,E01025850,1431,229,1202
2021,Hinckley and Bosworth 012B,E01025851,1291,231,1060
2021,Hinckley and Bosworth 010B,E01025852,1868,247,1621
2021,Hinckley and Bosworth 011B,E01025854,2033,355,1678
2021,Hinckley and Bosworth 011C,E01025855,1338,198,1140
2021,Hinckley and Bosworth 012C,E01025856,1207,185,1022
2021,Hinckley and Bosworth 012D,E01025857,1346,220,1126
2021,Hinckley and Bosworth 010C,E01025858,2076,324,1752
2021,Hinckley and Bosworth 009A,E01025859,1511,226,1285
2021,Hinckley and Bosworth 009B,E01025860,1301,201,1100
2021,Hinckley and Bosworth 009C,E01025861,1700,290,1410
2021,Hinckley and Bosworth 009D,E01025862,1833,259,1574
2021,Hinckley and Bosworth 010D,E01025863,1596,239,1357
2021,Hinckley and Bosworth 008C,E01025864,2146,466,1680
2021,Hinckley and Bosworth 010E,E01025865,1643,283,1360
2021,Hinckley and Bosworth 011D,E01025866,1778,324,1454
2021,Hinckley and Bosworth 011E,E01025867,1386,204,1182
2021,Hinckley and Bosworth 001A,E01025868,1355,172,1183
2021,Hinckley and Bosworth 001B,E01025869,1380,140,1240
2021,Hinckley and Bosworth 001C,E01025870,1595,259,1336
2021,Hinckley and Bosworth 001D,E01025871,1430,296,1134
2021,Hinckley and Bosworth 005A,E01025872,1416,164,1252
2021,Hinckley and Bosworth 005B,E01025873,1498,222,1276
2021,Hinckley and Bosworth 005C,E01025874,1974,469,1505
2021,Hinckley and Bosworth 005D,E01025875,1682,347,1335
2021,Hinckley and Bosworth 005E,E01025876,1902,348,1554
2021,Hinckley and Bosworth 003B,E01025877,1598,271,1327
2021,Hinckley and Bosworth 003C,E01025879,1137,200,937
2021,Hinckley and Bosworth 003D,E01025880,1581,296,1285
2021,Hinckley and Bosworth 008D,E01025881,1330,171,1159
2021,Hinckley and Bosworth 004E,E01025882,1673,274,1399
2021,Melton 003A,E01025883,1774,257,1517
2021,Melton 003B,E01025884,1620,313,1307
2021,Melton 001A,E01025885,1915,356,1559
2021,Melton 001B,E01025886,1659,276,1383
2021,Melton 001C,E01025887,1756,245,1511
2021,Melton 003C,E01025888,1826,301,1525
2021,Melton 006A,E01025889,1648,237,1411
2021,Melton 001D,E01025890,1278,219,1059
2021,Melton 001E,E01025891,1185,202,983
2021,Melton 001F,E01025892,1577,303,1274
2021,Melton 005A,E01025893,1822,235,1587
2021,Melton 005B,E01025894,1527,196,1331
2021,Melton 005C,E01025895,1579,260,1319
2021,Melton 004A,E01025896,1572,221,1351
2021,Melton 004B,E01025897,2052,358,1694
2021,Melton 004C,E01025898,1253,245,1008
2021,Melton 004D,E01025899,1240,214,1026
2021,Melton 004E,E01025900,1377,325,1052
2021,Melton 002A,E01025901,1924,294,1630
2021,Melton 002B,E01025902,1512,232,1280
2021,Melton 002C,E01025903,1682,291,1391
2021,Melton 002D,E01025904,2102,399,1703
2021,Melton 004F,E01025905,1531,330,1201
2021,Melton 002E,E01025906,1593,297,1296
2021,Melton 005D,E01025907,1743,331,1412
2021,Melton 005E,E01025908,1732,281,1451
2021,Melton 003D,E01025909,1853,308,1545
2021,Melton 006B,E01025910,1757,262,1495
2021,Melton 006C,E01025911,1729,291,1438
2021,Melton 006D,E01025912,1517,236,1281
2021,North West Leicestershire 012A,E01025913,2353,402,1951
2021,North West Leicestershire 006A,E01025914,1243,228,1015
2021,North West Leicestershire 003A,E01025915,1156,189,967
2021,North West Leicestershire 003B,E01025916,1644,268,1376
2021,North West Leicestershire 003D,E01025918,1595,324,1271
2021,North West Leicestershire 006B,E01025919,1446,284,1162
2021,North West Leicestershire 006C,E01025920,1887,427,1460
2021,North West Leicestershire 006D,E01025921,1928,278,1650
2021,North West Leicestershire 002A,E01025923,1370,185,1185
2021,North West Leicestershire 001A,E01025924,1051,149,902
2021,North West Leicestershire 001C,E01025926,2445,442,2003
2021,North West Leicestershire 001D,E01025927,1527,290,1237
2021,North West Leicestershire 001E,E01025928,1369,224,1145
2021,North West Leicestershire 010A,E01025929,1821,312,1509
2021,North West Leicestershire 010B,E01025930,1711,269,1442
2021,North West Leicestershire 010C,E01025931,1778,319,1459
2021,North West Leicestershire 009A,E01025932,1421,360,1061
2021,North West Leicestershire 009B,E01025933,1247,201,1046
2021,North West Leicestershire 009C,E01025934,1850,425,1425
2021,North West Leicestershire 009D,E01025935,1127,112,1015
2021,North West Leicestershire 009E,E01025936,1176,160,1016
2021,North West Leicestershire 011B,E01025937,2176,339,1837
2021,North West Leicestershire 013A,E01025938,1153,177,976
2021,North West Leicestershire 013B,E01025939,2021,432,1589
2021,North West Leicestershire 013C,E01025940,1902,345,1557
2021,North West Leicestershire 013D,E01025941,1869,316,1553
2021,North West Leicestershire 013E,E01025942,2635,492,2143
2021,North West Leicestershire 013F,E01025943,1728,262,1466
2021,North West Leicestershire 002B,E01025944,1621,285,1336
2021,North West Leicestershire 002C,E01025945,1654,513,1141
2021,North West Leicestershire 002D,E01025946,1948,683,1265
2021,North West Leicestershire 012B,E01025947,1965,303,1662
2021,North West Leicestershire 012C,E01025948,1643,300,1343
2021,North West Leicestershire 012D,E01025949,1480,286,1194
2021,North West Leicestershire 008A,E01025950,1981,367,1614
2021,North West Leicestershire 008B,E01025951,1949,320,1629
2021,North West Leicestershire 008C,E01025952,1591,232,1359
2021,North West Leicestershire 008D,E01025953,1296,273,1023
2021,North West Leicestershire 008E,E01025954,1458,291,1167
2021,North West Leicestershire 005A,E01025955,1800,316,1484
2021,North West Leicestershire 005B,E01025956,1218,220,998
2021,North West Leicestershire 010D,E01025957,2058,431,1627
2021,North West Leicestershire 011C,E01025958,2063,391,1672
2021,North West Leicestershire 011D,E01025959,2426,398,2028
2021,North West Leicestershire 004A,E01025960,1390,188,1202
2021,North West Leicestershire 004B,E01025961,1367,167,1200
2021,North West Leicestershire 004C,E01025962,1573,323,1250
2021,North West Leicestershire 005C,E01025963,1570,290,1280
2021,North West Leicestershire 005D,E01025964,1601,266,1335
2021,North West Leicestershire 004D,E01025965,1218,176,1042
2021,North West Leicestershire 007A,E01025966,1394,209,1185
2021,North West Leicestershire 007B,E01025967,1487,145,1342
2021,North West Leicestershire 007C,E01025968,1753,265,1488
2021,North West Leicestershire 007D,E01025969,1627,223,1404
2021,Oadby and Wigston 003A,E01025970,1622,372,1250
2021,Oadby and Wigston 003B,E01025971,1185,239,946
2021,Oadby and Wigston 003C,E01025972,1262,280,982
2021,Oadby and Wigston 010C,E01025973,2520,1180,1340
2021,Oadby and Wigston 010A,E01025974,1961,812,1149
2021,Oadby and Wigston 010D,E01025975,1360,295,1065
2021,Oadby and Wigston 003D,E01025976,1294,307,987
2021,Oadby and Wigston 003E,E01025977,1459,273,1186
2021,Oadby and Wigston 003F,E01025978,1567,282,1285
2021,Oadby and Wigston 011C,E01025979,1335,311,1024
2021,Oadby and Wigston 010B,E01025980,1332,280,1052
2021,Oadby and Wigston 011E,E01025981,1614,368,1246
2021,Oadby and Wigston 011B,E01025982,1872,504,1368
2021,Oadby and Wigston 011D,E01025983,1193,263,930
2021,Oadby and Wigston 011A,E01025984,1344,263,1081
2021,Oadby and Wigston 006A,E01025985,1206,139,1067
2021,Oadby and Wigston 006B,E01025986,1472,194,1278
2021,Oadby and Wigston 006C,E01025987,1554,336,1218
2021,Oadby and Wigston 006D,E01025988,1728,358,1370
2021,Oadby and Wigston 006E,E01025989,1645,356,1289
2021,Oadby and Wigston 007A,E01025990,1262,163,1099
2021,Oadby and Wigston 007B,E01025991,1356,217,1139
2021,Oadby and Wigston 005A,E01025992,1641,231,1410
2021,Oadby and Wigston 007C,E01025993,1359,243,1116
2021,Oadby and Wigston 005B,E01025994,1639,377,1262
2021,Oadby and Wigston 008A,E01025995,1466,289,1177
2021,Oadby and Wigston 005C,E01025997,1501,357,1144
2021,Oadby and Wigston 007D,E01025998,2109,370,1739
2021,Oadby and Wigston 005D,E01025999,1377,271,1106
2021,Oadby and Wigston 007E,E01026000,1188,174,1014
2021,Oadby and Wigston 007F,E01026001,1318,180,1138
2021,Oadby and Wigston 008B,E01026003,1547,280,1267
2021,Oadby and Wigston 008C,E01026004,1711,350,1361
2021,Oadby and Wigston 005E,E01026005,1613,292,1321
2021,Boston 001A,E01026007,1074,155,919
2021,Boston 001B,E01026008,1571,186,1385
2021,Boston 001C,E01026009,1175,174,1001
2021,Boston 002A,E01026010,1697,420,1277
2021,Boston 004A,E01026012,1093,188,905
2021,Boston 008A,E01026013,1406,239,1167
2021,Boston 008B,E01026014,1854,336,1518
2021,Boston 004B,E01026015,1571,300,1271
2021,Boston 006A,E01026016,2343,378,1965
2021,Boston 007A,E01026017,1578,246,1332
2021,Boston 007B,E01026018,1679,220,1459
2021,Boston 007C,E01026019,2630,550,2080
2021,Boston 007D,E01026020,2732,500,2232
2021,Boston 003B,E01026021,1697,295,1402
2021,Boston 008C,E01026022,2207,426,1781
2021,Boston 001D,E01026023,1335,172,1163
2021,Boston 001E,E01026024,2146,397,1749
2021,Boston 003C,E01026025,2274,400,1874
2021,Boston 004C,E01026026,2144,494,1650
2021,Boston 004D,E01026027,1777,357,1420
2021,Boston 004E,E01026028,1802,305,1497
2021,Boston 002C,E01026030,2432,473,1959
2021,Boston 009B,E01026031,1580,236,1344
2021,Boston 002D,E01026032,1836,307,1529
2021,Boston 006B,E01026033,2268,360,1908
2021,Boston 006C,E01026034,1771,292,1479
2021,Boston 009C,E01026035,2393,380,2013
2021,Boston 003D,E01026036,1510,273,1237
2021,Boston 002E,E01026037,1502,316,1186
2021,Boston 008D,E01026038,1367,192,1175
2021,Boston 009D,E01026039,1134,159,975
2021,Boston 008E,E01026040,1586,297,1289
2021,Boston 007E,E01026041,1293,284,1009
2021,East Lindsey 008A,E01026042,1640,326,1314
2021,East Lindsey 008B,E01026043,1727,301,1426
2021,East Lindsey 008C,E01026044,1344,144,1200
2021,East Lindsey 001A,E01026045,1830,218,1612
2021,East Lindsey 013A,E01026046,1275,200,1075
2021,East Lindsey 013B,E01026047,1239,143,1096
2021,East Lindsey 010A,E01026048,1542,164,1378
2021,East Lindsey 010B,E01026049,1525,166,1359
2021,East Lindsey 010C,E01026050,1563,115,1448
2021,East Lindsey 016A,E01026051,1316,206,1110
2021,East Lindsey 016B,E01026052,2357,302,2055
2021,East Lindsey 016C,E01026053,1868,407,1461
2021,East Lindsey 016D,E01026054,1546,271,1275
2021,East Lindsey 013C,E01026055,1119,148,971
2021,East Lindsey 017A,E01026056,1231,183,1048
2021,East Lindsey 018A,E01026057,1893,268,1625
2021,East Lindsey 002A,E01026058,2216,339,1877
2021,East Lindsey 013D,E01026059,1174,155,1019
2021,East Lindsey 009A,E01026060,1257,143,1114
2021,East Lindsey 001B,E01026061,1070,145,925
2021,East Lindsey 001C,E01026062,1098,191,907
2021,East Lindsey 001D,E01026063,1490,243,1247
2021,East Lindsey 011A,E01026064,1536,332,1204
2021,East Lindsey 011B,E01026065,1838,258,1580
2021,East Lindsey 011C,E01026066,2005,300,1705
2021,East Lindsey 011D,E01026067,1817,260,1557
2021,East Lindsey 009B,E01026068,2040,266,1774
2021,East Lindsey 010D,E01026069,2215,253,1962
2021,East Lindsey 009C,E01026070,2084,315,1769
2021,East Lindsey 007A,E01026071,2038,261,1777
2021,East Lindsey 005A,E01026072,2214,342,1872
2021,East Lindsey 005B,E01026073,1881,232,1649
2021,East Lindsey 005C,E01026074,2092,211,1881
2021,East Lindsey 018B,E01026075,2108,319,1789
2021,East Lindsey 002B,E01026076,2191,319,1872
2021,East Lindsey 003A,E01026077,1429,286,1143
2021,East Lindsey 003B,E01026078,1029,185,844
2021,East Lindsey 002C,E01026079,1872,248,1624
2021,East Lindsey 001E,E01026080,1906,252,1654
2021,East Lindsey 004A,E01026081,2234,350,1884
2021,East Lindsey 007B,E01026082,2294,267,2027
2021,East Lindsey 015A,E01026083,1650,338,1312
2021,East Lindsey 012A,E01026084,1506,243,1263
2021,East Lindsey 003C,E01026087,1369,318,1051
2021,East Lindsey 003D,E01026088,1344,187,1157
2021,East Lindsey 004C,E01026089,1944,243,1701
2021,East Lindsey 003E,E01026090,1296,188,1108
2021,East Lindsey 003F,E01026091,1095,206,889
2021,East Lindsey 014A,E01026092,1360,259,1101
2021,East Lindsey 014B,E01026093,1739,235,1504
2021,East Lindsey 015B,E01026094,2102,402,1700
2021,East Lindsey 014C,E01026095,1294,176,1118
2021,East Lindsey 015C,E01026096,1460,262,1198
2021,East Lindsey 015D,E01026097,1443,176,1267
2021,East Lindsey 018C,E01026098,1958,300,1658
2021,East Lindsey 005D,E01026099,1968,241,1727
2021,East Lindsey 013E,E01026100,1735,316,1419
2021,East Lindsey 013F,E01026101,1324,264,1060
2021,East Lindsey 018D,E01026102,2236,300,1936
2021,East Lindsey 006A,E01026103,1975,167,1808
2021,East Lindsey 006B,E01026104,2112,184,1928
2021,East Lindsey 009D,E01026105,2123,280,1843
2021,East Lindsey 001F,E01026106,1176,163,1013
2021,East Lindsey 001G,E01026107,1257,277,980
2021,East Lindsey 003G,E01026108,2342,455,1887
2021,East Lindsey 006C,E01026109,2031,130,1901
2021,East Lindsey 017B,E01026110,1422,162,1260
2021,East Lindsey 017C,E01026111,1510,222,1288
2021,East Lindsey 017D,E01026112,1168,248,920
2021,East Lindsey 008D,E01026113,1919,207,1712
2021,East Lindsey 014D,E01026114,1544,216,1328
2021,East Lindsey 012C,E01026115,1643,218,1425
2021,East Lindsey 012D,E01026116,1612,259,1353
2021,East Lindsey 008E,E01026117,1876,202,1674
2021,East Lindsey 016E,E01026118,1779,209,1570
2021,East Lindsey 016F,E01026119,1089,120,969
2021,East Lindsey 016G,E01026120,1446,213,1233
2021,East Lindsey 007C,E01026121,2475,384,2091
2021,Lincoln 004A,E01026122,2073,839,1234
2021,Lincoln 004B,E01026123,2396,643,1753
2021,Lincoln 004C,E01026124,1721,350,1371
2021,Lincoln 003A,E01026125,1433,188,1245
2021,Lincoln 004D,E01026126,1841,390,1451
2021,Lincoln 007A,E01026127,1319,292,1027
2021,Lincoln 007C,E01026129,1624,440,1184
2021,Lincoln 009A,E01026130,1310,179,1131
2021,Lincoln 007D,E01026131,1305,228,1077
2021,Lincoln 005A,E01026132,3646,2616,1030
2021,Lincoln 006A,E01026134,1913,424,1489
2021,Lincoln 008B,E01026135,1679,248,1431
2021,Lincoln 008C,E01026136,1671,259,1412
2021,Lincoln 011A,E01026137,1138,203,935
2021,Lincoln 011B,E01026138,1403,249,1154
2021,Lincoln 011C,E01026139,1291,256,1035
2021,Lincoln 011D,E01026140,1271,233,1038
2021,Lincoln 011E,E01026141,1490,317,1173
2021,Lincoln 011F,E01026142,1142,258,884
2021,Lincoln 003B,E01026144,2160,996,1164
2021,Lincoln 005C,E01026145,1623,699,924
2021,Lincoln 005D,E01026146,1995,1237,758
2021,Lincoln 003C,E01026147,2374,429,1945
2021,Lincoln 003D,E01026148,1810,422,1388
2021,Lincoln 001A,E01026149,1589,300,1289
2021,Lincoln 001B,E01026150,1647,315,1332
2021,Lincoln 003E,E01026151,1991,420,1571
2021,Lincoln 004E,E01026152,1427,408,1019
2021,Lincoln 002A,E01026153,2409,429,1980
2021,Lincoln 004F,E01026154,1312,301,1011
2021,Lincoln 002B,E01026155,1747,325,1422
2021,Lincoln 004G,E01026156,1216,304,912
2021,Lincoln 002C,E01026157,1343,271,1072
2021,Lincoln 009B,E01026158,1368,179,1189
2021,Lincoln 009C,E01026159,1398,244,1154
2021,Lincoln 009D,E01026160,1262,174,1088
2021,Lincoln 010A,E01026161,1310,234,1076
2021,Lincoln 009E,E01026162,1423,248,1175
2021,Lincoln 009F,E01026163,1257,190,1067
2021,Lincoln 003F,E01026164,1509,482,1027
2021,Lincoln 002D,E01026165,1572,247,1325
2021,Lincoln 001C,E01026166,1331,321,1010
2021,Lincoln 003G,E01026167,1776,396,1380
2021,Lincoln 001D,E01026168,1591,434,1157
2021,Lincoln 011G,E01026169,1603,270,1333
2021,Lincoln 010B,E01026170,1415,280,1135
2021,Lincoln 011H,E01026171,1479,199,1280
2021,Lincoln 010C,E01026172,1534,395,1139
2021,Lincoln 010D,E01026173,1540,430,1110
2021,Lincoln 008D,E01026174,1431,250,1181
2021,Lincoln 010E,E01026175,1713,285,1428
2021,Lincoln 006B,E01026176,2025,646,1379
2021,Lincoln 006C,E01026177,2105,719,1386
2021,Lincoln 006D,E01026178,1904,577,1327
2021,North Kesteven 008A,E01026179,1216,219,997
2021,North Kesteven 007A,E01026180,1405,236,1169
2021,North Kesteven 003B,E01026182,1458,240,1218
2021,North Kesteven 007B,E01026183,2643,448,2195
2021,North Kesteven 004A,E01026184,1792,316,1476
2021,North Kesteven 004B,E01026185,2104,300,1804
2021,North Kesteven 001A,E01026186,1610,276,1334
2021,North Kesteven 001B,E01026187,1828,363,1465
2021,North Kesteven 004C,E01026188,2083,390,1693
2021,North Kesteven 001C,E01026189,1671,196,1475
2021,North Kesteven 004D,E01026190,1799,386,1413
2021,North Kesteven 005A,E01026191,1768,317,1451
2021,North Kesteven 006A,E01026192,1195,175,1020
2021,North Kesteven 003C,E01026193,1555,238,1317
2021,North Kesteven 006B,E01026194,2037,345,1692
2021,North Kesteven 006C,E01026195,1840,273,1567
2021,North Kesteven 006D,E01026196,1430,177,1253
2021,North Kesteven 008B,E01026197,1417,240,1177
2021,North Kesteven 008C,E01026198,1474,262,1212
2021,North Kesteven 003D,E01026199,2478,409,2069
2021,North Kesteven 012A,E01026200,1661,213,1448
2021,North Kesteven 012B,E01026201,2003,320,1683
2021,North Kesteven 012C,E01026202,1846,252,1594
2021,North Kesteven 001D,E01026203,1893,283,1610
2021,North Kesteven 001E,E01026204,1545,192,1353
2021,North Kesteven 005B,E01026205,1619,297,1322
2021,North Kesteven 001F,E01026206,1778,309,1469
2021,North Kesteven 012D,E01026207,1242,181,1061
2021,North Kesteven 012E,E01026208,1581,254,1327
2021,North Kesteven 009A,E01026209,2010,227,1783
2021,North Kesteven 007C,E01026210,2341,367,1974
2021,North Kesteven 005C,E01026211,1878,338,1540
2021,North Kesteven 005D,E01026212,1437,244,1193
2021,North Kesteven 005E,E01026213,1625,234,1391
2021,North Kesteven 014A,E01026214,1054,170,884
2021,North Kesteven 014B,E01026215,1004,169,835
2021,North Kesteven 014C,E01026218,1124,127,997
2021,North Kesteven 014D,E01026219,1091,160,931
2021,North Kesteven 013A,E01026220,2169,272,1897
2021,North Kesteven 009B,E01026221,2393,378,2015
2021,North Kesteven 009C,E01026222,1767,225,1542
2021,North Kesteven 008D,E01026223,1941,274,1667
2021,North Kesteven 007D,E01026224,1734,335,1399
2021,North Kesteven 003E,E01026225,1627,290,1337
2021,North Kesteven 003F,E01026226,1791,192,1599
2021,North Kesteven 010A,E01026227,1468,237,1231
2021,North Kesteven 011A,E01026228,1629,324,1305
2021,North Kesteven 011B,E01026229,1794,390,1404
2021,North Kesteven 010B,E01026230,1672,385,1287
2021,North Kesteven 010C,E01026231,2566,480,2086
2021,North Kesteven 010D,E01026232,2019,292,1727
2021,North Kesteven 011C,E01026233,1652,321,1331
2021,North Kesteven 010E,E01026235,1574,345,1229
2021,North Kesteven 011E,E01026236,1104,185,919
2021,North Kesteven 004E,E01026237,1083,140,943
2021,North Kesteven 004F,E01026238,1419,268,1151
2021,South Holland 011A,E01026239,1987,333,1654
2021,South Holland 011B,E01026240,2632,485,2147
2021,South Holland 005A,E01026241,1847,348,1499
2021,South Holland 001A,E01026242,1683,287,1396
2021,South Holland 001B,E01026243,1343,280,1063
2021,South Holland 001C,E01026244,1278,175,1103
2021,South Holland 010A,E01026245,2363,303,2060
2021,South Holland 002A,E01026246,2226,338,1888
2021,South Holland 001D,E01026247,1871,245,1626
2021,South Holland 002B,E01026248,2192,283,1909
2021,South Holland 010B,E01026249,1931,231,1700
2021,South Holland 003A,E01026250,2026,338,1688
2021,South Holland 003B,E01026251,1743,251,1492
2021,South Holland 003C,E01026252,1704,230,1474
2021,South Holland 003D,E01026253,1863,298,1565
2021,South Holland 008A,E01026254,1735,212,1523
2021,South Holland 008B,E01026255,1902,254,1648
2021,South Holland 008C,E01026256,1574,218,1356
2021,South Holland 002C,E01026257,2060,305,1755
2021,South Holland 005B,E01026258,2146,321,1825
2021,South Holland 005C,E01026259,1671,265,1406
2021,South Holland 005D,E01026260,1879,315,1564
2021,South Holland 009A,E01026262,1408,190,1218
2021,South Holland 009B,E01026263,2245,424,1821
2021,South Holland 009C,E01026264,1569,285,1284
2021,South Holland 009D,E01026265,1378,183,1195
2021,South Holland 006B,E01026266,2142,304,1838
2021,South Holland 007A,E01026268,1874,343,1531
2021,South Holland 007B,E01026269,2070,301,1769
2021,South Holland 007C,E01026270,1749,341,1408
2021,South Holland 007D,E01026271,1665,294,1371
2021,South Holland 007E,E01026272,1316,187,1129
2021,South Holland 006C,E01026273,1686,268,1418
2021,South Holland 006E,E01026275,2540,442,2098
2021,South Holland 001E,E01026276,2247,318,1929
2021,South Holland 008D,E01026277,1593,349,1244
2021,South Holland 008E,E01026278,1396,203,1193
2021,South Holland 008F,E01026279,1291,176,1115
2021,South Holland 010C,E01026280,2554,378,2176
2021,South Holland 004A,E01026281,1307,204,1103
2021,South Holland 004B,E01026282,1764,314,1450
2021,South Holland 004C,E01026283,1686,275,1411
2021,South Holland 011C,E01026284,2204,364,1840
2021,South Holland 004D,E01026285,1358,177,1181
2021,South Holland 004E,E01026286,1204,193,1011
2021,South Kesteven 015A,E01026287,1271,178,1093
2021,South Kesteven 015B,E01026288,1520,292,1228
2021,South Kesteven 015C,E01026289,2165,419,1746
2021,South Kesteven 008A,E01026290,2155,309,1846
2021,South Kesteven 002A,E01026291,1965,314,1651
2021,South Kesteven 007A,E01026292,1333,180,1153
2021,South Kesteven 007B,E01026293,1949,338,1611
2021,South Kesteven 007C,E01026294,1513,299,1214
2021,South Kesteven 011B,E01026296,1467,213,1254
2021,South Kesteven 011C,E01026297,1455,251,1204
2021,South Kesteven 011D,E01026298,2000,331,1669
2021,South Kesteven 010A,E01026299,1603,293,1310
2021,South Kesteven 010B,E01026300,1413,202,1211
2021,South Kesteven 010D,E01026302,1085,180,905
2021,South Kesteven 014A,E01026303,1198,218,980
2021,South Kesteven 014B,E01026304,1436,241,1195
2021,South Kesteven 014C,E01026305,1246,173,1073
2021,South Kesteven 014D,E01026306,1835,343,1492
2021,South Kesteven 014E,E01026307,1228,216,1012
2021,South Kesteven 005A,E01026308,1483,457,1026
2021,South Kesteven 005B,E01026309,1500,273,1227
2021,South Kesteven 005C,E01026310,1101,252,849
2021,South Kesteven 005D,E01026311,1538,311,1227
2021,South Kesteven 005E,E01026312,1285,418,867
2021,South Kesteven 001A,E01026313,1431,250,1181
2021,South Kesteven 001B,E01026314,1291,233,1058
2021,South Kesteven 009A,E01026315,2122,357,1765
2021,South Kesteven 007D,E01026316,2352,360,1992
2021,South Kesteven 006A,E01026317,2169,349,1820
2021,South Kesteven 006B,E01026318,2043,389,1654
2021,South Kesteven 006C,E01026319,2468,464,2004
2021,South Kesteven 004B,E01026321,1330,210,1120
2021,South Kesteven 004C,E01026322,1157,157,1000
2021,South Kesteven 004D,E01026323,1868,266,1602
2021,South Kesteven 004E,E01026324,1972,334,1638
2021,South Kesteven 003A,E01026325,1522,364,1158
2021,South Kesteven 003B,E01026326,1421,248,1173
2021,South Kesteven 003C,E01026327,1329,229,1100
2021,South Kesteven 003D,E01026328,1432,358,1074
2021,South Kesteven 001C,E01026329,1770,293,1477
2021,South Kesteven 012A,E01026330,2108,395,1713
2021,South Kesteven 009B,E01026331,2396,365,2031
2021,South Kesteven 007E,E01026332,2085,310,1775
2021,South Kesteven 001D,E01026333,2451,392,2059
2021,South Kesteven 013A,E01026334,1489,234,1255
2021,South Kesteven 013B,E01026335,1492,171,1321
2021,South Kesteven 013C,E01026336,1634,263,1371
2021,South Kesteven 013D,E01026337,2132,456,1676
2021,South Kesteven 009C,E01026338,1192,208,984
2021,South Kesteven 009D,E01026339,1178,191,987
2021,South Kesteven 002B,E01026340,2146,368,1778
2021,South Kesteven 008B,E01026341,1543,268,1275
2021,South Kesteven 008C,E01026342,1348,248,1100
2021,South Kesteven 006D,E01026343,1735,247,1488
2021,South Kesteven 006E,E01026344,1419,267,1152
2021,South Kesteven 006F,E01026345,1701,373,1328
2021,South Kesteven 015D,E01026346,1131,187,944
2021,South Kesteven 015E,E01026347,1500,183,1317
2021,South Kesteven 015F,E01026348,1196,254,942
2021,South Kesteven 016A,E01026349,1460,256,1204
2021,South Kesteven 016B,E01026350,1775,253,1522
2021,South Kesteven 016C,E01026351,1450,218,1232
2021,South Kesteven 003E,E01026352,1272,245,1027
2021,South Kesteven 003F,E01026353,1488,204,1284
2021,South Kesteven 003G,E01026354,1095,185,910
2021,South Kesteven 002C,E01026355,2434,397,2037
2021,South Kesteven 016D,E01026356,1384,292,1092
2021,South Kesteven 016E,E01026357,1272,224,1048
2021,South Kesteven 016F,E01026358,1316,190,1126
2021,South Kesteven 016G,E01026359,2348,489,1859
2021,South Kesteven 012B,E01026360,2059,351,1708
2021,South Kesteven 008D,E01026361,2532,379,2153
2021,South Kesteven 012C,E01026362,1658,346,1312
2021,South Kesteven 012D,E01026363,1821,199,1622
2021,South Kesteven 012E,E01026364,1801,279,1522
2021,South Kesteven 002D,E01026365,2238,311,1927
2021,West Lindsey 011A,E01026366,2329,382,1947
2021,West Lindsey 001A,E01026367,1604,176,1428
2021,West Lindsey 001B,E01026368,1870,390,1480
2021,West Lindsey 011B,E01026369,1283,221,1062
2021,West Lindsey 011C,E01026370,2422,364,2058
2021,West Lindsey 011D,E01026371,1194,214,980
2021,West Lindsey 008A,E01026372,2456,482,1974
2021,West Lindsey 011E,E01026373,2103,343,1760
2021,West Lindsey 006A,E01026374,1375,376,999
2021,West Lindsey 006B,E01026375,1899,444,1455
2021,West Lindsey 006C,E01026376,1610,310,1300
2021,West Lindsey 006D,E01026377,2076,456,1620
2021,West Lindsey 004A,E01026378,1625,364,1261
2021,West Lindsey 004B,E01026379,1729,358,1371
2021,West Lindsey 002A,E01026380,2397,476,1921
2021,West Lindsey 004C,E01026381,1631,255,1376
2021,West Lindsey 004D,E01026382,1669,255,1414
2021,West Lindsey 004E,E01026383,1221,168,1053
2021,West Lindsey 004F,E01026384,2010,352,1658
2021,West Lindsey 005A,E01026385,1043,132,911
2021,West Lindsey 005B,E01026386,1180,218,962
2021,West Lindsey 001C,E01026387,2585,411,2174
2021,West Lindsey 007A,E01026388,2046,261,1785
2021,West Lindsey 003A,E01026389,1714,244,1470
2021,West Lindsey 003B,E01026390,1740,272,1468
2021,West Lindsey 003C,E01026391,1899,268,1631
2021,West Lindsey 003D,E01026392,2922,468,2454
2021,West Lindsey 010A,E01026393,1465,190,1275
2021,West Lindsey 010B,E01026394,2219,429,1790
2021,West Lindsey 010C,E01026395,1454,183,1271
2021,West Lindsey 009A,E01026396,1258,116,1142
2021,West Lindsey 009C,E01026398,1518,215,1303
2021,West Lindsey 005C,E01026399,1454,236,1218
2021,West Lindsey 009D,E01026400,1505,315,1190
2021,West Lindsey 002B,E01026401,1555,274,1281
2021,West Lindsey 002C,E01026402,1789,287,1502
2021,West Lindsey 002D,E01026403,1307,211,1096
2021,West Lindsey 007B,E01026404,2332,346,1986
2021,West Lindsey 010D,E01026405,1458,294,1164
2021,West Lindsey 010E,E01026406,1155,212,943
2021,West Lindsey 002E,E01026407,1318,209,1109
2021,West Lindsey 002F,E01026408,1321,186,1135
2021,West Lindsey 007C,E01026409,1180,139,1041
2021,West Lindsey 007D,E01026410,1593,160,1433
2021,West Lindsey 005D,E01026411,2344,325,2019
2021,West Lindsey 008B,E01026412,1865,383,1482
2021,West Lindsey 008C,E01026413,2032,386,1646
2021,West Lindsey 008D,E01026414,1825,325,1500
2021,West Lindsey 003E,E01026415,1027,167,860
2021,West Lindsey 001D,E01026416,1267,225,1042
2021,Breckland 010A,E01026419,1247,211,1036
2021,Breckland 010B,E01026420,1220,174,1046
2021,Breckland 013A,E01026421,1732,278,1454
2021,Breckland 011B,E01026423,1791,308,1483
2021,Breckland 012A,E01026424,2029,275,1754
2021,Breckland 005A,E01026425,1947,403,1544
2021,Breckland 005B,E01026426,2192,316,1876
2021,Breckland 005C,E01026427,2371,435,1936
2021,Breckland 003A,E01026428,2553,506,2047
2021,Breckland 003B,E01026429,1378,200,1178
2021,Breckland 003C,E01026430,2226,400,1826
2021,Breckland 003D,E01026431,1115,148,967
2021,Breckland 005D,E01026432,1400,209,1191
2021,Breckland 005E,E01026433,1298,257,1041
2021,Breckland 005F,E01026434,1844,242,1602
2021,Breckland 013B,E01026435,2114,342,1772
2021,Breckland 001A,E01026436,2379,387,1992
2021,Breckland 008A,E01026437,1215,126,1089
2021,Breckland 008B,E01026438,1023,128,895
2021,Breckland 014A,E01026439,1765,253,1512
2021,Breckland 014B,E01026440,1131,205,926
2021,Breckland 014C,E01026441,1539,222,1317
2021,Breckland 002A,E01026442,2074,293,1781
2021,Breckland 002B,E01026443,2086,364,1722
2021,Breckland 012B,E01026444,2026,268,1758
2021,Breckland 002C,E01026445,2404,320,2084
2021,Breckland 004A,E01026446,2078,272,1806
2021,Breckland 011C,E01026447,1610,295,1315
2021,Breckland 013C,E01026448,2368,426,1942
2021,Breckland 011D,E01026449,1867,299,1568
2021,Breckland 011E,E01026450,1760,254,1506
2021,Breckland 008C,E01026451,2346,373,1973
2021,Breckland 004B,E01026452,1636,257,1379
2021,Breckland 004C,E01026453,1480,193,1287
2021,Breckland 004D,E01026454,1497,278,1219
2021,Breckland 007B,E01026456,1158,133,1025
2021,Breckland 007C,E01026457,1288,94,1194
2021,Breckland 007D,E01026458,1643,259,1384
2021,Breckland 007E,E01026459,1469,190,1279
2021,Breckland 001C,E01026461,1540,222,1318
2021,Breckland 002D,E01026462,2343,339,2004
2021,Breckland 010D,E01026464,1248,172,1076
2021,Breckland 015A,E01026465,1763,298,1465
2021,Breckland 015B,E01026466,1736,342,1394
2021,Breckland 015C,E01026467,2064,618,1446
2021,Breckland 016A,E01026468,2330,268,2062
2021,Breckland 016B,E01026469,1563,259,1304
2021,Breckland 016C,E01026470,2626,483,2143
2021,Breckland 016D,E01026471,1128,183,945
2021,Breckland 016E,E01026472,1136,184,952
2021,Breckland 016F,E01026473,1326,246,1080
2021,Breckland 017A,E01026474,1942,373,1569
2021,Breckland 017B,E01026475,1464,239,1225
2021,Breckland 017C,E01026476,1435,301,1134
2021,Breckland 017D,E01026477,1701,432,1269
2021,Breckland 017E,E01026478,1564,355,1209
2021,Breckland 006A,E01026479,1453,217,1236
2021,Breckland 006B,E01026480,1548,194,1354
2021,Breckland 006C,E01026481,1283,190,1093
2021,Breckland 001E,E01026483,1059,152,907
2021,Breckland 006D,E01026484,1530,240,1290
2021,Breckland 006E,E01026485,1163,167,996
2021,Breckland 009A,E01026486,1888,192,1696
2021,Breckland 009B,E01026487,2063,355,1708
2021,Breckland 009C,E01026488,1330,163,1167
2021,Breckland 009D,E01026489,1396,152,1244
2021,Breckland 009E,E01026490,1828,207,1621
2021,Breckland 010E,E01026491,2233,326,1907
2021,Breckland 012C,E01026492,1208,187,1021
2021,Breckland 012D,E01026493,1294,174,1120
2021,Breckland 014D,E01026494,2311,368,1943
2021,Breckland 008D,E01026495,1378,200,1178
2021,Breckland 008E,E01026496,1092,126,966
2021,Broadland 018A,E01026497,1410,186,1224
2021,Broadland 018B,E01026498,1266,172,1094
2021,Broadland 001A,E01026499,1489,224,1265
2021,Broadland 001B,E01026500,1565,256,1309
2021,Broadland 001C,E01026501,1536,232,1304
2021,Broadland 001D,E01026502,1926,304,1622
2021,Broadland 001E,E01026503,2011,358,1653
2021,Broadland 014A,E01026504,1433,201,1232
2021,Broadland 014B,E01026505,1891,346,1545
2021,Broadland 014C,E01026506,1392,210,1182
2021,Broadland 014D,E01026507,1365,237,1128
2021,Broadland 017A,E01026508,1303,165,1138
2021,Broadland 017B,E01026509,1819,302,1517
2021,Broadland 017C,E01026510,1691,227,1464
2021,Broadland 017D,E01026511,1134,169,965
2021,Broadland 014E,E01026512,1222,183,1039
2021,Broadland 014F,E01026513,1350,229,1121
2021,Broadland 003A,E01026514,1457,229,1228
2021,Broadland 003B,E01026515,1130,192,938
2021,Broadland 003C,E01026516,1144,171,973
2021,Broadland 003D,E01026517,1531,212,1319
2021,Broadland 007A,E01026518,1241,264,977
2021,Broadland 007B,E01026519,1565,281,1284
2021,Broadland 007C,E01026520,1058,116,942
2021,Broadland 007D,E01026521,1261,189,1072
2021,Broadland 002A,E01026522,1382,214,1168
2021,Broadland 002B,E01026523,1748,274,1474
2021,Broadland 002C,E01026524,1401,215,1186
2021,Broadland 002D,E01026525,1206,172,1034
2021,Broadland 010A,E01026526,1288,153,1135
2021,Broadland 010B,E01026527,1346,173,1173
2021,Broadland 010C,E01026528,1342,199,1143
2021,Broadland 010D,E01026529,1500,215,1285
2021,Broadland 011A,E01026530,1756,251,1505
2021,Broadland 011B,E01026531,1802,258,1544
2021,Broadland 011C,E01026532,1648,276,1372
2021,Broadland 004A,E01026533,1183,150,1033
2021,Broadland 004B,E01026534,1602,305,1297
2021,Broadland 004C,E01026535,2169,397,1772
2021,Broadland 004D,E01026536,1798,322,1476
2021,Broadland 004E,E01026537,1395,264,1131
2021,Broadland 018C,E01026538,1541,249,1292
2021,Broadland 018D,E01026539,1549,256,1293
2021,Broadland 009A,E01026540,1341,164,1177
2021,Broadland 009B,E01026541,2339,474,1865
2021,Broadland 009C,E01026542,1361,197,1164
2021,Broadland 009D,E01026543,1396,179,1217
2021,Broadland 009E,E01026544,1660,237,1423
2021,Broadland 008A,E01026545,2021,400,1621
2021,Broadland 008B,E01026546,1374,221,1153
2021,Broadland 002E,E01026547,1348,207,1141
2021,Broadland 002F,E01026548,1246,240,1006
2021,Broadland 005A,E01026549,1718,268,1450
2021,Broadland 005B,E01026550,1021,183,838
2021,Broadland 005C,E01026551,1074,135,939
2021,Broadland 005D,E01026552,1296,167,1129
2021,Broadland 012A,E01026553,1266,185,1081
2021,Broadland 012B,E01026554,1062,139,923
2021,Broadland 012C,E01026555,1443,281,1162
2021,Broadland 012D,E01026556,1349,230,1119
2021,Broadland 013A,E01026557,1283,167,1116
2021,Broadland 013B,E01026558,2105,278,1827
2021,Broadland 013C,E01026559,1391,225,1166
2021,Broadland 013D,E01026560,1262,152,1110
2021,Broadland 006A,E01026562,1130,208,922
2021,Broadland 006B,E01026563,1287,246,1041
2021,Broadland 006C,E01026564,1554,281,1273
2021,Broadland 006D,E01026565,1031,163,868
2021,Broadland 006E,E01026566,1403,251,1152
2021,Broadland 006F,E01026567,1548,195,1353
2021,Broadland 006G,E01026568,1461,278,1183
2021,Broadland 015A,E01026569,1389,198,1191
2021,Broadland 015B,E01026570,1594,248,1346
2021,Broadland 015C,E01026571,1421,193,1228
2021,Broadland 015D,E01026572,1350,205,1145
2021,Broadland 015E,E01026573,1323,228,1095
2021,Broadland 016A,E01026574,1634,338,1296
2021,Broadland 016B,E01026575,1734,277,1457
2021,Broadland 016C,E01026576,1915,413,1502
2021,Broadland 016D,E01026577,1583,230,1353
2021,Broadland 008C,E01026578,2030,374,1656
2021,Broadland 008D,E01026579,1511,210,1301
2021,Broadland 008E,E01026580,1753,209,1544
2021,Great Yarmouth 008A,E01026581,1615,308,1307
2021,Great Yarmouth 008B,E01026582,1917,272,1645
2021,Great Yarmouth 008C,E01026583,1272,211,1061
2021,Great Yarmouth 008D,E01026584,1421,195,1226
2021,Great Yarmouth 013C,E01026587,2773,540,2233
2021,Great Yarmouth 013D,E01026588,2469,369,2100
2021,Great Yarmouth 003A,E01026589,1257,201,1056
2021,Great Yarmouth 003B,E01026590,1318,155,1163
2021,Great Yarmouth 003C,E01026591,1615,173,1442
2021,Great Yarmouth 003D,E01026592,1305,161,1144
2021,Great Yarmouth 003E,E01026593,1284,159,1125
2021,Great Yarmouth 003F,E01026594,1741,315,1426
2021,Great Yarmouth 005A,E01026595,1622,295,1327
2021,Great Yarmouth 005B,E01026596,1481,266,1215
2021,Great Yarmouth 005C,E01026597,1867,373,1494
2021,Great Yarmouth 005D,E01026598,1753,308,1445
2021,Great Yarmouth 004A,E01026599,1336,274,1062
2021,Great Yarmouth 007A,E01026600,1394,272,1122
2021,Great Yarmouth 009A,E01026601,1332,213,1119
2021,Great Yarmouth 009B,E01026602,1524,246,1278
2021,Great Yarmouth 009C,E01026603,1525,324,1201
2021,Great Yarmouth 009D,E01026604,1465,257,1208
2021,Great Yarmouth 001A,E01026605,1749,199,1550
2021,Great Yarmouth 001B,E01026606,1385,155,1230
2021,Great Yarmouth 001C,E01026607,1709,236,1473
2021,Great Yarmouth 002A,E01026608,1432,216,1216
2021,Great Yarmouth 002B,E01026609,1156,175,981
2021,Great Yarmouth 010A,E01026610,1407,259,1148
2021,Great Yarmouth 010B,E01026611,1296,155,1141
2021,Great Yarmouth 010C,E01026612,2372,391,1981
2021,Great Yarmouth 012A,E01026613,1232,143,1089
2021,Great Yarmouth 012B,E01026614,1721,203,1518
2021,Great Yarmouth 012C,E01026615,1301,220,1081
2021,Great Yarmouth 012D,E01026616,1148,217,931
2021,Great Yarmouth 011A,E01026617,1193,174,1019
2021,Great Yarmouth 011B,E01026618,1452,231,1221
2021,Great Yarmouth 011C,E01026619,1348,316,1032
2021,Great Yarmouth 011D,E01026620,1481,328,1153
2021,Great Yarmouth 011E,E01026621,1492,316,1176
2021,Great Yarmouth 006A,E01026622,1523,425,1098
2021,Great Yarmouth 006B,E01026623,1722,297,1425
2021,Great Yarmouth 006C,E01026624,1833,357,1476
2021,Great Yarmouth 006D,E01026625,1662,466,1196
2021,Great Yarmouth 006E,E01026626,1954,332,1622
2021,Great Yarmouth 001D,E01026627,1320,142,1178
2021,Great Yarmouth 001E,E01026628,1786,262,1524
2021,Great Yarmouth 001F,E01026629,1428,211,1217
2021,Great Yarmouth 010D,E01026630,1518,300,1218
2021,Great Yarmouth 010E,E01026631,1539,238,1301
2021,Great Yarmouth 009E,E01026632,1586,234,1352
2021,Great Yarmouth 007B,E01026633,1647,317,1330
2021,Great Yarmouth 007C,E01026634,1416,317,1099
2021,Great Yarmouth 007D,E01026635,2200,499,1701
2021,Great Yarmouth 002C,E01026636,1503,184,1319
2021,Great Yarmouth 002D,E01026637,2027,255,1772
2021,Great Yarmouth 002E,E01026638,1584,316,1268
2021,Great Yarmouth 004B,E01026639,1490,256,1234
2021,Great Yarmouth 004C,E01026640,1454,196,1258
2021,Great Yarmouth 004D,E01026641,1352,311,1041
2021,King's Lynn and West Norfolk 014A,E01026642,1367,198,1169
2021,King's Lynn and West Norfolk 014B,E01026643,1322,148,1174
2021,King's Lynn and West Norfolk 014C,E01026644,1668,284,1384
2021,King's Lynn and West Norfolk 002A,E01026645,1098,90,1008
2021,King's Lynn and West Norfolk 002B,E01026646,1440,180,1260
2021,King's Lynn and West Norfolk 008A,E01026647,2158,336,1822
2021,King's Lynn and West Norfolk 019A,E01026648,1585,265,1320
2021,King's Lynn and West Norfolk 019B,E01026649,1710,289,1421
2021,King's Lynn and West Norfolk 019C,E01026650,1139,268,871
2021,King's Lynn and West Norfolk 019D,E01026651,2462,421,2041
2021,King's Lynn and West Norfolk 019E,E01026652,1358,213,1145
2021,King's Lynn and West Norfolk 004A,E01026653,1738,175,1563
2021,King's Lynn and West Norfolk 004B,E01026654,1482,205,1277
2021,King's Lynn and West Norfolk 004C,E01026655,1376,175,1201
2021,King's Lynn and West Norfolk 002C,E01026656,1738,226,1512
2021,King's Lynn and West Norfolk 016A,E01026659,1601,281,1320
2021,King's Lynn and West Norfolk 016B,E01026660,1685,240,1445
2021,King's Lynn and West Norfolk 016C,E01026661,1611,249,1362
2021,King's Lynn and West Norfolk 010A,E01026662,2650,685,1965
2021,King's Lynn and West Norfolk 010B,E01026663,1626,373,1253
2021,King's Lynn and West Norfolk 010C,E01026664,2058,369,1689
2021,King's Lynn and West Norfolk 012A,E01026665,2367,362,2005
2021,King's Lynn and West Norfolk 009A,E01026666,1887,467,1420
2021,King's Lynn and West Norfolk 009B,E01026667,1420,189,1231
2021,King's Lynn and West Norfolk 009C,E01026668,1555,268,1287
2021,King's Lynn and West Norfolk 006A,E01026669,1845,270,1575
2021,King's Lynn and West Norfolk 006B,E01026670,1527,269,1258
2021,King's Lynn and West Norfolk 006C,E01026671,1284,221,1063
2021,King's Lynn and West Norfolk 006D,E01026672,1346,194,1152
2021,King's Lynn and West Norfolk 006E,E01026673,1346,215,1131
2021,King's Lynn and West Norfolk 012B,E01026674,1090,126,964
2021,King's Lynn and West Norfolk 012C,E01026675,1180,181,999
2021,King's Lynn and West Norfolk 003A,E01026676,1593,146,1447
2021,King's Lynn and West Norfolk 003B,E01026677,1408,173,1235
2021,King's Lynn and West Norfolk 003C,E01026678,1498,129,1369
2021,King's Lynn and West Norfolk 018A,E01026679,2349,354,1995
2021,King's Lynn and West Norfolk 001A,E01026680,1554,141,1413
2021,King's Lynn and West Norfolk 001B,E01026681,1186,93,1093
2021,King's Lynn and West Norfolk 001C,E01026682,1116,94,1022
2021,King's Lynn and West Norfolk 001D,E01026683,1242,156,1086
2021,King's Lynn and West Norfolk 013A,E01026684,1372,217,1155
2021,King's Lynn and West Norfolk 013B,E01026685,1199,159,1040
2021,King's Lynn and West Norfolk 007A,E01026687,1825,409,1416
2021,King's Lynn and West Norfolk 007B,E01026688,1564,445,1119
2021,King's Lynn and West Norfolk 007C,E01026689,1423,233,1190
2021,King's Lynn and West Norfolk 007D,E01026690,1571,343,1228
2021,King's Lynn and West Norfolk 005A,E01026691,1146,195,951
2021,King's Lynn and West Norfolk 005B,E01026692,1100,161,939
2021,King's Lynn and West Norfolk 009D,E01026693,2119,351,1768
2021,King's Lynn and West Norfolk 012D,E01026694,2522,357,2165
2021,King's Lynn and West Norfolk 002D,E01026695,2051,284,1767
2021,King's Lynn and West Norfolk 015A,E01026696,1178,178,1000
2021,King's Lynn and West Norfolk 015B,E01026697,1286,183,1103
2021,King's Lynn and West Norfolk 011B,E01026699,1516,193,1323
2021,King's Lynn and West Norfolk 011C,E01026700,1332,181,1151
2021,King's Lynn and West Norfolk 003D,E01026701,1637,171,1466
2021,King's Lynn and West Norfolk 003E,E01026702,1272,189,1083
2021,King's Lynn and West Norfolk 003F,E01026703,1079,129,950
2021,King's Lynn and West Norfolk 011D,E01026704,1704,420,1284
2021,King's Lynn and West Norfolk 011E,E01026705,1691,372,1319
2021,King's Lynn and West Norfolk 011F,E01026706,1898,350,1548
2021,King's Lynn and West Norfolk 005C,E01026708,1338,209,1129
2021,King's Lynn and West Norfolk 005D,E01026709,1848,340,1508
2021,King's Lynn and West Norfolk 005E,E01026710,1160,157,1003
2021,King's Lynn and West Norfolk 008B,E01026711,1472,251,1221
2021,King's Lynn and West Norfolk 008C,E01026712,1790,282,1508
2021,King's Lynn and West Norfolk 008D,E01026713,1622,218,1404
2021,King's Lynn and West Norfolk 010D,E01026714,2160,393,1767
2021,King's Lynn and West Norfolk 016D,E01026715,1529,211,1318
2021,King's Lynn and West Norfolk 016E,E01026716,1887,289,1598
2021,King's Lynn and West Norfolk 016F,E01026717,1606,251,1355
2021,King's Lynn and West Norfolk 004D,E01026718,2219,315,1904
2021,King's Lynn and West Norfolk 013C,E01026719,2366,388,1978
2021,King's Lynn and West Norfolk 013D,E01026720,1338,218,1120
2021,King's Lynn and West Norfolk 013E,E01026721,1416,240,1176
2021,King's Lynn and West Norfolk 015C,E01026722,2464,415,2049
2021,King's Lynn and West Norfolk 014D,E01026723,1607,275,1332
2021,King's Lynn and West Norfolk 014E,E01026724,1784,254,1530
2021,King's Lynn and West Norfolk 014F,E01026725,1428,186,1242
2021,King's Lynn and West Norfolk 015D,E01026726,2064,294,1770
2021,King's Lynn and West Norfolk 018B,E01026727,2496,342,2154
2021,King's Lynn and West Norfolk 018C,E01026728,2440,336,2104
2021,North Norfolk 008A,E01026729,2116,253,1863
2021,North Norfolk 008B,E01026730,2429,369,2060
2021,North Norfolk 006C,E01026733,2304,362,1942
2021,North Norfolk 003A,E01026734,1001,81,920
2021,North Norfolk 003B,E01026735,1124,100,1024
2021,North Norfolk 003C,E01026736,1256,143,1113
2021,North Norfolk 006D,E01026737,2278,315,1963
2021,North Norfolk 007A,E01026738,2303,291,2012
2021,North Norfolk 002A,E01026739,1864,210,1654
2021,North Norfolk 012A,E01026740,2301,250,2051
2021,North Norfolk 004A,E01026741,1701,157,1544
2021,North Norfolk 004B,E01026742,1768,340,1428
2021,North Norfolk 004C,E01026743,2073,271,1802
2021,North Norfolk 014A,E01026744,2224,271,1953
2021,North Norfolk 011A,E01026745,1763,271,1492
2021,North Norfolk 011B,E01026746,1643,228,1415
2021,North Norfolk 011C,E01026747,1273,176,1097
2021,North Norfolk 011D,E01026748,1427,149,1278
2021,North Norfolk 011E,E01026749,1542,248,1294
2021,North Norfolk 007B,E01026750,1296,182,1114
2021,North Norfolk 007C,E01026751,1378,157,1221
2021,North Norfolk 007D,E01026752,1468,217,1251
2021,North Norfolk 015D,E01026753,1491,246,1245
2021,North Norfolk 015C,E01026754,1287,183,1104
2021,North Norfolk 015E,E01026755,1152,107,1045
2021,North Norfolk 015B,E01026756,1202,220,982
2021,North Norfolk 015A,E01026757,1399,173,1226
2021,North Norfolk 016B,E01026758,1253,148,1105
2021,North Norfolk 016C,E01026759,1378,240,1138
2021,North Norfolk 016D,E01026760,1818,274,1544
2021,North Norfolk 016A,E01026761,1476,209,1267
2021,North Norfolk 002B,E01026763,1252,196,1056
2021,North Norfolk 002C,E01026764,1223,129,1094
2021,North Norfolk 002D,E01026765,1297,144,1153
2021,North Norfolk 005B,E01026766,2261,315,1946
2021,North Norfolk 012B,E01026767,1169,151,1018
2021,North Norfolk 012C,E01026768,1815,235,1580
2021,North Norfolk 014B,E01026769,2010,196,1814
2021,North Norfolk 001A,E01026770,1720,176,1544
2021,North Norfolk 001B,E01026771,1469,205,1264
2021,North Norfolk 001C,E01026772,1721,245,1476
2021,North Norfolk 001D,E01026773,2001,274,1727
2021,North Norfolk 013A,E01026774,1615,244,1371
2021,North Norfolk 013B,E01026775,1221,213,1008
2021,North Norfolk 013C,E01026776,1724,201,1523
2021,North Norfolk 003D,E01026777,1262,146,1116
2021,North Norfolk 003E,E01026778,1337,102,1235
2021,North Norfolk 003F,E01026779,1333,288,1045
2021,North Norfolk 009A,E01026780,2574,404,2170
2021,North Norfolk 005C,E01026781,1970,196,1774
2021,North Norfolk 009B,E01026782,2043,280,1763
2021,North Norfolk 014C,E01026783,1782,188,1594
2021,North Norfolk 014D,E01026784,1024,155,869
2021,North Norfolk 014E,E01026785,1319,133,1186
2021,North Norfolk 013D,E01026786,1988,223,1765
2021,North Norfolk 009C,E01026787,1036,170,866
2021,North Norfolk 008C,E01026788,1190,157,1033
2021,North Norfolk 012D,E01026789,1127,166,961
2021,North Norfolk 012E,E01026790,1154,191,963
2021,Norwich 005A,E01026791,1423,387,1036
2021,Norwich 005B,E01026792,1328,260,1068
2021,Norwich 005C,E01026793,1773,629,1144
2021,Norwich 005D,E01026794,1922,421,1501
2021,Norwich 005F,E01026796,1991,1067,924
2021,Norwich 001A,E01026797,2497,510,1987
2021,Norwich 001B,E01026798,1445,308,1137
2021,Norwich 001C,E01026799,1459,317,1142
2021,Norwich 001D,E01026800,1998,416,1582
2021,Norwich 001E,E01026801,1494,222,1272
2021,Norwich 001F,E01026802,1572,297,1275
2021,Norwich 004A,E01026803,1464,307,1157
2021,Norwich 004B,E01026804,1449,306,1143
2021,Norwich 004C,E01026805,1438,327,1111
2021,Norwich 004D,E01026806,1527,121,1406
2021,Norwich 004E,E01026807,1267,304,963
2021,Norwich 004F,E01026808,1242,355,887
2021,Norwich 004G,E01026809,1418,251,1167
2021,Norwich 012A,E01026810,1555,375,1180
2021,Norwich 012B,E01026811,1530,254,1276
2021,Norwich 012C,E01026812,1545,288,1257
2021,Norwich 012D,E01026813,1377,239,1138
2021,Norwich 012E,E01026814,1585,592,993
2021,Norwich 012F,E01026815,1449,349,1100
2021,Norwich 013A,E01026816,1795,228,1567
2021,Norwich 013B,E01026817,1418,244,1174
2021,Norwich 013C,E01026818,1459,317,1142
2021,Norwich 013D,E01026819,1380,324,1056
2021,Norwich 013E,E01026820,1777,424,1353
2021,Norwich 013F,E01026821,1514,343,1171
2021,Norwich 017A,E01026823,2108,298,1810
2021,Norwich 016D,E01026824,1666,258,1408
2021,Norwich 016A,E01026825,1379,232,1147
2021,Norwich 016B,E01026826,1572,189,1383
2021,Norwich 016C,E01026827,1506,221,1285
2021,Norwich 002A,E01026828,1599,414,1185
2021,Norwich 002B,E01026829,2049,457,1592
2021,Norwich 002C,E01026830,1283,227,1056
2021,Norwich 002D,E01026831,1254,165,1089
2021,Norwich 002E,E01026832,1405,392,1013
2021,Norwich 002F,E01026833,1457,335,1122
2021,Norwich 002G,E01026834,1512,355,1157
2021,Norwich 009A,E01026835,1468,445,1023
2021,Norwich 009B,E01026836,1438,395,1043
2021,Norwich 009C,E01026837,1432,306,1126
2021,Norwich 009D,E01026838,1460,411,1049
2021,Norwich 009E,E01026839,1489,538,951
2021,Norwich 009F,E01026840,1541,353,1188
2021,Norwich 003A,E01026841,1347,190,1157
2021,Norwich 003B,E01026842,1665,244,1421
2021,Norwich 003C,E01026843,1822,308,1514
2021,Norwich 003D,E01026844,1761,378,1383
2021,Norwich 003E,E01026845,1488,194,1294
2021,Norwich 003F,E01026846,1724,296,1428
2021,Norwich 015A,E01026848,1752,287,1465
2021,Norwich 015B,E01026849,1714,184,1530
2021,Norwich 015C,E01026850,1801,244,1557
2021,Norwich 011A,E01026852,1267,196,1071
2021,Norwich 011B,E01026853,1854,286,1568
2021,Norwich 011D,E01026855,1653,334,1319
2021,Norwich 011E,E01026856,1719,482,1237
2021,Norwich 011F,E01026857,1493,348,1145
2021,Norwich 010A,E01026858,1581,661,920
2021,Norwich 010B,E01026859,1552,557,995
2021,Norwich 010C,E01026860,4441,3763,678
2021,Norwich 010D,E01026861,1678,884,794
2021,Norwich 010E,E01026862,1299,467,832
2021,Norwich 006A,E01026863,1900,686,1214
2021,Norwich 006B,E01026864,1453,284,1169
2021,Norwich 006C,E01026865,1907,620,1287
2021,Norwich 006D,E01026866,1604,310,1294
2021,Norwich 006E,E01026867,1578,562,1016
2021,Norwich 006F,E01026868,1672,742,930
2021,Norwich 006G,E01026869,1439,339,1100
2021,South Norfolk 005A,E01026870,1496,178,1318
2021,South Norfolk 005B,E01026871,1174,151,1023
2021,South Norfolk 013A,E01026872,2216,319,1897
2021,South Norfolk 014A,E01026873,1197,131,1066
2021,South Norfolk 014B,E01026874,1501,208,1293
2021,South Norfolk 006A,E01026875,1067,179,888
2021,South Norfolk 006B,E01026876,1492,214,1278
2021,South Norfolk 011A,E01026877,1503,204,1299
2021,South Norfolk 011B,E01026878,1173,216,957
2021,South Norfolk 008A,E01026879,1185,252,933
2021,South Norfolk 008B,E01026880,1394,200,1194
2021,South Norfolk 002A,E01026881,1718,378,1340
2021,South Norfolk 002C,E01026883,2075,365,1710
2021,South Norfolk 007A,E01026884,2302,469,1833
2021,South Norfolk 007B,E01026885,1544,323,1221
2021,South Norfolk 014C,E01026886,1277,159,1118
2021,South Norfolk 014D,E01026887,1520,270,1250
2021,South Norfolk 015A,E01026888,1593,226,1367
2021,South Norfolk 015B,E01026889,1494,187,1307
2021,South Norfolk 015D,E01026891,1660,228,1432
2021,South Norfolk 012A,E01026892,1223,180,1043
2021,South Norfolk 012B,E01026893,1240,141,1099
2021,South Norfolk 012C,E01026894,2455,348,2107
2021,South Norfolk 002D,E01026895,1367,268,1099
2021,South Norfolk 002E,E01026896,1103,147,956
2021,South Norfolk 011C,E01026897,2681,412,2269
2021,South Norfolk 010A,E01026898,1417,224,1193
2021,South Norfolk 010B,E01026899,1563,269,1294
2021,South Norfolk 013B,E01026900,1437,219,1218
2021,South Norfolk 013C,E01026901,1265,158,1107
2021,South Norfolk 013D,E01026902,2304,427,1877
2021,South Norfolk 012D,E01026903,1129,175,954
2021,South Norfolk 012E,E01026904,1318,225,1093
2021,South Norfolk 003A,E01026905,977,130,847
2021,South Norfolk 003B,E01026906,1674,289,1385
2021,South Norfolk 003C,E01026907,1815,328,1487
2021,South Norfolk 003D,E01026908,2312,481,1831
2021,South Norfolk 004A,E01026909,1395,181,1214
2021,South Norfolk 004B,E01026910,1546,254,1292
2021,South Norfolk 008C,E01026911,1375,232,1143
2021,South Norfolk 008D,E01026912,1623,236,1387
2021,South Norfolk 009A,E01026913,1573,257,1316
2021,South Norfolk 009B,E01026914,1858,316,1542
2021,South Norfolk 009C,E01026915,1950,388,1562
2021,South Norfolk 017A,E01026916,1984,257,1727
2021,South Norfolk 017C,E01026917,1356,190,1166
2021,South Norfolk 017B,E01026918,1590,202,1388
2021,South Norfolk 009D,E01026919,1413,239,1174
2021,South Norfolk 009E,E01026920,1150,178,972
2021,South Norfolk 005C,E01026921,1237,152,1085
2021,South Norfolk 005D,E01026922,1378,223,1155
2021,South Norfolk 016D,E01026924,1562,241,1321
2021,South Norfolk 017D,E01026925,2312,482,1830
2021,South Norfolk 006D,E01026927,1714,244,1470
2021,South Norfolk 006E,E01026928,1793,291,1502
2021,South Norfolk 008E,E01026929,1326,197,1129
2021,South Norfolk 008F,E01026930,1517,237,1280
2021,South Norfolk 015E,E01026931,1045,137,908
2021,South Norfolk 015F,E01026932,1279,214,1065
2021,South Norfolk 014E,E01026934,1001,142,859
2021,South Norfolk 014F,E01026935,1299,158,1141
2021,South Norfolk 006F,E01026936,1652,269,1383
2021,South Norfolk 006G,E01026937,1466,242,1224
2021,South Norfolk 011D,E01026938,2043,338,1705
2021,South Norfolk 011E,E01026939,1635,267,1368
2021,South Norfolk 011F,E01026940,1977,389,1588
2021,South Norfolk 009F,E01026941,1193,184,1009
2021,South Norfolk 009G,E01026942,1057,186,871
2021,South Norfolk 010C,E01026943,1470,179,1291
2021,South Norfolk 010D,E01026944,1208,201,1007
2021,South Norfolk 004C,E01026947,1362,242,1120
2021,South Norfolk 004D,E01026948,1848,777,1071
2021,North Northamptonshire 005A,E01026949,1309,175,1134
2021,North Northamptonshire 005B,E01026950,1546,335,1211
2021,North Northamptonshire 005C,E01026951,1266,269,997
2021,North Northamptonshire 005D,E01026952,1365,221,1144
2021,North Northamptonshire 009A,E01026953,1356,196,1160
2021,North Northamptonshire 009B,E01026954,1479,336,1143
2021,North Northamptonshire 009C,E01026955,1340,210,1130
2021,North Northamptonshire 009D,E01026956,2151,476,1675
2021,North Northamptonshire 006A,E01026957,1764,310,1454
2021,North Northamptonshire 006B,E01026958,1838,395,1443
2021,North Northamptonshire 007A,E01026959,1438,247,1191
2021,North Northamptonshire 007B,E01026960,1506,288,1218
2021,North Northamptonshire 007C,E01026961,1254,263,991
2021,North Northamptonshire 004A,E01026962,1367,236,1131
2021,North Northamptonshire 008A,E01026963,1261,286,975
2021,North Northamptonshire 007D,E01026965,1504,364,1140
2021,North Northamptonshire 007E,E01026966,1419,292,1127
2021,North Northamptonshire 007F,E01026967,1746,360,1386
2021,North Northamptonshire 007G,E01026968,1647,404,1243
2021,North Northamptonshire 003A,E01026969,1691,298,1393
2021,North Northamptonshire 003B,E01026970,1614,333,1281
2021,North Northamptonshire 002A,E01026971,1682,237,1445
2021,North Northamptonshire 003C,E01026972,1723,316,1407
2021,North Northamptonshire 004B,E01026973,1389,256,1133
2021,North Northamptonshire 004C,E01026974,1084,164,920
2021,North Northamptonshire 004D,E01026975,1315,238,1077
2021,North Northamptonshire 003D,E01026976,1559,322,1237
2021,North Northamptonshire 002B,E01026979,1559,272,1287
2021,North Northamptonshire 002C,E01026980,1568,232,1336
2021,North Northamptonshire 003E,E01026981,1179,173,1006
2021,North Northamptonshire 002D,E01026982,2131,488,1643
2021,North Northamptonshire 003F,E01026983,1047,171,876
2021,North Northamptonshire 004E,E01026984,1783,311,1472
2021,North Northamptonshire 004F,E01026985,1918,376,1542
2021,West Northamptonshire 016A,E01026986,2734,569,2165
2021,West Northamptonshire 010A,E01026987,1121,149,972
2021,West Northamptonshire 016B,E01026988,1481,327,1154
2021,West Northamptonshire 010B,E01026989,1291,207,1084
2021,West Northamptonshire 016C,E01026991,1534,149,1385
2021,West Northamptonshire 016D,E01026992,1940,257,1683
2021,West Northamptonshire 042A,E01026993,2004,251,1753
2021,West Northamptonshire 004A,E01026994,1073,135,938
2021,West Northamptonshire 005A,E01026998,2267,390,1877
2021,West Northamptonshire 004B,E01026999,1748,262,1486
2021,West Northamptonshire 002A,E01027000,1422,245,1177
2021,West Northamptonshire 002B,E01027001,1910,426,1484
2021,West Northamptonshire 002C,E01027002,1694,378,1316
2021,West Northamptonshire 002D,E01027003,1371,240,1131
2021,West Northamptonshire 042B,E01027004,1822,289,1533
2021,West Northamptonshire 001A,E01027005,2210,404,1806
2021,West Northamptonshire 004C,E01027006,2388,443,1945
2021,West Northamptonshire 022A,E01027007,1616,343,1273
2021,West Northamptonshire 022B,E01027008,1868,260,1608
2021,West Northamptonshire 022C,E01027009,1534,381,1153
2021,West Northamptonshire 016E,E01027010,1226,207,1019
2021,West Northamptonshire 027A,E01027011,2097,315,1782
2021,West Northamptonshire 010C,E01027012,2208,422,1786
2021,West Northamptonshire 022D,E01027013,1688,416,1272
2021,West Northamptonshire 005B,E01027015,1340,231,1109
2021,West Northamptonshire 005C,E01027016,1421,239,1182
2021,West Northamptonshire 027B,E01027017,1824,339,1485
2021,West Northamptonshire 003A,E01027018,2347,412,1935
2021,West Northamptonshire 003B,E01027019,2002,477,1525
2021,West Northamptonshire 003C,E01027020,1699,293,1406
2021,West Northamptonshire 005D,E01027021,1811,305,1506
2021,West Northamptonshire 002E,E01027022,1850,310,1540
2021,West Northamptonshire 003D,E01027023,2006,342,1664
2021,West Northamptonshire 027C,E01027024,1672,247,1425
2021,West Northamptonshire 027D,E01027025,1693,309,1384
2021,West Northamptonshire 001B,E01027026,2066,348,1718
2021,West Northamptonshire 005E,E01027027,2588,558,2030
2021,West Northamptonshire 042C,E01027028,2009,295,1714
2021,West Northamptonshire 042D,E01027029,2242,466,1776
2021,West Northamptonshire 001C,E01027030,1810,269,1541
2021,North Northamptonshire 010A,E01027031,2086,337,1749
2021,North Northamptonshire 011A,E01027032,1797,296,1501
2021,North Northamptonshire 001A,E01027033,1836,294,1542
2021,North Northamptonshire 035A,E01027034,1554,239,1315
2021,North Northamptonshire 035B,E01027035,1398,255,1143
2021,North Northamptonshire 035C,E01027037,2416,502,1914
2021,North Northamptonshire 027A,E01027038,1815,332,1483
2021,North Northamptonshire 027B,E01027039,1978,369,1609
2021,North Northamptonshire 027C,E01027040,1666,275,1391
2021,North Northamptonshire 027D,E01027041,1587,325,1262
2021,North Northamptonshire 027E,E01027042,1717,352,1365
2021,North Northamptonshire 001B,E01027043,2274,378,1896
2021,North Northamptonshire 010B,E01027044,2108,364,1744
2021,North Northamptonshire 011B,E01027045,1955,305,1650
2021,North Northamptonshire 010C,E01027046,1537,336,1201
2021,North Northamptonshire 010D,E01027047,1271,209,1062
2021,North Northamptonshire 010E,E01027048,2217,1011,1206
2021,North Northamptonshire 010F,E01027049,1011,166,845
2021,North Northamptonshire 001C,E01027050,2057,330,1727
2021,North Northamptonshire 025A,E01027051,1963,344,1619
2021,North Northamptonshire 025B,E01027052,1449,256,1193
2021,North Northamptonshire 025C,E01027053,2050,328,1722
2021,North Northamptonshire 025D,E01027054,1124,141,983
2021,North Northamptonshire 025E,E01027055,1216,199,1017
2021,North Northamptonshire 025F,E01027056,1493,299,1194
2021,North Northamptonshire 024A,E01027057,2186,379,1807
2021,North Northamptonshire 037A,E01027058,1655,343,1312
2021,North Northamptonshire 037B,E01027059,1634,257,1377
2021,North Northamptonshire 037C,E01027060,2044,390,1654
2021,North Northamptonshire 034A,E01027061,2502,491,2011
2021,North Northamptonshire 034B,E01027062,2214,417,1797
2021,North Northamptonshire 034C,E01027063,1787,301,1486
2021,North Northamptonshire 034D,E01027064,1540,227,1313
2021,North Northamptonshire 037D,E01027065,1791,271,1520
2021,North Northamptonshire 039A,E01027066,2027,388,1639
2021,North Northamptonshire 039B,E01027067,1661,245,1416
2021,North Northamptonshire 037E,E01027069,1609,211,1398
2021,North Northamptonshire 039C,E01027070,1459,223,1236
2021,North Northamptonshire 039D,E01027071,1363,213,1150
2021,North Northamptonshire 034E,E01027072,1650,455,1195
2021,North Northamptonshire 034F,E01027073,1952,343,1609
2021,North Northamptonshire 024B,E01027074,2041,354,1687
2021,North Northamptonshire 011C,E01027075,1895,370,1525
2021,North Northamptonshire 011D,E01027076,2092,341,1751
2021,North Northamptonshire 024C,E01027078,2024,295,1729
2021,North Northamptonshire 015A,E01027079,1768,324,1444
2021,North Northamptonshire 015B,E01027080,1875,333,1542
2021,North Northamptonshire 016A,E01027081,1457,331,1126
2021,North Northamptonshire 016B,E01027082,1705,362,1343
2021,North Northamptonshire 016C,E01027083,1412,298,1114
2021,North Northamptonshire 021A,E01027084,2193,438,1755
2021,North Northamptonshire 021B,E01027085,1500,283,1217
2021,North Northamptonshire 021C,E01027086,1990,422,1568
2021,North Northamptonshire 015C,E01027087,1097,183,914
2021,North Northamptonshire 015D,E01027088,1202,228,974
2021,North Northamptonshire 015E,E01027089,2123,414,1709
2021,North Northamptonshire 012A,E01027090,1634,242,1392
2021,North Northamptonshire 023A,E01027091,1820,362,1458
2021,North Northamptonshire 023B,E01027092,1835,394,1441
2021,North Northamptonshire 013A,E01027094,1504,211,1293
2021,North Northamptonshire 013B,E01027095,1533,280,1253
2021,North Northamptonshire 019A,E01027096,1116,231,885
2021,North Northamptonshire 019B,E01027097,1453,296,1157
2021,North Northamptonshire 019C,E01027098,1114,225,889
2021,North Northamptonshire 019D,E01027099,1417,213,1204
2021,North Northamptonshire 022A,E01027100,1711,320,1391
2021,North Northamptonshire 023C,E01027102,1774,287,1487
2021,North Northamptonshire 012B,E01027103,1554,239,1315
2021,North Northamptonshire 018A,E01027104,2274,380,1894
2021,North Northamptonshire 017A,E01027105,2386,418,1968
2021,North Northamptonshire 017B,E01027106,1943,378,1565
2021,North Northamptonshire 013C,E01027107,1221,194,1027
2021,North Northamptonshire 013D,E01027108,1276,189,1087
2021,North Northamptonshire 013E,E01027109,1165,206,959
2021,North Northamptonshire 017C,E01027111,2041,372,1669
2021,North Northamptonshire 017D,E01027112,2195,469,1726
2021,North Northamptonshire 018B,E01027113,2151,384,1767
2021,North Northamptonshire 022B,E01027114,1570,291,1279
2021,North Northamptonshire 018C,E01027115,1958,354,1604
2021,North Northamptonshire 018D,E01027116,2068,512,1556
2021,North Northamptonshire 018E,E01027117,1380,194,1186
2021,North Northamptonshire 020A,E01027119,1608,260,1348
2021,North Northamptonshire 021D,E01027120,1227,221,1006
2021,North Northamptonshire 021E,E01027121,2238,467,1771
2021,North Northamptonshire 019E,E01027122,1144,182,962
2021,North Northamptonshire 014A,E01027123,1567,289,1278
2021,North Northamptonshire 014B,E01027125,1714,277,1437
2021,North Northamptonshire 014C,E01027126,2276,394,1882
2021,North Northamptonshire 016D,E01027127,1843,435,1408
2021,North Northamptonshire 016E,E01027128,1693,446,1247
2021,North Northamptonshire 012C,E01027129,2180,298,1882
2021,North Northamptonshire 022C,E01027130,1797,369,1428
2021,North Northamptonshire 022D,E01027131,2134,400,1734
2021,West Northamptonshire 030A,E01027132,2074,439,1635
2021,West Northamptonshire 030B,E01027133,1862,383,1479
2021,West Northamptonshire 030C,E01027134,1782,438,1344
2021,West Northamptonshire 030D,E01027135,1721,335,1386
2021,West Northamptonshire 019A,E01027136,1621,349,1272
2021,West Northamptonshire 024A,E01027137,1533,353,1180
2021,West Northamptonshire 024B,E01027138,1496,295,1201
2021,West Northamptonshire 024C,E01027139,1505,263,1242
2021,West Northamptonshire 026A,E01027140,1682,412,1270
2021,West Northamptonshire 024D,E01027141,1997,409,1588
2021,West Northamptonshire 026B,E01027142,1527,344,1183
2021,West Northamptonshire 008A,E01027143,1507,259,1248
2021,West Northamptonshire 008B,E01027144,1455,217,1238
2021,West Northamptonshire 006A,E01027145,1501,306,1195
2021,West Northamptonshire 008C,E01027146,1461,207,1254
2021,West Northamptonshire 008D,E01027147,1948,363,1585
2021,West Northamptonshire 006B,E01027148,1379,221,1158
2021,West Northamptonshire 006C,E01027149,1301,192,1109
2021,West Northamptonshire 033A,E01027151,1788,369,1419
2021,West Northamptonshire 032A,E01027152,1791,461,1330
2021,West Northamptonshire 032B,E01027153,2129,411,1718
2021,West Northamptonshire 032C,E01027154,1982,482,1500
2021,West Northamptonshire 031A,E01027155,2351,521,1830
2021,West Northamptonshire 038A,E01027156,1312,368,944
2021,West Northamptonshire 037A,E01027158,1510,420,1090
2021,West Northamptonshire 038B,E01027159,1235,241,994
2021,West Northamptonshire 038C,E01027160,1844,400,1444
2021,West Northamptonshire 038D,E01027161,1518,356,1162
2021,West Northamptonshire 041A,E01027162,1554,325,1229
2021,West Northamptonshire 041B,E01027163,1353,227,1126
2021,West Northamptonshire 041C,E01027164,1468,288,1180
2021,West Northamptonshire 041D,E01027165,1262,252,1010
2021,West Northamptonshire 041E,E01027166,1530,289,1241
2021,West Northamptonshire 041F,E01027167,1355,249,1106
2021,West Northamptonshire 017A,E01027168,1780,500,1280
2021,West Northamptonshire 017B,E01027169,1518,336,1182
2021,West Northamptonshire 017C,E01027170,1564,400,1164
2021,West Northamptonshire 012A,E01027171,1565,311,1254
2021,West Northamptonshire 012B,E01027172,1593,318,1275
2021,West Northamptonshire 017D,E01027173,1699,462,1237
2021,West Northamptonshire 009A,E01027174,1252,196,1056
2021,West Northamptonshire 009B,E01027175,1557,352,1205
2021,West Northamptonshire 026C,E01027176,1379,244,1135
2021,West Northamptonshire 026D,E01027177,1672,451,1221
2021,West Northamptonshire 009C,E01027178,1999,582,1417
2021,West Northamptonshire 018A,E01027179,2095,480,1615
2021,West Northamptonshire 018B,E01027180,1870,390,1480
2021,West Northamptonshire 018C,E01027181,1718,274,1444
2021,West Northamptonshire 012C,E01027182,1348,219,1129
2021,West Northamptonshire 012D,E01027183,1585,267,1318
2021,West Northamptonshire 025A,E01027184,1601,291,1310
2021,West Northamptonshire 025B,E01027185,1259,232,1027
2021,West Northamptonshire 019B,E01027186,1716,394,1322
2021,West Northamptonshire 025C,E01027187,1312,233,1079
2021,West Northamptonshire 019C,E01027188,1801,425,1376
2021,West Northamptonshire 025D,E01027189,1665,333,1332
2021,West Northamptonshire 013A,E01027190,1526,221,1305
2021,West Northamptonshire 013B,E01027191,1984,397,1587
2021,West Northamptonshire 015A,E01027192,1392,326,1066
2021,West Northamptonshire 013C,E01027193,1416,205,1211
2021,West Northamptonshire 013D,E01027194,1334,189,1145
2021,West Northamptonshire 011A,E01027195,1679,447,1232
2021,West Northamptonshire 014A,E01027196,1551,393,1158
2021,West Northamptonshire 014B,E01027197,1498,365,1133
2021,West Northamptonshire 014C,E01027198,1777,464,1313
2021,West Northamptonshire 014D,E01027199,1389,447,942
2021,West Northamptonshire 009D,E01027200,1488,411,1077
2021,West Northamptonshire 037B,E01027201,2191,492,1699
2021,West Northamptonshire 037C,E01027202,1517,278,1239
2021,West Northamptonshire 044A,E01027203,1561,404,1157
2021,West Northamptonshire 044B,E01027204,1722,420,1302
2021,West Northamptonshire 044C,E01027205,2118,602,1516
2021,West Northamptonshire 028A,E01027207,1352,190,1162
2021,West Northamptonshire 023A,E01027208,1352,213,1139
2021,West Northamptonshire 023B,E01027209,1120,172,948
2021,West Northamptonshire 028B,E01027210,1123,230,893
2021,West Northamptonshire 023C,E01027211,1331,182,1149
2021,West Northamptonshire 023D,E01027212,1439,290,1149
2021,West Northamptonshire 020A,E01027213,1578,295,1283
2021,West Northamptonshire 020B,E01027214,1618,342,1276
2021,West Northamptonshire 028C,E01027215,1441,276,1165
2021,West Northamptonshire 020C,E01027216,1937,359,1578
2021,West Northamptonshire 028D,E01027217,2353,427,1926
2021,West Northamptonshire 007A,E01027218,1472,191,1281
2021,West Northamptonshire 007B,E01027219,1768,229,1539
2021,West Northamptonshire 019D,E01027220,1309,161,1148
2021,West Northamptonshire 007C,E01027221,1791,327,1464
2021,West Northamptonshire 007D,E01027222,1117,186,931
2021,West Northamptonshire 034A,E01027224,2128,383,1745
2021,West Northamptonshire 031B,E01027225,1652,436,1216
2021,West Northamptonshire 034B,E01027226,2038,439,1599
2021,West Northamptonshire 031C,E01027227,1747,403,1344
2021,West Northamptonshire 031D,E01027228,2242,506,1736
2021,West Northamptonshire 015B,E01027229,1611,421,1190
2021,West Northamptonshire 015C,E01027230,1681,462,1219
2021,West Northamptonshire 015D,E01027231,1781,399,1382
2021,West Northamptonshire 006D,E01027232,2408,835,1573
2021,West Northamptonshire 036A,E01027233,1322,407,915
2021,West Northamptonshire 036B,E01027234,1590,348,1242
2021,West Northamptonshire 036C,E01027235,1575,390,1185
2021,West Northamptonshire 033B,E01027236,1539,205,1334
2021,West Northamptonshire 033C,E01027237,1947,363,1584
2021,West Northamptonshire 033D,E01027238,1975,358,1617
2021,West Northamptonshire 021A,E01027239,1785,539,1246
2021,West Northamptonshire 020D,E01027240,1259,281,978
2021,West Northamptonshire 021B,E01027241,1775,454,1321
2021,West Northamptonshire 021C,E01027242,1652,438,1214
2021,West Northamptonshire 021D,E01027243,1673,393,1280
2021,West Northamptonshire 021E,E01027244,1601,492,1109
2021,West Northamptonshire 011B,E01027245,1588,324,1264
2021,West Northamptonshire 009E,E01027246,1839,459,1380
2021,West Northamptonshire 011C,E01027247,1681,372,1309
2021,West Northamptonshire 011D,E01027248,1582,485,1097
2021,West Northamptonshire 011E,E01027249,1750,468,1282
2021,West Northamptonshire 039A,E01027250,1295,194,1101
2021,West Northamptonshire 036D,E01027252,1507,341,1166
2021,West Northamptonshire 039B,E01027253,1724,287,1437
2021,West Northamptonshire 039C,E01027254,2035,412,1623
2021,West Northamptonshire 029A,E01027255,1501,303,1198
2021,West Northamptonshire 029B,E01027256,1476,260,1216
2021,West Northamptonshire 034C,E01027257,1265,213,1052
2021,West Northamptonshire 029C,E01027258,1290,264,1026
2021,West Northamptonshire 024E,E01027259,1524,274,1250
2021,West Northamptonshire 029D,E01027260,1531,246,1285
2021,West Northamptonshire 049A,E01027261,1979,350,1629
2021,West Northamptonshire 045A,E01027262,1665,263,1402
2021,West Northamptonshire 046A,E01027263,1785,248,1537
2021,West Northamptonshire 053A,E01027264,1393,204,1189
2021,West Northamptonshire 051A,E01027265,1410,200,1210
2021,West Northamptonshire 053B,E01027267,1091,185,906
2021,West Northamptonshire 053C,E01027268,1182,180,1002
2021,West Northamptonshire 053D,E01027269,1545,261,1284
2021,West Northamptonshire 051B,E01027270,1491,296,1195
2021,West Northamptonshire 051C,E01027271,1476,260,1216
2021,West Northamptonshire 051D,E01027272,1429,228,1201
2021,West Northamptonshire 043A,E01027273,1772,278,1494
2021,West Northamptonshire 043B,E01027274,2451,561,1890
2021,West Northamptonshire 043C,E01027275,1419,253,1166
2021,West Northamptonshire 045B,E01027277,1712,263,1449
2021,West Northamptonshire 046B,E01027279,2039,350,1689
2021,West Northamptonshire 050A,E01027280,2609,541,2068
2021,West Northamptonshire 050B,E01027281,1615,299,1316
2021,West Northamptonshire 040A,E01027282,1794,390,1404
2021,West Northamptonshire 040B,E01027283,1618,277,1341
2021,West Northamptonshire 046C,E01027284,1853,316,1537
2021,West Northamptonshire 040C,E01027285,1700,307,1393
2021,West Northamptonshire 040D,E01027286,1490,246,1244
2021,West Northamptonshire 040E,E01027287,1646,284,1362
2021,West Northamptonshire 052A,E01027288,2191,367,1824
2021,West Northamptonshire 045C,E01027289,1742,287,1455
2021,West Northamptonshire 052B,E01027290,2331,327,2004
2021,West Northamptonshire 048A,E01027291,1756,378,1378
2021,West Northamptonshire 048B,E01027292,1181,219,962
2021,West Northamptonshire 048C,E01027293,1267,241,1026
2021,West Northamptonshire 046D,E01027294,1926,377,1549
2021,West Northamptonshire 049B,E01027295,2687,548,2139
2021,West Northamptonshire 052C,E01027296,1935,301,1634
2021,West Northamptonshire 047A,E01027297,1757,282,1475
2021,West Northamptonshire 047B,E01027298,2722,458,2264
2021,West Northamptonshire 047C,E01027299,1428,238,1190
2021,West Northamptonshire 045D,E01027300,1493,300,1193
2021,West Northamptonshire 047D,E01027301,2077,360,1717
2021,West Northamptonshire 047E,E01027302,1483,272,1211
2021,West Northamptonshire 045E,E01027303,1684,336,1348
2021,West Northamptonshire 048D,E01027304,1672,230,1442
2021,West Northamptonshire 048E,E01027305,1828,299,1529
2021,West Northamptonshire 049C,E01027306,1730,252,1478
2021,West Northamptonshire 050C,E01027307,2133,372,1761
2021,West Northamptonshire 043D,E01027308,1552,246,1306
2021,North Northamptonshire 033A,E01027309,1431,202,1229
2021,North Northamptonshire 033B,E01027310,1554,487,1067
2021,North Northamptonshire 033C,E01027311,1288,197,1091
2021,North Northamptonshire 033D,E01027312,1435,295,1140
2021,North Northamptonshire 030A,E01027313,1667,290,1377
2021,North Northamptonshire 030B,E01027314,2152,345,1807
2021,North Northamptonshire 030C,E01027316,2136,449,1687
2021,North Northamptonshire 036A,E01027317,1488,305,1183
2021,North Northamptonshire 036B,E01027318,1442,432,1010
2021,North Northamptonshire 036C,E01027319,1467,305,1162
2021,North Northamptonshire 036D,E01027320,1991,487,1504
2021,North Northamptonshire 036E,E01027321,1666,377,1289
2021,North Northamptonshire 038A,E01027322,1172,181,991
2021,North Northamptonshire 038B,E01027323,1913,383,1530
2021,North Northamptonshire 038C,E01027324,1106,187,919
2021,North Northamptonshire 038D,E01027325,1817,329,1488
2021,North Northamptonshire 026A,E01027326,1507,214,1293
2021,North Northamptonshire 026B,E01027327,1477,227,1250
2021,North Northamptonshire 026C,E01027328,1359,218,1141
2021,North Northamptonshire 038E,E01027329,1719,239,1480
2021,North Northamptonshire 028A,E01027330,1688,404,1284
2021,North Northamptonshire 028B,E01027331,1442,335,1107
2021,North Northamptonshire 028C,E01027332,1514,252,1262
2021,North Northamptonshire 028D,E01027333,2150,427,1723
2021,North Northamptonshire 028E,E01027334,1397,465,932
2021,North Northamptonshire 040A,E01027335,1409,192,1217
2021,North Northamptonshire 040B,E01027336,1572,300,1272
2021,North Northamptonshire 040C,E01027337,1715,273,1442
2021,North Northamptonshire 026D,E01027338,2327,384,1943
2021,North Northamptonshire 031A,E01027339,1353,395,958
2021,North Northamptonshire 031B,E01027340,1528,326,1202
2021,North Northamptonshire 031C,E01027341,1594,422,1172
2021,North Northamptonshire 031D,E01027342,1528,296,1232
2021,North Northamptonshire 029A,E01027343,1362,225,1137
2021,North Northamptonshire 029B,E01027344,1425,217,1208
2021,North Northamptonshire 029C,E01027345,1251,249,1002
2021,North Northamptonshire 029D,E01027346,1427,264,1163
2021,North Northamptonshire 029E,E01027347,1809,332,1477
2021,North Northamptonshire 040D,E01027348,2089,348,1741
2021,North Northamptonshire 032A,E01027350,1503,219,1284
2021,North Northamptonshire 032B,E01027351,1586,282,1304
2021,North Northamptonshire 032C,E01027352,1425,239,1186
2021,North Northamptonshire 038F,E01027353,1998,232,1766
2021,North Northamptonshire 040E,E01027354,2366,454,1912
2021,North Northamptonshire 040F,E01027355,1573,286,1287
2021,Northumberland 004A,E01027356,2135,315,1820
2021,Northumberland 004B,E01027357,1256,175,1081
2021,Northumberland 005A,E01027358,1876,223,1653
2021,Northumberland 005B,E01027359,2172,415,1757
2021,Northumberland 006A,E01027361,1584,178,1406
2021,Northumberland 006B,E01027362,1693,265,1428
2021,Northumberland 006C,E01027363,1178,232,946
2021,Northumberland 006D,E01027364,1709,183,1526
2021,Northumberland 007A,E01027365,2353,322,2031
2021,Northumberland 004C,E01027366,1471,152,1319
2021,Northumberland 004D,E01027367,1600,268,1332
2021,Northumberland 007B,E01027368,1617,242,1375
2021,Northumberland 007C,E01027369,1450,158,1292
2021,Northumberland 006E,E01027370,1978,234,1744
2021,Northumberland 006F,E01027371,1716,308,1408
2021,Northumberland 006G,E01027372,2275,224,2051
2021,Northumberland 007D,E01027373,1949,236,1713
2021,Northumberland 003A,E01027374,1883,209,1674
2021,Northumberland 003B,E01027375,1753,204,1549
2021,Northumberland 001A,E01027376,1575,276,1299
2021,Northumberland 001B,E01027377,1501,119,1382
2021,Northumberland 002A,E01027378,1082,135,947
2021,Northumberland 002B,E01027379,1563,233,1330
2021,Northumberland 002C,E01027380,1268,161,1107
2021,Northumberland 003C,E01027381,1817,242,1575
2021,Northumberland 002D,E01027382,1601,168,1433
2021,Northumberland 003D,E01027383,1092,112,980
2021,Northumberland 003E,E01027384,1271,134,1137
2021,Northumberland 001C,E01027385,1188,280,908
2021,Northumberland 002E,E01027386,1319,222,1097
2021,Northumberland 001D,E01027387,1647,217,1430
2021,Northumberland 001E,E01027388,1349,289,1060
2021,Northumberland 001F,E01027389,1490,252,1238
2021,Northumberland 003F,E01027390,1880,183,1697
2021,Northumberland 024A,E01027391,1388,299,1089
2021,Northumberland 022A,E01027392,1745,263,1482
2021,Northumberland 022B,E01027393,1365,343,1022
2021,Northumberland 031A,E01027394,978,105,873
2021,Northumberland 042J,E01027395,1755,279,1476
2021,Northumberland 042H,E01027396,1188,253,935
2021,Northumberland 042I,E01027397,1303,236,1067
2021,Northumberland 029A,E01027398,2038,511,1527
2021,Northumberland 042E,E01027399,1327,228,1099
2021,Northumberland 042A,E01027400,1237,294,943
2021,Northumberland 042C,E01027401,1356,277,1079
2021,Northumberland 042B,E01027402,1204,217,987
2021,Northumberland 042D,E01027403,1068,165,903
2021,Northumberland 042F,E01027404,2107,389,1718
2021,Northumberland 042G,E01027405,1321,180,1141
2021,Northumberland 031B,E01027406,1159,114,1045
2021,Northumberland 031C,E01027407,1156,130,1026
2021,Northumberland 031D,E01027408,1293,211,1082
2021,Northumberland 029B,E01027409,1436,162,1274
2021,Northumberland 031E,E01027410,1461,219,1242
2021,Northumberland 029C,E01027411,1286,205,1081
2021,Northumberland 029D,E01027412,1906,382,1524
2021,Northumberland 029E,E01027413,2074,391,1683
2021,Northumberland 023A,E01027414,1311,218,1093
2021,Northumberland 023B,E01027415,1489,223,1266
2021,Northumberland 022C,E01027416,1449,300,1149
2021,Northumberland 030A,E01027417,1428,188,1240
2021,Northumberland 030B,E01027418,1694,312,1382
2021,Northumberland 030C,E01027419,1447,203,1244
2021,Northumberland 030D,E01027420,1247,144,1103
2021,Northumberland 030E,E01027421,1292,158,1134
2021,Northumberland 024B,E01027422,1591,273,1318
2021,Northumberland 024C,E01027423,1314,258,1056
2021,Northumberland 022D,E01027424,1788,370,1418
2021,Northumberland 025B,E01027426,1960,569,1391
2021,Northumberland 025C,E01027427,1711,261,1450
2021,Northumberland 025D,E01027428,1369,213,1156
2021,Northumberland 024D,E01027429,1680,305,1375
2021,Northumberland 024E,E01027430,1427,264,1163
2021,Northumberland 023C,E01027431,1505,242,1263
2021,Northumberland 032A,E01027432,1417,186,1231
2021,Northumberland 032B,E01027433,2374,383,1991
2021,Northumberland 032C,E01027434,1249,163,1086
2021,Northumberland 032D,E01027435,1300,170,1130
2021,Northumberland 032E,E01027436,1402,212,1190
2021,Northumberland 026A,E01027437,1565,210,1355
2021,Northumberland 026B,E01027438,1284,186,1098
2021,Northumberland 026C,E01027439,1766,318,1448
2021,Northumberland 026D,E01027440,1408,219,1189
2021,Northumberland 023E,E01027442,1490,156,1334
2021,Northumberland 008A,E01027443,1527,245,1282
2021,Northumberland 008B,E01027444,2562,188,2374
2021,Northumberland 008C,E01027445,1566,219,1347
2021,Northumberland 008D,E01027446,1274,137,1137
2021,Northumberland 015A,E01027447,1690,238,1452
2021,Northumberland 034A,E01027449,1486,205,1281
2021,Northumberland 015C,E01027450,1626,233,1393
2021,Northumberland 008E,E01027451,1598,257,1341
2021,Northumberland 016A,E01027452,1260,147,1113
2021,Northumberland 016B,E01027453,1437,151,1286
2021,Northumberland 018A,E01027455,1373,215,1158
2021,Northumberland 018B,E01027456,1179,182,997
2021,Northumberland 011A,E01027457,1629,277,1352
2021,Northumberland 018C,E01027458,2256,417,1839
2021,Northumberland 018D,E01027460,1546,263,1283
2021,Northumberland 016E,E01027461,1234,235,999
2021,Northumberland 011B,E01027462,1857,348,1509
2021,Northumberland 011C,E01027463,1717,262,1455
2021,Northumberland 033A,E01027464,1256,181,1075
2021,Northumberland 033B,E01027465,1394,212,1182
2021,Northumberland 033C,E01027466,1269,226,1043
2021,Northumberland 034B,E01027468,1256,216,1040
2021,Northumberland 034C,E01027469,1287,231,1056
2021,Northumberland 034D,E01027471,1906,404,1502
2021,Northumberland 034E,E01027472,1653,247,1406
2021,Northumberland 015D,E01027473,2539,423,2116
2021,Northumberland 008F,E01027474,1776,310,1466
2021,Northumberland 008G,E01027475,1356,146,1210
2021,Northumberland 035A,E01027476,2176,315,1861
2021,Northumberland 040A,E01027477,1160,142,1018
2021,Northumberland 040B,E01027478,1027,152,875
2021,Northumberland 019A,E01027479,2098,316,1782
2021,Northumberland 019B,E01027480,1167,168,999
2021,Northumberland 043A,E01027481,1505,168,1337
2021,Northumberland 043B,E01027482,1504,229,1275
2021,Northumberland 036A,E01027483,1273,217,1056
2021,Northumberland 037A,E01027484,2006,257,1749
2021,Northumberland 037B,E01027485,1387,220,1167
2021,Northumberland 037C,E01027486,1030,156,874
2021,Northumberland 037D,E01027487,1075,140,935
2021,Northumberland 040C,E01027488,2251,362,1889
2021,Northumberland 035B,E01027489,1430,216,1214
2021,Northumberland 035C,E01027490,1653,276,1377
2021,Northumberland 035D,E01027491,1450,206,1244
2021,Northumberland 035E,E01027492,1637,299,1338
2021,Northumberland 035F,E01027493,1466,254,1212
2021,Northumberland 035G,E01027494,2362,350,2012
2021,Northumberland 040D,E01027495,1076,157,919
2021,Northumberland 036B,E01027496,1115,179,936
2021,Northumberland 038A,E01027497,2350,488,1862
2021,Northumberland 038B,E01027498,2516,533,1983
2021,Northumberland 038C,E01027499,1806,326,1480
2021,Northumberland 038D,E01027500,1575,267,1308
2021,Northumberland 019C,E01027503,1522,187,1335
2021,Northumberland 043C,E01027504,1830,293,1537
2021,Northumberland 040E,E01027505,1321,199,1122
2021,Northumberland 043E,E01027507,1342,245,1097
2021,Northumberland 036C,E01027508,1094,176,918
2021,Northumberland 043D,E01027509,1250,192,1058
2021,Northumberland 040F,E01027510,1106,176,930
2021,Northumberland 019D,E01027511,1038,134,904
2021,Northumberland 037E,E01027512,961,125,836
2021,Northumberland 036D,E01027513,1921,353,1568
2021,Northumberland 021A,E01027514,1605,220,1385
2021,Northumberland 020A,E01027515,1421,236,1185
2021,Northumberland 021B,E01027516,1067,118,949
2021,Northumberland 020B,E01027517,1763,259,1504
2021,Northumberland 020C,E01027518,1339,293,1046
2021,Northumberland 020D,E01027519,1258,264,994
2021,Northumberland 021C,E01027520,1390,218,1172
2021,Northumberland 021D,E01027521,1747,300,1447
2021,Northumberland 021E,E01027522,1243,262,981
2021,Northumberland 021F,E01027523,1069,176,893
2021,Northumberland 041B,E01027524,1916,378,1538
2021,Northumberland 041A,E01027525,1672,243,1429
2021,Northumberland 041D,E01027526,1101,120,981
2021,Northumberland 041C,E01027527,1206,250,956
2021,Northumberland 010A,E01027528,1276,228,1048
2021,Northumberland 010B,E01027529,1015,180,835
2021,Northumberland 017A,E01027530,1281,234,1047
2021,Northumberland 017B,E01027531,1567,307,1260
2021,Northumberland 041H,E01027532,1936,236,1700
2021,Northumberland 013A,E01027533,1602,242,1360
2021,Northumberland 017C,E01027534,1686,285,1401
2021,Northumberland 017D,E01027535,1278,122,1156
2021,Northumberland 041E,E01027536,1228,170,1058
2021,Northumberland 041F,E01027537,1256,256,1000
2021,Northumberland 041G,E01027538,1568,203,1365
2021,Northumberland 010C,E01027539,1395,282,1113
2021,Northumberland 013B,E01027540,1770,362,1408
2021,Northumberland 009A,E01027541,1608,146,1462
2021,Northumberland 009B,E01027542,1621,340,1281
2021,Northumberland 009C,E01027543,1217,253,964
2021,Northumberland 009D,E01027544,1185,131,1054
2021,Northumberland 010D,E01027545,1614,350,1264
2021,Northumberland 010E,E01027546,1404,274,1130
2021,Northumberland 013E,E01027549,2660,569,2091
2021,Northumberland 020E,E01027550,1173,186,987
2021,Northumberland 020F,E01027551,1420,298,1122
2021,Northumberland 020G,E01027552,1192,165,1027
2021,Northumberland 017E,E01027553,1521,216,1305
2021,Northumberland 017F,E01027554,1256,141,1115
2021,Craven 008A,E01027555,1854,264,1590
2021,Craven 007A,E01027556,1890,353,1537
2021,Craven 009D,E01027557,1517,223,1294
2021,Craven 001A,E01027558,1849,241,1608
2021,Craven 001B,E01027559,1617,237,1380
2021,Craven 007B,E01027560,2302,404,1898
2021,Craven 009E,E01027561,1820,341,1479
2021,Craven 009C,E01027562,1501,183,1318
2021,Craven 007C,E01027563,1399,177,1222
2021,Craven 008B,E01027564,1169,181,988
2021,Craven 008C,E01027565,1503,250,1253
2021,Craven 008D,E01027566,1301,227,1074
2021,Craven 009B,E01027567,1490,194,1296
2021,Craven 003A,E01027568,2151,335,1816
2021,Craven 001C,E01027569,1323,168,1155
2021,Craven 001D,E01027570,2357,329,2028
2021,Craven 003B,E01027571,1821,294,1527
2021,Craven 003C,E01027572,1993,219,1774
2021,Craven 003D,E01027573,1666,157,1509
2021,Craven 005A,E01027574,1631,245,1386
2021,Craven 005B,E01027575,1765,218,1547
2021,Craven 009F,E01027576,1746,306,1440
2021,Craven 005C,E01027577,1869,263,1606
2021,Craven 006A,E01027578,1372,169,1203
2021,Craven 005D,E01027579,1094,203,891
2021,Craven 006B,E01027580,1044,217,827
2021,Craven 006D,E01027582,1538,264,1274
2021,Craven 008E,E01027583,1939,364,1575
2021,Craven 008F,E01027584,1843,321,1522
2021,Craven 009A,E01027585,1761,195,1566
2021,Craven 007D,E01027586,1874,267,1607
2021,Hambleton 006A,E01027587,1283,192,1091
2021,Hambleton 006B,E01027588,1630,260,1370
2021,Hambleton 006C,E01027589,1894,302,1592
2021,Hambleton 003A,E01027590,2320,346,1974
2021,Hambleton 001A,E01027591,1586,212,1374
2021,Hambleton 003B,E01027592,1654,204,1450
2021,Hambleton 006D,E01027593,1661,197,1464
2021,Hambleton 010A,E01027594,1769,296,1473
2021,Hambleton 010B,E01027595,1702,233,1469
2021,Hambleton 010C,E01027596,1607,179,1428
2021,Hambleton 001B,E01027597,1486,193,1293
2021,Hambleton 002A,E01027598,1634,179,1455
2021,Hambleton 001C,E01027599,1556,269,1287
2021,Hambleton 011A,E01027600,1820,293,1527
2021,Hambleton 010D,E01027601,1941,332,1609
2021,Hambleton 005A,E01027603,1968,257,1711
2021,Hambleton 005B,E01027604,1791,256,1535
2021,Hambleton 013D,E01027605,1438,197,1241
2021,Hambleton 012E,E01027606,1393,187,1206
2021,Hambleton 005C,E01027607,1111,108,1003
2021,Hambleton 013B,E01027608,1609,325,1284
2021,Hambleton 012D,E01027609,1246,329,917
2021,Hambleton 012C,E01027610,1516,234,1282
2021,Hambleton 013A,E01027612,1542,295,1247
2021,Hambleton 003C,E01027613,1657,241,1416
2021,Hambleton 005D,E01027614,1166,153,1013
2021,Hambleton 005E,E01027615,1122,166,956
2021,Hambleton 013C,E01027616,1388,255,1133
2021,Hambleton 003D,E01027617,1012,145,867
2021,Hambleton 002B,E01027618,2283,323,1960
2021,Hambleton 011B,E01027619,2117,387,1730
2021,Hambleton 008A,E01027620,1822,310,1512
2021,Hambleton 010E,E01027622,1878,281,1597
2021,Hambleton 001D,E01027623,1142,146,996
2021,Hambleton 002C,E01027624,1192,153,1039
2021,Hambleton 001E,E01027625,1629,264,1365
2021,Hambleton 002D,E01027626,1519,209,1310
2021,Hambleton 002E,E01027627,1683,192,1491
2021,Hambleton 007B,E01027628,1759,244,1515
2021,Hambleton 009B,E01027629,1426,279,1147
2021,Hambleton 008B,E01027630,1721,179,1542
2021,Hambleton 008C,E01027631,1323,134,1189
2021,Hambleton 008D,E01027632,1644,292,1352
2021,Hambleton 007C,E01027633,1743,261,1482
2021,Hambleton 011C,E01027634,2018,333,1685
2021,Hambleton 009C,E01027635,2508,416,2092
2021,Hambleton 009D,E01027636,1899,259,1640
2021,Hambleton 008E,E01027637,1772,224,1548
2021,Harrogate 010A,E01027638,1245,165,1080
2021,Harrogate 010B,E01027639,1181,146,1035
2021,Harrogate 010C,E01027640,1384,239,1145
2021,Harrogate 008A,E01027641,1175,205,970
2021,Harrogate 007A,E01027642,1419,249,1170
2021,Harrogate 003A,E01027643,1446,218,1228
2021,Harrogate 005A,E01027644,1372,207,1165
2021,Harrogate 005B,E01027645,1863,283,1580
2021,Harrogate 007B,E01027646,1590,284,1306
2021,Harrogate 005C,E01027647,1750,243,1507
2021,Harrogate 014A,E01027648,1431,236,1195
2021,Harrogate 013A,E01027649,2013,342,1671
2021,Harrogate 014B,E01027650,1490,268,1222
2021,Harrogate 013B,E01027651,1387,329,1058
2021,Harrogate 015A,E01027652,1659,280,1379
2021,Harrogate 020A,E01027653,1656,338,1318
2021,Harrogate 020B,E01027654,1106,189,917
2021,Harrogate 015B,E01027655,1275,196,1079
2021,Harrogate 019A,E01027656,1660,143,1517
2021,Harrogate 013C,E01027657,1142,170,972
2021,Harrogate 013D,E01027658,1437,185,1252
2021,Harrogate 015C,E01027659,1640,153,1487
2021,Harrogate 017A,E01027660,1419,249,1170
2021,Harrogate 017B,E01027661,1344,245,1099
2021,Harrogate 017C,E01027662,1157,247,910
2021,Harrogate 017D,E01027663,1298,189,1109
2021,Harrogate 008C,E01027665,1259,201,1058
2021,Harrogate 001A,E01027666,1721,291,1430
2021,Harrogate 001B,E01027667,1411,274,1137
2021,Harrogate 009A,E01027668,1454,234,1220
2021,Harrogate 009B,E01027669,1854,260,1594
2021,Harrogate 012A,E01027670,1481,252,1229
2021,Harrogate 012B,E01027671,1463,245,1218
2021,Harrogate 012C,E01027672,1553,222,1331
2021,Harrogate 009C,E01027673,1676,184,1492
2021,Harrogate 007C,E01027674,1254,186,1068
2021,Harrogate 007D,E01027675,2810,609,2201
2021,Harrogate 009D,E01027676,1677,404,1273
2021,Harrogate 015D,E01027677,1379,148,1231
2021,Harrogate 015E,E01027678,1700,162,1538
2021,Harrogate 019B,E01027679,1467,198,1269
2021,Harrogate 015F,E01027680,1238,130,1108
2021,Harrogate 006A,E01027681,1568,234,1334
2021,Harrogate 018A,E01027682,1591,265,1326
2021,Harrogate 016A,E01027683,1679,286,1393
2021,Harrogate 016B,E01027684,1367,246,1121
2021,Harrogate 001C,E01027685,1077,134,943
2021,Harrogate 001D,E01027686,1081,178,903
2021,Harrogate 005D,E01027687,1820,269,1551
2021,Harrogate 003B,E01027688,1550,242,1308
2021,Harrogate 011A,E01027689,1281,232,1049
2021,Harrogate 010D,E01027690,1314,171,1143
2021,Harrogate 011B,E01027691,1436,255,1181
2021,Harrogate 013E,E01027692,1089,165,924
2021,Harrogate 006B,E01027693,1709,249,1460
2021,Harrogate 018B,E01027694,1121,179,942
2021,Harrogate 016C,E01027695,1639,278,1361
2021,Harrogate 016D,E01027696,2326,990,1336
2021,Harrogate 017E,E01027697,1365,286,1079
2021,Harrogate 020C,E01027698,1481,301,1180
2021,Harrogate 021A,E01027699,1264,259,1005
2021,Harrogate 021B,E01027700,1499,249,1250
2021,Harrogate 006C,E01027701,1492,221,1271
2021,Harrogate 006D,E01027702,1028,153,875
2021,Harrogate 016E,E01027703,1949,302,1647
2021,Harrogate 012D,E01027704,1178,193,985
2021,Harrogate 004A,E01027705,1700,318,1382
2021,Harrogate 004B,E01027706,1706,225,1481
2021,Harrogate 004C,E01027707,1649,234,1415
2021,Harrogate 004D,E01027708,1359,203,1156
2021,Harrogate 004E,E01027709,1176,176,1000
2021,Harrogate 004F,E01027710,1078,189,889
2021,Harrogate 004G,E01027711,1239,248,991
2021,Harrogate 002A,E01027712,1811,346,1465
2021,Harrogate 002B,E01027713,1564,227,1337
2021,Harrogate 002C,E01027714,1563,234,1329
2021,Harrogate 002D,E01027715,1071,306,765
2021,Harrogate 020D,E01027716,1443,299,1144
2021,Harrogate 020E,E01027717,1505,342,1163
2021,Harrogate 020F,E01027718,1935,453,1482
2021,Harrogate 020G,E01027719,1456,323,1133
2021,Harrogate 011C,E01027720,1720,364,1356
2021,Harrogate 011D,E01027721,1350,223,1127
2021,Harrogate 008D,E01027722,1407,280,1127
2021,Harrogate 011E,E01027723,1381,222,1159
2021,Harrogate 021C,E01027724,1621,303,1318
2021,Harrogate 021D,E01027725,1471,268,1203
2021,Harrogate 014C,E01027726,1643,273,1370
2021,Harrogate 014D,E01027727,1678,222,1456
2021,Harrogate 014E,E01027728,1274,179,1095
2021,Harrogate 014F,E01027729,1374,268,1106
2021,Harrogate 019C,E01027730,1444,267,1177
2021,Harrogate 019D,E01027731,1376,296,1080
2021,Harrogate 019E,E01027732,1188,230,958
2021,Harrogate 017F,E01027733,1296,267,1029
2021,Harrogate 018C,E01027734,1625,272,1353
2021,Harrogate 018D,E01027735,1539,209,1330
2021,Harrogate 003C,E01027736,1582,259,1323
2021,Harrogate 003D,E01027737,1569,323,1246
2021,Harrogate 010E,E01027738,1186,195,991
2021,Harrogate 010F,E01027739,968,166,802
2021,Harrogate 013F,E01027740,1473,148,1325
2021,Harrogate 010G,E01027741,1310,232,1078
2021,Richmondshire 005A,E01027742,1270,156,1114
2021,Richmondshire 001A,E01027743,1143,164,979
2021,Richmondshire 006A,E01027744,1228,130,1098
2021,Richmondshire 003A,E01027745,1602,287,1315
2021,Richmondshire 003B,E01027746,1387,199,1188
2021,Richmondshire 003C,E01027747,1447,204,1243
2021,Richmondshire 003D,E01027748,1121,190,931
2021,Richmondshire 004A,E01027749,1813,383,1430
2021,Richmondshire 001B,E01027751,1246,213,1033
2021,Richmondshire 001C,E01027752,1154,150,1004
2021,Richmondshire 005B,E01027753,1186,139,1047
2021,Richmondshire 006B,E01027756,1712,328,1384
2021,Richmondshire 006D,E01027758,1447,260,1187
2021,Richmondshire 001D,E01027759,1348,167,1181
2021,Richmondshire 006E,E01027760,1158,140,1018
2021,Richmondshire 001E,E01027761,1077,143,934
2021,Richmondshire 001F,E01027762,1290,183,1107
2021,Richmondshire 005C,E01027763,1030,85,945
2021,Richmondshire 005D,E01027764,1048,100,948
2021,Richmondshire 002A,E01027765,1522,284,1238
2021,Richmondshire 002B,E01027766,1155,142,1013
2021,Richmondshire 002C,E01027767,1393,263,1130
2021,Richmondshire 002D,E01027768,1094,199,895
2021,Richmondshire 002E,E01027769,1159,162,997
2021,Richmondshire 002F,E01027770,1463,145,1318
2021,Richmondshire 004E,E01027771,2344,307,2037
2021,Richmondshire 004F,E01027772,1231,149,1082
2021,Richmondshire 005E,E01027773,1033,105,928
2021,Ryedale 007A,E01027774,1840,299,1541
2021,Ryedale 003A,E01027775,1923,533,1390
2021,Ryedale 001A,E01027776,1494,188,1306
2021,Ryedale 001B,E01027777,1263,134,1129
2021,Ryedale 007B,E01027778,2154,276,1878
2021,Ryedale 004A,E01027779,1070,165,905
2021,Ryedale 003B,E01027780,2058,309,1749
2021,Ryedale 003C,E01027781,1205,129,1076
2021,Ryedale 007C,E01027782,1632,198,1434
2021,Ryedale 001C,E01027783,1773,218,1555
2021,Ryedale 001D,E01027784,1593,271,1322
2021,Ryedale 010A,E01027786,1538,213,1325
2021,Ryedale 009A,E01027787,1790,310,1480
2021,Ryedale 010B,E01027788,1508,219,1289
2021,Ryedale 010D,E01027790,1823,278,1545
2021,Ryedale 010C,E01027791,1579,271,1308
2021,Ryedale 002A,E01027792,2153,240,1913
2021,Ryedale 002B,E01027793,1393,197,1196
2021,Ryedale 002C,E01027794,1915,258,1657
2021,Ryedale 002D,E01027795,1523,244,1279
2021,Ryedale 004B,E01027796,1763,266,1497
2021,Ryedale 007D,E01027797,1630,273,1357
2021,Ryedale 004C,E01027798,1933,313,1620
2021,Ryedale 007E,E01027799,1681,230,1451
2021,Ryedale 003D,E01027800,1659,229,1430
2021,Ryedale 002E,E01027801,1692,217,1475
2021,Ryedale 002F,E01027802,1555,174,1381
2021,Ryedale 004D,E01027803,1763,284,1479
2021,Scarborough 010A,E01027804,1426,157,1269
2021,Scarborough 006A,E01027805,1225,141,1084
2021,Scarborough 006B,E01027806,1569,262,1307
2021,Scarborough 011A,E01027807,1465,200,1265
2021,Scarborough 011B,E01027808,1548,201,1347
2021,Scarborough 011C,E01027809,1192,91,1101
2021,Scarborough 008A,E01027810,1437,315,1122
2021,Scarborough 008B,E01027811,1395,295,1100
2021,Scarborough 008C,E01027812,1654,323,1331
2021,Scarborough 002A,E01027813,1814,195,1619
2021,Scarborough 013A,E01027814,1611,247,1364
2021,Scarborough 013B,E01027815,1344,239,1105
2021,Scarborough 013C,E01027816,1622,257,1365
2021,Scarborough 012A,E01027817,1381,293,1088
2021,Scarborough 011D,E01027818,1800,337,1463
2021,Scarborough 012B,E01027819,2107,555,1552
2021,Scarborough 012C,E01027820,1322,394,928
2021,Scarborough 004A,E01027821,1385,153,1232
2021,Scarborough 002B,E01027822,1330,198,1132
2021,Scarborough 004B,E01027823,1352,159,1193
2021,Scarborough 009A,E01027824,1484,196,1288
2021,Scarborough 009B,E01027825,1992,414,1578
2021,Scarborough 009C,E01027826,1338,223,1115
2021,Scarborough 014A,E01027827,1495,141,1354
2021,Scarborough 014B,E01027828,1995,278,1717
2021,Scarborough 014C,E01027829,1342,95,1247
2021,Scarborough 014D,E01027830,1590,279,1311
2021,Scarborough 014E,E01027833,1495,188,1307
2021,Scarborough 014F,E01027834,1530,169,1361
2021,Scarborough 014G,E01027835,1703,268,1435
2021,Scarborough 004E,E01027836,2105,307,1798
2021,Scarborough 001A,E01027837,1252,193,1059
2021,Scarborough 003A,E01027838,1530,196,1334
2021,Scarborough 001B,E01027839,1824,307,1517
2021,Scarborough 002C,E01027840,1896,275,1621
2021,Scarborough 002D,E01027841,1248,170,1078
2021,Scarborough 005A,E01027842,1564,277,1287
2021,Scarborough 005B,E01027843,1407,283,1124
2021,Scarborough 005C,E01027844,1437,200,1237
2021,Scarborough 005D,E01027845,1622,249,1373
2021,Scarborough 006D,E01027847,1632,192,1440
2021,Scarborough 007A,E01027849,1100,133,967
2021,Scarborough 007B,E01027850,1223,258,965
2021,Scarborough 008D,E01027851,1354,234,1120
2021,Scarborough 010B,E01027852,1433,140,1293
2021,Scarborough 010C,E01027853,1095,101,994
2021,Scarborough 010D,E01027854,1277,104,1173
2021,Scarborough 005E,E01027855,1771,290,1481
2021,Scarborough 005F,E01027856,1195,106,1089
2021,Scarborough 004F,E01027857,1207,204,1003
2021,Scarborough 012D,E01027858,1299,177,1122
2021,Scarborough 013D,E01027859,1666,260,1406
2021,Scarborough 012E,E01027860,1512,284,1228
2021,Scarborough 009D,E01027861,1309,215,1094
2021,Scarborough 008E,E01027862,1468,228,1240
2021,Scarborough 009E,E01027863,1326,164,1162
2021,Scarborough 003B,E01027864,1351,267,1084
2021,Scarborough 003C,E01027865,1112,125,987
2021,Scarborough 003D,E01027866,1935,363,1572
2021,Scarborough 011E,E01027867,1355,160,1195
2021,Scarborough 010E,E01027868,2180,203,1977
2021,Scarborough 001E,E01027871,1516,221,1295
2021,Scarborough 007C,E01027872,1302,271,1031
2021,Scarborough 009F,E01027873,1353,180,1173
2021,Scarborough 007D,E01027874,1635,490,1145
2021,Selby 002A,E01027875,1875,360,1515
2021,Selby 003A,E01027876,1499,249,1250
2021,Selby 003B,E01027877,1778,304,1474
2021,Selby 005A,E01027878,1172,198,974
2021,Selby 007A,E01027879,1184,159,1025
2021,Selby 007B,E01027880,1420,230,1190
2021,Selby 006A,E01027881,1716,299,1417
2021,Selby 007C,E01027882,1694,286,1408
2021,Selby 008A,E01027883,1004,167,837
2021,Selby 008B,E01027884,1570,269,1301
2021,Selby 008C,E01027885,1672,277,1395
2021,Selby 002B,E01027886,1373,245,1128
2021,Selby 002C,E01027887,1494,241,1253
2021,Selby 002D,E01027888,1828,385,1443
2021,Selby 010A,E01027889,1678,261,1417
2021,Selby 010B,E01027890,2284,381,1903
2021,Selby 009A,E01027891,1601,214,1387
2021,Selby 009B,E01027892,1719,270,1449
2021,Selby 009C,E01027893,2087,352,1735
2021,Selby 007D,E01027894,2584,477,2107
2021,Selby 007E,E01027895,1367,137,1230
2021,Selby 008D,E01027896,1906,354,1552
2021,Selby 008E,E01027897,2112,310,1802
2021,Selby 009D,E01027899,1634,306,1328
2021,Selby 003C,E01027900,1885,337,1548
2021,Selby 003D,E01027901,1680,269,1411
2021,Selby 003E,E01027902,1371,229,1142
2021,Selby 003F,E01027903,1156,306,850
2021,Selby 002E,E01027904,2387,482,1905
2021,Selby 006B,E01027906,1481,308,1173
2021,Selby 005C,E01027907,1330,333,997
2021,Selby 005D,E01027908,1497,211,1286
2021,Selby 005E,E01027909,2094,261,1833
2021,Selby 006E,E01027913,1133,172,961
2021,Selby 004B,E01027914,1483,198,1285
2021,Selby 004C,E01027915,1922,318,1604
2021,Selby 004D,E01027916,1522,226,1296
2021,Selby 001A,E01027918,1392,255,1137
2021,Selby 001B,E01027919,1088,183,905
2021,Selby 001C,E01027920,1044,137,907
2021,Selby 001D,E01027921,1668,220,1448
2021,Selby 001E,E01027922,1941,369,1572
2021,Selby 010C,E01027923,2212,308,1904
2021,Selby 010D,E01027924,2206,437,1769
2021,Ashfield 015A,E01027925,2105,401,1704
2021,Ashfield 016A,E01027926,1412,202,1210
2021,Ashfield 014A,E01027927,2041,315,1726
2021,Ashfield 014B,E01027928,1935,315,1620
2021,Ashfield 016B,E01027930,1642,319,1323
2021,Ashfield 014C,E01027932,2155,461,1694
2021,Ashfield 014D,E01027933,1429,266,1163
2021,Ashfield 013C,E01027934,1245,219,1026
2021,Ashfield 013D,E01027935,1158,214,944
2021,Ashfield 013E,E01027936,1372,183,1189
2021,Ashfield 014E,E01027937,1249,198,1051
2021,Ashfield 015B,E01027938,1167,206,961
2021,Ashfield 016C,E01027939,1437,324,1113
2021,Ashfield 015C,E01027940,1246,202,1044
2021,Ashfield 016D,E01027941,1204,170,1034
2021,Ashfield 016E,E01027942,2564,587,1977
2021,Ashfield 015D,E01027943,1365,205,1160
2021,Ashfield 015E,E01027944,1399,209,1190
2021,Ashfield 012A,E01027945,1578,226,1352
2021,Ashfield 012B,E01027946,1334,184,1150
2021,Ashfield 009A,E01027947,1581,271,1310
2021,Ashfield 009B,E01027948,2061,351,1710
2021,Ashfield 007A,E01027949,1388,225,1163
2021,Ashfield 009C,E01027950,2211,361,1850
2021,Ashfield 007B,E01027951,1493,387,1106
2021,Ashfield 008A,E01027952,1718,327,1391
2021,Ashfield 007C,E01027953,1461,242,1219
2021,Ashfield 007D,E01027954,1540,307,1233
2021,Ashfield 008B,E01027955,1189,235,954
2021,Ashfield 008C,E01027956,1447,317,1130
2021,Ashfield 009D,E01027957,1244,226,1018
2021,Ashfield 008D,E01027958,1421,368,1053
2021,Ashfield 009E,E01027959,1873,370,1503
2021,Ashfield 011A,E01027960,1481,219,1262
2021,Ashfield 011B,E01027961,1780,243,1537
2021,Ashfield 011C,E01027962,1420,232,1188
2021,Ashfield 011D,E01027963,1604,333,1271
2021,Ashfield 005A,E01027964,1397,278,1119
2021,Ashfield 005B,E01027965,1392,306,1086
2021,Ashfield 003A,E01027966,1278,240,1038
2021,Ashfield 004A,E01027967,1598,310,1288
2021,Ashfield 005C,E01027968,1134,182,952
2021,Ashfield 006A,E01027969,1243,214,1029
2021,Ashfield 002A,E01027970,1285,169,1116
2021,Ashfield 002B,E01027971,1304,193,1111
2021,Ashfield 004B,E01027972,2266,464,1802
2021,Ashfield 007E,E01027973,1495,254,1241
2021,Ashfield 005D,E01027974,1433,321,1112
2021,Ashfield 006B,E01027975,1519,258,1261
2021,Ashfield 005E,E01027976,1908,316,1592
2021,Ashfield 004C,E01027977,2010,412,1598
2021,Ashfield 004D,E01027978,1753,339,1414
2021,Ashfield 001A,E01027979,1495,172,1323
2021,Ashfield 001B,E01027980,1470,305,1165
2021,Ashfield 001C,E01027981,1546,194,1352
2021,Ashfield 002C,E01027982,1320,201,1119
2021,Ashfield 001D,E01027983,1450,297,1153
2021,Ashfield 002D,E01027984,1405,242,1163
2021,Ashfield 004E,E01027985,2004,386,1618
2021,Ashfield 003B,E01027986,1271,231,1040
2021,Ashfield 003C,E01027987,2080,483,1597
2021,Ashfield 006C,E01027988,1399,208,1191
2021,Ashfield 006D,E01027989,1527,185,1342
2021,Ashfield 003D,E01027990,1693,243,1450
2021,Ashfield 006E,E01027991,1152,189,963
2021,Ashfield 006F,E01027992,2499,512,1987
2021,Ashfield 012C,E01027993,1414,208,1206
2021,Ashfield 012D,E01027994,1326,155,1171
2021,Ashfield 010A,E01027995,1436,193,1243
2021,Ashfield 010B,E01027996,1873,311,1562
2021,Ashfield 010C,E01027997,2257,360,1897
2021,Ashfield 010D,E01027998,1730,276,1454
2021,Bassetlaw 002A,E01027999,2386,409,1977
2021,Bassetlaw 001A,E01028000,2224,282,1942
2021,Bassetlaw 004A,E01028001,1261,288,973
2021,Bassetlaw 004B,E01028002,1276,177,1099
2021,Bassetlaw 004C,E01028003,1344,208,1136
2021,Bassetlaw 004D,E01028004,1487,166,1321
2021,Bassetlaw 002B,E01028005,1767,237,1530
2021,Bassetlaw 015A,E01028006,1241,193,1048
2021,Bassetlaw 015B,E01028007,1179,226,953
2021,Bassetlaw 008A,E01028008,1255,276,979
2021,Bassetlaw 008B,E01028009,1274,132,1142
2021,Bassetlaw 008C,E01028010,1515,242,1273
2021,Bassetlaw 008D,E01028011,1479,223,1256
2021,Bassetlaw 008E,E01028012,1256,175,1081
2021,Bassetlaw 005A,E01028013,1845,292,1553
2021,Bassetlaw 005B,E01028014,1413,216,1197
2021,Bassetlaw 005C,E01028015,1518,217,1301
2021,Bassetlaw 005D,E01028016,1300,179,1121
2021,Bassetlaw 010A,E01028017,2282,478,1804
2021,Bassetlaw 010B,E01028018,1317,179,1138
2021,Bassetlaw 010C,E01028019,1321,277,1044
2021,Bassetlaw 010D,E01028020,1688,256,1432
2021,Bassetlaw 010E,E01028021,1659,325,1334
2021,Bassetlaw 008F,E01028022,1543,297,1246
2021,Bassetlaw 003A,E01028023,2414,372,2042
2021,Bassetlaw 001B,E01028024,1924,298,1626
2021,Bassetlaw 001C,E01028025,1307,222,1085
2021,Bassetlaw 001D,E01028026,1437,266,1171
2021,Bassetlaw 001E,E01028027,1572,289,1283
2021,Bassetlaw 001F,E01028028,2048,425,1623
2021,Bassetlaw 004E,E01028029,1286,217,1069
2021,Bassetlaw 004F,E01028030,1152,220,932
2021,Bassetlaw 002C,E01028031,1108,182,926
2021,Bassetlaw 002D,E01028032,1320,199,1121
2021,Bassetlaw 015C,E01028033,2231,305,1926
2021,Bassetlaw 003B,E01028034,2297,381,1916
2021,Bassetlaw 002E,E01028035,2276,367,1909
2021,Bassetlaw 003C,E01028036,2842,230,2612
2021,Bassetlaw 015D,E01028037,1713,302,1411
2021,Bassetlaw 015E,E01028038,1468,296,1172
2021,Bassetlaw 015F,E01028039,1235,171,1064
2021,Bassetlaw 016E,E01028042,1319,203,1116
2021,Bassetlaw 014C,E01028043,1379,202,1177
2021,Bassetlaw 016F,E01028044,1567,296,1271
2021,Bassetlaw 016G,E01028045,1803,309,1494
2021,Bassetlaw 006A,E01028046,1470,237,1233
2021,Bassetlaw 006B,E01028047,2692,583,2109
2021,Bassetlaw 006C,E01028048,1559,335,1224
2021,Bassetlaw 006D,E01028049,1690,335,1355
2021,Bassetlaw 006E,E01028050,1755,368,1387
2021,Bassetlaw 016A,E01028051,1367,131,1236
2021,Bassetlaw 016B,E01028052,1589,261,1328
2021,Bassetlaw 016C,E01028053,1482,208,1274
2021,Bassetlaw 016D,E01028054,1417,226,1191
2021,Bassetlaw 009A,E01028055,1547,212,1335
2021,Bassetlaw 009B,E01028056,1341,239,1102
2021,Bassetlaw 012A,E01028057,1219,201,1018
2021,Bassetlaw 009C,E01028058,2064,373,1691
2021,Bassetlaw 009D,E01028059,1685,398,1287
2021,Bassetlaw 013A,E01028060,1816,264,1552
2021,Bassetlaw 013B,E01028061,1352,212,1140
2021,Bassetlaw 013C,E01028062,1962,251,1711
2021,Bassetlaw 014D,E01028063,1628,231,1397
2021,Bassetlaw 014E,E01028064,1217,234,983
2021,Bassetlaw 012B,E01028065,1661,431,1230
2021,Bassetlaw 012C,E01028066,1650,370,1280
2021,Bassetlaw 013D,E01028067,1471,268,1203
2021,Bassetlaw 012D,E01028068,1759,243,1516
2021,Broxtowe 014A,E01028069,1063,151,912
2021,Broxtowe 014B,E01028070,1036,138,898
2021,Broxtowe 011A,E01028073,1598,396,1202
2021,Broxtowe 011B,E01028074,1990,833,1157
2021,Broxtowe 011C,E01028075,1600,558,1042
2021,Broxtowe 009A,E01028076,1194,201,993
2021,Broxtowe 009B,E01028077,1368,336,1032
2021,Broxtowe 009C,E01028078,1578,393,1185
2021,Broxtowe 009D,E01028079,1942,1106,836
2021,Broxtowe 012A,E01028080,1678,296,1382
2021,Broxtowe 012B,E01028081,1049,143,906
2021,Broxtowe 012C,E01028082,1145,203,942
2021,Broxtowe 012D,E01028083,1252,241,1011
2021,Broxtowe 009E,E01028084,1659,323,1336
2021,Broxtowe 011D,E01028085,2085,593,1492
2021,Broxtowe 011E,E01028086,1488,201,1287
2021,Broxtowe 007A,E01028087,1528,248,1280
2021,Broxtowe 007B,E01028088,1399,232,1167
2021,Broxtowe 007C,E01028089,1249,235,1014
2021,Broxtowe 007D,E01028090,1305,218,1087
2021,Broxtowe 007E,E01028091,1466,264,1202
2021,Broxtowe 001A,E01028092,1233,228,1005
2021,Broxtowe 001B,E01028093,974,121,853
2021,Broxtowe 014C,E01028094,1691,297,1394
2021,Broxtowe 014D,E01028095,1373,270,1103
2021,Broxtowe 014E,E01028096,1929,317,1612
2021,Broxtowe 013A,E01028097,1309,165,1144
2021,Broxtowe 013B,E01028098,1424,311,1113
2021,Broxtowe 013C,E01028099,1249,179,1070
2021,Broxtowe 013D,E01028100,1730,288,1442
2021,Broxtowe 013E,E01028101,1426,370,1056
2021,Broxtowe 004A,E01028102,1263,220,1043
2021,Broxtowe 004B,E01028103,1042,172,870
2021,Broxtowe 004C,E01028104,1500,227,1273
2021,Broxtowe 016A,E01028105,1122,219,903
2021,Broxtowe 016B,E01028106,1342,186,1156
2021,Broxtowe 001C,E01028107,1431,221,1210
2021,Broxtowe 001D,E01028108,1344,186,1158
2021,Broxtowe 003A,E01028109,1651,230,1421
2021,Broxtowe 002A,E01028110,1550,360,1190
2021,Broxtowe 002B,E01028111,1412,196,1216
2021,Broxtowe 002C,E01028112,1540,257,1283
2021,Broxtowe 002D,E01028113,1376,285,1091
2021,Broxtowe 001E,E01028114,1412,207,1205
2021,Broxtowe 003B,E01028115,1544,199,1345
2021,Broxtowe 003C,E01028116,1608,246,1362
2021,Broxtowe 003D,E01028117,1497,279,1218
2021,Broxtowe 003E,E01028118,1598,179,1419
2021,Broxtowe 016C,E01028119,1931,385,1546
2021,Broxtowe 016D,E01028120,1636,284,1352
2021,Broxtowe 016E,E01028121,1374,259,1115
2021,Broxtowe 004D,E01028122,1521,249,1272
2021,Broxtowe 004E,E01028123,1794,334,1460
2021,Broxtowe 004F,E01028124,1564,246,1318
2021,Broxtowe 008A,E01028125,1751,278,1473
2021,Broxtowe 008B,E01028126,1243,244,999
2021,Broxtowe 008C,E01028127,1468,283,1185
2021,Broxtowe 010A,E01028128,1650,248,1402
2021,Broxtowe 010B,E01028129,1473,275,1198
2021,Broxtowe 010C,E01028130,1815,357,1458
2021,Broxtowe 010D,E01028131,1454,291,1163
2021,Broxtowe 010E,E01028132,1035,237,798
2021,Broxtowe 010F,E01028133,1360,228,1132
2021,Broxtowe 008D,E01028134,1343,251,1092
2021,Broxtowe 015A,E01028135,1334,268,1066
2021,Broxtowe 015B,E01028136,1601,354,1247
2021,Broxtowe 015C,E01028137,2341,447,1894
2021,Broxtowe 015D,E01028138,1133,153,980
2021,Broxtowe 015E,E01028139,1353,275,1078
2021,Gedling 016A,E01028142,2117,363,1754
2021,Gedling 004A,E01028143,1292,258,1034
2021,Gedling 006A,E01028144,1418,276,1142
2021,Gedling 016B,E01028146,1349,201,1148
2021,Gedling 016C,E01028147,1008,236,772
2021,Gedling 008A,E01028148,2345,407,1938
2021,Gedling 008B,E01028149,1557,296,1261
2021,Gedling 002A,E01028150,1294,164,1130
2021,Gedling 002B,E01028151,1065,170,895
2021,Gedling 002C,E01028152,1730,298,1432
2021,Gedling 002D,E01028153,1258,261,997
2021,Gedling 002E,E01028154,1571,300,1271
2021,Gedling 014A,E01028155,1330,229,1101
2021,Gedling 014B,E01028156,1297,211,1086
2021,Gedling 014C,E01028157,1212,218,994
2021,Gedling 014D,E01028158,1581,248,1333
2021,Gedling 014E,E01028159,1262,254,1008
2021,Gedling 013A,E01028160,1397,239,1158
2021,Gedling 013B,E01028161,1442,314,1128
2021,Gedling 013C,E01028162,1482,313,1169
2021,Gedling 013D,E01028163,1410,228,1182
2021,Gedling 014F,E01028164,1202,205,997
2021,Gedling 006B,E01028165,1441,244,1197
2021,Gedling 006C,E01028166,1667,358,1309
2021,Gedling 006D,E01028167,1815,351,1464
2021,Gedling 012A,E01028168,1223,189,1034
2021,Gedling 012B,E01028169,1347,217,1130
2021,Gedling 012C,E01028170,1434,262,1172
2021,Gedling 012D,E01028171,1279,202,1077
2021,Gedling 011A,E01028172,2017,391,1626
2021,Gedling 005A,E01028173,971,262,709
2021,Gedling 005B,E01028174,1567,381,1186
2021,Gedling 005C,E01028175,1673,280,1393
2021,Gedling 009A,E01028176,1411,247,1164
2021,Gedling 009B,E01028177,1483,225,1258
2021,Gedling 008C,E01028178,2396,385,2011
2021,Gedling 007A,E01028179,1300,204,1096
2021,Gedling 007B,E01028180,1416,213,1203
2021,Gedling 007C,E01028181,1379,191,1188
2021,Gedling 007D,E01028182,1434,245,1189
2021,Gedling 007E,E01028183,1208,174,1034
2021,Gedling 015A,E01028184,1069,168,901
2021,Gedling 015B,E01028185,1706,322,1384
2021,Gedling 015C,E01028186,1440,225,1215
2021,Gedling 015D,E01028187,1293,253,1040
2021,Gedling 015E,E01028188,1327,236,1091
2021,Gedling 001A,E01028189,2537,445,2092
2021,Gedling 011B,E01028190,1473,251,1222
2021,Gedling 012E,E01028191,1625,333,1292
2021,Gedling 012F,E01028192,1464,301,1163
2021,Gedling 010A,E01028193,1445,229,1216
2021,Gedling 010B,E01028194,1362,215,1147
2021,Gedling 010C,E01028195,1323,213,1110
2021,Gedling 010D,E01028196,1310,244,1066
2021,Gedling 010E,E01028197,1301,206,1095
2021,Gedling 001B,E01028198,1366,208,1158
2021,Gedling 001C,E01028199,1419,182,1237
2021,Gedling 001D,E01028200,1760,319,1441
2021,Gedling 001E,E01028201,1114,176,938
2021,Gedling 011C,E01028202,1383,193,1190
2021,Gedling 011D,E01028203,1270,228,1042
2021,Gedling 010F,E01028204,1243,185,1058
2021,Gedling 004B,E01028205,1663,356,1307
2021,Gedling 004C,E01028206,1340,212,1128
2021,Gedling 004D,E01028207,1583,284,1299
2021,Gedling 004E,E01028208,1048,167,881
2021,Gedling 005D,E01028209,1342,287,1055
2021,Gedling 014G,E01028210,1352,214,1138
2021,Gedling 013E,E01028211,1264,228,1036
2021,Gedling 011E,E01028212,1556,344,1212
2021,Gedling 002F,E01028213,1843,244,1599
2021,Gedling 009C,E01028214,1346,231,1115
2021,Gedling 009D,E01028215,1268,291,977
2021,Gedling 009E,E01028216,1219,205,1014
2021,Gedling 009F,E01028217,1335,212,1123
2021,Gedling 009G,E01028218,1521,274,1247
2021,Mansfield 013A,E01028219,1432,207,1225
2021,Mansfield 013B,E01028220,1725,295,1430
2021,Mansfield 013D,E01028222,2393,381,2012
2021,Mansfield 002A,E01028223,1338,254,1084
2021,Mansfield 001A,E01028224,1345,206,1139
2021,Mansfield 002B,E01028225,1473,224,1249
2021,Mansfield 002C,E01028226,1374,306,1068
2021,Mansfield 008A,E01028227,1279,240,1039
2021,Mansfield 008B,E01028228,1212,175,1037
2021,Mansfield 006A,E01028229,1313,146,1167
2021,Mansfield 010A,E01028230,1424,322,1102
2021,Mansfield 010B,E01028231,1394,297,1097
2021,Mansfield 006B,E01028232,1438,256,1182
2021,Mansfield 009A,E01028233,1871,329,1542
2021,Mansfield 009B,E01028234,1593,304,1289
2021,Mansfield 011A,E01028235,1491,220,1271
2021,Mansfield 011B,E01028236,1682,283,1399
2021,Mansfield 007A,E01028237,1531,234,1297
2021,Mansfield 007B,E01028238,1441,331,1110
2021,Mansfield 007C,E01028239,1586,298,1288
2021,Mansfield 007D,E01028240,1393,169,1224
2021,Mansfield 005A,E01028242,1394,149,1245
2021,Mansfield 007F,E01028243,1839,289,1550
2021,Mansfield 010C,E01028244,1439,204,1235
2021,Mansfield 010D,E01028245,1282,243,1039
2021,Mansfield 010E,E01028246,1599,203,1396
2021,Mansfield 008C,E01028247,1592,287,1305
2021,Mansfield 010F,E01028248,1563,313,1250
2021,Mansfield 010G,E01028249,1397,263,1134
2021,Mansfield 005B,E01028250,1336,188,1148
2021,Mansfield 003A,E01028251,1480,235,1245
2021,Mansfield 003B,E01028252,1813,343,1470
2021,Mansfield 003C,E01028253,1584,281,1303
2021,Mansfield 012A,E01028254,1272,195,1077
2021,Mansfield 013E,E01028255,1289,165,1124
2021,Mansfield 012B,E01028256,1721,360,1361
2021,Mansfield 001B,E01028257,1484,335,1149
2021,Mansfield 001C,E01028258,1559,265,1294
2021,Mansfield 001D,E01028259,1650,358,1292
2021,Mansfield 002D,E01028260,1688,230,1458
2021,Mansfield 012C,E01028261,1547,355,1192
2021,Mansfield 011C,E01028262,1325,176,1149
2021,Mansfield 012D,E01028263,1463,263,1200
2021,Mansfield 011D,E01028264,1778,245,1533
2021,Mansfield 006E,E01028267,2053,501,1552
2021,Mansfield 008D,E01028268,2086,334,1752
2021,Mansfield 008E,E01028269,1624,287,1337
2021,Mansfield 013F,E01028270,1486,232,1254
2021,Mansfield 004A,E01028271,1639,285,1354
2021,Mansfield 005C,E01028272,1693,311,1382
2021,Mansfield 005D,E01028273,1389,210,1179
2021,Mansfield 009C,E01028274,1434,182,1252
2021,Mansfield 009D,E01028275,1486,353,1133
2021,Mansfield 009E,E01028276,1537,288,1249
2021,Mansfield 003D,E01028277,1317,179,1138
2021,Mansfield 003E,E01028278,1320,200,1120
2021,Mansfield 004B,E01028279,1383,187,1196
2021,Mansfield 004C,E01028280,1294,271,1023
2021,Mansfield 004D,E01028281,1381,357,1024
2021,Mansfield 006F,E01028282,1138,194,944
2021,Mansfield 004E,E01028283,2124,382,1742
2021,Mansfield 008F,E01028284,1735,248,1487
2021,Newark and Sherwood 011A,E01028285,1140,200,940
2021,Newark and Sherwood 011B,E01028286,1254,194,1060
2021,Newark and Sherwood 011C,E01028287,1451,233,1218
2021,Newark and Sherwood 011D,E01028288,1403,193,1210
2021,Newark and Sherwood 011E,E01028289,1305,151,1154
2021,Newark and Sherwood 011F,E01028290,1370,239,1131
2021,Newark and Sherwood 011G,E01028291,1938,363,1575
2021,Newark and Sherwood 009A,E01028292,2592,475,2117
2021,Newark and Sherwood 009B,E01028293,1841,333,1508
2021,Newark and Sherwood 007A,E01028294,1793,294,1499
2021,Newark and Sherwood 005A,E01028295,1820,238,1582
2021,Newark and Sherwood 006A,E01028296,1686,318,1368
2021,Newark and Sherwood 005B,E01028297,1885,373,1512
2021,Newark and Sherwood 006B,E01028298,1456,229,1227
2021,Newark and Sherwood 006C,E01028299,1247,250,997
2021,Newark and Sherwood 006D,E01028300,1379,230,1149
2021,Newark and Sherwood 001A,E01028301,1796,465,1331
2021,Newark and Sherwood 001B,E01028302,1463,199,1264
2021,Newark and Sherwood 003A,E01028303,1441,175,1266
2021,Newark and Sherwood 007B,E01028304,1367,270,1097
2021,Newark and Sherwood 007C,E01028305,1453,256,1197
2021,Newark and Sherwood 007D,E01028306,1586,315,1271
2021,Newark and Sherwood 007E,E01028307,1143,156,987
2021,Newark and Sherwood 010A,E01028308,1498,190,1308
2021,Newark and Sherwood 010B,E01028309,1355,152,1203
2021,Newark and Sherwood 007F,E01028310,2064,262,1802
2021,Newark and Sherwood 007G,E01028311,1554,196,1358
2021,Newark and Sherwood 003B,E01028312,2258,367,1891
2021,Newark and Sherwood 002A,E01028313,1944,380,1564
2021,Newark and Sherwood 004A,E01028315,1473,191,1282
2021,Newark and Sherwood 004B,E01028316,1638,213,1425
2021,Newark and Sherwood 004C,E01028317,1553,230,1323
2021,Newark and Sherwood 010C,E01028318,1443,312,1131
2021,Newark and Sherwood 010D,E01028319,1842,362,1480
2021,Newark and Sherwood 010E,E01028320,1570,347,1223
2021,Newark and Sherwood 002C,E01028321,1486,186,1300
2021,Newark and Sherwood 002D,E01028322,1966,272,1694
2021,Newark and Sherwood 002E,E01028323,1602,271,1331
2021,Newark and Sherwood 012B,E01028325,1255,218,1037
2021,Newark and Sherwood 012C,E01028326,1256,197,1059
2021,Newark and Sherwood 005C,E01028327,1902,356,1546
2021,Newark and Sherwood 005D,E01028328,1708,284,1424
2021,Newark and Sherwood 005E,E01028329,1568,284,1284
2021,Newark and Sherwood 013A,E01028330,1470,205,1265
2021,Newark and Sherwood 013B,E01028331,2241,193,2048
2021,Newark and Sherwood 013C,E01028332,1543,214,1329
2021,Newark and Sherwood 009C,E01028333,1390,218,1172
2021,Newark and Sherwood 009D,E01028334,1509,374,1135
2021,Newark and Sherwood 009E,E01028335,1776,251,1525
2021,Newark and Sherwood 012D,E01028336,1095,162,933
2021,Newark and Sherwood 003C,E01028337,1412,218,1194
2021,Newark and Sherwood 001C,E01028338,1695,285,1410
2021,Newark and Sherwood 001D,E01028339,1764,369,1395
2021,Newark and Sherwood 001E,E01028340,1499,222,1277
2021,Newark and Sherwood 006E,E01028342,1390,294,1096
2021,Newark and Sherwood 006F,E01028343,2310,400,1910
2021,Newark and Sherwood 006G,E01028344,1298,176,1122
2021,Newark and Sherwood 008A,E01028345,2146,354,1792
2021,Newark and Sherwood 008B,E01028346,2067,361,1706
2021,Newark and Sherwood 008C,E01028347,1415,288,1127
2021,Newark and Sherwood 008D,E01028348,1711,690,1021
2021,Newark and Sherwood 003D,E01028349,1470,196,1274
2021,Newark and Sherwood 003E,E01028350,1192,202,990
2021,Newark and Sherwood 013D,E01028351,1246,237,1009
2021,Newark and Sherwood 012E,E01028352,1106,189,917
2021,Newark and Sherwood 004D,E01028353,2616,430,2186
2021,Rushcliffe 004A,E01028354,1441,360,1081
2021,Rushcliffe 004B,E01028355,1447,304,1143
2021,Rushcliffe 006A,E01028356,1356,286,1070
2021,Rushcliffe 002A,E01028357,1391,252,1139
2021,Rushcliffe 002B,E01028358,1272,200,1072
2021,Rushcliffe 002C,E01028359,1781,426,1355
2021,Rushcliffe 002D,E01028360,2631,623,2008
2021,Rushcliffe 002E,E01028361,1230,214,1016
2021,Rushcliffe 002F,E01028362,1266,252,1014
2021,Rushcliffe 007A,E01028363,1297,272,1025
2021,Rushcliffe 007B,E01028364,1648,314,1334
2021,Rushcliffe 007C,E01028365,1955,398,1557
2021,Rushcliffe 009A,E01028366,1218,263,955
2021,Rushcliffe 009B,E01028367,2388,432,1956
2021,Rushcliffe 009C,E01028368,1410,224,1186
2021,Rushcliffe 009D,E01028369,1373,284,1089
2021,Rushcliffe 009E,E01028370,1323,222,1101
2021,Rushcliffe 001A,E01028371,2868,353,2515
2021,Rushcliffe 008A,E01028372,1239,291,948
2021,Rushcliffe 008C,E01028374,1310,236,1074
2021,Rushcliffe 006B,E01028375,1796,391,1405
2021,Rushcliffe 006C,E01028376,1490,284,1206
2021,Rushcliffe 006D,E01028377,1805,409,1396
2021,Rushcliffe 014A,E01028378,1934,274,1660
2021,Rushcliffe 012A,E01028379,1671,255,1416
2021,Rushcliffe 013A,E01028380,1202,270,932
2021,Rushcliffe 013B,E01028381,1255,186,1069
2021,Rushcliffe 013C,E01028382,1362,222,1140
2021,Rushcliffe 013D,E01028383,1025,118,907
2021,Rushcliffe 004C,E01028384,1700,476,1224
2021,Rushcliffe 004D,E01028385,1666,405,1261
2021,Rushcliffe 004E,E01028386,1613,419,1194
2021,Rushcliffe 014B,E01028387,2336,563,1773
2021,Rushcliffe 015A,E01028388,1609,301,1308
2021,Rushcliffe 015B,E01028389,1776,261,1515
2021,Rushcliffe 015C,E01028390,2379,417,1962
2021,Rushcliffe 007D,E01028391,1985,363,1622
2021,Rushcliffe 007E,E01028392,2031,417,1614
2021,Rushcliffe 003A,E01028393,1059,149,910
2021,Rushcliffe 003B,E01028394,1424,213,1211
2021,Rushcliffe 003C,E01028395,1279,231,1048
2021,Rushcliffe 005A,E01028396,1409,283,1126
2021,Rushcliffe 006E,E01028397,1683,387,1296
2021,Rushcliffe 005B,E01028398,1318,279,1039
2021,Rushcliffe 005C,E01028399,1310,406,904
2021,Rushcliffe 008D,E01028400,1475,348,1127
2021,Rushcliffe 008E,E01028401,1193,267,926
2021,Rushcliffe 010A,E01028402,1862,279,1583
2021,Rushcliffe 001B,E01028403,2068,349,1719
2021,Rushcliffe 011A,E01028404,1542,250,1292
2021,Rushcliffe 011B,E01028405,2064,404,1660
2021,Rushcliffe 011C,E01028406,1589,295,1294
2021,Rushcliffe 011D,E01028407,2048,374,1674
2021,Rushcliffe 014C,E01028408,2699,1122,1577
2021,Rushcliffe 015D,E01028409,1229,197,1032
2021,Rushcliffe 015E,E01028410,1293,226,1067
2021,Rushcliffe 001C,E01028411,2069,336,1733
2021,Rushcliffe 012B,E01028412,1892,326,1566
2021,Rushcliffe 003D,E01028413,1607,310,1297
2021,Rushcliffe 003E,E01028414,1547,227,1320
2021,Rushcliffe 003F,E01028415,1937,395,1542
2021,Rushcliffe 005D,E01028416,1569,468,1101
2021,Rushcliffe 005E,E01028417,1501,521,980
2021,Rushcliffe 005F,E01028418,1450,453,997
2021,Rushcliffe 010B,E01028419,2337,374,1963
2021,Rushcliffe 010C,E01028420,1263,185,1078
2021,Rushcliffe 012C,E01028421,2160,342,1818
2021,Cherwell 008A,E01028422,1754,339,1415
2021,Cherwell 008B,E01028423,1563,259,1304
2021,Cherwell 007A,E01028426,1642,299,1343
2021,Cherwell 007B,E01028427,1372,207,1165
2021,Cherwell 007C,E01028428,1291,245,1046
2021,Cherwell 007D,E01028429,1027,136,891
2021,Cherwell 006A,E01028430,1795,253,1542
2021,Cherwell 006B,E01028431,1561,252,1309
2021,Cherwell 006C,E01028432,1876,325,1551
2021,Cherwell 006D,E01028433,1559,172,1387
2021,Cherwell 006E,E01028434,1865,462,1403
2021,Cherwell 004A,E01028435,1975,195,1780
2021,Cherwell 004C,E01028437,1527,300,1227
2021,Cherwell 004E,E01028439,1326,235,1091
2021,Cherwell 004F,E01028440,1545,207,1338
2021,Cherwell 002A,E01028441,2269,461,1808
2021,Cherwell 002C,E01028443,1357,247,1110
2021,Cherwell 002D,E01028444,1337,204,1133
2021,Cherwell 003A,E01028445,1381,338,1043
2021,Cherwell 003B,E01028446,1481,258,1223
2021,Cherwell 003C,E01028447,1217,220,997
2021,Cherwell 003D,E01028448,1564,348,1216
2021,Cherwell 005A,E01028449,1394,314,1080
2021,Cherwell 005B,E01028450,1389,399,990
2021,Cherwell 005C,E01028451,1221,221,1000
2021,Cherwell 005D,E01028452,1392,354,1038
2021,Cherwell 005E,E01028453,1307,339,968
2021,Cherwell 005F,E01028454,1612,355,1257
2021,Cherwell 013A,E01028455,1415,260,1155
2021,Cherwell 013B,E01028456,1384,228,1156
2021,Cherwell 013C,E01028457,1310,243,1067
2021,Cherwell 013D,E01028458,1471,282,1189
2021,Cherwell 012A,E01028459,1345,209,1136
2021,Cherwell 012B,E01028460,1917,457,1460
2021,Cherwell 012C,E01028461,1581,298,1283
2021,Cherwell 012D,E01028462,1508,255,1253
2021,Cherwell 015A,E01028463,2438,405,2033
2021,Cherwell 015B,E01028464,1535,294,1241
2021,Cherwell 015C,E01028465,1308,288,1020
2021,Cherwell 014A,E01028466,1656,365,1291
2021,Cherwell 013E,E01028467,1712,227,1485
2021,Cherwell 014B,E01028469,1384,176,1208
2021,Cherwell 014C,E01028470,1570,234,1336
2021,Cherwell 014D,E01028471,1271,278,993
2021,Cherwell 014E,E01028472,1142,198,944
2021,Cherwell 014F,E01028473,1380,194,1186
2021,Cherwell 009A,E01028474,1808,376,1432
2021,Cherwell 008D,E01028476,2704,642,2062
2021,Cherwell 011B,E01028477,2345,403,1942
2021,Cherwell 011C,E01028478,1280,280,1000
2021,Cherwell 001A,E01028479,1273,176,1097
2021,Cherwell 001B,E01028480,1472,194,1278
2021,Cherwell 010A,E01028481,1400,216,1184
2021,Cherwell 010B,E01028482,1315,237,1078
2021,Cherwell 011D,E01028483,1239,195,1044
2021,Cherwell 011E,E01028484,1048,165,883
2021,Cherwell 009B,E01028485,1510,296,1214
2021,Cherwell 009C,E01028486,1193,187,1006
2021,Cherwell 017A,E01028487,1154,158,996
2021,Cherwell 019A,E01028488,1303,198,1105
2021,Cherwell 017B,E01028489,1329,162,1167
2021,Cherwell 017C,E01028490,1233,193,1040
2021,Cherwell 017D,E01028491,1509,216,1293
2021,Cherwell 018A,E01028492,1485,233,1252
2021,Cherwell 018B,E01028493,1329,240,1089
2021,Cherwell 017E,E01028494,1046,181,865
2021,Cherwell 018C,E01028495,1242,222,1020
2021,Cherwell 018D,E01028496,1342,259,1083
2021,Cherwell 016B,E01028497,1385,222,1163
2021,Cherwell 016C,E01028498,1591,279,1312
2021,Cherwell 011F,E01028499,1864,304,1560
2021,Cherwell 016D,E01028500,1938,252,1686
2021,Cherwell 016E,E01028501,1183,201,982
2021,Cherwell 016F,E01028502,1173,204,969
2021,Cherwell 009D,E01028503,1114,133,981
2021,Cherwell 009E,E01028504,1400,286,1114
2021,Cherwell 010D,E01028506,1794,275,1519
2021,Cherwell 010E,E01028507,1393,252,1141
2021,Cherwell 001C,E01028508,1038,163,875
2021,Cherwell 019B,E01028510,1554,249,1305
2021,Cherwell 019C,E01028511,1803,267,1536
2021,Cherwell 019D,E01028512,1782,370,1412
2021,Oxford 005A,E01028513,2433,509,1924
2021,Oxford 005B,E01028514,1506,388,1118
2021,Oxford 007A,E01028515,1645,316,1329
2021,Oxford 005C,E01028516,2243,541,1702
2021,Oxford 017A,E01028517,1284,308,976
2021,Oxford 017B,E01028518,1507,337,1170
2021,Oxford 017C,E01028519,1633,362,1271
2021,Oxford 018A,E01028520,1584,444,1140
2021,Oxford 008A,E01028521,9859,8893,966
2021,Oxford 008B,E01028522,4039,3074,965
2021,Oxford 010A,E01028523,1532,364,1168
2021,Oxford 010B,E01028524,1612,432,1180
2021,Oxford 010C,E01028525,1923,608,1315
2021,Oxford 010D,E01028526,2199,1416,783
2021,Oxford 015A,E01028527,1697,327,1370
2021,Oxford 015B,E01028528,1604,364,1240
2021,Oxford 015C,E01028529,1628,422,1206
2021,Oxford 015D,E01028530,1981,327,1654
2021,Oxford 019B,E01028531,1950,554,1396
2021,Oxford 019A,E01028532,2831,845,1986
2021,Oxford 006A,E01028534,1202,307,895
2021,Oxford 006B,E01028535,2103,924,1179
2021,Oxford 006C,E01028536,1367,341,1026
2021,Oxford 006D,E01028537,1768,333,1435
2021,Oxford 005D,E01028538,1687,425,1262
2021,Oxford 006E,E01028539,2021,652,1369
2021,Oxford 006F,E01028540,2275,1275,1000
2021,Oxford 012A,E01028541,1340,371,969
2021,Oxford 012B,E01028542,1731,389,1342
2021,Oxford 012C,E01028543,1165,281,884
2021,Oxford 012D,E01028544,1128,309,819
2021,Oxford 014A,E01028545,1823,549,1274
2021,Oxford 014B,E01028546,1789,387,1402
2021,Oxford 014C,E01028547,2164,767,1397
2021,Oxford 009A,E01028548,1783,438,1345
2021,Oxford 009B,E01028549,1463,371,1092
2021,Oxford 009C,E01028550,1389,461,928
2021,Oxford 009D,E01028551,1658,896,762
2021,Oxford 016A,E01028552,1999,540,1459
2021,Oxford 016B,E01028553,1717,322,1395
2021,Oxford 016C,E01028554,1494,249,1245
2021,Oxford 016D,E01028555,1562,282,1280
2021,Oxford 020B,E01028556,2611,1274,1337
2021,Oxford 020D,E01028557,1950,521,1429
2021,Oxford 020C,E01028558,1646,351,1295
2021,Oxford 020A,E01028559,1824,432,1392
2021,Oxford 004A,E01028560,1704,448,1256
2021,Oxford 004B,E01028561,1902,363,1539
2021,Oxford 004C,E01028562,1857,697,1160
2021,Oxford 004D,E01028563,1499,364,1135
2021,Oxford 003A,E01028565,1227,347,880
2021,Oxford 017D,E01028567,1766,375,1391
2021,Oxford 018B,E01028568,1404,333,1071
2021,Oxford 018C,E01028569,1515,355,1160
2021,Oxford 018D,E01028570,1959,449,1510
2021,Oxford 007B,E01028571,1582,350,1232
2021,Oxford 007C,E01028572,1768,351,1417
2021,Oxford 007D,E01028573,1651,433,1218
2021,Oxford 007E,E01028574,1371,299,1072
2021,Oxford 015E,E01028575,1485,270,1215
2021,Oxford 016E,E01028576,1614,354,1260
2021,Oxford 016F,E01028577,2121,586,1535
2021,Oxford 015F,E01028578,1447,209,1238
2021,Oxford 011A,E01028579,1653,765,888
2021,Oxford 011B,E01028580,1305,536,769
2021,Oxford 011C,E01028581,1463,684,779
2021,Oxford 011D,E01028582,1185,553,632
2021,Oxford 003C,E01028584,2359,609,1750
2021,Oxford 011E,E01028586,1668,599,1069
2021,Oxford 011F,E01028587,1815,798,1017
2021,Oxford 011G,E01028588,1746,1176,570
2021,Oxford 002C,E01028591,1248,349,899
2021,Oxford 002D,E01028592,1620,826,794
2021,Oxford 001A,E01028594,1497,291,1206
2021,Oxford 001B,E01028595,1546,385,1161
2021,Oxford 001C,E01028596,1394,306,1088
2021,Oxford 001D,E01028597,1458,316,1142
2021,South Oxfordshire 005A,E01028598,2422,377,2045
2021,South Oxfordshire 011A,E01028599,1845,334,1511
2021,South Oxfordshire 007A,E01028600,1379,199,1180
2021,South Oxfordshire 011B,E01028601,1547,219,1328
2021,South Oxfordshire 011C,E01028602,1130,279,851
2021,South Oxfordshire 007B,E01028603,1286,235,1051
2021,South Oxfordshire 006A,E01028604,1431,319,1112
2021,South Oxfordshire 006B,E01028605,1433,258,1175
2021,South Oxfordshire 007C,E01028606,1623,256,1367
2021,South Oxfordshire 006C,E01028607,1263,200,1063
2021,South Oxfordshire 012A,E01028608,1192,228,964
2021,South Oxfordshire 007D,E01028609,1280,221,1059
2021,South Oxfordshire 007E,E01028610,1395,213,1182
2021,South Oxfordshire 018A,E01028611,1178,216,962
2021,South Oxfordshire 019A,E01028612,1233,220,1013
2021,South Oxfordshire 005B,E01028613,1339,272,1067
2021,South Oxfordshire 005C,E01028614,2378,456,1922
2021,South Oxfordshire 005D,E01028615,1765,261,1504
2021,South Oxfordshire 005E,E01028616,1659,294,1365
2021,South Oxfordshire 012B,E01028617,1966,387,1579
2021,South Oxfordshire 015B,E01028619,1711,364,1347
2021,South Oxfordshire 010B,E01028622,1885,330,1555
2021,South Oxfordshire 010C,E01028623,1544,239,1305
2021,South Oxfordshire 010D,E01028624,2092,344,1748
2021,South Oxfordshire 009A,E01028625,1800,336,1464
2021,South Oxfordshire 009B,E01028626,1510,325,1185
2021,South Oxfordshire 009C,E01028627,1359,238,1121
2021,South Oxfordshire 009D,E01028628,1643,314,1329
2021,South Oxfordshire 009E,E01028629,1344,236,1108
2021,South Oxfordshire 013A,E01028630,1352,168,1184
2021,South Oxfordshire 013B,E01028631,1086,191,895
2021,South Oxfordshire 013C,E01028632,1397,254,1143
2021,South Oxfordshire 013D,E01028633,1367,209,1158
2021,South Oxfordshire 014A,E01028634,1248,244,1004
2021,South Oxfordshire 014B,E01028635,1473,239,1234
2021,South Oxfordshire 014C,E01028636,1268,212,1056
2021,South Oxfordshire 014D,E01028637,2025,380,1645
2021,South Oxfordshire 002A,E01028638,1461,203,1258
2021,South Oxfordshire 002B,E01028639,1434,350,1084
2021,South Oxfordshire 002C,E01028640,1322,263,1059
2021,South Oxfordshire 006D,E01028641,1121,152,969
2021,South Oxfordshire 018B,E01028642,1419,326,1093
2021,South Oxfordshire 018C,E01028643,1345,281,1064
2021,South Oxfordshire 015C,E01028644,1608,291,1317
2021,South Oxfordshire 018D,E01028645,1465,235,1230
2021,South Oxfordshire 004A,E01028646,1135,197,938
2021,South Oxfordshire 004B,E01028647,1507,255,1252
2021,South Oxfordshire 015E,E01028649,1456,268,1188
2021,South Oxfordshire 016A,E01028650,2052,469,1583
2021,South Oxfordshire 016B,E01028651,1573,215,1358
2021,South Oxfordshire 016C,E01028652,2033,198,1835
2021,South Oxfordshire 017A,E01028653,1519,236,1283
2021,South Oxfordshire 017B,E01028654,1517,319,1198
2021,South Oxfordshire 017C,E01028655,1627,197,1430
2021,South Oxfordshire 017D,E01028656,1313,280,1033
2021,South Oxfordshire 006E,E01028657,1164,126,1038
2021,South Oxfordshire 006F,E01028658,1257,227,1030
2021,South Oxfordshire 020A,E01028659,1608,329,1279
2021,South Oxfordshire 019B,E01028660,1893,355,1538
2021,South Oxfordshire 019C,E01028661,1655,451,1204
2021,South Oxfordshire 019D,E01028662,1336,274,1062
2021,South Oxfordshire 020B,E01028663,1500,301,1199
2021,South Oxfordshire 020C,E01028664,1431,211,1220
2021,South Oxfordshire 020D,E01028665,1312,222,1090
2021,South Oxfordshire 001A,E01028666,1404,208,1196
2021,South Oxfordshire 001B,E01028667,1235,222,1013
2021,South Oxfordshire 001C,E01028668,1216,197,1019
2021,South Oxfordshire 001D,E01028669,1247,210,1037
2021,South Oxfordshire 003A,E01028670,1421,280,1141
2021,South Oxfordshire 003B,E01028671,1544,242,1302
2021,South Oxfordshire 003C,E01028672,2582,518,2064
2021,South Oxfordshire 003D,E01028673,1852,416,1436
2021,South Oxfordshire 012C,E01028674,1291,238,1053
2021,South Oxfordshire 012D,E01028675,1263,266,997
2021,South Oxfordshire 012E,E01028676,2102,351,1751
2021,South Oxfordshire 012F,E01028677,1357,157,1200
2021,South Oxfordshire 008A,E01028678,1555,284,1271
2021,South Oxfordshire 008B,E01028679,2095,365,1730
2021,South Oxfordshire 008C,E01028680,1609,259,1350
2021,South Oxfordshire 004C,E01028681,1247,216,1031
2021,South Oxfordshire 004D,E01028682,1198,172,1026
2021,South Oxfordshire 002D,E01028683,1401,211,1190
2021,South Oxfordshire 004E,E01028684,1342,193,1149
2021,South Oxfordshire 018E,E01028685,1190,217,973
2021,South Oxfordshire 018F,E01028686,1326,346,980
2021,Vale of White Horse 005A,E01028688,1073,171,902
2021,Vale of White Horse 005B,E01028689,1307,209,1098
2021,Vale of White Horse 008A,E01028690,1514,224,1290
2021,Vale of White Horse 008B,E01028691,1650,272,1378
2021,Vale of White Horse 008C,E01028692,1353,320,1033
2021,Vale of White Horse 004A,E01028693,1464,281,1183
2021,Vale of White Horse 004B,E01028694,1340,244,1096
2021,Vale of White Horse 005C,E01028695,1515,261,1254
2021,Vale of White Horse 006B,E01028696,1379,366,1013
2021,Vale of White Horse 006C,E01028697,1498,282,1216
2021,Vale of White Horse 006D,E01028698,1354,222,1132
2021,Vale of White Horse 005D,E01028699,1521,289,1232
2021,Vale of White Horse 006E,E01028700,1562,308,1254
2021,Vale of White Horse 004C,E01028701,1466,267,1199
2021,Vale of White Horse 008D,E01028702,1171,175,996
2021,Vale of White Horse 006F,E01028703,1615,195,1420
2021,Vale of White Horse 008E,E01028704,1776,302,1474
2021,Vale of White Horse 004D,E01028705,1181,201,980
2021,Vale of White Horse 004E,E01028706,1328,186,1142
2021,Vale of White Horse 004F,E01028707,1375,201,1174
2021,Vale of White Horse 001A,E01028708,1805,260,1545
2021,Vale of White Horse 001B,E01028709,1829,277,1552
2021,Vale of White Horse 001C,E01028710,2007,405,1602
2021,Vale of White Horse 001D,E01028711,1626,311,1315
2021,Vale of White Horse 015A,E01028712,2066,343,1723
2021,Vale of White Horse 016E,E01028713,2441,449,1992
2021,Vale of White Horse 016F,E01028715,2163,401,1762
2021,Vale of White Horse 009A,E01028716,2239,499,1740
2021,Vale of White Horse 009B,E01028717,1480,181,1299
2021,Vale of White Horse 009C,E01028718,1402,261,1141
2021,Vale of White Horse 009D,E01028719,1537,252,1285
2021,Vale of White Horse 016G,E01028720,2496,412,2084
2021,Vale of White Horse 011A,E01028721,1169,206,963
2021,Vale of White Horse 011B,E01028722,1469,218,1251
2021,Vale of White Horse 011C,E01028723,2059,399,1660
2021,Vale of White Horse 011D,E01028724,1135,162,973
2021,Vale of White Horse 011E,E01028725,2630,538,2092
2021,Vale of White Horse 007A,E01028726,2722,507,2215
2021,Vale of White Horse 015C,E01028728,1205,230,975
2021,Vale of White Horse 015D,E01028729,1751,398,1353
2021,Vale of White Horse 015E,E01028730,1555,277,1278
2021,Vale of White Horse 010B,E01028731,1936,400,1536
2021,Vale of White Horse 010C,E01028732,1556,265,1291
2021,Vale of White Horse 002A,E01028733,1270,223,1047
2021,Vale of White Horse 002B,E01028734,1510,261,1249
2021,Vale of White Horse 002C,E01028735,1583,265,1318
2021,Vale of White Horse 007C,E01028737,2302,424,1878
2021,Vale of White Horse 003A,E01028738,1766,358,1408
2021,Vale of White Horse 003B,E01028739,2310,565,1745
2021,Vale of White Horse 002D,E01028740,1568,308,1260
2021,Vale of White Horse 002E,E01028741,1932,675,1257
2021,Vale of White Horse 002F,E01028742,1978,371,1607
2021,Vale of White Horse 003C,E01028743,1616,811,805
2021,Vale of White Horse 003D,E01028744,1234,195,1039
2021,Vale of White Horse 016A,E01028745,1697,271,1426
2021,Vale of White Horse 016B,E01028746,1567,323,1244
2021,Vale of White Horse 016C,E01028747,1363,309,1054
2021,Vale of White Horse 016D,E01028748,1249,264,985
2021,Vale of White Horse 009E,E01028749,2525,473,2052
2021,Vale of White Horse 003E,E01028750,1315,248,1067
2021,Vale of White Horse 003F,E01028751,1395,220,1175
2021,Vale of White Horse 003G,E01028752,1585,282,1303
2021,Vale of White Horse 010D,E01028753,1652,349,1303
2021,Vale of White Horse 010E,E01028754,1542,297,1245
2021,Vale of White Horse 014A,E01028755,1732,278,1454
2021,Vale of White Horse 015F,E01028757,2120,413,1707
2021,Vale of White Horse 014C,E01028758,1611,287,1324
2021,Vale of White Horse 014D,E01028759,1653,289,1364
2021,Vale of White Horse 014E,E01028760,1173,197,976
2021,Vale of White Horse 014F,E01028761,1184,232,952
2021,West Oxfordshire 012A,E01028762,1756,293,1463
2021,West Oxfordshire 003A,E01028763,2093,327,1766
2021,West Oxfordshire 015A,E01028764,1662,232,1430
2021,West Oxfordshire 015B,E01028765,2312,423,1889
2021,West Oxfordshire 012C,E01028767,1917,302,1615
2021,West Oxfordshire 014A,E01028771,1423,200,1223
2021,West Oxfordshire 013D,E01028772,2279,448,1831
2021,West Oxfordshire 014B,E01028773,1309,191,1118
2021,West Oxfordshire 014C,E01028774,1425,349,1076
2021,West Oxfordshire 014D,E01028775,1197,155,1042
2021,West Oxfordshire 003B,E01028776,1884,291,1593
2021,West Oxfordshire 005A,E01028777,1125,159,966
2021,West Oxfordshire 005B,E01028778,1433,251,1182
2021,West Oxfordshire 005C,E01028779,1096,177,919
2021,West Oxfordshire 001A,E01028780,2190,327,1863
2021,West Oxfordshire 001B,E01028781,1699,373,1326
2021,West Oxfordshire 001C,E01028782,1461,241,1220
2021,West Oxfordshire 001D,E01028783,1510,179,1331
2021,West Oxfordshire 007A,E01028784,2302,381,1921
2021,West Oxfordshire 011A,E01028785,1508,212,1296
2021,West Oxfordshire 011B,E01028786,1362,226,1136
2021,West Oxfordshire 011C,E01028787,1361,272,1089
2021,West Oxfordshire 006A,E01028788,1925,366,1559
2021,West Oxfordshire 006B,E01028789,1772,289,1483
2021,West Oxfordshire 006C,E01028790,1515,316,1199
2021,West Oxfordshire 006D,E01028791,1462,217,1245
2021,West Oxfordshire 007B,E01028792,1076,168,908
2021,West Oxfordshire 007C,E01028793,1503,257,1246
2021,West Oxfordshire 007D,E01028794,1402,225,1177
2021,West Oxfordshire 002A,E01028795,1564,245,1319
2021,West Oxfordshire 002B,E01028796,1368,340,1028
2021,West Oxfordshire 002C,E01028797,1183,191,992
2021,West Oxfordshire 003C,E01028798,2155,374,1781
2021,West Oxfordshire 005D,E01028799,2054,316,1738
2021,West Oxfordshire 011D,E01028800,1417,263,1154
2021,West Oxfordshire 015C,E01028801,1426,260,1166
2021,West Oxfordshire 015D,E01028802,1568,287,1281
2021,West Oxfordshire 004B,E01028804,1393,257,1136
2021,West Oxfordshire 002D,E01028806,1890,341,1549
2021,West Oxfordshire 010A,E01028807,2078,260,1818
2021,West Oxfordshire 010B,E01028808,2156,400,1756
2021,West Oxfordshire 009A,E01028809,1394,390,1004
2021,West Oxfordshire 008A,E01028810,1224,185,1039
2021,West Oxfordshire 008B,E01028811,1287,233,1054
2021,West Oxfordshire 008D,E01028813,1247,253,994
2021,West Oxfordshire 008E,E01028814,1393,215,1178
2021,West Oxfordshire 008F,E01028815,1164,167,997
2021,West Oxfordshire 010C,E01028816,1231,219,1012
2021,West Oxfordshire 010D,E01028817,1380,220,1160
2021,West Oxfordshire 010E,E01028818,1597,160,1437
2021,West Oxfordshire 010F,E01028819,1804,288,1516
2021,West Oxfordshire 009B,E01028820,2540,488,2052
2021,West Oxfordshire 009C,E01028821,1316,197,1119
2021,West Oxfordshire 009D,E01028822,1383,200,1183
2021,West Oxfordshire 004D,E01028823,1255,164,1091
2021,West Oxfordshire 004E,E01028824,1792,372,1420
2021,West Oxfordshire 004F,E01028825,1239,226,1013
2021,Shropshire 027A,E01028826,1735,228,1507
2021,Shropshire 027B,E01028827,1410,239,1171
2021,Shropshire 034A,E01028828,1650,273,1377
2021,Shropshire 034B,E01028829,1221,162,1059
2021,Shropshire 031A,E01028830,1388,164,1224
2021,Shropshire 031B,E01028831,1461,269,1192
2021,Shropshire 033A,E01028832,1541,144,1397
2021,Shropshire 033B,E01028833,1375,167,1208
2021,Shropshire 033C,E01028834,1565,227,1338
2021,Shropshire 033D,E01028835,1496,244,1252
2021,Shropshire 031C,E01028836,1334,237,1097
2021,Shropshire 031D,E01028837,1274,165,1109
2021,Shropshire 029A,E01028838,1545,275,1270
2021,Shropshire 029B,E01028839,1373,209,1164
2021,Shropshire 029C,E01028840,1323,197,1126
2021,Shropshire 029D,E01028841,1431,198,1233
2021,Shropshire 034C,E01028842,1667,258,1409
2021,Shropshire 035A,E01028843,1632,243,1389
2021,Shropshire 027C,E01028844,2600,581,2019
2021,Shropshire 027D,E01028845,1882,193,1689
2021,Shropshire 035B,E01028846,2179,289,1890
2021,Shropshire 034D,E01028847,1428,224,1204
2021,Shropshire 035C,E01028848,1686,238,1448
2021,Shropshire 035D,E01028849,1840,264,1576
2021,Shropshire 029E,E01028850,2329,398,1931
2021,Shropshire 029F,E01028851,1778,285,1493
2021,Shropshire 029G,E01028852,1566,266,1300
2021,Shropshire 025A,E01028853,1316,215,1101
2021,Shropshire 025B,E01028854,1340,185,1155
2021,Shropshire 025C,E01028855,2632,476,2156
2021,Shropshire 025D,E01028856,1525,211,1314
2021,Shropshire 035E,E01028858,2084,228,1856
2021,Shropshire 034E,E01028859,1642,208,1434
2021,Shropshire 010A,E01028860,2212,445,1767
2021,Shropshire 013A,E01028861,1361,218,1143
2021,Shropshire 010B,E01028862,1688,267,1421
2021,Shropshire 010C,E01028863,1325,202,1123
2021,Shropshire 004A,E01028864,1453,197,1256
2021,Shropshire 004B,E01028865,1757,283,1474
2021,Shropshire 004C,E01028866,1360,175,1185
2021,Shropshire 004D,E01028867,1659,319,1340
2021,Shropshire 009A,E01028868,1373,201,1172
2021,Shropshire 009B,E01028869,1642,237,1405
2021,Shropshire 013B,E01028870,1426,201,1225
2021,Shropshire 009C,E01028871,1328,244,1084
2021,Shropshire 004E,E01028872,1528,316,1212
2021,Shropshire 005A,E01028873,2010,327,1683
2021,Shropshire 005B,E01028874,1497,223,1274
2021,Shropshire 005C,E01028875,2575,473,2102
2021,Shropshire 005D,E01028876,1697,306,1391
2021,Shropshire 005E,E01028877,1209,199,1010
2021,Shropshire 005F,E01028878,1447,214,1233
2021,Shropshire 005G,E01028879,1466,265,1201
2021,Shropshire 002A,E01028880,1643,282,1361
2021,Shropshire 002B,E01028881,1301,153,1148
2021,Shropshire 002C,E01028882,1567,235,1332
2021,Shropshire 013C,E01028883,1530,264,1266
2021,Shropshire 013D,E01028884,1431,239,1192
2021,Shropshire 008A,E01028886,1583,250,1333
2021,Shropshire 008B,E01028887,1577,262,1315
2021,Shropshire 010D,E01028888,1673,295,1378
2021,Shropshire 008C,E01028889,1581,288,1293
2021,Shropshire 008D,E01028890,1262,178,1084
2021,Shropshire 001A,E01028891,1569,247,1322
2021,Shropshire 001B,E01028892,1756,246,1510
2021,Shropshire 002D,E01028893,1527,201,1326
2021,Shropshire 001C,E01028894,1314,242,1072
2021,Shropshire 001D,E01028895,1592,256,1336
2021,Shropshire 001E,E01028896,2033,359,1674
2021,Shropshire 001F,E01028897,1419,218,1201
2021,Shropshire 010E,E01028898,1513,244,1269
2021,Shropshire 002E,E01028899,1766,276,1490
2021,Shropshire 006C,E01028902,1180,196,984
2021,Shropshire 006D,E01028903,1165,146,1019
2021,Shropshire 006E,E01028904,1603,324,1279
2021,Shropshire 006F,E01028905,1780,356,1424
2021,Shropshire 007A,E01028906,1288,155,1133
2021,Shropshire 007B,E01028907,1806,345,1461
2021,Shropshire 007C,E01028908,1443,227,1216
2021,Shropshire 006G,E01028909,1341,231,1110
2021,Shropshire 003A,E01028910,1340,257,1083
2021,Shropshire 003B,E01028911,1221,164,1057
2021,Shropshire 003C,E01028912,1345,274,1071
2021,Shropshire 011A,E01028913,1631,234,1397
2021,Shropshire 012A,E01028914,1008,125,883
2021,Shropshire 012B,E01028915,1471,230,1241
2021,Shropshire 007D,E01028916,1434,181,1253
2021,Shropshire 007E,E01028917,1387,281,1106
2021,Shropshire 011B,E01028918,1542,314,1228
2021,Shropshire 011C,E01028919,1224,252,972
2021,Shropshire 003D,E01028920,1191,205,986
2021,Shropshire 003E,E01028921,1723,299,1424
2021,Shropshire 012C,E01028922,1198,161,1037
2021,Shropshire 012D,E01028923,1545,243,1302
2021,Shropshire 007F,E01028924,1871,375,1496
2021,Shropshire 003F,E01028925,1387,336,1051
2021,Shropshire 003G,E01028926,1306,227,1079
2021,Shropshire 011D,E01028927,1111,172,939
2021,Shropshire 011E,E01028928,1573,263,1310
2021,Shropshire 014A,E01028929,1305,172,1133
2021,Shropshire 017A,E01028930,1726,280,1446
2021,Shropshire 017B,E01028931,2089,289,1800
2021,Shropshire 015A,E01028933,1414,211,1203
2021,Shropshire 015B,E01028934,1517,364,1153
2021,Shropshire 024A,E01028935,1498,258,1240
2021,Shropshire 024B,E01028936,2105,346,1759
2021,Shropshire 024C,E01028937,1351,233,1118
2021,Shropshire 022A,E01028938,1487,205,1282
2021,Shropshire 022B,E01028939,1505,215,1290
2021,Shropshire 023A,E01028940,1491,276,1215
2021,Shropshire 020B,E01028942,1550,282,1268
2021,Shropshire 020C,E01028943,2054,249,1805
2021,Shropshire 017C,E01028944,1887,262,1625
2021,Shropshire 017D,E01028945,1881,331,1550
2021,Shropshire 021A,E01028947,1645,224,1421
2021,Shropshire 021B,E01028948,1333,197,1136
2021,Shropshire 021C,E01028949,1462,236,1226
2021,Shropshire 028A,E01028950,2506,392,2114
2021,Shropshire 020D,E01028951,1919,401,1518
2021,Shropshire 023B,E01028952,1532,244,1288
2021,Shropshire 020E,E01028953,1479,284,1195
2021,Shropshire 026A,E01028954,1247,196,1051
2021,Shropshire 026B,E01028955,1184,218,966
2021,Shropshire 015C,E01028956,1449,228,1221
2021,Shropshire 015D,E01028957,1708,569,1139
2021,Shropshire 015E,E01028958,1624,253,1371
2021,Shropshire 028B,E01028960,1460,255,1205
2021,Shropshire 028C,E01028961,1431,365,1066
2021,Shropshire 023C,E01028962,1482,283,1199
2021,Shropshire 023D,E01028963,1531,276,1255
2021,Shropshire 023E,E01028964,1821,306,1515
2021,Shropshire 018A,E01028965,1236,208,1028
2021,Shropshire 018B,E01028966,1202,208,994
2021,Shropshire 018C,E01028967,1403,303,1100
2021,Shropshire 018D,E01028968,1285,268,1017
2021,Shropshire 014B,E01028969,1483,274,1209
2021,Shropshire 014C,E01028970,1454,182,1272
2021,Shropshire 014D,E01028971,2223,375,1848
2021,Shropshire 019B,E01028972,1822,357,1465
2021,Shropshire 019C,E01028973,1877,279,1598
2021,Shropshire 023F,E01028974,1694,749,945
2021,Shropshire 026C,E01028975,1887,346,1541
2021,Shropshire 026D,E01028976,1653,241,1412
2021,Shropshire 026E,E01028977,1917,308,1609
2021,Shropshire 014E,E01028978,1841,372,1469
2021,Shropshire 014F,E01028979,1119,184,935
2021,Shropshire 028D,E01028980,2113,301,1812
2021,Shropshire 016B,E01028981,1678,287,1391
2021,Shropshire 016C,E01028982,1506,290,1216
2021,Shropshire 016D,E01028983,1862,386,1476
2021,Shropshire 022C,E01028984,1259,172,1087
2021,Shropshire 021D,E01028985,1207,142,1065
2021,Shropshire 022D,E01028986,2058,305,1753
2021,Shropshire 018E,E01028988,1533,271,1262
2021,Shropshire 018F,E01028989,1486,305,1181
2021,Shropshire 032A,E01028990,1122,161,961
2021,Shropshire 030B,E01028992,1440,200,1240
2021,Shropshire 036A,E01028993,1451,212,1239
2021,Shropshire 037A,E01028994,1204,186,1018
2021,Shropshire 039A,E01028995,1383,210,1173
2021,Shropshire 039B,E01028996,1252,171,1081
2021,Shropshire 032B,E01028997,2296,272,2024
2021,Shropshire 032C,E01028998,2203,246,1957
2021,Shropshire 039C,E01028999,1474,200,1274
2021,Shropshire 039D,E01029000,1127,114,1013
2021,Shropshire 039E,E01029001,1993,299,1694
2021,Shropshire 039F,E01029002,1322,226,1096
2021,Shropshire 037B,E01029003,2142,222,1920
2021,Shropshire 037C,E01029005,1156,157,999
2021,Shropshire 038A,E01029006,1475,176,1299
2021,Shropshire 038B,E01029007,1056,221,835
2021,Shropshire 038D,E01029009,1195,200,995
2021,Shropshire 038E,E01029010,1200,183,1017
2021,Shropshire 038F,E01029011,1300,153,1147
2021,Shropshire 038G,E01029012,1806,301,1505
2021,Shropshire 036C,E01029013,1618,192,1426
2021,Shropshire 036D,E01029014,1082,214,868
2021,Shropshire 037D,E01029016,1418,198,1220
2021,Mendip 006A,E01029018,2327,362,1965
2021,Mendip 013A,E01029019,2551,428,2123
2021,Mendip 010A,E01029020,1452,255,1197
2021,Mendip 010B,E01029021,1194,193,1001
2021,Mendip 001A,E01029022,1414,246,1168
2021,Mendip 001B,E01029023,1258,219,1039
2021,Mendip 002A,E01029024,2176,388,1788
2021,Mendip 002B,E01029025,1309,268,1041
2021,Mendip 010C,E01029027,1470,240,1230
2021,Mendip 010D,E01029028,1078,111,967
2021,Mendip 007A,E01029029,1587,300,1287
2021,Mendip 003A,E01029030,1749,262,1487
2021,Mendip 003B,E01029031,1548,247,1301
2021,Mendip 003C,E01029032,1022,119,903
2021,Mendip 003D,E01029033,1320,209,1111
2021,Mendip 003E,E01029034,1227,208,1019
2021,Mendip 004A,E01029036,1743,307,1436
2021,Mendip 007C,E01029037,1330,263,1067
2021,Mendip 007D,E01029038,1515,340,1175
2021,Mendip 007E,E01029039,1472,231,1241
2021,Mendip 007F,E01029040,1537,235,1302
2021,Mendip 004B,E01029041,1932,346,1586
2021,Mendip 004C,E01029042,1418,268,1150
2021,Mendip 004D,E01029043,1610,343,1267
2021,Mendip 001C,E01029044,1326,249,1077
2021,Mendip 004E,E01029045,1570,264,1306
2021,Mendip 011A,E01029046,1310,119,1191
2021,Mendip 012A,E01029047,1286,187,1099
2021,Mendip 011D,E01029050,2525,401,2124
2021,Mendip 011E,E01029051,1384,159,1225
2021,Mendip 005A,E01029052,2013,332,1681
2021,Mendip 001D,E01029053,2286,386,1900
2021,Mendip 012B,E01029054,1606,276,1330
2021,Mendip 012C,E01029055,1214,231,983
2021,Mendip 006B,E01029056,2256,328,1928
2021,Mendip 001E,E01029057,2124,330,1794
2021,Mendip 010E,E01029058,2217,361,1856
2021,Mendip 013B,E01029059,2099,285,1814
2021,Mendip 005B,E01029060,1935,305,1630
2021,Mendip 009A,E01029062,1406,236,1170
2021,Mendip 009B,E01029063,2445,459,1986
2021,Mendip 006C,E01029064,1434,217,1217
2021,Mendip 009C,E01029065,1455,227,1228
2021,Mendip 009D,E01029066,1634,249,1385
2021,Mendip 009E,E01029067,1593,288,1305
2021,Mendip 002D,E01029068,1407,409,998
2021,Mendip 014A,E01029070,2369,469,1900
2021,Mendip 014B,E01029071,1391,215,1176
2021,Mendip 014C,E01029072,1512,261,1251
2021,Mendip 014D,E01029073,1201,254,947
2021,Mendip 012D,E01029074,2148,1036,1112
2021,Mendip 014E,E01029075,1359,220,1139
2021,Mendip 012E,E01029076,2196,411,1785
2021,Mendip 013C,E01029077,2030,316,1714
2021,Mendip 008A,E01029078,1781,212,1569
2021,Mendip 008B,E01029079,1404,199,1205
2021,Mendip 008C,E01029080,1644,265,1379
2021,Mendip 008D,E01029081,1845,263,1582
2021,Mendip 008E,E01029082,1292,164,1128
2021,Mendip 005D,E01029083,1323,355,968
2021,Mendip 006D,E01029084,1425,248,1177
2021,Sedgemoor 001A,E01029085,1922,346,1576
2021,Sedgemoor 003A,E01029086,2143,366,1777
2021,Sedgemoor 002C,E01029089,2251,385,1866
2021,Sedgemoor 010B,E01029091,1427,180,1247
2021,Sedgemoor 010C,E01029092,1326,211,1115
2021,Sedgemoor 008A,E01029093,1446,265,1181
2021,Sedgemoor 009A,E01029094,1802,294,1508
2021,Sedgemoor 009B,E01029095,1699,283,1416
2021,Sedgemoor 008B,E01029096,1614,300,1314
2021,Sedgemoor 013A,E01029097,1390,311,1079
2021,Sedgemoor 013B,E01029098,1636,252,1384
2021,Sedgemoor 013C,E01029099,1292,283,1009
2021,Sedgemoor 013D,E01029100,1430,372,1058
2021,Sedgemoor 014A,E01029101,1065,188,877
2021,Sedgemoor 011A,E01029102,1845,303,1542
2021,Sedgemoor 011B,E01029103,1451,197,1254
2021,Sedgemoor 011C,E01029104,1894,412,1482
2021,Sedgemoor 013E,E01029105,1613,301,1312
2021,Sedgemoor 008C,E01029106,1552,407,1145
2021,Sedgemoor 008D,E01029107,1481,324,1157
2021,Sedgemoor 010D,E01029108,1956,290,1666
2021,Sedgemoor 008E,E01029109,1326,312,1014
2021,Sedgemoor 009C,E01029110,2075,339,1736
2021,Sedgemoor 009D,E01029111,2299,527,1772
2021,Sedgemoor 009E,E01029112,2103,202,1901
2021,Sedgemoor 002D,E01029113,1566,161,1405
2021,Sedgemoor 004A,E01029114,1443,141,1302
2021,Sedgemoor 002E,E01029115,1530,210,1320
2021,Sedgemoor 004B,E01029116,1523,155,1368
2021,Sedgemoor 004C,E01029117,1626,214,1412
2021,Sedgemoor 005A,E01029118,1650,270,1380
2021,Sedgemoor 004D,E01029119,1547,182,1365
2021,Sedgemoor 004E,E01029120,1389,219,1170
2021,Sedgemoor 007A,E01029121,1205,162,1043
2021,Sedgemoor 007B,E01029122,1472,296,1176
2021,Sedgemoor 007C,E01029123,1093,261,832
2021,Sedgemoor 007D,E01029124,1762,269,1493
2021,Sedgemoor 007E,E01029125,1341,206,1135
2021,Sedgemoor 001B,E01029126,1473,235,1238
2021,Sedgemoor 001C,E01029127,1532,224,1308
2021,Sedgemoor 001D,E01029128,1821,317,1504
2021,Sedgemoor 001E,E01029129,2225,424,1801
2021,Sedgemoor 012A,E01029130,1970,285,1685
2021,Sedgemoor 005B,E01029131,2109,384,1725
2021,Sedgemoor 005C,E01029132,1462,330,1132
2021,Sedgemoor 005D,E01029133,1210,158,1052
2021,Sedgemoor 005E,E01029134,2002,343,1659
2021,Sedgemoor 006A,E01029135,1624,207,1417
2021,Sedgemoor 006B,E01029136,2147,368,1779
2021,Sedgemoor 012B,E01029137,1648,220,1428
2021,Sedgemoor 012C,E01029138,1390,215,1175
2021,Sedgemoor 012D,E01029139,1494,246,1248
2021,Sedgemoor 014C,E01029142,1447,235,1212
2021,Sedgemoor 014D,E01029143,1306,206,1100
2021,Sedgemoor 014E,E01029144,1200,167,1033
2021,Sedgemoor 006C,E01029145,2162,314,1848
2021,Sedgemoor 003B,E01029147,1659,276,1383
2021,Sedgemoor 003C,E01029148,1524,285,1239
2021,Sedgemoor 003D,E01029149,1360,232,1128
2021,Sedgemoor 012E,E01029150,1279,177,1102
2021,Sedgemoor 012F,E01029151,1268,156,1112
2021,Sedgemoor 006D,E01029152,2193,336,1857
2021,South Somerset 024A,E01029153,2319,302,2017
2021,South Somerset 008A,E01029154,1819,314,1505
2021,South Somerset 005A,E01029155,1743,219,1524
2021,South Somerset 008B,E01029156,1856,272,1584
2021,South Somerset 001A,E01029157,1389,380,1009
2021,South Somerset 001B,E01029158,1354,354,1000
2021,South Somerset 018A,E01029159,1886,368,1518
2021,South Somerset 013A,E01029161,1462,295,1167
2021,South Somerset 013B,E01029162,1446,178,1268
2021,South Somerset 010A,E01029163,2128,271,1857
2021,South Somerset 006A,E01029164,1594,360,1234
2021,South Somerset 006B,E01029165,1181,166,1015
2021,South Somerset 002A,E01029166,2365,346,2019
2021,South Somerset 002B,E01029167,1628,264,1364
2021,South Somerset 002C,E01029168,1689,216,1473
2021,South Somerset 022A,E01029169,1657,306,1351
2021,South Somerset 023A,E01029170,1172,241,931
2021,South Somerset 023B,E01029171,2208,306,1902
2021,South Somerset 022B,E01029172,1423,202,1221
2021,South Somerset 022C,E01029173,1341,234,1107
2021,South Somerset 023C,E01029174,1043,128,915
2021,South Somerset 023D,E01029175,2123,419,1704
2021,South Somerset 022D,E01029176,1311,181,1130
2021,South Somerset 022E,E01029177,1203,186,1017
2021,South Somerset 020A,E01029178,1499,220,1279
2021,South Somerset 020B,E01029179,1041,175,866
2021,South Somerset 020C,E01029180,1406,217,1189
2021,South Somerset 020D,E01029181,1268,168,1100
2021,South Somerset 021A,E01029182,1606,230,1376
2021,South Somerset 021B,E01029183,1594,309,1285
2021,South Somerset 021C,E01029184,1704,235,1469
2021,South Somerset 021D,E01029185,1612,184,1428
2021,South Somerset 021E,E01029186,1481,212,1269
2021,South Somerset 007A,E01029187,1150,218,932
2021,South Somerset 007B,E01029188,1467,197,1270
2021,South Somerset 017A,E01029189,1040,157,883
2021,South Somerset 017B,E01029190,1391,188,1203
2021,South Somerset 017C,E01029191,1238,193,1045
2021,South Somerset 017D,E01029192,1337,210,1127
2021,South Somerset 019A,E01029193,1855,304,1551
2021,South Somerset 019B,E01029194,2507,393,2114
2021,South Somerset 019C,E01029195,1468,179,1289
2021,South Somerset 007C,E01029196,1674,316,1358
2021,South Somerset 007D,E01029197,1248,193,1055
2021,South Somerset 006C,E01029198,1077,261,816
2021,South Somerset 006D,E01029199,2722,261,2461
2021,South Somerset 004A,E01029200,1526,242,1284
2021,South Somerset 004B,E01029201,1688,235,1453
2021,South Somerset 009A,E01029202,1155,146,1009
2021,South Somerset 009B,E01029203,1426,194,1232
2021,South Somerset 009C,E01029204,1188,146,1042
2021,South Somerset 009D,E01029205,1616,233,1383
2021,South Somerset 008C,E01029206,1637,265,1372
2021,South Somerset 008D,E01029207,1398,195,1203
2021,South Somerset 019D,E01029208,1234,172,1062
2021,South Somerset 019E,E01029209,1289,177,1112
2021,South Somerset 002D,E01029210,1747,269,1478
2021,South Somerset 002E,E01029211,1340,184,1156
2021,South Somerset 017E,E01029212,1068,132,936
2021,South Somerset 017F,E01029213,1247,171,1076
2021,South Somerset 017G,E01029214,1164,207,957
2021,South Somerset 017H,E01029215,1107,180,927
2021,South Somerset 010B,E01029216,1557,223,1334
2021,South Somerset 010C,E01029217,1522,181,1341
2021,South Somerset 010D,E01029218,1998,342,1656
2021,South Somerset 024B,E01029219,1398,189,1209
2021,South Somerset 024C,E01029220,1234,199,1035
2021,South Somerset 001C,E01029221,2365,390,1975
2021,South Somerset 004C,E01029222,1654,249,1405
2021,South Somerset 004D,E01029223,1180,150,1030
2021,South Somerset 003A,E01029224,2011,296,1715
2021,South Somerset 003B,E01029225,2353,430,1923
2021,South Somerset 003C,E01029226,1569,206,1363
2021,South Somerset 005B,E01029227,2144,387,1757
2021,South Somerset 005C,E01029228,2020,361,1659
2021,South Somerset 005D,E01029229,1983,262,1721
2021,South Somerset 024D,E01029230,2275,288,1987
2021,South Somerset 014A,E01029231,1410,231,1179
2021,South Somerset 015A,E01029232,1497,273,1224
2021,South Somerset 014B,E01029233,1626,390,1236
2021,South Somerset 014C,E01029235,1341,233,1108
2021,South Somerset 014D,E01029236,1396,307,1089
2021,South Somerset 014E,E01029237,1603,353,1250
2021,South Somerset 011A,E01029238,1385,281,1104
2021,South Somerset 015C,E01029239,1684,286,1398
2021,South Somerset 015D,E01029240,1511,284,1227
2021,South Somerset 016A,E01029241,2015,373,1642
2021,South Somerset 018B,E01029242,1381,226,1155
2021,South Somerset 018C,E01029243,1524,157,1367
2021,South Somerset 018D,E01029244,1417,199,1218
2021,South Somerset 016B,E01029245,2128,406,1722
2021,South Somerset 016C,E01029246,1374,187,1187
2021,South Somerset 013C,E01029247,1498,435,1063
2021,South Somerset 012B,E01029248,1465,327,1138
2021,South Somerset 016D,E01029249,1285,209,1076
2021,South Somerset 012C,E01029250,1284,184,1100
2021,South Somerset 012D,E01029251,1706,272,1434
2021,South Somerset 011B,E01029252,1296,186,1110
2021,South Somerset 011D,E01029254,1280,181,1099
2021,South Somerset 013D,E01029255,1254,196,1058
2021,Somerset West and Taunton 012A,E01029256,2130,443,1687
2021,Somerset West and Taunton 012B,E01029257,2147,444,1703
2021,Somerset West and Taunton 006A,E01029258,1562,268,1294
2021,Somerset West and Taunton 006B,E01029259,1456,231,1225
2021,Somerset West and Taunton 006C,E01029260,2259,549,1710
2021,Somerset West and Taunton 019A,E01029261,2208,330,1878
2021,Somerset West and Taunton 017A,E01029262,2245,341,1904
2021,Somerset West and Taunton 016A,E01029263,1325,281,1044
2021,Somerset West and Taunton 016B,E01029264,1306,220,1086
2021,Somerset West and Taunton 016C,E01029265,1304,186,1118
2021,Somerset West and Taunton 015A,E01029266,1250,248,1002
2021,Somerset West and Taunton 013A,E01029267,1650,273,1377
2021,Somerset West and Taunton 006D,E01029268,1593,261,1332
2021,Somerset West and Taunton 017B,E01029269,2124,237,1887
2021,Somerset West and Taunton 019B,E01029270,2171,290,1881
2021,Somerset West and Taunton 009A,E01029271,1831,311,1520
2021,Somerset West and Taunton 009B,E01029273,1348,283,1065
2021,Somerset West and Taunton 009C,E01029274,1790,296,1494
2021,Somerset West and Taunton 009D,E01029275,1220,167,1053
2021,Somerset West and Taunton 007A,E01029276,1668,572,1096
2021,Somerset West and Taunton 012C,E01029277,1298,226,1072
2021,Somerset West and Taunton 007B,E01029278,1389,237,1152
2021,Somerset West and Taunton 009E,E01029279,1480,218,1262
2021,Somerset West and Taunton 014A,E01029280,1639,362,1277
2021,Somerset West and Taunton 014B,E01029281,1577,241,1336
2021,Somerset West and Taunton 008A,E01029282,1284,202,1082
2021,Somerset West and Taunton 014C,E01029283,1657,263,1394
2021,Somerset West and Taunton 015B,E01029284,1643,135,1508
2021,Somerset West and Taunton 011A,E01029285,2371,379,1992
2021,Somerset West and Taunton 015C,E01029286,1601,255,1346
2021,Somerset West and Taunton 011B,E01029287,1433,231,1202
2021,Somerset West and Taunton 011C,E01029288,1413,249,1164
2021,Somerset West and Taunton 011D,E01029289,1777,267,1510
2021,Somerset West and Taunton 007C,E01029290,1337,214,1123
2021,Somerset West and Taunton 008B,E01029291,1505,199,1306
2021,Somerset West and Taunton 014D,E01029292,1468,326,1142
2021,Somerset West and Taunton 014E,E01029293,1541,462,1079
2021,Somerset West and Taunton 008C,E01029294,1742,300,1442
2021,Somerset West and Taunton 019C,E01029295,1505,216,1289
2021,Somerset West and Taunton 019D,E01029296,2126,567,1559
2021,Somerset West and Taunton 010A,E01029297,1299,250,1049
2021,Somerset West and Taunton 010B,E01029298,1339,246,1093
2021,Somerset West and Taunton 011E,E01029299,1520,210,1310
2021,Somerset West and Taunton 011F,E01029300,2101,291,1810
2021,Somerset West and Taunton 015D,E01029301,1995,228,1767
2021,Somerset West and Taunton 016D,E01029302,1682,303,1379
2021,Somerset West and Taunton 015E,E01029303,1821,300,1521
2021,Somerset West and Taunton 010C,E01029304,1345,218,1127
2021,Somerset West and Taunton 010D,E01029305,1271,196,1075
2021,Somerset West and Taunton 007D,E01029306,1446,226,1220
2021,Somerset West and Taunton 010E,E01029307,1282,271,1011
2021,Somerset West and Taunton 016E,E01029308,1990,367,1623
2021,Somerset West and Taunton 017C,E01029310,1873,323,1550
2021,Somerset West and Taunton 018A,E01029311,2296,411,1885
2021,Somerset West and Taunton 018B,E01029312,1309,243,1066
2021,Somerset West and Taunton 018C,E01029313,1508,236,1272
2021,Somerset West and Taunton 017D,E01029315,1344,162,1182
2021,Somerset West and Taunton 018D,E01029316,1650,196,1454
2021,Somerset West and Taunton 008D,E01029317,1761,332,1429
2021,Somerset West and Taunton 007E,E01029319,1916,359,1557
2021,Somerset West and Taunton 013B,E01029320,1662,272,1390
2021,Somerset West and Taunton 013C,E01029321,2258,357,1901
2021,Somerset West and Taunton 002A,E01029322,1589,193,1396
2021,Somerset West and Taunton 001A,E01029324,1660,344,1316
2021,Somerset West and Taunton 005A,E01029325,1936,206,1730
2021,Somerset West and Taunton 003A,E01029326,1216,144,1072
2021,Somerset West and Taunton 004A,E01029327,1973,266,1707
2021,Somerset West and Taunton 005B,E01029328,1873,222,1651
2021,Somerset West and Taunton 001B,E01029329,1690,207,1483
2021,Somerset West and Taunton 001C,E01029330,1866,171,1695
2021,Somerset West and Taunton 002B,E01029331,1451,138,1313
2021,Somerset West and Taunton 002C,E01029333,1122,153,969
2021,Somerset West and Taunton 003B,E01029334,1089,119,970
2021,Somerset West and Taunton 004B,E01029335,1067,123,944
2021,Somerset West and Taunton 002D,E01029336,2010,210,1800
2021,Somerset West and Taunton 004C,E01029337,2084,289,1795
2021,Somerset West and Taunton 005C,E01029338,1640,173,1467
2021,Somerset West and Taunton 003C,E01029339,1477,258,1219
2021,Somerset West and Taunton 003D,E01029341,1252,123,1129
2021,Somerset West and Taunton 004D,E01029342,1061,104,957
2021,Somerset West and Taunton 004E,E01029343,1555,173,1382
2021,Cannock Chase 003A,E01029345,1882,353,1529
2021,Cannock Chase 003B,E01029346,1656,357,1299
2021,Cannock Chase 003C,E01029347,1437,185,1252
2021,Cannock Chase 003D,E01029348,1648,311,1337
2021,Cannock Chase 008A,E01029349,1295,206,1089
2021,Cannock Chase 008B,E01029350,1443,220,1223
2021,Cannock Chase 008C,E01029351,1433,317,1116
2021,Cannock Chase 008D,E01029352,1210,183,1027
2021,Cannock Chase 011A,E01029353,1313,177,1136
2021,Cannock Chase 007A,E01029354,1414,234,1180
2021,Cannock Chase 007B,E01029355,1340,204,1136
2021,Cannock Chase 007C,E01029356,1363,257,1106
2021,Cannock Chase 007D,E01029357,1565,307,1258
2021,Cannock Chase 007E,E01029358,1247,355,892
2021,Cannock Chase 012A,E01029359,2181,403,1778
2021,Cannock Chase 012B,E01029360,1459,271,1188
2021,Cannock Chase 012C,E01029361,1332,221,1111
2021,Cannock Chase 012D,E01029362,1522,283,1239
2021,Cannock Chase 012E,E01029363,1264,148,1116
2021,Cannock Chase 011B,E01029364,1577,215,1362
2021,Cannock Chase 011C,E01029365,1452,213,1239
2021,Cannock Chase 011D,E01029366,1659,210,1449
2021,Cannock Chase 011E,E01029367,2100,328,1772
2021,Cannock Chase 001A,E01029368,1158,145,1013
2021,Cannock Chase 001B,E01029369,1148,187,961
2021,Cannock Chase 001C,E01029370,1326,168,1158
2021,Cannock Chase 001D,E01029371,1407,247,1160
2021,Cannock Chase 002A,E01029372,1222,246,976
2021,Cannock Chase 002B,E01029373,2137,445,1692
2021,Cannock Chase 003E,E01029374,2142,423,1719
2021,Cannock Chase 010A,E01029375,2247,501,1746
2021,Cannock Chase 010B,E01029376,1633,293,1340
2021,Cannock Chase 010C,E01029377,1304,264,1040
2021,Cannock Chase 010D,E01029378,1544,266,1278
2021,Cannock Chase 006A,E01029379,1648,349,1299
2021,Cannock Chase 009A,E01029380,1378,248,1130
2021,Cannock Chase 009B,E01029381,1340,201,1139
2021,Cannock Chase 009C,E01029382,1570,217,1353
2021,Cannock Chase 004A,E01029383,1764,265,1499
2021,Cannock Chase 004B,E01029385,1471,213,1258
2021,Cannock Chase 005B,E01029386,1358,237,1121
2021,Cannock Chase 005C,E01029387,1378,209,1169
2021,Cannock Chase 004C,E01029388,1306,195,1111
2021,Cannock Chase 005D,E01029389,1584,186,1398
2021,Cannock Chase 004D,E01029390,988,198,790
2021,Cannock Chase 009D,E01029391,1626,255,1371
2021,Cannock Chase 009E,E01029392,2022,380,1642
2021,Cannock Chase 008E,E01029393,1527,203,1324
2021,Cannock Chase 013A,E01029394,1454,207,1247
2021,Cannock Chase 013B,E01029395,2346,367,1979
2021,Cannock Chase 013C,E01029396,1544,200,1344
2021,Cannock Chase 013D,E01029397,2469,563,1906
2021,Cannock Chase 006B,E01029398,1562,244,1318
2021,Cannock Chase 006C,E01029399,1355,177,1178
2021,Cannock Chase 006D,E01029400,1569,284,1285
2021,Cannock Chase 002C,E01029401,1441,253,1188
2021,Cannock Chase 001E,E01029402,2047,313,1734
2021,Cannock Chase 002D,E01029403,1327,252,1075
2021,Cannock Chase 002E,E01029404,1595,181,1414
2021,East Staffordshire 001A,E01029405,1551,257,1294
2021,East Staffordshire 001B,E01029406,1228,201,1027
2021,East Staffordshire 011A,E01029407,1543,399,1144
2021,East Staffordshire 011B,E01029408,2173,515,1658
2021,East Staffordshire 011C,E01029409,1901,423,1478
2021,East Staffordshire 011D,E01029410,1609,397,1212
2021,East Staffordshire 006A,E01029411,1385,255,1130
2021,East Staffordshire 006B,E01029412,1282,199,1083
2021,East Staffordshire 013A,E01029413,1362,204,1158
2021,East Staffordshire 013B,E01029414,1636,302,1334
2021,East Staffordshire 013C,E01029415,1558,320,1238
2021,East Staffordshire 013D,E01029416,2286,440,1846
2021,East Staffordshire 013E,E01029417,1938,424,1514
2021,East Staffordshire 012A,E01029418,1933,310,1623
2021,East Staffordshire 012B,E01029419,1483,245,1238
2021,East Staffordshire 012C,E01029420,1594,231,1363
2021,East Staffordshire 001C,E01029422,1258,298,960
2021,East Staffordshire 001D,E01029423,1471,281,1190
2021,East Staffordshire 006C,E01029424,999,125,874
2021,East Staffordshire 006D,E01029425,2412,205,2207
2021,East Staffordshire 008A,E01029426,2149,491,1658
2021,East Staffordshire 008B,E01029427,1641,408,1233
2021,East Staffordshire 008C,E01029428,2240,481,1759
2021,East Staffordshire 008D,E01029429,1375,356,1019
2021,East Staffordshire 002A,E01029430,2326,458,1868
2021,East Staffordshire 002B,E01029431,1527,314,1213
2021,East Staffordshire 002C,E01029432,1332,217,1115
2021,East Staffordshire 002D,E01029433,1468,311,1157
2021,East Staffordshire 007A,E01029434,1513,351,1162
2021,East Staffordshire 007B,E01029435,1426,233,1193
2021,East Staffordshire 007C,E01029436,1723,363,1360
2021,East Staffordshire 007D,E01029437,2551,623,1928
2021,East Staffordshire 007E,E01029438,1384,230,1154
2021,East Staffordshire 015A,E01029439,1329,206,1123
2021,East Staffordshire 015B,E01029440,1239,239,1000
2021,East Staffordshire 015C,E01029441,1547,247,1300
2021,East Staffordshire 015D,E01029442,1603,370,1233
2021,East Staffordshire 004A,E01029443,1622,270,1352
2021,East Staffordshire 004B,E01029444,1502,220,1282
2021,East Staffordshire 009A,E01029445,2395,546,1849
2021,East Staffordshire 009B,E01029446,2031,403,1628
2021,East Staffordshire 009C,E01029447,1674,447,1227
2021,East Staffordshire 009D,E01029448,1755,357,1398
2021,East Staffordshire 014A,E01029449,1590,248,1342
2021,East Staffordshire 014B,E01029450,1503,362,1141
2021,East Staffordshire 014C,E01029451,1679,244,1435
2021,East Staffordshire 014D,E01029452,1515,254,1261
2021,East Staffordshire 014E,E01029453,1426,279,1147
2021,East Staffordshire 005A,E01029454,1502,267,1235
2021,East Staffordshire 005B,E01029455,1655,268,1387
2021,East Staffordshire 005C,E01029456,1363,174,1189
2021,East Staffordshire 005D,E01029457,1230,231,999
2021,East Staffordshire 005E,E01029458,1703,294,1409
2021,East Staffordshire 003A,E01029459,1450,273,1177
2021,East Staffordshire 003B,E01029460,1670,285,1385
2021,East Staffordshire 003C,E01029461,1884,317,1567
2021,East Staffordshire 003D,E01029462,1601,236,1365
2021,East Staffordshire 004C,E01029463,1194,219,975
2021,East Staffordshire 004D,E01029464,1461,232,1229
2021,East Staffordshire 004E,E01029465,2020,309,1711
2021,East Staffordshire 004F,E01029466,2164,453,1711
2021,East Staffordshire 001E,E01029467,1930,230,1700
2021,East Staffordshire 010A,E01029468,1506,364,1142
2021,East Staffordshire 010B,E01029469,1712,274,1438
2021,East Staffordshire 010C,E01029470,1524,324,1200
2021,East Staffordshire 010D,E01029471,1671,273,1398
2021,East Staffordshire 010E,E01029472,1504,330,1174
2021,East Staffordshire 006E,E01029473,1516,241,1275
2021,East Staffordshire 006F,E01029474,1140,193,947
2021,Lichfield 009A,E01029475,1949,299,1650
2021,Lichfield 009B,E01029476,1309,197,1112
2021,Lichfield 002A,E01029477,1545,230,1315
2021,Lichfield 002B,E01029478,1452,272,1180
2021,Lichfield 001A,E01029480,1839,308,1531
2021,Lichfield 001C,E01029482,1501,240,1261
2021,Lichfield 005A,E01029483,1447,254,1193
2021,Lichfield 005B,E01029484,1632,193,1439
2021,Lichfield 005C,E01029485,1372,204,1168
2021,Lichfield 003A,E01029486,1356,190,1166
2021,Lichfield 006A,E01029487,1533,235,1298
2021,Lichfield 012A,E01029488,2238,299,1939
2021,Lichfield 009C,E01029489,1464,161,1303
2021,Lichfield 009D,E01029490,1341,182,1159
2021,Lichfield 007A,E01029491,1660,300,1360
2021,Lichfield 004A,E01029492,1816,437,1379
2021,Lichfield 006B,E01029493,1807,296,1511
2021,Lichfield 006C,E01029494,1482,215,1267
2021,Lichfield 006D,E01029495,1517,234,1283
2021,Lichfield 010A,E01029496,1795,359,1436
2021,Lichfield 001D,E01029498,1882,241,1641
2021,Lichfield 004B,E01029499,1574,307,1267
2021,Lichfield 005D,E01029500,1542,206,1336
2021,Lichfield 004C,E01029501,1514,330,1184
2021,Lichfield 012B,E01029502,1563,284,1279
2021,Lichfield 012C,E01029503,1520,238,1282
2021,Lichfield 012D,E01029504,1561,240,1321
2021,Lichfield 009E,E01029505,1521,204,1317
2021,Lichfield 009F,E01029506,1679,215,1464
2021,Lichfield 003B,E01029507,1565,252,1313
2021,Lichfield 003C,E01029508,2171,391,1780
2021,Lichfield 002D,E01029509,1645,249,1396
2021,Lichfield 007B,E01029511,1512,264,1248
2021,Lichfield 007C,E01029512,2032,372,1660
2021,Lichfield 011A,E01029513,1369,259,1110
2021,Lichfield 011B,E01029514,1576,252,1324
2021,Lichfield 003D,E01029515,1786,228,1558
2021,Lichfield 008A,E01029516,1943,306,1637
2021,Lichfield 008B,E01029517,1953,321,1632
2021,Lichfield 007D,E01029518,2627,499,2128
2021,Lichfield 007E,E01029519,2040,359,1681
2021,Lichfield 005E,E01029520,1504,288,1216
2021,Lichfield 011C,E01029521,1658,249,1409
2021,Lichfield 011D,E01029522,1546,220,1326
2021,Lichfield 011E,E01029523,1505,250,1255
2021,Lichfield 005F,E01029524,1697,245,1452
2021,Lichfield 005G,E01029525,1802,240,1562
2021,Lichfield 004E,E01029526,1611,144,1467
2021,Lichfield 010B,E01029527,1140,227,913
2021,Lichfield 010C,E01029528,1229,228,1001
2021,Lichfield 010D,E01029529,1182,270,912
2021,Lichfield 008D,E01029531,1623,248,1375
2021,Newcastle-under-Lyme 005A,E01029532,1423,213,1210
2021,Newcastle-under-Lyme 005B,E01029533,1407,216,1191
2021,Newcastle-under-Lyme 005C,E01029534,1403,176,1227
2021,Newcastle-under-Lyme 005D,E01029535,1297,247,1050
2021,Newcastle-under-Lyme 004A,E01029536,1385,184,1201
2021,Newcastle-under-Lyme 006A,E01029537,1437,283,1154
2021,Newcastle-under-Lyme 006B,E01029538,1592,342,1250
2021,Newcastle-under-Lyme 006C,E01029539,1398,253,1145
2021,Newcastle-under-Lyme 003A,E01029540,1263,183,1080
2021,Newcastle-under-Lyme 003B,E01029541,1703,384,1319
2021,Newcastle-under-Lyme 003C,E01029542,1477,204,1273
2021,Newcastle-under-Lyme 003D,E01029543,1162,257,905
2021,Newcastle-under-Lyme 004B,E01029544,1276,227,1049
2021,Newcastle-under-Lyme 004C,E01029545,1408,254,1154
2021,Newcastle-under-Lyme 004D,E01029546,1219,268,951
2021,Newcastle-under-Lyme 007A,E01029547,1376,278,1098
2021,Newcastle-under-Lyme 007B,E01029548,1230,260,970
2021,Newcastle-under-Lyme 014A,E01029549,1553,290,1263
2021,Newcastle-under-Lyme 014B,E01029551,1541,384,1157
2021,Newcastle-under-Lyme 006D,E01029552,1390,261,1129
2021,Newcastle-under-Lyme 010A,E01029553,1572,367,1205
2021,Newcastle-under-Lyme 010B,E01029554,1744,411,1333
2021,Newcastle-under-Lyme 011A,E01029555,1706,496,1210
2021,Newcastle-under-Lyme 005E,E01029556,2426,372,2054
2021,Newcastle-under-Lyme 013A,E01029557,1202,166,1036
2021,Newcastle-under-Lyme 006E,E01029558,1604,365,1239
2021,Newcastle-under-Lyme 007C,E01029559,1381,232,1149
2021,Newcastle-under-Lyme 007D,E01029560,1473,356,1117
2021,Newcastle-under-Lyme 002A,E01029561,1382,278,1104
2021,Newcastle-under-Lyme 001A,E01029562,1168,180,988
2021,Newcastle-under-Lyme 002B,E01029563,1240,172,1068
2021,Newcastle-under-Lyme 002C,E01029564,1244,313,931
2021,Newcastle-under-Lyme 001B,E01029565,1107,175,932
2021,Newcastle-under-Lyme 010C,E01029566,1115,325,790
2021,Newcastle-under-Lyme 010D,E01029567,1564,300,1264
2021,Newcastle-under-Lyme 007E,E01029568,1310,247,1063
2021,Newcastle-under-Lyme 016A,E01029569,1381,186,1195
2021,Newcastle-under-Lyme 016B,E01029570,2576,394,2182
2021,Newcastle-under-Lyme 016C,E01029571,1210,155,1055
2021,Newcastle-under-Lyme 016D,E01029572,1529,237,1292
2021,Newcastle-under-Lyme 013B,E01029573,1343,220,1123
2021,Newcastle-under-Lyme 013C,E01029574,1414,215,1199
2021,Newcastle-under-Lyme 013D,E01029575,987,172,815
2021,Newcastle-under-Lyme 012A,E01029576,3135,2217,918
2021,Newcastle-under-Lyme 009A,E01029577,1415,218,1197
2021,Newcastle-under-Lyme 011B,E01029578,1598,237,1361
2021,Newcastle-under-Lyme 009B,E01029579,1569,271,1298
2021,Newcastle-under-Lyme 009C,E01029580,1309,231,1078
2021,Newcastle-under-Lyme 001C,E01029581,1499,224,1275
2021,Newcastle-under-Lyme 001D,E01029582,1759,299,1460
2021,Newcastle-under-Lyme 008A,E01029583,1313,169,1144
2021,Newcastle-under-Lyme 008B,E01029584,1168,191,977
2021,Newcastle-under-Lyme 008C,E01029585,1273,197,1076
2021,Newcastle-under-Lyme 001E,E01029586,1137,125,1012
2021,Newcastle-under-Lyme 001F,E01029587,1119,157,962
2021,Newcastle-under-Lyme 002D,E01029588,1542,221,1321
2021,Newcastle-under-Lyme 015B,E01029589,1121,168,953
2021,Newcastle-under-Lyme 015C,E01029590,1305,210,1095
2021,Newcastle-under-Lyme 014C,E01029591,1429,285,1144
2021,Newcastle-under-Lyme 012B,E01029593,2437,640,1797
2021,Newcastle-under-Lyme 012C,E01029594,1729,325,1404
2021,Newcastle-under-Lyme 003E,E01029595,1150,117,1033
2021,Newcastle-under-Lyme 004E,E01029596,1004,93,911
2021,Newcastle-under-Lyme 003F,E01029597,1388,264,1124
2021,Newcastle-under-Lyme 010E,E01029598,1938,653,1285
2021,Newcastle-under-Lyme 010F,E01029599,1467,416,1051
2021,Newcastle-under-Lyme 014D,E01029600,1419,263,1156
2021,Newcastle-under-Lyme 015E,E01029601,1425,286,1139
2021,Newcastle-under-Lyme 011C,E01029602,1630,521,1109
2021,Newcastle-under-Lyme 011D,E01029603,1352,282,1070
2021,Newcastle-under-Lyme 011E,E01029604,1749,638,1111
2021,Newcastle-under-Lyme 014E,E01029605,1295,309,986
2021,Newcastle-under-Lyme 015F,E01029606,1397,276,1121
2021,Newcastle-under-Lyme 014F,E01029607,1348,271,1077
2021,Newcastle-under-Lyme 015G,E01029608,1451,249,1202
2021,Newcastle-under-Lyme 008D,E01029609,1514,232,1282
2021,Newcastle-under-Lyme 009D,E01029610,1284,234,1050
2021,Newcastle-under-Lyme 008E,E01029611,1747,336,1411
2021,Newcastle-under-Lyme 009E,E01029612,1113,155,958
2021,South Staffordshire 008A,E01029613,1256,160,1096
2021,South Staffordshire 008B,E01029614,1571,259,1312
2021,South Staffordshire 008C,E01029615,1131,221,910
2021,South Staffordshire 006A,E01029616,1442,182,1260
2021,South Staffordshire 003A,E01029617,1557,244,1313
2021,South Staffordshire 003B,E01029618,1489,216,1273
2021,South Staffordshire 006B,E01029619,1847,263,1584
2021,South Staffordshire 004A,E01029620,1161,192,969
2021,South Staffordshire 002A,E01029621,1409,222,1187
2021,South Staffordshire 004B,E01029622,1541,276,1265
2021,South Staffordshire 004C,E01029623,1095,146,949
2021,South Staffordshire 004D,E01029624,1243,193,1050
2021,South Staffordshire 004E,E01029625,987,127,860
2021,South Staffordshire 009A,E01029626,1476,244,1232
2021,South Staffordshire 008D,E01029627,1316,230,1086
2021,South Staffordshire 009B,E01029628,1543,315,1228
2021,South Staffordshire 009C,E01029629,1143,201,942
2021,South Staffordshire 009D,E01029630,1326,216,1110
2021,South Staffordshire 009E,E01029631,1338,240,1098
2021,South Staffordshire 007A,E01029632,1666,220,1446
2021,South Staffordshire 007B,E01029633,1794,328,1466
2021,South Staffordshire 007C,E01029634,1503,287,1216
2021,South Staffordshire 007D,E01029635,1633,308,1325
2021,South Staffordshire 006C,E01029636,1334,186,1148
2021,South Staffordshire 006D,E01029637,4637,288,4349
2021,South Staffordshire 005A,E01029638,1865,237,1628
2021,South Staffordshire 005B,E01029639,1294,222,1072
2021,South Staffordshire 005C,E01029640,1264,225,1039
2021,South Staffordshire 004F,E01029641,1865,300,1565
2021,South Staffordshire 004G,E01029642,1397,183,1214
2021,South Staffordshire 005D,E01029643,1408,257,1151
2021,South Staffordshire 005E,E01029644,1317,158,1159
2021,South Staffordshire 013A,E01029645,2418,318,2100
2021,South Staffordshire 002B,E01029646,1475,260,1215
2021,South Staffordshire 002C,E01029647,2244,444,1800
2021,South Staffordshire 002D,E01029648,1328,225,1103
2021,South Staffordshire 014A,E01029649,1132,110,1022
2021,South Staffordshire 014B,E01029650,1436,193,1243
2021,South Staffordshire 014C,E01029651,1412,184,1228
2021,South Staffordshire 014D,E01029652,1698,285,1413
2021,South Staffordshire 014E,E01029653,1187,226,961
2021,South Staffordshire 015G,E01029654,2161,372,1789
2021,South Staffordshire 001A,E01029655,1845,249,1596
2021,South Staffordshire 001B,E01029656,1723,238,1485
2021,South Staffordshire 001C,E01029657,1593,347,1246
2021,South Staffordshire 001D,E01029658,1911,291,1620
2021,South Staffordshire 001E,E01029659,1269,210,1059
2021,South Staffordshire 001F,E01029660,2071,309,1762
2021,South Staffordshire 015C,E01029661,1838,263,1575
2021,South Staffordshire 015D,E01029662,1931,334,1597
2021,South Staffordshire 015E,E01029663,1312,205,1107
2021,South Staffordshire 015F,E01029664,1369,193,1176
2021,South Staffordshire 015A,E01029665,1592,199,1393
2021,South Staffordshire 015B,E01029666,1384,246,1138
2021,South Staffordshire 013B,E01029667,2172,309,1863
2021,South Staffordshire 003C,E01029668,1269,163,1106
2021,South Staffordshire 003D,E01029669,1265,207,1058
2021,South Staffordshire 003E,E01029670,1484,256,1228
2021,South Staffordshire 012A,E01029671,1464,250,1214
2021,South Staffordshire 013C,E01029672,1541,256,1285
2021,South Staffordshire 012B,E01029673,1464,229,1235
2021,South Staffordshire 013D,E01029674,1619,246,1373
2021,South Staffordshire 013E,E01029675,1398,179,1219
2021,South Staffordshire 012C,E01029676,1054,125,929
2021,South Staffordshire 013F,E01029677,1299,221,1078
2021,South Staffordshire 013G,E01029678,1523,222,1301
2021,South Staffordshire 012D,E01029679,1375,264,1111
2021,South Staffordshire 012E,E01029680,1445,240,1205
2021,Stafford 002A,E01029681,1157,211,946
2021,Stafford 002B,E01029682,1553,219,1334
2021,Stafford 002C,E01029683,1206,162,1044
2021,Stafford 014A,E01029684,1376,299,1077
2021,Stafford 014B,E01029685,1452,270,1182
2021,Stafford 011A,E01029686,1286,234,1052
2021,Stafford 008A,E01029687,1884,258,1626
2021,Stafford 015A,E01029688,2330,331,1999
2021,Stafford 010A,E01029689,1545,211,1334
2021,Stafford 006A,E01029690,1390,240,1150
2021,Stafford 010B,E01029691,1300,151,1149
2021,Stafford 009A,E01029692,1332,288,1044
2021,Stafford 009B,E01029693,1288,317,971
2021,Stafford 010C,E01029694,2097,504,1593
2021,Stafford 005A,E01029695,2231,338,1893
2021,Stafford 005B,E01029696,1356,149,1207
2021,Stafford 005C,E01029697,1515,198,1317
2021,Stafford 005D,E01029698,1670,243,1427
2021,Stafford 010D,E01029699,1849,311,1538
2021,Stafford 011B,E01029700,1170,208,962
2021,Stafford 001A,E01029702,1471,257,1214
2021,Stafford 001B,E01029703,1559,288,1271
2021,Stafford 001C,E01029704,1345,189,1156
2021,Stafford 001D,E01029705,1370,178,1192
2021,Stafford 015B,E01029706,1743,273,1470
2021,Stafford 015C,E01029707,1349,174,1175
2021,Stafford 015D,E01029708,2034,326,1708
2021,Stafford 015E,E01029709,1406,180,1226
2021,Stafford 008B,E01029710,1340,155,1185
2021,Stafford 008C,E01029711,1473,224,1249
2021,Stafford 008D,E01029712,1976,330,1646
2021,Stafford 008E,E01029713,1717,292,1425
2021,Stafford 012A,E01029714,1420,197,1223
2021,Stafford 013A,E01029715,1357,192,1165
2021,Stafford 013B,E01029716,1494,336,1158
2021,Stafford 013C,E01029717,1629,364,1265
2021,Stafford 006B,E01029718,1813,321,1492
2021,Stafford 007A,E01029719,1480,203,1277
2021,Stafford 007B,E01029720,1430,316,1114
2021,Stafford 007C,E01029721,1535,218,1317
2021,Stafford 009C,E01029722,1580,358,1222
2021,Stafford 011C,E01029723,1404,209,1195
2021,Stafford 011D,E01029724,1600,268,1332
2021,Stafford 009D,E01029725,2612,302,2310
2021,Stafford 016A,E01029726,1646,312,1334
2021,Stafford 013D,E01029727,1377,299,1078
2021,Stafford 013E,E01029728,1367,232,1135
2021,Stafford 016B,E01029729,1477,198,1279
2021,Stafford 004A,E01029733,1842,260,1582
2021,Stafford 016C,E01029734,2054,512,1542
2021,Stafford 016D,E01029735,2094,404,1690
2021,Stafford 012B,E01029736,1638,269,1369
2021,Stafford 012C,E01029737,1640,265,1375
2021,Stafford 012D,E01029738,1271,215,1056
2021,Stafford 004B,E01029739,1429,261,1168
2021,Stafford 003A,E01029740,1483,271,1212
2021,Stafford 004C,E01029741,1497,254,1243
2021,Stafford 012E,E01029742,2017,273,1744
2021,Stafford 006C,E01029743,2315,386,1929
2021,Stafford 003B,E01029744,2299,436,1863
2021,Stafford 003C,E01029745,1668,182,1486
2021,Stafford 003D,E01029746,1415,244,1171
2021,Stafford 005E,E01029747,2011,427,1584
2021,Stafford 002D,E01029748,1265,194,1071
2021,Stafford 002E,E01029749,1754,281,1473
2021,Stafford 007D,E01029750,2271,488,1783
2021,Stafford 006D,E01029751,1547,205,1342
2021,Stafford 007E,E01029752,1167,289,878
2021,Stafford 003E,E01029753,1848,342,1506
2021,Stafford 004D,E01029754,1670,283,1387
2021,Stafford 004E,E01029755,1294,155,1139
2021,Stafford 003F,E01029756,1816,364,1452
2021,Stafford 014E,E01029757,1404,271,1133
2021,Stafford 014F,E01029758,1498,269,1229
2021,Stafford 014G,E01029759,1635,294,1341
2021,Stafford 014H,E01029760,1695,340,1355
2021,Staffordshire Moorlands 010A,E01029761,1320,198,1122
2021,Staffordshire Moorlands 008A,E01029762,1577,261,1316
2021,Staffordshire Moorlands 003A,E01029763,1460,317,1143
2021,Staffordshire Moorlands 003B,E01029764,1674,371,1303
2021,Staffordshire Moorlands 003C,E01029765,1236,311,925
2021,Staffordshire Moorlands 003D,E01029766,1354,249,1105
2021,Staffordshire Moorlands 002A,E01029767,1510,153,1357
2021,Staffordshire Moorlands 004A,E01029768,1506,242,1264
2021,Staffordshire Moorlands 002B,E01029769,1713,213,1500
2021,Staffordshire Moorlands 002C,E01029770,1980,296,1684
2021,Staffordshire Moorlands 004B,E01029771,1543,161,1382
2021,Staffordshire Moorlands 004C,E01029772,1543,224,1319
2021,Staffordshire Moorlands 004D,E01029773,1441,172,1269
2021,Staffordshire Moorlands 003E,E01029774,1836,316,1520
2021,Staffordshire Moorlands 008B,E01029775,1383,167,1216
2021,Staffordshire Moorlands 008C,E01029776,1686,282,1404
2021,Staffordshire Moorlands 008D,E01029777,1479,258,1221
2021,Staffordshire Moorlands 012A,E01029778,1720,228,1492
2021,Staffordshire Moorlands 009A,E01029779,1530,219,1311
2021,Staffordshire Moorlands 009B,E01029780,1536,257,1279
2021,Staffordshire Moorlands 011A,E01029781,1355,152,1203
2021,Staffordshire Moorlands 010B,E01029782,1882,345,1537
2021,Staffordshire Moorlands 011B,E01029783,1364,251,1113
2021,Staffordshire Moorlands 013A,E01029784,2031,286,1745
2021,Staffordshire Moorlands 013B,E01029785,1685,287,1398
2021,Staffordshire Moorlands 011C,E01029786,1330,206,1124
2021,Staffordshire Moorlands 011D,E01029787,1815,305,1510
2021,Staffordshire Moorlands 013C,E01029788,1246,184,1062
2021,Staffordshire Moorlands 012B,E01029789,971,123,848
2021,Staffordshire Moorlands 013D,E01029790,1725,348,1377
2021,Staffordshire Moorlands 013E,E01029791,1382,222,1160
2021,Staffordshire Moorlands 006A,E01029792,2266,394,1872
2021,Staffordshire Moorlands 006B,E01029793,1455,230,1225
2021,Staffordshire Moorlands 009C,E01029794,1370,202,1168
2021,Staffordshire Moorlands 010C,E01029795,1646,229,1417
2021,Staffordshire Moorlands 010D,E01029796,1428,223,1205
2021,Staffordshire Moorlands 001A,E01029797,1532,258,1274
2021,Staffordshire Moorlands 012C,E01029798,1552,249,1303
2021,Staffordshire Moorlands 012D,E01029799,1767,248,1519
2021,Staffordshire Moorlands 012E,E01029800,1541,276,1265
2021,Staffordshire Moorlands 007A,E01029801,1665,260,1405
2021,Staffordshire Moorlands 002D,E01029802,1804,283,1521
2021,Staffordshire Moorlands 007B,E01029803,1688,216,1472
2021,Staffordshire Moorlands 005A,E01029804,1670,228,1442
2021,Staffordshire Moorlands 006C,E01029805,1611,234,1377
2021,Staffordshire Moorlands 001B,E01029806,1398,182,1216
2021,Staffordshire Moorlands 005B,E01029807,1069,146,923
2021,Staffordshire Moorlands 001C,E01029808,1433,277,1156
2021,Staffordshire Moorlands 001D,E01029809,1404,319,1085
2021,Staffordshire Moorlands 001E,E01029810,1327,268,1059
2021,Staffordshire Moorlands 005C,E01029811,1426,263,1163
2021,Staffordshire Moorlands 005D,E01029812,1899,344,1555
2021,Staffordshire Moorlands 006D,E01029813,2144,392,1752
2021,Staffordshire Moorlands 005E,E01029814,1533,237,1296
2021,Staffordshire Moorlands 006E,E01029815,1382,180,1202
2021,Staffordshire Moorlands 006F,E01029816,1302,197,1105
2021,Staffordshire Moorlands 007C,E01029817,1650,219,1431
2021,Staffordshire Moorlands 009D,E01029818,1410,215,1195
2021,Staffordshire Moorlands 009E,E01029819,1586,253,1333
2021,Tamworth 003A,E01029820,2150,418,1732
2021,Tamworth 003B,E01029821,1326,150,1176
2021,Tamworth 003C,E01029822,1415,316,1099
2021,Tamworth 004A,E01029823,1367,175,1192
2021,Tamworth 003D,E01029824,1596,335,1261
2021,Tamworth 006A,E01029825,1203,207,996
2021,Tamworth 006B,E01029826,1635,220,1415
2021,Tamworth 006C,E01029827,1409,315,1094
2021,Tamworth 006D,E01029828,1189,305,884
2021,Tamworth 010A,E01029829,2006,415,1591
2021,Tamworth 006E,E01029830,1080,201,879
2021,Tamworth 004B,E01029831,1428,264,1164
2021,Tamworth 004C,E01029832,1533,258,1275
2021,Tamworth 005A,E01029833,1542,280,1262
2021,Tamworth 004D,E01029834,1522,281,1241
2021,Tamworth 002A,E01029835,1650,143,1507
2021,Tamworth 002B,E01029836,1580,240,1340
2021,Tamworth 005B,E01029837,1464,294,1170
2021,Tamworth 005C,E01029838,1456,223,1233
2021,Tamworth 005D,E01029839,1082,176,906
2021,Tamworth 007A,E01029840,1254,382,872
2021,Tamworth 003E,E01029841,1325,183,1142
2021,Tamworth 007B,E01029842,1175,301,874
2021,Tamworth 007C,E01029843,1366,315,1051
2021,Tamworth 004E,E01029844,1127,172,955
2021,Tamworth 007D,E01029845,993,279,714
2021,Tamworth 001A,E01029846,1573,297,1276
2021,Tamworth 001B,E01029847,1307,164,1143
2021,Tamworth 001C,E01029848,1133,164,969
2021,Tamworth 002C,E01029849,1432,295,1137
2021,Tamworth 002D,E01029850,1267,243,1024
2021,Tamworth 002E,E01029851,2062,330,1732
2021,Tamworth 001D,E01029852,1672,299,1373
2021,Tamworth 001E,E01029853,1641,311,1330
2021,Tamworth 001F,E01029854,2307,418,1889
2021,Tamworth 008A,E01029855,1421,279,1142
2021,Tamworth 008B,E01029856,1339,229,1110
2021,Tamworth 008C,E01029857,1374,269,1105
2021,Tamworth 008D,E01029858,1404,234,1170
2021,Tamworth 007E,E01029859,1610,382,1228
2021,Tamworth 009A,E01029860,1252,221,1031
2021,Tamworth 009B,E01029861,1259,202,1057
2021,Tamworth 009C,E01029862,1232,248,984
2021,Tamworth 009D,E01029863,1717,288,1429
2021,Tamworth 009E,E01029864,1530,248,1282
2021,Tamworth 008E,E01029865,1545,281,1264
2021,Tamworth 010C,E01029867,1495,305,1190
2021,Tamworth 010D,E01029868,1321,227,1094
2021,Tamworth 010E,E01029869,1495,288,1207
2021,Babergh 010A,E01029870,1100,218,882
2021,Babergh 011A,E01029871,1301,190,1111
2021,Babergh 010B,E01029872,1410,216,1194
2021,Babergh 011B,E01029873,2083,303,1780
2021,Babergh 011C,E01029874,1576,241,1335
2021,Babergh 009A,E01029875,2273,386,1887
2021,Babergh 001A,E01029876,2108,319,1789
2021,Babergh 005A,E01029877,1330,215,1115
2021,Babergh 005B,E01029878,1169,156,1013
2021,Babergh 005C,E01029879,1612,254,1358
2021,Babergh 006A,E01029880,1797,255,1542
2021,Babergh 002A,E01029881,2028,352,1676
2021,Babergh 010C,E01029882,1471,249,1222
2021,Babergh 010D,E01029883,1967,305,1662
2021,Babergh 002B,E01029884,1594,286,1308
2021,Babergh 002C,E01029885,2245,301,1944
2021,Babergh 008A,E01029886,1259,223,1036
2021,Babergh 008B,E01029887,1918,299,1619
2021,Babergh 008C,E01029888,1244,279,965
2021,Babergh 008D,E01029889,1295,301,994
2021,Babergh 008E,E01029890,1616,330,1286
2021,Babergh 008F,E01029891,2075,421,1654
2021,Babergh 004A,E01029892,1890,362,1528
2021,Babergh 004C,E01029894,1088,162,926
2021,Babergh 004D,E01029895,1130,208,922
2021,Babergh 004E,E01029896,1257,184,1073
2021,Babergh 011D,E01029897,2353,651,1702
2021,Babergh 001B,E01029898,1856,188,1668
2021,Babergh 009B,E01029899,1734,243,1491
2021,Babergh 003A,E01029900,1737,287,1450
2021,Babergh 003B,E01029901,2307,236,2071
2021,Babergh 009C,E01029902,2090,287,1803
2021,Babergh 010E,E01029903,1438,244,1194
2021,Babergh 010F,E01029904,1554,262,1292
2021,Babergh 010G,E01029905,1127,197,930
2021,Babergh 009D,E01029906,1771,281,1490
2021,Babergh 001C,E01029907,2234,305,1929
2021,Babergh 005D,E01029908,1514,263,1251
2021,Babergh 005E,E01029909,1473,232,1241
2021,Babergh 005F,E01029910,1133,220,913
2021,Babergh 004F,E01029911,2192,360,1832
2021,Babergh 007A,E01029912,1767,279,1488
2021,Babergh 007B,E01029913,1059,93,966
2021,Babergh 007C,E01029914,1477,302,1175
2021,Babergh 007D,E01029915,1162,161,1001
2021,Babergh 007E,E01029916,1262,289,973
2021,Babergh 003C,E01029917,1911,325,1586
2021,Babergh 007F,E01029918,1075,136,939
2021,Babergh 007G,E01029919,1493,177,1316
2021,Babergh 007H,E01029920,1774,178,1596
2021,Babergh 006B,E01029921,1198,157,1041
2021,Babergh 006C,E01029922,1505,266,1239
2021,Babergh 006D,E01029923,1352,230,1122
2021,West Suffolk 015A,E01029925,1767,218,1549
2021,West Suffolk 002A,E01029926,1603,165,1438
2021,West Suffolk 002B,E01029927,2257,445,1812
2021,West Suffolk 002C,E01029928,1760,281,1479
2021,West Suffolk 002D,E01029929,2055,308,1747
2021,West Suffolk 002E,E01029930,1531,210,1321
2021,West Suffolk 008A,E01029937,2174,341,1833
2021,West Suffolk 004A,E01029938,1416,366,1050
2021,West Suffolk 004B,E01029939,1526,203,1323
2021,West Suffolk 004C,E01029940,1264,256,1008
2021,West Suffolk 007A,E01029941,1769,266,1503
2021,West Suffolk 001A,E01029942,1491,227,1264
2021,West Suffolk 001B,E01029944,1603,212,1391
2021,West Suffolk 003A,E01029945,2172,319,1853
2021,West Suffolk 004D,E01029946,2009,346,1663
2021,West Suffolk 004E,E01029947,2143,246,1897
2021,West Suffolk 015B,E01029949,1449,280,1169
2021,West Suffolk 015C,E01029950,1649,306,1343
2021,West Suffolk 015D,E01029951,1284,158,1126
2021,West Suffolk 015E,E01029952,1173,181,992
2021,West Suffolk 008B,E01029953,1284,205,1079
2021,West Suffolk 008C,E01029955,1670,223,1447
2021,West Suffolk 008D,E01029956,1349,239,1110
2021,West Suffolk 007B,E01029957,2125,325,1800
2021,Ipswich 007A,E01029958,1310,225,1085
2021,Ipswich 007C,E01029960,1901,412,1489
2021,Ipswich 007D,E01029961,1420,293,1127
2021,Ipswich 007E,E01029962,1530,330,1200
2021,Ipswich 009A,E01029963,1561,277,1284
2021,Ipswich 009B,E01029964,1304,284,1020
2021,Ipswich 009C,E01029965,1404,234,1170
2021,Ipswich 009D,E01029966,1568,222,1346
2021,Ipswich 009E,E01029967,1264,184,1080
2021,Ipswich 012A,E01029968,1473,320,1153
2021,Ipswich 012B,E01029969,1438,248,1190
2021,Ipswich 012C,E01029970,1642,287,1355
2021,Ipswich 012D,E01029971,1448,304,1144
2021,Ipswich 002A,E01029973,1403,200,1203
2021,Ipswich 002B,E01029974,1478,245,1233
2021,Ipswich 002C,E01029975,1212,236,976
2021,Ipswich 002D,E01029976,1486,293,1193
2021,Ipswich 002E,E01029977,1454,228,1226
2021,Ipswich 016A,E01029978,1192,229,963
2021,Ipswich 016B,E01029979,1516,381,1135
2021,Ipswich 016C,E01029980,1504,385,1119
2021,Ipswich 016D,E01029981,1148,191,957
2021,Ipswich 016E,E01029982,1391,387,1004
2021,Ipswich 016F,E01029983,1486,274,1212
2021,Ipswich 010A,E01029984,1542,316,1226
2021,Ipswich 010B,E01029985,2364,410,1954
2021,Ipswich 010C,E01029986,1474,375,1099
2021,Ipswich 010D,E01029987,1466,342,1124
2021,Ipswich 010E,E01029988,1967,311,1656
2021,Ipswich 011B,E01029990,1447,258,1189
2021,Ipswich 011C,E01029991,1518,237,1281
2021,Ipswich 011D,E01029992,1250,205,1045
2021,Ipswich 014B,E01029994,1579,417,1162
2021,Ipswich 014C,E01029995,1584,269,1315
2021,Ipswich 014D,E01029996,1595,368,1227
2021,Ipswich 004A,E01029997,1478,335,1143
2021,Ipswich 004B,E01029998,1799,464,1335
2021,Ipswich 004C,E01029999,1560,355,1205
2021,Ipswich 004D,E01030000,1520,357,1163
2021,Ipswich 004E,E01030001,1697,360,1337
2021,Ipswich 008A,E01030002,1862,296,1566
2021,Ipswich 008B,E01030003,1675,318,1357
2021,Ipswich 008C,E01030004,1202,246,956
2021,Ipswich 008D,E01030005,2728,644,2084
2021,Ipswich 008E,E01030006,1663,333,1330
2021,Ipswich 005A,E01030007,1974,437,1537
2021,Ipswich 005B,E01030008,1302,236,1066
2021,Ipswich 005C,E01030009,1366,291,1075
2021,Ipswich 005D,E01030010,1866,335,1531
2021,Ipswich 005E,E01030011,1520,277,1243
2021,Ipswich 013A,E01030012,1104,186,918
2021,Ipswich 013B,E01030013,1440,301,1139
2021,Ipswich 013C,E01030014,1379,330,1049
2021,Ipswich 013D,E01030015,1209,206,1003
2021,Ipswich 013E,E01030016,1291,194,1097
2021,Ipswich 015A,E01030017,1336,290,1046
2021,Ipswich 015B,E01030018,1422,347,1075
2021,Ipswich 015C,E01030019,1412,238,1174
2021,Ipswich 015D,E01030020,1324,192,1132
2021,Ipswich 015E,E01030021,1278,274,1004
2021,Ipswich 006A,E01030022,2047,424,1623
2021,Ipswich 006B,E01030023,1895,417,1478
2021,Ipswich 006C,E01030024,1862,319,1543
2021,Ipswich 006D,E01030025,1827,283,1544
2021,Ipswich 006E,E01030026,1850,442,1408
2021,Ipswich 003A,E01030027,1916,368,1548
2021,Ipswich 003B,E01030028,1593,321,1272
2021,Ipswich 003C,E01030029,1544,373,1171
2021,Ipswich 003D,E01030030,2039,386,1653
2021,Ipswich 003E,E01030031,1416,297,1119
2021,Ipswich 001A,E01030032,1410,373,1037
2021,Ipswich 001B,E01030033,1421,208,1213
2021,Ipswich 001C,E01030034,1392,142,1250
2021,Ipswich 001D,E01030035,1789,448,1341
2021,Ipswich 001E,E01030036,1763,397,1366
2021,Mid Suffolk 005A,E01030037,1163,176,987
2021,Mid Suffolk 005B,E01030038,1120,152,968
2021,Mid Suffolk 002A,E01030039,1362,210,1152
2021,Mid Suffolk 004A,E01030040,1223,172,1051
2021,Mid Suffolk 011A,E01030041,2241,287,1954
2021,Mid Suffolk 012A,E01030042,1646,224,1422
2021,Mid Suffolk 011B,E01030043,2278,375,1903
2021,Mid Suffolk 012B,E01030044,1274,187,1087
2021,Mid Suffolk 012C,E01030045,1662,283,1379
2021,Mid Suffolk 012D,E01030046,1624,271,1353
2021,Mid Suffolk 012E,E01030047,1166,198,968
2021,Mid Suffolk 007A,E01030048,2358,450,1908
2021,Mid Suffolk 004B,E01030049,1788,310,1478
2021,Mid Suffolk 004C,E01030050,2217,399,1818
2021,Mid Suffolk 006A,E01030051,1703,258,1445
2021,Mid Suffolk 001A,E01030052,2140,338,1802
2021,Mid Suffolk 003A,E01030053,2214,285,1929
2021,Mid Suffolk 002B,E01030054,1380,207,1173
2021,Mid Suffolk 002C,E01030055,1426,232,1194
2021,Mid Suffolk 006B,E01030056,2106,306,1800
2021,Mid Suffolk 007B,E01030057,2238,370,1868
2021,Mid Suffolk 001B,E01030058,1967,280,1687
2021,Mid Suffolk 005C,E01030059,2329,360,1969
2021,Mid Suffolk 010A,E01030060,1486,198,1288
2021,Mid Suffolk 011C,E01030061,1617,222,1395
2021,Mid Suffolk 011D,E01030062,1406,177,1229
2021,Mid Suffolk 009A,E01030063,2436,412,2024
2021,Mid Suffolk 001C,E01030064,2414,374,2040
2021,Mid Suffolk 006C,E01030065,2069,316,1753
2021,Mid Suffolk 002D,E01030066,1541,227,1314
2021,Mid Suffolk 002E,E01030067,1268,208,1060
2021,Mid Suffolk 002F,E01030068,1692,272,1420
2021,Mid Suffolk 009B,E01030069,1409,168,1241
2021,Mid Suffolk 011E,E01030070,1736,209,1527
2021,Mid Suffolk 010B,E01030071,1373,160,1213
2021,Mid Suffolk 009C,E01030072,1541,209,1332
2021,Mid Suffolk 008A,E01030073,1484,192,1292
2021,Mid Suffolk 009D,E01030075,1959,384,1575
2021,Mid Suffolk 010D,E01030076,1526,263,1263
2021,Mid Suffolk 008B,E01030077,1413,261,1152
2021,Mid Suffolk 010E,E01030078,1538,208,1330
2021,Mid Suffolk 008C,E01030079,1417,286,1131
2021,Mid Suffolk 008D,E01030080,1577,256,1321
2021,Mid Suffolk 005D,E01030081,2451,357,2094
2021,Mid Suffolk 007C,E01030083,2219,334,1885
2021,Mid Suffolk 004D,E01030084,1650,265,1385
2021,Mid Suffolk 004E,E01030085,1542,249,1293
2021,Mid Suffolk 006D,E01030086,1153,193,960
2021,Mid Suffolk 007D,E01030087,1282,209,1073
2021,Mid Suffolk 001D,E01030088,1180,181,999
2021,Mid Suffolk 006E,E01030089,2014,268,1746
2021,Mid Suffolk 003C,E01030090,2400,399,2001
2021,West Suffolk 011A,E01030091,1760,170,1590
2021,West Suffolk 014A,E01030092,1427,159,1268
2021,West Suffolk 011B,E01030093,1570,254,1316
2021,West Suffolk 006A,E01030094,1355,227,1128
2021,West Suffolk 005A,E01030095,1197,200,997
2021,West Suffolk 005B,E01030096,1398,168,1230
2021,West Suffolk 005C,E01030097,1186,190,996
2021,West Suffolk 010A,E01030098,2457,453,2004
2021,West Suffolk 017A,E01030099,1899,239,1660
2021,West Suffolk 010B,E01030100,2120,327,1793
2021,West Suffolk 017B,E01030101,2212,328,1884
2021,West Suffolk 016A,E01030104,2460,451,2009
2021,West Suffolk 020A,E01030105,1674,302,1372
2021,West Suffolk 020B,E01030106,2158,432,1726
2021,West Suffolk 020C,E01030107,1531,260,1271
2021,West Suffolk 020D,E01030108,1743,342,1401
2021,West Suffolk 019A,E01030109,1688,363,1325
2021,West Suffolk 019B,E01030110,2591,483,2108
2021,West Suffolk 019C,E01030111,1285,225,1060
2021,West Suffolk 019D,E01030112,1723,263,1460
2021,West Suffolk 020E,E01030113,1994,347,1647
2021,West Suffolk 020F,E01030114,1393,332,1061
2021,West Suffolk 021A,E01030115,2153,496,1657
2021,West Suffolk 021B,E01030116,2141,443,1698
2021,West Suffolk 021C,E01030117,1447,248,1199
2021,West Suffolk 021D,E01030118,1381,284,1097
2021,West Suffolk 010C,E01030119,2110,362,1748
2021,West Suffolk 006B,E01030121,2195,375,1820
2021,West Suffolk 018A,E01030122,2118,407,1711
2021,West Suffolk 014B,E01030123,1429,285,1144
2021,West Suffolk 014C,E01030124,1532,210,1322
2021,West Suffolk 014D,E01030125,1312,219,1093
2021,West Suffolk 012A,E01030127,1077,173,904
2021,West Suffolk 012B,E01030128,1227,188,1039
2021,West Suffolk 012C,E01030129,1256,209,1047
2021,West Suffolk 009A,E01030130,1333,278,1055
2021,West Suffolk 009B,E01030131,1171,292,879
2021,West Suffolk 006C,E01030132,1425,158,1267
2021,West Suffolk 006D,E01030133,1315,205,1110
2021,West Suffolk 010D,E01030134,1171,195,976
2021,West Suffolk 010E,E01030135,1447,317,1130
2021,West Suffolk 011C,E01030137,1531,220,1311
2021,West Suffolk 016B,E01030138,2349,405,1944
2021,West Suffolk 009C,E01030139,1522,289,1233
2021,West Suffolk 009D,E01030140,1161,197,964
2021,West Suffolk 009E,E01030141,1428,271,1157
2021,West Suffolk 013A,E01030142,1581,216,1365
2021,West Suffolk 013B,E01030143,1350,214,1136
2021,West Suffolk 013C,E01030144,1226,215,1011
2021,West Suffolk 005D,E01030145,1374,212,1162
2021,West Suffolk 005E,E01030146,1391,213,1178
2021,West Suffolk 013D,E01030147,1428,181,1247
2021,West Suffolk 014E,E01030148,1136,163,973
2021,West Suffolk 014F,E01030149,1397,223,1174
2021,West Suffolk 017C,E01030150,2197,330,1867
2021,West Suffolk 018B,E01030151,2416,346,2070
2021,East Suffolk 019A,E01030152,1995,148,1847
2021,East Suffolk 019B,E01030153,1137,161,976
2021,East Suffolk 017A,E01030154,2106,332,1774
2021,East Suffolk 022A,E01030155,1930,331,1599
2021,East Suffolk 028A,E01030158,1416,98,1318
2021,East Suffolk 028B,E01030159,1422,222,1200
2021,East Suffolk 029A,E01030160,1477,202,1275
2021,East Suffolk 029B,E01030161,1555,337,1218
2021,East Suffolk 030A,E01030162,1423,159,1264
2021,East Suffolk 030B,E01030163,1676,294,1382
2021,East Suffolk 028C,E01030164,1488,205,1283
2021,East Suffolk 030C,E01030165,1648,219,1429
2021,East Suffolk 028D,E01030166,1428,190,1238
2021,East Suffolk 030D,E01030167,1300,184,1116
2021,East Suffolk 029C,E01030168,1342,271,1071
2021,East Suffolk 029D,E01030169,1481,204,1277
2021,East Suffolk 029E,E01030170,1622,285,1337
2021,East Suffolk 027A,E01030171,1768,285,1483
2021,East Suffolk 017B,E01030172,2062,388,1674
2021,East Suffolk 017C,E01030173,2140,509,1631
2021,East Suffolk 017D,E01030174,1352,209,1143
2021,East Suffolk 021A,E01030175,2309,429,1880
2021,East Suffolk 017E,E01030176,2001,328,1673
2021,East Suffolk 024A,E01030179,2580,628,1952
2021,East Suffolk 024B,E01030180,1335,255,1080
2021,East Suffolk 025A,E01030181,1845,414,1431
2021,East Suffolk 024C,E01030183,1843,249,1594
2021,East Suffolk 024D,E01030184,1633,235,1398
2021,East Suffolk 022B,E01030185,1910,361,1549
2021,East Suffolk 018A,E01030186,1573,176,1397
2021,East Suffolk 019C,E01030187,1520,251,1269
2021,East Suffolk 019D,E01030188,1602,213,1389
2021,East Suffolk 019E,E01030189,1509,251,1258
2021,East Suffolk 025B,E01030190,2236,336,1900
2021,East Suffolk 025C,E01030191,1448,203,1245
2021,East Suffolk 025D,E01030192,1311,173,1138
2021,East Suffolk 020A,E01030193,1963,321,1642
2021,East Suffolk 020B,E01030194,1708,244,1464
2021,East Suffolk 020C,E01030195,1533,224,1309
2021,East Suffolk 026A,E01030196,1501,223,1278
2021,East Suffolk 026B,E01030197,1766,276,1490
2021,East Suffolk 025E,E01030198,1291,160,1131
2021,East Suffolk 023A,E01030199,1707,194,1513
2021,East Suffolk 021B,E01030200,2171,372,1799
2021,East Suffolk 016A,E01030201,2072,257,1815
2021,East Suffolk 022C,E01030203,1921,266,1655
2021,East Suffolk 026C,E01030204,1843,343,1500
2021,East Suffolk 026D,E01030205,1237,217,1020
2021,East Suffolk 026E,E01030206,1436,211,1225
2021,East Suffolk 024E,E01030207,1546,238,1308
2021,East Suffolk 018B,E01030208,1253,176,1077
2021,East Suffolk 018C,E01030209,2134,303,1831
2021,East Suffolk 018D,E01030210,2337,527,1810
2021,East Suffolk 022D,E01030211,1858,188,1670
2021,East Suffolk 018E,E01030212,1931,231,1700
2021,East Suffolk 027B,E01030214,1163,183,980
2021,East Suffolk 027C,E01030215,1570,234,1336
2021,East Suffolk 027D,E01030216,1420,190,1230
2021,East Suffolk 027E,E01030217,1368,207,1161
2021,East Suffolk 027F,E01030218,1434,220,1214
2021,East Suffolk 016B,E01030219,1937,268,1669
2021,East Suffolk 020D,E01030220,2140,318,1822
2021,East Suffolk 021C,E01030221,2075,315,1760
2021,East Suffolk 016C,E01030222,2036,192,1844
2021,East Suffolk 010A,E01030223,1714,283,1431
2021,East Suffolk 010B,E01030224,1598,201,1397
2021,East Suffolk 010C,E01030225,1535,205,1330
2021,East Suffolk 011A,E01030226,1766,316,1450
2021,East Suffolk 010D,E01030227,1426,315,1111
2021,East Suffolk 010E,E01030228,1622,246,1376
2021,East Suffolk 015A,E01030229,2077,311,1766
2021,East Suffolk 013A,E01030230,1727,176,1551
2021,East Suffolk 013B,E01030231,1440,248,1192
2021,East Suffolk 013C,E01030232,1587,275,1312
2021,East Suffolk 007A,E01030233,1412,184,1228
2021,East Suffolk 008A,E01030234,1439,286,1153
2021,East Suffolk 007B,E01030235,1454,188,1266
2021,East Suffolk 008B,E01030236,1787,315,1472
2021,East Suffolk 008C,E01030237,2769,513,2256
2021,East Suffolk 008D,E01030238,1670,285,1385
2021,East Suffolk 012A,E01030239,1802,401,1401
2021,East Suffolk 001A,E01030240,1541,152,1389
2021,East Suffolk 001B,E01030241,1449,175,1274
2021,East Suffolk 001C,E01030242,1356,192,1164
2021,East Suffolk 015B,E01030243,1445,225,1220
2021,East Suffolk 015C,E01030244,1738,187,1551
2021,East Suffolk 015D,E01030245,1524,218,1306
2021,East Suffolk 004A,E01030246,1317,266,1051
2021,East Suffolk 006A,E01030247,1736,298,1438
2021,East Suffolk 004B,E01030248,1451,329,1122
2021,East Suffolk 004C,E01030249,1648,340,1308
2021,East Suffolk 004D,E01030250,1894,372,1522
2021,East Suffolk 012B,E01030251,1440,158,1282
2021,East Suffolk 012C,E01030252,1651,195,1456
2021,East Suffolk 012D,E01030253,1725,338,1387
2021,East Suffolk 006B,E01030254,1311,270,1041
2021,East Suffolk 005A,E01030255,1212,259,953
2021,East Suffolk 006C,E01030256,1452,210,1242
2021,East Suffolk 009A,E01030257,1474,260,1214
2021,East Suffolk 006D,E01030258,1545,205,1340
2021,East Suffolk 001D,E01030259,1100,130,970
2021,East Suffolk 001E,E01030260,1018,179,839
2021,East Suffolk 002A,E01030261,1428,342,1086
2021,East Suffolk 002B,E01030262,1192,233,959
2021,East Suffolk 005B,E01030263,1421,190,1231
2021,East Suffolk 004E,E01030264,1382,300,1082
2021,East Suffolk 004F,E01030265,1338,272,1066
2021,East Suffolk 003A,E01030266,1559,249,1310
2021,East Suffolk 003B,E01030267,2039,366,1673
2021,East Suffolk 007C,E01030268,1269,212,1057
2021,East Suffolk 007D,E01030269,1600,202,1398
2021,East Suffolk 005C,E01030270,1493,250,1243
2021,East Suffolk 003C,E01030271,1384,127,1257
2021,East Suffolk 012E,E01030272,1491,170,1321
2021,East Suffolk 012F,E01030273,1415,136,1279
2021,East Suffolk 009B,E01030274,1150,157,993
2021,East Suffolk 009C,E01030275,1109,170,939
2021,East Suffolk 006E,E01030276,1146,196,950
2021,East Suffolk 002C,E01030277,1101,237,864
2021,East Suffolk 003D,E01030278,1484,207,1277
2021,East Suffolk 002D,E01030279,1349,291,1058
2021,East Suffolk 003E,E01030280,1319,166,1153
2021,East Suffolk 002E,E01030281,2464,536,1928
2021,East Suffolk 014A,E01030283,1252,211,1041
2021,East Suffolk 013D,E01030285,2192,293,1899
2021,East Suffolk 011B,E01030286,2031,261,1770
2021,East Suffolk 009D,E01030287,1326,200,1126
2021,East Suffolk 007E,E01030288,1383,167,1216
2021,East Suffolk 005D,E01030289,1425,233,1192
2021,East Suffolk 005E,E01030290,1403,203,1200
2021,East Suffolk 009E,E01030291,1388,307,1081
2021,East Suffolk 011C,E01030292,1387,204,1183
2021,East Suffolk 011D,E01030293,1597,249,1348
2021,East Suffolk 011E,E01030294,1381,214,1167
2021,East Suffolk 014B,E01030295,2253,304,1949
2021,Elmbridge 015A,E01030296,1738,412,1326
2021,Elmbridge 015B,E01030297,2031,413,1618
2021,Elmbridge 015C,E01030298,1534,331,1203
2021,Elmbridge 015D,E01030299,1578,351,1227
2021,Elmbridge 017A,E01030300,1552,300,1252
2021,Elmbridge 017B,E01030301,1526,378,1148
2021,Elmbridge 017C,E01030302,1704,243,1461
2021,Elmbridge 018A,E01030303,1636,336,1300
2021,Elmbridge 017D,E01030304,1568,333,1235
2021,Elmbridge 017E,E01030305,1584,498,1086
2021,Elmbridge 017F,E01030306,1521,498,1023
2021,Elmbridge 013A,E01030307,1739,387,1352
2021,Elmbridge 013B,E01030308,1687,360,1327
2021,Elmbridge 013C,E01030309,1598,340,1258
2021,Elmbridge 013D,E01030310,1752,349,1403
2021,Elmbridge 014A,E01030311,1443,270,1173
2021,Elmbridge 014B,E01030312,1403,292,1111
2021,Elmbridge 010A,E01030313,1960,429,1531
2021,Elmbridge 010B,E01030314,1646,330,1316
2021,Elmbridge 014C,E01030315,1603,356,1247
2021,Elmbridge 014D,E01030316,1570,372,1198
2021,Elmbridge 014E,E01030317,1821,350,1471
2021,Elmbridge 014F,E01030318,1452,259,1193
2021,Elmbridge 009A,E01030319,1890,540,1350
2021,Elmbridge 009B,E01030320,1683,394,1289
2021,Elmbridge 009C,E01030321,1511,358,1153
2021,Elmbridge 006A,E01030322,1707,355,1352
2021,Elmbridge 006B,E01030323,1314,298,1016
2021,Elmbridge 006C,E01030324,1550,372,1178
2021,Elmbridge 006D,E01030325,1558,418,1140
2021,Elmbridge 002A,E01030326,1628,219,1409
2021,Elmbridge 002B,E01030327,1818,343,1475
2021,Elmbridge 002C,E01030328,1583,363,1220
2021,Elmbridge 002D,E01030329,1492,251,1241
2021,Elmbridge 001A,E01030330,1562,306,1256
2021,Elmbridge 001B,E01030331,1563,302,1261
2021,Elmbridge 001C,E01030332,1491,323,1168
2021,Elmbridge 001D,E01030333,1351,267,1084
2021,Elmbridge 003A,E01030334,1441,304,1137
2021,Elmbridge 003B,E01030335,1738,358,1380
2021,Elmbridge 003C,E01030336,1839,388,1451
2021,Elmbridge 003D,E01030337,1691,336,1355
2021,Elmbridge 011A,E01030338,1576,384,1192
2021,Elmbridge 011B,E01030339,1419,255,1164
2021,Elmbridge 011C,E01030340,1501,338,1163
2021,Elmbridge 011D,E01030341,1840,417,1423
2021,Elmbridge 018B,E01030342,1740,391,1349
2021,Elmbridge 018C,E01030343,1727,394,1333
2021,Elmbridge 018D,E01030344,1462,366,1096
2021,Elmbridge 018E,E01030345,1563,374,1189
2021,Elmbridge 016A,E01030346,1460,296,1164
2021,Elmbridge 016B,E01030347,1665,385,1280
2021,Elmbridge 016C,E01030348,1567,315,1252
2021,Elmbridge 016D,E01030349,1642,302,1340
2021,Elmbridge 005A,E01030350,1686,363,1323
2021,Elmbridge 005B,E01030351,1461,329,1132
2021,Elmbridge 005C,E01030352,1534,343,1191
2021,Elmbridge 005D,E01030353,1499,381,1118
2021,Elmbridge 008A,E01030354,1696,478,1218
2021,Elmbridge 008B,E01030355,1325,258,1067
2021,Elmbridge 008C,E01030356,1332,318,1014
2021,Elmbridge 007A,E01030357,1520,246,1274
2021,Elmbridge 007B,E01030358,1486,283,1203
2021,Elmbridge 007D,E01030360,1602,321,1281
2021,Elmbridge 004A,E01030361,2116,390,1726
2021,Elmbridge 004B,E01030362,1319,298,1021
2021,Elmbridge 004C,E01030363,1721,319,1402
2021,Elmbridge 004D,E01030364,1475,260,1215
2021,Elmbridge 008D,E01030365,1424,249,1175
2021,Elmbridge 010C,E01030366,1836,316,1520
2021,Elmbridge 010D,E01030367,1553,349,1204
2021,Elmbridge 008E,E01030368,1552,366,1186
2021,Elmbridge 009D,E01030369,2038,483,1555
2021,Elmbridge 009E,E01030370,1573,378,1195
2021,Elmbridge 012A,E01030371,1502,298,1204
2021,Elmbridge 012B,E01030372,1367,298,1069
2021,Elmbridge 012C,E01030373,1516,330,1186
2021,Elmbridge 012D,E01030374,1652,309,1343
2021,Elmbridge 012E,E01030375,1752,327,1425
2021,Elmbridge 012F,E01030376,1239,264,975
2021,Epsom and Ewell 003A,E01030377,2301,454,1847
2021,Epsom and Ewell 003B,E01030378,1579,295,1284
2021,Epsom and Ewell 009A,E01030379,1482,491,991
2021,Epsom and Ewell 009B,E01030380,1395,321,1074
2021,Epsom and Ewell 008A,E01030381,1405,284,1121
2021,Epsom and Ewell 010A,E01030382,1459,310,1149
2021,Epsom and Ewell 005B,E01030384,2554,652,1902
2021,Epsom and Ewell 007A,E01030385,1651,348,1303
2021,Epsom and Ewell 001A,E01030386,1412,259,1153
2021,Epsom and Ewell 001B,E01030387,1446,234,1212
2021,Epsom and Ewell 001C,E01030388,1275,230,1045
2021,Epsom and Ewell 001D,E01030389,1459,270,1189
2021,Epsom and Ewell 010B,E01030390,1896,336,1560
2021,Epsom and Ewell 007B,E01030391,1805,339,1466
2021,Epsom and Ewell 010C,E01030392,1953,344,1609
2021,Epsom and Ewell 001E,E01030393,1915,331,1584
2021,Epsom and Ewell 002A,E01030394,1715,348,1367
2021,Epsom and Ewell 004A,E01030395,1673,262,1411
2021,Epsom and Ewell 010D,E01030396,2334,538,1796
2021,Epsom and Ewell 010E,E01030398,1636,322,1314
2021,Epsom and Ewell 002B,E01030399,2231,442,1789
2021,Epsom and Ewell 002C,E01030400,1512,391,1121
2021,Epsom and Ewell 005C,E01030401,2391,465,1926
2021,Epsom and Ewell 005D,E01030402,2280,575,1705
2021,Epsom and Ewell 007C,E01030403,1534,348,1186
2021,Epsom and Ewell 007D,E01030404,1516,320,1196
2021,Epsom and Ewell 009C,E01030405,1734,406,1328
2021,Epsom and Ewell 003C,E01030406,1473,277,1196
2021,Epsom and Ewell 003D,E01030407,1335,234,1101
2021,Epsom and Ewell 003E,E01030408,1696,346,1350
2021,Epsom and Ewell 007E,E01030409,1517,393,1124
2021,Epsom and Ewell 007F,E01030410,1625,336,1289
2021,Epsom and Ewell 008C,E01030412,1931,364,1567
2021,Epsom and Ewell 004B,E01030413,1873,454,1419
2021,Epsom and Ewell 002D,E01030414,1244,256,988
2021,Epsom and Ewell 004C,E01030415,1555,308,1247
2021,Epsom and Ewell 004D,E01030416,1297,245,1052
2021,Epsom and Ewell 009D,E01030417,1269,278,991
2021,Epsom and Ewell 009E,E01030418,1435,276,1159
2021,Epsom and Ewell 008D,E01030419,1683,340,1343
2021,Epsom and Ewell 009F,E01030420,1271,270,1001
2021,Guildford 014A,E01030421,1652,267,1385
2021,Guildford 014B,E01030422,1665,282,1383
2021,Guildford 014C,E01030423,1637,254,1383
2021,Guildford 010A,E01030424,1402,260,1142
2021,Guildford 014D,E01030425,1787,292,1495
2021,Guildford 004A,E01030426,1425,286,1139
2021,Guildford 004B,E01030427,1334,212,1122
2021,Guildford 004C,E01030428,1205,160,1045
2021,Guildford 004D,E01030429,1374,205,1169
2021,Guildford 004E,E01030430,1382,197,1185
2021,Guildford 010B,E01030431,1380,204,1176
2021,Guildford 010C,E01030432,1438,281,1157
2021,Guildford 010D,E01030433,1562,302,1260
2021,Guildford 008A,E01030434,1511,291,1220
2021,Guildford 008B,E01030435,1903,514,1389
2021,Guildford 011A,E01030436,2148,455,1693
2021,Guildford 011B,E01030437,2244,560,1684
2021,Guildford 013A,E01030438,1737,338,1399
2021,Guildford 011C,E01030439,1662,412,1250
2021,Guildford 001A,E01030440,1610,352,1258
2021,Guildford 003A,E01030441,1324,281,1043
2021,Guildford 003B,E01030442,1422,315,1107
2021,Guildford 003C,E01030443,1312,294,1018
2021,Guildford 003D,E01030444,1471,343,1128
2021,Guildford 003E,E01030445,1392,233,1159
2021,Guildford 003F,E01030446,1340,295,1045
2021,Guildford 003G,E01030447,1300,280,1020
2021,Guildford 016A,E01030448,1489,343,1146
2021,Guildford 016B,E01030449,1310,268,1042
2021,Guildford 013B,E01030450,2455,696,1759
2021,Guildford 013C,E01030451,1904,464,1440
2021,Guildford 015A,E01030452,2461,960,1501
2021,Guildford 013D,E01030453,1416,216,1200
2021,Guildford 016C,E01030454,1614,330,1284
2021,Guildford 013E,E01030455,1780,316,1464
2021,Guildford 016D,E01030456,1444,329,1115
2021,Guildford 013F,E01030457,1600,285,1315
2021,Guildford 001B,E01030458,1158,187,971
2021,Guildford 001C,E01030459,1349,196,1153
2021,Guildford 011D,E01030460,1543,369,1174
2021,Guildford 011E,E01030461,1597,338,1259
2021,Guildford 008C,E01030462,1536,303,1233
2021,Guildford 008D,E01030463,1367,269,1098
2021,Guildford 008E,E01030464,1648,459,1189
2021,Guildford 002A,E01030465,1443,279,1164
2021,Guildford 002B,E01030466,1573,204,1369
2021,Guildford 015B,E01030467,1636,425,1211
2021,Guildford 015C,E01030468,3172,2555,617
2021,Guildford 015D,E01030469,1404,460,944
2021,Guildford 012A,E01030470,4629,3719,910
2021,Guildford 017A,E01030471,1215,215,1000
2021,Guildford 017B,E01030472,1236,250,986
2021,Guildford 002C,E01030473,1618,346,1272
2021,Guildford 002D,E01030474,2688,365,2323
2021,Guildford 001D,E01030475,1348,287,1061
2021,Guildford 001E,E01030476,1108,179,929
2021,Guildford 001F,E01030477,1609,301,1308
2021,Guildford 017C,E01030478,1791,340,1451
2021,Guildford 017D,E01030479,1744,323,1421
2021,Guildford 017E,E01030480,1775,346,1429
2021,Guildford 007A,E01030481,1658,373,1285
2021,Guildford 007B,E01030482,1335,285,1050
2021,Guildford 007C,E01030483,1390,303,1087
2021,Guildford 007D,E01030484,1617,358,1259
2021,Guildford 006A,E01030485,1672,371,1301
2021,Guildford 009A,E01030486,1474,282,1192
2021,Guildford 006B,E01030487,1516,406,1110
2021,Guildford 006C,E01030488,2030,598,1432
2021,Guildford 006D,E01030489,2335,533,1802
2021,Guildford 018A,E01030490,1597,268,1329
2021,Guildford 018B,E01030491,1910,412,1498
2021,Guildford 018C,E01030492,1932,326,1606
2021,Guildford 009B,E01030493,1226,373,853
2021,Guildford 012B,E01030494,1710,494,1216
2021,Guildford 009C,E01030495,1845,803,1042
2021,Guildford 012C,E01030496,1642,538,1104
2021,Guildford 012D,E01030497,1488,475,1013
2021,Guildford 009D,E01030498,1309,343,966
2021,Guildford 005A,E01030499,1439,233,1206
2021,Guildford 005B,E01030500,1476,320,1156
2021,Guildford 005C,E01030501,1565,286,1279
2021,Guildford 005D,E01030502,1169,228,941
2021,Guildford 005E,E01030503,1275,276,999
2021,Guildford 005F,E01030504,1078,162,916
2021,Mole Valley 002A,E01030505,1473,281,1192
2021,Mole Valley 001A,E01030506,1253,262,991
2021,Mole Valley 002B,E01030507,1214,251,963
2021,Mole Valley 001B,E01030508,1389,333,1056
2021,Mole Valley 001C,E01030509,1150,188,962
2021,Mole Valley 004A,E01030510,1798,363,1435
2021,Mole Valley 002C,E01030511,1553,369,1184
2021,Mole Valley 002D,E01030512,1537,292,1245
2021,Mole Valley 001D,E01030513,1350,300,1050
2021,Mole Valley 001E,E01030514,1415,277,1138
2021,Mole Valley 013A,E01030515,1852,272,1580
2021,Mole Valley 006A,E01030516,1253,201,1052
2021,Mole Valley 006B,E01030517,1587,251,1336
2021,Mole Valley 006C,E01030518,1353,263,1090
2021,Mole Valley 006D,E01030519,1529,328,1201
2021,Mole Valley 007A,E01030520,1333,211,1122
2021,Mole Valley 007B,E01030521,1582,260,1322
2021,Mole Valley 007C,E01030522,1373,283,1090
2021,Mole Valley 007D,E01030523,1177,208,969
2021,Mole Valley 008A,E01030524,1810,149,1661
2021,Mole Valley 008B,E01030525,1437,212,1225
2021,Mole Valley 008C,E01030526,1223,228,995
2021,Mole Valley 008D,E01030527,1567,228,1339
2021,Mole Valley 013B,E01030528,1358,212,1146
2021,Mole Valley 012A,E01030529,1558,266,1292
2021,Mole Valley 013C,E01030530,1168,190,978
2021,Mole Valley 013D,E01030531,2277,315,1962
2021,Mole Valley 009A,E01030532,1530,289,1241
2021,Mole Valley 009B,E01030533,1383,261,1122
2021,Mole Valley 009C,E01030534,1332,167,1165
2021,Mole Valley 010A,E01030535,1755,341,1414
2021,Mole Valley 010B,E01030536,1759,270,1489
2021,Mole Valley 010C,E01030537,1667,261,1406
2021,Mole Valley 010D,E01030538,1825,336,1489
2021,Mole Valley 005A,E01030539,1634,287,1347
2021,Mole Valley 005B,E01030540,2072,343,1729
2021,Mole Valley 005C,E01030541,1210,207,1003
2021,Mole Valley 005D,E01030542,1173,232,941
2021,Mole Valley 005E,E01030543,1554,321,1233
2021,Mole Valley 011A,E01030544,1591,275,1316
2021,Mole Valley 011B,E01030545,1423,230,1193
2021,Mole Valley 011C,E01030546,1476,280,1196
2021,Mole Valley 011D,E01030547,1557,362,1195
2021,Mole Valley 003A,E01030548,2130,377,1753
2021,Mole Valley 003B,E01030549,1755,319,1436
2021,Mole Valley 003C,E01030550,1713,232,1481
2021,Mole Valley 003D,E01030551,1582,295,1287
2021,Mole Valley 004B,E01030552,1447,239,1208
2021,Mole Valley 004C,E01030553,1643,201,1442
2021,Mole Valley 004D,E01030554,1124,214,910
2021,Mole Valley 012B,E01030555,1586,285,1301
2021,Mole Valley 009D,E01030556,1827,320,1507
2021,Mole Valley 012C,E01030557,1872,329,1543
2021,Mole Valley 012D,E01030558,2190,386,1804
2021,Reigate and Banstead 002A,E01030559,1196,194,1002
2021,Reigate and Banstead 002B,E01030560,1514,220,1294
2021,Reigate and Banstead 002C,E01030561,1324,197,1127
2021,Reigate and Banstead 002D,E01030562,1229,250,979
2021,Reigate and Banstead 002E,E01030563,2277,228,2049
2021,Reigate and Banstead 002F,E01030564,1325,271,1054
2021,Reigate and Banstead 004A,E01030565,1424,243,1181
2021,Reigate and Banstead 004B,E01030566,1377,290,1087
2021,Reigate and Banstead 004C,E01030567,1589,277,1312
2021,Reigate and Banstead 004D,E01030568,1411,263,1148
2021,Reigate and Banstead 004E,E01030569,2551,566,1985
2021,Reigate and Banstead 014A,E01030570,1618,308,1310
2021,Reigate and Banstead 014B,E01030571,1507,262,1245
2021,Reigate and Banstead 014C,E01030572,2068,382,1686
2021,Reigate and Banstead 014D,E01030573,1720,344,1376
2021,Reigate and Banstead 014E,E01030574,1829,345,1484
2021,Reigate and Banstead 018B,E01030576,1608,298,1310
2021,Reigate and Banstead 018C,E01030577,1554,231,1323
2021,Reigate and Banstead 018D,E01030578,1400,237,1163
2021,Reigate and Banstead 018E,E01030579,1535,194,1341
2021,Reigate and Banstead 017A,E01030580,2100,446,1654
2021,Reigate and Banstead 017B,E01030581,2246,473,1773
2021,Reigate and Banstead 017C,E01030582,1319,270,1049
2021,Reigate and Banstead 017D,E01030583,1565,258,1307
2021,Reigate and Banstead 016B,E01030585,1440,263,1177
2021,Reigate and Banstead 016C,E01030586,1807,405,1402
2021,Reigate and Banstead 016D,E01030587,1527,290,1237
2021,Reigate and Banstead 016E,E01030588,1419,330,1089
2021,Reigate and Banstead 007A,E01030589,1726,307,1419
2021,Reigate and Banstead 007B,E01030590,1806,324,1482
2021,Reigate and Banstead 007C,E01030591,1631,300,1331
2021,Reigate and Banstead 007D,E01030592,1758,280,1478
2021,Reigate and Banstead 012A,E01030593,1428,305,1123
2021,Reigate and Banstead 013A,E01030594,1789,443,1346
2021,Reigate and Banstead 013B,E01030595,1546,365,1181
2021,Reigate and Banstead 012B,E01030596,1495,409,1086
2021,Reigate and Banstead 012C,E01030597,1594,408,1186
2021,Reigate and Banstead 009A,E01030598,1592,305,1287
2021,Reigate and Banstead 008A,E01030599,1554,341,1213
2021,Reigate and Banstead 008B,E01030600,1529,309,1220
2021,Reigate and Banstead 008C,E01030601,1554,367,1187
2021,Reigate and Banstead 008D,E01030602,1723,353,1370
2021,Reigate and Banstead 001A,E01030603,1449,258,1191
2021,Reigate and Banstead 001B,E01030604,1516,269,1247
2021,Reigate and Banstead 001C,E01030605,1588,359,1229
2021,Reigate and Banstead 003A,E01030606,1594,298,1296
2021,Reigate and Banstead 001D,E01030607,1870,346,1524
2021,Reigate and Banstead 005A,E01030608,1442,338,1104
2021,Reigate and Banstead 005B,E01030609,2157,605,1552
2021,Reigate and Banstead 011A,E01030610,1410,295,1115
2021,Reigate and Banstead 011D,E01030613,1835,313,1522
2021,Reigate and Banstead 011E,E01030614,1607,329,1278
2021,Reigate and Banstead 010A,E01030615,1889,397,1492
2021,Reigate and Banstead 010B,E01030616,1633,348,1285
2021,Reigate and Banstead 010C,E01030617,1626,294,1332
2021,Reigate and Banstead 010D,E01030618,1833,442,1391
2021,Reigate and Banstead 010E,E01030619,1420,326,1094
2021,Reigate and Banstead 012D,E01030620,1844,347,1497
2021,Reigate and Banstead 012E,E01030621,1563,403,1160
2021,Reigate and Banstead 010F,E01030622,1867,340,1527
2021,Reigate and Banstead 009B,E01030623,2177,413,1764
2021,Reigate and Banstead 009C,E01030624,1389,283,1106
2021,Reigate and Banstead 009D,E01030625,1634,670,964
2021,Reigate and Banstead 009E,E01030626,1031,191,840
2021,Reigate and Banstead 009F,E01030627,1785,264,1521
2021,Reigate and Banstead 015A,E01030628,1493,222,1271
2021,Reigate and Banstead 015B,E01030629,1314,203,1111
2021,Reigate and Banstead 013C,E01030630,1507,318,1189
2021,Reigate and Banstead 013D,E01030631,1528,352,1176
2021,Reigate and Banstead 015C,E01030632,1283,277,1006
2021,Reigate and Banstead 015D,E01030633,1377,324,1053
2021,Reigate and Banstead 015E,E01030634,1460,381,1079
2021,Reigate and Banstead 006A,E01030635,1587,322,1265
2021,Reigate and Banstead 006B,E01030636,1113,193,920
2021,Reigate and Banstead 006C,E01030637,1167,210,957
2021,Reigate and Banstead 006D,E01030638,1438,235,1203
2021,Reigate and Banstead 006E,E01030639,1467,189,1278
2021,Reigate and Banstead 005C,E01030640,1446,293,1153
2021,Reigate and Banstead 003B,E01030641,1499,249,1250
2021,Reigate and Banstead 003C,E01030642,1616,332,1284
2021,Reigate and Banstead 005D,E01030643,1365,230,1135
2021,Reigate and Banstead 003D,E01030644,1209,208,1001
2021,Runnymede 009A,E01030645,2049,422,1627
2021,Runnymede 009B,E01030646,2120,350,1770
2021,Runnymede 007A,E01030647,1563,231,1332
2021,Runnymede 007B,E01030648,1641,332,1309
2021,Runnymede 007C,E01030649,2335,345,1990
2021,Runnymede 007D,E01030650,1253,255,998
2021,Runnymede 007E,E01030651,1280,250,1030
2021,Runnymede 006A,E01030652,1762,318,1444
2021,Runnymede 006B,E01030653,1696,286,1410
2021,Runnymede 006C,E01030654,1391,226,1165
2021,Runnymede 007F,E01030655,1722,284,1438
2021,Runnymede 004A,E01030656,1479,291,1188
2021,Runnymede 006D,E01030657,1435,315,1120
2021,Runnymede 004B,E01030658,1393,121,1272
2021,Runnymede 006E,E01030659,1793,260,1533
2021,Runnymede 009C,E01030660,2537,564,1973
2021,Runnymede 009D,E01030661,1934,341,1593
2021,Runnymede 007G,E01030662,1636,356,1280
2021,Runnymede 003A,E01030663,1639,343,1296
2021,Runnymede 003B,E01030664,1681,293,1388
2021,Runnymede 003C,E01030665,1491,358,1133
2021,Runnymede 003D,E01030666,1649,283,1366
2021,Runnymede 001A,E01030667,1470,344,1126
2021,Runnymede 001B,E01030668,1857,480,1377
2021,Runnymede 001C,E01030669,1800,778,1022
2021,Runnymede 001D,E01030670,1501,759,742
2021,Runnymede 002A,E01030671,1389,838,551
2021,Runnymede 002B,E01030672,4458,3054,1404
2021,Runnymede 002C,E01030673,1408,521,887
2021,Runnymede 002D,E01030674,1378,392,986
2021,Runnymede 002E,E01030675,1454,528,926
2021,Runnymede 002F,E01030676,1397,656,741
2021,Runnymede 008A,E01030677,1407,193,1214
2021,Runnymede 008B,E01030678,1346,224,1122
2021,Runnymede 008C,E01030679,1199,227,972
2021,Runnymede 008D,E01030680,1437,236,1201
2021,Runnymede 010A,E01030681,1617,292,1325
2021,Runnymede 010B,E01030682,1280,254,1026
2021,Runnymede 010C,E01030683,1334,223,1111
2021,Runnymede 009E,E01030684,1424,270,1154
2021,Runnymede 004C,E01030685,1433,381,1052
2021,Runnymede 004D,E01030686,1395,214,1181
2021,Runnymede 003E,E01030687,1184,181,1003
2021,Runnymede 003F,E01030688,1485,249,1236
2021,Runnymede 005A,E01030689,1428,258,1170
2021,Runnymede 005B,E01030690,1728,407,1321
2021,Runnymede 005C,E01030691,1489,305,1184
2021,Runnymede 005D,E01030692,1402,258,1144
2021,Runnymede 010D,E01030693,1206,213,993
2021,Runnymede 010E,E01030694,1282,246,1036
2021,Runnymede 010F,E01030695,1168,209,959
2021,Runnymede 010G,E01030696,1467,263,1204
2021,Spelthorne 006A,E01030697,1646,312,1334
2021,Spelthorne 006B,E01030698,1629,324,1305
2021,Spelthorne 006C,E01030699,1432,237,1195
2021,Spelthorne 006D,E01030700,1669,267,1402
2021,Spelthorne 005A,E01030701,1510,260,1250
2021,Spelthorne 005B,E01030702,1220,271,949
2021,Spelthorne 005C,E01030703,1533,285,1248
2021,Spelthorne 005D,E01030704,1523,229,1294
2021,Spelthorne 005E,E01030705,1558,264,1294
2021,Spelthorne 005F,E01030706,1409,273,1136
2021,Spelthorne 003A,E01030707,1918,361,1557
2021,Spelthorne 003B,E01030708,1588,305,1283
2021,Spelthorne 002A,E01030709,1684,364,1320
2021,Spelthorne 002B,E01030710,1947,478,1469
2021,Spelthorne 002C,E01030711,1839,407,1432
2021,Spelthorne 003C,E01030712,1665,293,1372
2021,Spelthorne 003D,E01030713,1263,239,1024
2021,Spelthorne 003E,E01030714,1428,203,1225
2021,Spelthorne 003F,E01030715,1452,235,1217
2021,Spelthorne 003G,E01030716,1401,219,1182
2021,Spelthorne 011A,E01030717,1576,266,1310
2021,Spelthorne 011B,E01030718,1311,257,1054
2021,Spelthorne 011C,E01030719,1528,264,1264
2021,Spelthorne 011D,E01030720,1732,305,1427
2021,Spelthorne 012A,E01030721,1442,236,1206
2021,Spelthorne 012B,E01030722,1548,306,1242
2021,Spelthorne 012C,E01030723,1521,298,1223
2021,Spelthorne 012D,E01030724,1418,250,1168
2021,Spelthorne 006E,E01030725,1912,350,1562
2021,Spelthorne 009A,E01030726,1656,293,1363
2021,Spelthorne 009B,E01030727,1735,230,1505
2021,Spelthorne 009C,E01030728,1618,230,1388
2021,Spelthorne 007A,E01030729,1423,252,1171
2021,Spelthorne 013A,E01030730,1756,265,1491
2021,Spelthorne 013B,E01030731,1764,334,1430
2021,Spelthorne 013C,E01030732,1577,229,1348
2021,Spelthorne 013D,E01030733,1600,208,1392
2021,Spelthorne 004A,E01030734,1450,285,1165
2021,Spelthorne 004B,E01030735,1553,278,1275
2021,Spelthorne 004D,E01030737,1422,237,1185
2021,Spelthorne 004E,E01030738,1445,222,1223
2021,Spelthorne 007B,E01030739,1626,334,1292
2021,Spelthorne 007C,E01030740,1767,369,1398
2021,Spelthorne 007D,E01030741,1590,310,1280
2021,Spelthorne 009D,E01030742,1816,332,1484
2021,Spelthorne 001A,E01030743,1570,259,1311
2021,Spelthorne 001B,E01030744,1627,211,1416
2021,Spelthorne 001C,E01030745,1714,409,1305
2021,Spelthorne 002D,E01030746,1747,374,1373
2021,Spelthorne 001D,E01030747,1342,244,1098
2021,Spelthorne 008A,E01030748,1674,351,1323
2021,Spelthorne 008B,E01030749,1491,346,1145
2021,Spelthorne 008C,E01030750,1465,326,1139
2021,Spelthorne 008D,E01030751,1680,309,1371
2021,Spelthorne 008E,E01030752,1652,382,1270
2021,Spelthorne 010A,E01030753,1739,293,1446
2021,Spelthorne 010B,E01030754,2083,435,1648
2021,Spelthorne 010C,E01030755,1939,403,1536
2021,Spelthorne 010D,E01030756,1592,289,1303
2021,Surrey Heath 002A,E01030757,1576,268,1308
2021,Surrey Heath 002B,E01030758,1120,185,935
2021,Surrey Heath 002C,E01030759,1478,260,1218
2021,Surrey Heath 002D,E01030760,1551,298,1253
2021,Surrey Heath 006A,E01030761,2446,386,2060
2021,Surrey Heath 006B,E01030762,1744,296,1448
2021,Surrey Heath 001A,E01030763,1169,168,1001
2021,Surrey Heath 001B,E01030764,1265,207,1058
2021,Surrey Heath 001C,E01030765,1471,285,1186
2021,Surrey Heath 010A,E01030766,1740,271,1469
2021,Surrey Heath 010B,E01030767,1667,377,1290
2021,Surrey Heath 010C,E01030768,1301,235,1066
2021,Surrey Heath 010D,E01030769,1444,287,1157
2021,Surrey Heath 011A,E01030770,1401,260,1141
2021,Surrey Heath 011B,E01030771,1171,204,967
2021,Surrey Heath 011C,E01030772,1434,266,1168
2021,Surrey Heath 011D,E01030773,1273,235,1038
2021,Surrey Heath 007A,E01030774,1433,292,1141
2021,Surrey Heath 007B,E01030775,1443,301,1142
2021,Surrey Heath 007C,E01030776,1552,349,1203
2021,Surrey Heath 007D,E01030777,1487,332,1155
2021,Surrey Heath 003A,E01030778,1618,242,1376
2021,Surrey Heath 003B,E01030779,1653,229,1424
2021,Surrey Heath 003C,E01030780,1504,226,1278
2021,Surrey Heath 003D,E01030781,1504,283,1221
2021,Surrey Heath 012A,E01030782,1511,253,1258
2021,Surrey Heath 012B,E01030783,1558,291,1267
2021,Surrey Heath 012C,E01030784,2325,486,1839
2021,Surrey Heath 012D,E01030785,1408,183,1225
2021,Surrey Heath 004A,E01030786,1705,335,1370
2021,Surrey Heath 004B,E01030787,1379,283,1096
2021,Surrey Heath 004C,E01030788,1289,321,968
2021,Surrey Heath 009A,E01030789,1589,301,1288
2021,Surrey Heath 009B,E01030790,1717,397,1320
2021,Surrey Heath 009C,E01030791,1646,318,1328
2021,Surrey Heath 009D,E01030792,1278,243,1035
2021,Surrey Heath 008A,E01030793,2004,392,1612
2021,Surrey Heath 008B,E01030794,1493,258,1235
2021,Surrey Heath 008C,E01030795,2163,306,1857
2021,Surrey Heath 005A,E01030796,1352,263,1089
2021,Surrey Heath 005B,E01030797,1354,252,1102
2021,Surrey Heath 005C,E01030798,1508,297,1211
2021,Surrey Heath 005D,E01030799,1332,247,1085
2021,Surrey Heath 005E,E01030800,1907,268,1639
2021,Surrey Heath 004D,E01030801,1616,261,1355
2021,Surrey Heath 004E,E01030802,1761,286,1475
2021,Surrey Heath 008D,E01030803,1680,270,1410
2021,Surrey Heath 008E,E01030804,1669,276,1393
2021,Surrey Heath 008F,E01030805,1609,334,1275
2021,Surrey Heath 006C,E01030806,1454,325,1129
2021,Surrey Heath 006D,E01030807,2602,828,1774
2021,Surrey Heath 006E,E01030808,1566,338,1228
2021,Surrey Heath 001D,E01030809,1402,224,1178
2021,Surrey Heath 001E,E01030810,1241,217,1024
2021,Surrey Heath 001F,E01030811,1406,273,1133
2021,Tandridge 008A,E01030812,1598,309,1289
2021,Tandridge 008B,E01030813,1440,244,1196
2021,Tandridge 008C,E01030814,1245,225,1020
2021,Tandridge 008D,E01030815,1489,271,1218
2021,Tandridge 011A,E01030816,1574,288,1286
2021,Tandridge 011B,E01030817,1363,220,1143
2021,Tandridge 011C,E01030818,1187,209,978
2021,Tandridge 011D,E01030819,1655,250,1405
2021,Tandridge 005A,E01030820,1743,327,1416
2021,Tandridge 010A,E01030821,1914,405,1509
2021,Tandridge 010B,E01030822,1945,294,1651
2021,Tandridge 011E,E01030823,2249,382,1867
2021,Tandridge 009A,E01030824,1475,319,1156
2021,Tandridge 009B,E01030825,1300,204,1096
2021,Tandridge 009C,E01030826,1411,267,1144
2021,Tandridge 009D,E01030827,1655,265,1390
2021,Tandridge 004A,E01030828,1378,362,1016
2021,Tandridge 004B,E01030829,1603,248,1355
2021,Tandridge 004C,E01030830,1250,254,996
2021,Tandridge 006A,E01030831,2144,383,1761
2021,Tandridge 006B,E01030832,1309,203,1106
2021,Tandridge 010C,E01030833,1343,245,1098
2021,Tandridge 010D,E01030834,1398,261,1137
2021,Tandridge 010E,E01030835,1398,261,1137
2021,Tandridge 006C,E01030836,1513,293,1220
2021,Tandridge 006D,E01030837,1385,268,1117
2021,Tandridge 006E,E01030838,1280,244,1036
2021,Tandridge 006F,E01030839,1352,248,1104
2021,Tandridge 007A,E01030840,1356,284,1072
2021,Tandridge 007B,E01030841,1301,262,1039
2021,Tandridge 007C,E01030842,2147,455,1692
2021,Tandridge 007D,E01030843,1426,294,1132
2021,Tandridge 003A,E01030844,1713,370,1343
2021,Tandridge 003B,E01030845,1177,245,932
2021,Tandridge 003C,E01030846,1480,287,1193
2021,Tandridge 005B,E01030847,1526,216,1310
2021,Tandridge 005C,E01030848,2104,421,1683
2021,Tandridge 004D,E01030850,2266,439,1827
2021,Tandridge 004E,E01030851,1937,394,1543
2021,Tandridge 012A,E01030852,1847,329,1518
2021,Tandridge 012B,E01030853,1698,319,1379
2021,Tandridge 012C,E01030854,1875,337,1538
2021,Tandridge 002A,E01030855,1963,323,1640
2021,Tandridge 002B,E01030856,1453,246,1207
2021,Tandridge 003D,E01030857,2071,427,1644
2021,Tandridge 003E,E01030858,2424,485,1939
2021,Tandridge 002C,E01030859,1915,339,1576
2021,Tandridge 004F,E01030861,2436,882,1554
2021,Waverley 015A,E01030862,1889,233,1656
2021,Waverley 008A,E01030863,1800,371,1429
2021,Waverley 012A,E01030864,1705,312,1393
2021,Waverley 008B,E01030865,1528,338,1190
2021,Waverley 008C,E01030866,1485,308,1177
2021,Waverley 015B,E01030867,1485,271,1214
2021,Waverley 015C,E01030868,1236,278,958
2021,Waverley 015D,E01030869,1135,217,918
2021,Waverley 013A,E01030870,1534,274,1260
2021,Waverley 013B,E01030871,1815,354,1461
2021,Waverley 013C,E01030872,1732,277,1455
2021,Waverley 013D,E01030873,1349,227,1122
2021,Waverley 013E,E01030874,1669,697,972
2021,Waverley 013F,E01030875,1656,230,1426
2021,Waverley 013G,E01030876,1495,234,1261
2021,Waverley 011A,E01030877,1107,181,926
2021,Waverley 011B,E01030878,1612,316,1296
2021,Waverley 012B,E01030879,1085,187,898
2021,Waverley 015E,E01030880,2277,599,1678
2021,Waverley 004A,E01030881,1495,401,1094
2021,Waverley 006A,E01030882,1393,352,1041
2021,Waverley 004B,E01030883,1423,341,1082
2021,Waverley 003A,E01030884,1513,340,1173
2021,Waverley 003B,E01030885,1692,438,1254
2021,Waverley 003C,E01030886,1342,286,1056
2021,Waverley 006B,E01030887,1363,336,1027
2021,Waverley 004C,E01030888,1547,358,1189
2021,Waverley 006C,E01030889,1482,388,1094
2021,Waverley 001A,E01030890,1470,305,1165
2021,Waverley 002A,E01030891,1584,312,1272
2021,Waverley 002B,E01030892,1206,233,973
2021,Waverley 003D,E01030893,1948,501,1447
2021,Waverley 004D,E01030894,1665,343,1322
2021,Waverley 003E,E01030895,1524,434,1090
2021,Waverley 006D,E01030896,1235,272,963
2021,Waverley 006E,E01030897,1293,313,980
2021,Waverley 009A,E01030898,1573,363,1210
2021,Waverley 002C,E01030899,1514,243,1271
2021,Waverley 002D,E01030900,1216,217,999
2021,Waverley 002E,E01030901,1326,393,933
2021,Waverley 001B,E01030902,1230,223,1007
2021,Waverley 001C,E01030903,1794,283,1511
2021,Waverley 001D,E01030904,1424,245,1179
2021,Waverley 009B,E01030905,1640,399,1241
2021,Waverley 009C,E01030906,1852,402,1450
2021,Waverley 009D,E01030907,1374,398,976
2021,Waverley 018A,E01030908,1598,338,1260
2021,Waverley 018B,E01030909,1265,246,1019
2021,Waverley 018C,E01030910,1126,197,929
2021,Waverley 005A,E01030911,1425,274,1151
2021,Waverley 005B,E01030912,1263,218,1045
2021,Waverley 005C,E01030913,1232,226,1006
2021,Waverley 010A,E01030914,1325,232,1093
2021,Waverley 010B,E01030915,1405,250,1155
2021,Waverley 007A,E01030916,2098,331,1767
2021,Waverley 007B,E01030917,1091,199,892
2021,Waverley 007C,E01030918,1125,173,952
2021,Waverley 007D,E01030919,1932,899,1033
2021,Waverley 005D,E01030920,1469,228,1241
2021,Waverley 005E,E01030921,1604,230,1374
2021,Waverley 007E,E01030922,1696,273,1423
2021,Waverley 010C,E01030923,1480,343,1137
2021,Waverley 010D,E01030924,1133,232,901
2021,Waverley 010E,E01030925,1598,357,1241
2021,Waverley 017A,E01030926,1474,284,1190
2021,Waverley 017B,E01030927,1238,239,999
2021,Waverley 017C,E01030928,1640,233,1407
2021,Waverley 017D,E01030929,1482,377,1105
2021,Waverley 016A,E01030930,1458,294,1164
2021,Waverley 016B,E01030931,1662,298,1364
2021,Waverley 016C,E01030932,1571,319,1252
2021,Waverley 016D,E01030933,1727,336,1391
2021,Waverley 018D,E01030934,1365,213,1152
2021,Waverley 018E,E01030935,1242,243,999
2021,Waverley 011C,E01030937,1549,301,1248
2021,Waverley 011D,E01030938,1218,199,1019
2021,Waverley 011E,E01030939,1116,217,899
2021,Waverley 008D,E01030940,1849,432,1417
2021,Waverley 012C,E01030941,1434,365,1069
2021,Waverley 012D,E01030942,1303,239,1064
2021,Waverley 012E,E01030943,1276,298,978
2021,Woking 012A,E01030944,1284,310,974
2021,Woking 012B,E01030945,1142,181,961
2021,Woking 001A,E01030946,1349,248,1101
2021,Woking 001B,E01030947,1389,313,1076
2021,Woking 001C,E01030948,1543,282,1261
2021,Woking 001D,E01030949,1758,321,1437
2021,Woking 001E,E01030950,1488,241,1247
2021,Woking 005A,E01030951,1222,200,1022
2021,Woking 005B,E01030952,1488,417,1071
2021,Woking 005C,E01030953,1356,222,1134
2021,Woking 008A,E01030954,2246,375,1871
2021,Woking 010A,E01030955,1284,237,1047
2021,Woking 005D,E01030956,1194,232,962
2021,Woking 005E,E01030957,1159,272,887
2021,Woking 005F,E01030958,1357,229,1128
2021,Woking 005G,E01030959,946,149,797
2021,Woking 009A,E01030960,1613,276,1337
2021,Woking 009B,E01030961,1826,373,1453
2021,Woking 009C,E01030962,1541,262,1279
2021,Woking 003A,E01030963,1456,314,1142
2021,Woking 003B,E01030964,1668,275,1393
2021,Woking 003C,E01030965,1448,293,1155
2021,Woking 003D,E01030966,1352,328,1024
2021,Woking 003E,E01030967,1583,296,1287
2021,Woking 003F,E01030968,1264,287,977
2021,Woking 008B,E01030969,1379,305,1074
2021,Woking 008C,E01030970,1359,251,1108
2021,Woking 011A,E01030971,2313,570,1743
2021,Woking 011B,E01030972,1910,433,1477
2021,Woking 007A,E01030974,1462,270,1192
2021,Woking 007B,E01030975,1361,298,1063
2021,Woking 007C,E01030976,1419,247,1172
2021,Woking 007D,E01030977,1690,295,1395
2021,Woking 012C,E01030978,2079,457,1622
2021,Woking 007E,E01030979,1956,447,1509
2021,Woking 004A,E01030980,1616,348,1268
2021,Woking 004B,E01030981,1665,386,1279
2021,Woking 004D,E01030983,1827,323,1504
2021,Woking 004E,E01030984,2091,582,1509
2021,Woking 012D,E01030986,1009,151,858
2021,Woking 012E,E01030987,1301,248,1053
2021,Woking 006A,E01030988,1930,330,1600
2021,Woking 006B,E01030989,1755,347,1408
2021,Woking 006C,E01030990,1358,281,1077
2021,Woking 008D,E01030991,1927,285,1642
2021,Woking 010B,E01030992,1637,303,1334
2021,Woking 011D,E01030994,1857,374,1483
2021,Woking 011E,E01030995,1651,382,1269
2021,Woking 002A,E01030996,1452,299,1153
2021,Woking 006D,E01030997,1428,254,1174
2021,Woking 002B,E01030998,1796,328,1468
2021,Woking 010C,E01030999,1310,263,1047
2021,Woking 009D,E01031000,1431,274,1157
2021,Woking 010D,E01031001,1640,312,1328
2021,Woking 002C,E01031002,1673,309,1364
2021,Woking 002D,E01031003,1814,401,1413
2021,Woking 002E,E01031004,2094,327,1767
2021,North Warwickshire 005A,E01031005,1535,279,1256
2021,North Warwickshire 007A,E01031006,1391,234,1157
2021,North Warwickshire 007B,E01031007,1228,185,1043
2021,North Warwickshire 005B,E01031008,1437,282,1155
2021,North Warwickshire 003A,E01031009,2070,360,1710
2021,North Warwickshire 003B,E01031010,1855,367,1488
2021,North Warwickshire 003C,E01031011,2128,322,1806
2021,North Warwickshire 003D,E01031012,1422,247,1175
2021,North Warwickshire 003E,E01031013,986,135,851
2021,North Warwickshire 003F,E01031014,1171,199,972
2021,North Warwickshire 003G,E01031015,1488,268,1220
2021,North Warwickshire 002A,E01031016,1449,220,1229
2021,North Warwickshire 005C,E01031017,1620,321,1299
2021,North Warwickshire 005D,E01031018,1053,144,909
2021,North Warwickshire 006A,E01031019,1602,297,1305
2021,North Warwickshire 006B,E01031020,1438,212,1226
2021,North Warwickshire 006C,E01031021,1718,226,1492
2021,North Warwickshire 006D,E01031022,1793,268,1525
2021,North Warwickshire 004A,E01031023,1543,243,1300
2021,North Warwickshire 004B,E01031024,1720,250,1470
2021,North Warwickshire 002B,E01031025,1586,251,1335
2021,North Warwickshire 002C,E01031026,1483,343,1140
2021,North Warwickshire 007C,E01031027,1660,258,1402
2021,North Warwickshire 007D,E01031028,1818,288,1530
2021,North Warwickshire 005E,E01031029,1442,220,1222
2021,North Warwickshire 005F,E01031030,2206,336,1870
2021,North Warwickshire 002D,E01031031,2444,463,1981
2021,North Warwickshire 002E,E01031032,1324,263,1061
2021,North Warwickshire 004C,E01031033,1713,272,1441
2021,North Warwickshire 004D,E01031034,1708,261,1447
2021,North Warwickshire 001A,E01031035,1900,296,1604
2021,North Warwickshire 001B,E01031036,1658,266,1392
2021,North Warwickshire 001C,E01031037,1879,357,1522
2021,North Warwickshire 001D,E01031038,1889,371,1518
2021,North Warwickshire 001E,E01031039,1481,237,1244
2021,North Warwickshire 001F,E01031040,1668,270,1398
2021,North Warwickshire 006E,E01031041,1562,237,1325
2021,North Warwickshire 006F,E01031042,1761,301,1460
2021,Nuneaton and Bedworth 005A,E01031043,1691,229,1462
2021,Nuneaton and Bedworth 005B,E01031044,1618,337,1281
2021,Nuneaton and Bedworth 005C,E01031045,1805,307,1498
2021,Nuneaton and Bedworth 005D,E01031046,1634,289,1345
2021,Nuneaton and Bedworth 005E,E01031047,1867,360,1507
2021,Nuneaton and Bedworth 008A,E01031048,1192,212,980
2021,Nuneaton and Bedworth 008B,E01031049,2594,491,2103
2021,Nuneaton and Bedworth 008C,E01031050,1731,319,1412
2021,Nuneaton and Bedworth 008D,E01031051,1265,201,1064
2021,Nuneaton and Bedworth 010A,E01031052,1413,235,1178
2021,Nuneaton and Bedworth 010B,E01031053,1339,163,1176
2021,Nuneaton and Bedworth 010C,E01031054,1500,245,1255
2021,Nuneaton and Bedworth 010D,E01031055,1568,338,1230
2021,Nuneaton and Bedworth 010E,E01031056,1429,297,1132
2021,Nuneaton and Bedworth 006A,E01031057,1430,356,1074
2021,Nuneaton and Bedworth 006B,E01031058,1396,235,1161
2021,Nuneaton and Bedworth 006C,E01031059,1518,287,1231
2021,Nuneaton and Bedworth 006D,E01031060,1320,190,1130
2021,Nuneaton and Bedworth 006E,E01031061,1359,220,1139
2021,Nuneaton and Bedworth 013A,E01031062,1143,196,947
2021,Nuneaton and Bedworth 013B,E01031063,1177,210,967
2021,Nuneaton and Bedworth 013C,E01031064,1248,186,1062
2021,Nuneaton and Bedworth 013D,E01031065,1515,272,1243
2021,Nuneaton and Bedworth 013E,E01031066,1474,310,1164
2021,Nuneaton and Bedworth 014A,E01031067,1371,179,1192
2021,Nuneaton and Bedworth 014B,E01031068,1668,262,1406
2021,Nuneaton and Bedworth 014C,E01031069,1428,194,1234
2021,Nuneaton and Bedworth 014D,E01031070,1365,148,1217
2021,Nuneaton and Bedworth 002C,E01031073,1931,315,1616
2021,Nuneaton and Bedworth 002D,E01031074,1477,246,1231
2021,Nuneaton and Bedworth 002E,E01031075,2075,468,1607
2021,Nuneaton and Bedworth 018A,E01031077,1668,451,1217
2021,Nuneaton and Bedworth 018B,E01031078,2038,356,1682
2021,Nuneaton and Bedworth 018C,E01031079,1471,226,1245
2021,Nuneaton and Bedworth 018D,E01031080,1550,278,1272
2021,Nuneaton and Bedworth 004A,E01031081,1545,329,1216
2021,Nuneaton and Bedworth 004B,E01031082,1319,199,1120
2021,Nuneaton and Bedworth 004C,E01031083,1699,316,1383
2021,Nuneaton and Bedworth 004D,E01031084,2078,439,1639
2021,Nuneaton and Bedworth 004E,E01031085,1274,199,1075
2021,Nuneaton and Bedworth 016A,E01031086,1949,416,1533
2021,Nuneaton and Bedworth 016B,E01031087,2073,432,1641
2021,Nuneaton and Bedworth 016C,E01031088,1903,370,1533
2021,Nuneaton and Bedworth 016D,E01031089,1382,207,1175
2021,Nuneaton and Bedworth 007A,E01031090,1545,416,1129
2021,Nuneaton and Bedworth 007B,E01031091,1545,283,1262
2021,Nuneaton and Bedworth 007C,E01031092,1410,325,1085
2021,Nuneaton and Bedworth 007D,E01031093,1232,202,1030
2021,Nuneaton and Bedworth 007E,E01031094,1127,240,887
2021,Nuneaton and Bedworth 015A,E01031095,1194,312,882
2021,Nuneaton and Bedworth 015B,E01031096,1261,251,1010
2021,Nuneaton and Bedworth 015C,E01031097,1600,301,1299
2021,Nuneaton and Bedworth 015D,E01031098,1333,286,1047
2021,Nuneaton and Bedworth 015E,E01031099,2155,404,1751
2021,Nuneaton and Bedworth 003A,E01031100,1243,204,1039
2021,Nuneaton and Bedworth 003B,E01031101,1300,246,1054
2021,Nuneaton and Bedworth 003C,E01031102,1247,224,1023
2021,Nuneaton and Bedworth 003E,E01031104,1367,204,1163
2021,Nuneaton and Bedworth 012A,E01031105,1464,213,1251
2021,Nuneaton and Bedworth 012B,E01031106,1381,196,1185
2021,Nuneaton and Bedworth 012C,E01031107,1069,190,879
2021,Nuneaton and Bedworth 012D,E01031108,1330,241,1089
2021,Nuneaton and Bedworth 012E,E01031109,1478,255,1223
2021,Nuneaton and Bedworth 001A,E01031110,1535,254,1281
2021,Nuneaton and Bedworth 001B,E01031111,982,178,804
2021,Nuneaton and Bedworth 001C,E01031112,1503,288,1215
2021,Nuneaton and Bedworth 001E,E01031114,1470,213,1257
2021,Nuneaton and Bedworth 009A,E01031115,1684,305,1379
2021,Nuneaton and Bedworth 009B,E01031116,1622,397,1225
2021,Nuneaton and Bedworth 009C,E01031117,1471,335,1136
2021,Nuneaton and Bedworth 009D,E01031118,1141,225,916
2021,Nuneaton and Bedworth 009E,E01031119,1576,279,1297
2021,Nuneaton and Bedworth 011A,E01031120,1284,161,1123
2021,Nuneaton and Bedworth 011B,E01031121,1094,151,943
2021,Nuneaton and Bedworth 011C,E01031122,1339,151,1188
2021,Nuneaton and Bedworth 011D,E01031123,1160,159,1001
2021,Nuneaton and Bedworth 011E,E01031124,1462,222,1240
2021,Rugby 007A,E01031125,1417,231,1186
2021,Rugby 007C,E01031127,1608,411,1197
2021,Rugby 014D,E01031129,1163,174,989
2021,Rugby 005A,E01031130,1800,335,1465
2021,Rugby 005B,E01031131,1746,292,1454
2021,Rugby 005C,E01031132,1850,316,1534
2021,Rugby 005D,E01031133,1350,278,1072
2021,Rugby 011A,E01031134,1582,212,1370
2021,Rugby 011B,E01031135,1505,200,1305
2021,Rugby 011C,E01031136,1768,261,1507
2021,Rugby 002A,E01031137,1111,170,941
2021,Rugby 002B,E01031138,1096,208,888
2021,Rugby 002C,E01031139,1638,284,1354
2021,Rugby 002D,E01031140,1286,233,1053
2021,Rugby 002F,E01031142,1623,395,1228
2021,Rugby 009A,E01031143,1401,185,1216
2021,Rugby 009B,E01031144,1431,263,1168
2021,Rugby 009C,E01031145,1508,698,810
2021,Rugby 009D,E01031146,1523,330,1193
2021,Rugby 012B,E01031148,1858,390,1468
2021,Rugby 012C,E01031149,1479,234,1245
2021,Rugby 012D,E01031150,1130,209,921
2021,Rugby 004A,E01031151,1461,217,1244
2021,Rugby 004B,E01031152,1002,146,856
2021,Rugby 004C,E01031153,1555,293,1262
2021,Rugby 004D,E01031154,1640,228,1412
2021,Rugby 008A,E01031155,1344,290,1054
2021,Rugby 008B,E01031156,1453,277,1176
2021,Rugby 008C,E01031157,2249,491,1758
2021,Rugby 008D,E01031158,1048,175,873
2021,Rugby 013C,E01031159,1518,211,1307
2021,Rugby 013B,E01031160,2019,332,1687
2021,Rugby 010A,E01031161,2017,370,1647
2021,Rugby 010B,E01031162,2050,423,1627
2021,Rugby 010C,E01031163,1596,305,1291
2021,Rugby 007E,E01031165,1504,311,1193
2021,Rugby 012E,E01031166,1939,301,1638
2021,Rugby 006A,E01031167,1306,198,1108
2021,Rugby 006B,E01031168,2707,597,2110
2021,Rugby 006C,E01031169,1983,314,1669
2021,Rugby 006D,E01031170,1640,279,1361
2021,Rugby 003A,E01031171,1394,263,1131
2021,Rugby 003B,E01031172,1573,341,1232
2021,Rugby 003C,E01031173,1820,254,1566
2021,Rugby 003D,E01031174,2096,313,1783
2021,Rugby 011D,E01031175,1417,205,1212
2021,Rugby 011E,E01031176,1480,339,1141
2021,Rugby 011F,E01031177,1436,342,1094
2021,Rugby 011G,E01031178,1376,248,1128
2021,Rugby 010D,E01031179,1999,468,1531
2021,Rugby 010E,E01031180,1993,401,1592
2021,Rugby 004E,E01031181,1736,295,1441
2021,Rugby 013A,E01031182,2235,310,1925
2021,Stratford-on-Avon 006A,E01031183,1530,179,1351
2021,Stratford-on-Avon 006B,E01031184,1377,214,1163
2021,Stratford-on-Avon 006C,E01031185,1245,187,1058
2021,Stratford-on-Avon 006D,E01031186,1482,237,1245
2021,Stratford-on-Avon 007A,E01031187,1796,242,1554
2021,Stratford-on-Avon 007B,E01031188,2486,391,2095
2021,Stratford-on-Avon 012A,E01031189,1659,242,1417
2021,Stratford-on-Avon 012B,E01031190,2295,430,1865
2021,Stratford-on-Avon 012C,E01031191,1965,309,1656
2021,Stratford-on-Avon 012D,E01031192,2295,406,1889
2021,Stratford-on-Avon 015A,E01031193,2055,263,1792
2021,Stratford-on-Avon 013A,E01031194,2220,335,1885
2021,Stratford-on-Avon 002A,E01031195,2183,372,1811
2021,Stratford-on-Avon 014A,E01031196,2386,404,1982
2021,Stratford-on-Avon 005A,E01031197,1196,180,1016
2021,Stratford-on-Avon 005B,E01031198,1286,229,1057
2021,Stratford-on-Avon 005C,E01031199,2025,345,1680
2021,Stratford-on-Avon 005D,E01031200,1660,281,1379
2021,Stratford-on-Avon 005E,E01031201,1560,263,1297
2021,Stratford-on-Avon 002B,E01031202,1560,198,1362
2021,Stratford-on-Avon 002C,E01031203,1546,243,1303
2021,Stratford-on-Avon 002D,E01031204,1396,177,1219
2021,Stratford-on-Avon 013B,E01031205,1761,262,1499
2021,Stratford-on-Avon 013C,E01031206,1499,251,1248
2021,Stratford-on-Avon 013D,E01031207,1355,198,1157
2021,Stratford-on-Avon 007C,E01031208,2310,360,1950
2021,Stratford-on-Avon 015B,E01031209,2140,283,1857
2021,Stratford-on-Avon 005F,E01031210,1153,185,968
2021,Stratford-on-Avon 005G,E01031211,1687,357,1330
2021,Stratford-on-Avon 001A,E01031213,1881,309,1572
2021,Stratford-on-Avon 015C,E01031214,2299,397,1902
2021,Stratford-on-Avon 015D,E01031215,1742,229,1513
2021,Stratford-on-Avon 015E,E01031216,1541,214,1327
2021,Stratford-on-Avon 008A,E01031217,1220,226,994
2021,Stratford-on-Avon 008B,E01031218,1180,225,955
2021,Stratford-on-Avon 004A,E01031219,2124,368,1756
2021,Stratford-on-Avon 004B,E01031220,1380,232,1148
2021,Stratford-on-Avon 004C,E01031221,1812,326,1486
2021,Stratford-on-Avon 004D,E01031222,2362,347,2015
2021,Stratford-on-Avon 004E,E01031223,1427,239,1188
2021,Stratford-on-Avon 004F,E01031224,1355,243,1112
2021,Stratford-on-Avon 010A,E01031225,1712,295,1417
2021,Stratford-on-Avon 010C,E01031227,2056,321,1735
2021,Stratford-on-Avon 009A,E01031228,1513,212,1301
2021,Stratford-on-Avon 009B,E01031229,2028,154,1874
2021,Stratford-on-Avon 009D,E01031231,2252,319,1933
2021,Stratford-on-Avon 011A,E01031232,2013,321,1692
2021,Stratford-on-Avon 011B,E01031233,1616,266,1350
2021,Stratford-on-Avon 011C,E01031234,1708,176,1532
2021,Stratford-on-Avon 011D,E01031235,1775,229,1546
2021,Stratford-on-Avon 009E,E01031236,1480,220,1260
2021,Stratford-on-Avon 011E,E01031237,1463,270,1193
2021,Stratford-on-Avon 009F,E01031238,1215,187,1028
2021,Stratford-on-Avon 003A,E01031239,1574,254,1320
2021,Stratford-on-Avon 003B,E01031240,1305,203,1102
2021,Stratford-on-Avon 003C,E01031241,1422,251,1171
2021,Stratford-on-Avon 003D,E01031242,1457,305,1152
2021,Stratford-on-Avon 001B,E01031243,1979,285,1694
2021,Stratford-on-Avon 001C,E01031244,1803,253,1550
2021,Stratford-on-Avon 014C,E01031245,1211,168,1043
2021,Stratford-on-Avon 014D,E01031246,1302,233,1069
2021,Stratford-on-Avon 013E,E01031247,2328,328,2000
2021,Stratford-on-Avon 012E,E01031248,2366,372,1994
2021,Stratford-on-Avon 008C,E01031249,1056,155,901
2021,Stratford-on-Avon 008E,E01031251,1068,141,927
2021,Stratford-on-Avon 008F,E01031252,1252,289,963
2021,Stratford-on-Avon 008G,E01031253,1359,241,1118
2021,Warwick 001A,E01031254,1636,293,1343
2021,Warwick 001B,E01031255,1374,254,1120
2021,Warwick 001C,E01031256,1596,281,1315
2021,Warwick 001D,E01031257,1411,291,1120
2021,Warwick 001E,E01031258,1629,315,1314
2021,Warwick 014A,E01031259,2613,566,2047
2021,Warwick 014B,E01031260,2092,428,1664
2021,Warwick 013A,E01031261,1861,700,1161
2021,Warwick 013B,E01031262,1318,305,1013
2021,Warwick 013C,E01031263,1677,663,1014
2021,Warwick 013D,E01031264,1608,408,1200
2021,Warwick 013E,E01031265,1659,439,1220
2021,Warwick 013F,E01031266,1765,790,975
2021,Warwick 014C,E01031267,1679,279,1400
2021,Warwick 014D,E01031268,2494,557,1937
2021,Warwick 014E,E01031269,1962,399,1563
2021,Warwick 010A,E01031271,1740,351,1389
2021,Warwick 007B,E01031272,1641,397,1244
2021,Warwick 006A,E01031273,1183,226,957
2021,Warwick 006B,E01031274,1448,303,1145
2021,Warwick 006C,E01031275,1167,196,971
2021,Warwick 006D,E01031276,1399,255,1144
2021,Warwick 005A,E01031277,1463,286,1177
2021,Warwick 005B,E01031278,1647,317,1330
2021,Warwick 005C,E01031279,1322,203,1119
2021,Warwick 005D,E01031280,1219,198,1021
2021,Warwick 004A,E01031281,1541,263,1278
2021,Warwick 004B,E01031282,1584,241,1343
2021,Warwick 004C,E01031283,1240,203,1037
2021,Warwick 004D,E01031284,1205,215,990
2021,Warwick 007C,E01031285,2197,300,1897
2021,Warwick 007D,E01031286,1330,200,1130
2021,Warwick 007E,E01031287,1432,322,1110
2021,Warwick 007F,E01031288,1679,355,1324
2021,Warwick 007G,E01031289,1500,328,1172
2021,Warwick 009A,E01031290,1616,327,1289
2021,Warwick 009B,E01031291,1838,434,1404
2021,Warwick 009C,E01031292,1421,252,1169
2021,Warwick 009D,E01031293,1502,328,1174
2021,Warwick 009E,E01031294,1430,335,1095
2021,Warwick 009F,E01031295,1156,232,924
2021,Warwick 002A,E01031296,1456,240,1216
2021,Warwick 002B,E01031297,1933,389,1544
2021,Warwick 002C,E01031298,1561,254,1307
2021,Warwick 002D,E01031299,1327,246,1081
2021,Warwick 002E,E01031300,1793,392,1401
2021,Warwick 005E,E01031301,1751,316,1435
2021,Warwick 005F,E01031302,973,160,813
2021,Warwick 003A,E01031303,1409,244,1165
2021,Warwick 003B,E01031304,1430,302,1128
2021,Warwick 003C,E01031305,1444,233,1211
2021,Warwick 003D,E01031306,1380,265,1115
2021,Warwick 003E,E01031307,1349,205,1144
2021,Warwick 005G,E01031308,4012,2593,1419
2021,Warwick 008A,E01031309,1919,325,1594
2021,Warwick 008B,E01031310,1273,234,1039
2021,Warwick 008C,E01031311,1296,229,1067
2021,Warwick 008D,E01031312,1200,195,1005
2021,Warwick 008E,E01031313,1275,165,1110
2021,Warwick 008F,E01031314,1237,151,1086
2021,Warwick 012A,E01031315,2310,527,1783
2021,Warwick 012B,E01031316,1404,189,1215
2021,Warwick 012C,E01031317,1502,265,1237
2021,Warwick 012E,E01031319,1889,334,1555
2021,Warwick 012F,E01031320,1301,221,1080
2021,Warwick 011A,E01031321,1206,280,926
2021,Warwick 011B,E01031322,1845,280,1565
2021,Warwick 011C,E01031323,1601,203,1398
2021,Warwick 011D,E01031324,2023,200,1823
2021,Warwick 011E,E01031325,1377,294,1083
2021,Warwick 015A,E01031327,1404,250,1154
2021,Warwick 015B,E01031328,2745,550,2195
2021,Warwick 015C,E01031329,2374,469,1905
2021,Warwick 015D,E01031330,1423,224,1199
2021,Warwick 015E,E01031331,1733,255,1478
2021,Warwick 010B,E01031332,1266,287,979
2021,Warwick 010C,E01031333,1280,244,1036
2021,Warwick 010D,E01031334,1377,204,1173
2021,Warwick 010E,E01031335,1387,456,931
2021,Warwick 010F,E01031336,1942,916,1026
2021,Warwick 010G,E01031337,1710,367,1343
2021,Adur 002A,E01031338,1220,259,961
2021,Adur 002B,E01031339,1124,202,922
2021,Adur 002C,E01031340,1464,250,1214
2021,Adur 008A,E01031341,1393,267,1126
2021,Adur 008B,E01031342,1543,178,1365
2021,Adur 008C,E01031343,1319,202,1117
2021,Adur 006A,E01031344,1377,234,1143
2021,Adur 003A,E01031345,1520,240,1280
2021,Adur 006B,E01031346,1392,213,1179
2021,Adur 004A,E01031347,1579,354,1225
2021,Adur 004B,E01031348,1646,406,1240
2021,Adur 001A,E01031349,1330,226,1104
2021,Adur 001B,E01031350,1250,234,1016
2021,Adur 001C,E01031351,1544,293,1251
2021,Adur 001D,E01031352,1467,236,1231
2021,Adur 003B,E01031353,1343,432,911
2021,Adur 003C,E01031354,1265,201,1064
2021,Adur 003D,E01031355,1724,348,1376
2021,Adur 005A,E01031356,2302,435,1867
2021,Adur 005B,E01031357,2143,360,1783
2021,Adur 007A,E01031358,1414,241,1173
2021,Adur 003E,E01031359,1324,268,1056
2021,Adur 007B,E01031360,1462,255,1207
2021,Adur 006C,E01031361,1441,299,1142
2021,Adur 006D,E01031362,1285,253,1032
2021,Adur 006E,E01031363,1473,163,1310
2021,Adur 005C,E01031364,1761,221,1540
2021,Adur 002D,E01031365,1840,375,1465
2021,Adur 004C,E01031366,1352,284,1068
2021,Adur 002E,E01031367,1327,250,1077
2021,Adur 005D,E01031368,1423,254,1169
2021,Adur 005E,E01031369,1211,170,1041
2021,Adur 001E,E01031370,1448,333,1115
2021,Adur 004D,E01031371,1200,213,987
2021,Adur 004E,E01031372,1376,249,1127
2021,Adur 004F,E01031373,1370,275,1095
2021,Adur 001F,E01031374,1596,323,1273
2021,Adur 004G,E01031375,1404,219,1185
2021,Adur 007C,E01031376,1233,121,1112
2021,Adur 008D,E01031377,1603,230,1373
2021,Adur 007D,E01031378,1318,180,1138
2021,Adur 008E,E01031379,1548,193,1355
2021,Arun 018A,E01031380,1533,140,1393
2021,Arun 018B,E01031381,1612,192,1420
2021,Arun 018C,E01031382,1658,183,1475
2021,Arun 018D,E01031383,1540,144,1396
2021,Arun 018E,E01031384,1637,199,1438
2021,Arun 019A,E01031385,1500,217,1283
2021,Arun 002A,E01031386,1451,249,1202
2021,Arun 002B,E01031387,1505,223,1282
2021,Arun 005B,E01031389,2097,320,1777
2021,Arun 001A,E01031390,1302,214,1088
2021,Arun 001B,E01031391,1432,226,1206
2021,Arun 001C,E01031392,1501,174,1327
2021,Arun 003A,E01031393,2357,436,1921
2021,Arun 003B,E01031394,1551,284,1267
2021,Arun 003C,E01031395,1585,246,1339
2021,Arun 003D,E01031396,2287,389,1898
2021,Arun 003E,E01031397,1794,261,1533
2021,Arun 009A,E01031398,1413,221,1192
2021,Arun 009B,E01031399,1611,182,1429
2021,Arun 011A,E01031400,1515,162,1353
2021,Arun 012B,E01031402,1611,245,1366
2021,Arun 012C,E01031403,1418,227,1191
2021,Arun 014A,E01031404,1104,265,839
2021,Arun 012D,E01031405,1323,191,1132
2021,Arun 012E,E01031406,1273,277,996
2021,Arun 007A,E01031407,1450,263,1187
2021,Arun 007B,E01031408,1977,378,1599
2021,Arun 009C,E01031409,1362,306,1056
2021,Arun 007C,E01031410,1228,185,1043
2021,Arun 010A,E01031411,1330,96,1234
2021,Arun 008A,E01031412,1369,158,1211
2021,Arun 010B,E01031413,1367,113,1254
2021,Arun 005C,E01031414,1437,229,1208
2021,Arun 005D,E01031415,1533,166,1367
2021,Arun 015A,E01031416,1485,208,1277
2021,Arun 013A,E01031417,1607,297,1310
2021,Arun 015B,E01031418,1993,325,1668
2021,Arun 015C,E01031419,1528,195,1333
2021,Arun 015D,E01031420,1714,255,1459
2021,Arun 008B,E01031422,1537,96,1441
2021,Arun 008C,E01031423,1806,228,1578
2021,Arun 008D,E01031424,1398,124,1274
2021,Arun 002C,E01031425,1300,153,1147
2021,Arun 002D,E01031426,1161,148,1013
2021,Arun 004A,E01031427,1582,368,1214
2021,Arun 011B,E01031428,1442,258,1184
2021,Arun 004B,E01031429,1439,377,1062
2021,Arun 004C,E01031430,1352,206,1146
2021,Arun 017A,E01031431,1072,339,733
2021,Arun 017B,E01031432,1849,263,1586
2021,Arun 014B,E01031433,1356,248,1108
2021,Arun 014C,E01031434,1568,279,1289
2021,Arun 017C,E01031435,1800,241,1559
2021,Arun 017D,E01031436,1878,254,1624
2021,Arun 017E,E01031437,2014,239,1775
2021,Arun 013B,E01031438,1455,222,1233
2021,Arun 013C,E01031439,1833,195,1638
2021,Arun 013D,E01031440,1487,126,1361
2021,Arun 014D,E01031441,1621,303,1318
2021,Arun 014E,E01031442,1660,319,1341
2021,Arun 016A,E01031443,1340,283,1057
2021,Arun 016B,E01031444,1587,269,1318
2021,Arun 019B,E01031445,1866,139,1727
2021,Arun 019C,E01031446,1276,159,1117
2021,Arun 019D,E01031447,1605,203,1402
2021,Arun 019E,E01031448,1499,157,1342
2021,Arun 019F,E01031449,1633,308,1325
2021,Arun 016C,E01031450,1376,293,1083
2021,Arun 016D,E01031451,1606,318,1288
2021,Arun 016E,E01031452,1419,263,1156
2021,Arun 017F,E01031453,1644,226,1418
2021,Arun 011C,E01031454,2363,360,2003
2021,Arun 009D,E01031455,1577,207,1370
2021,Arun 011D,E01031456,1675,180,1495
2021,Arun 010C,E01031457,1649,141,1508
2021,Arun 010D,E01031458,1764,126,1638
2021,Arun 005E,E01031459,1785,307,1478
2021,Arun 010E,E01031460,1681,107,1574
2021,Arun 009E,E01031461,1713,188,1525
2021,Arun 007D,E01031462,1434,265,1169
2021,Arun 007E,E01031463,1576,269,1307
2021,Arun 007F,E01031464,1616,233,1383
2021,Arun 001D,E01031465,1321,184,1137
2021,Arun 003F,E01031466,1500,241,1259
2021,Arun 009F,E01031469,1569,220,1349
2021,Arun 006A,E01031470,1766,200,1566
2021,Arun 006B,E01031471,2096,443,1653
2021,Arun 006C,E01031472,1535,236,1299
2021,Arun 006D,E01031473,1167,202,965
2021,Chichester 011A,E01031474,1324,194,1130
2021,Chichester 009A,E01031475,1815,331,1484
2021,Chichester 009B,E01031476,1521,231,1290
2021,Chichester 006A,E01031477,2148,342,1806
2021,Chichester 005A,E01031478,1254,364,890
2021,Chichester 005B,E01031479,992,125,867
2021,Chichester 010A,E01031480,1243,236,1007
2021,Chichester 010B,E01031481,1482,242,1240
2021,Chichester 008A,E01031482,1440,307,1133
2021,Chichester 008B,E01031483,2267,611,1656
2021,Chichester 010C,E01031484,1761,285,1476
2021,Chichester 006B,E01031485,1465,213,1252
2021,Chichester 008C,E01031486,1789,517,1272
2021,Chichester 006C,E01031487,1476,270,1206
2021,Chichester 012A,E01031489,1454,278,1176
2021,Chichester 010D,E01031490,2327,623,1704
2021,Chichester 010E,E01031491,1761,250,1511
2021,Chichester 012B,E01031492,1757,494,1263
2021,Chichester 011B,E01031493,1742,403,1339
2021,Chichester 008E,E01031494,1533,286,1247
2021,Chichester 008F,E01031495,1428,233,1195
2021,Chichester 011C,E01031496,2532,466,2066
2021,Chichester 004A,E01031497,1537,215,1322
2021,Chichester 005C,E01031498,1031,189,842
2021,Chichester 013A,E01031499,1650,269,1381
2021,Chichester 013B,E01031500,2259,366,1893
2021,Chichester 013C,E01031501,1392,167,1225
2021,Chichester 001A,E01031502,1520,382,1138
2021,Chichester 001B,E01031503,1528,315,1213
2021,Chichester 001C,E01031504,2027,382,1645
2021,Chichester 011D,E01031505,2542,472,2070
2021,Chichester 007A,E01031506,1224,176,1048
2021,Chichester 007B,E01031507,1291,180,1111
2021,Chichester 003A,E01031508,1988,330,1658
2021,Chichester 004C,E01031511,1437,220,1217
2021,Chichester 004D,E01031512,1871,349,1522
2021,Chichester 005D,E01031514,1560,204,1356
2021,Chichester 005E,E01031515,1596,289,1307
2021,Chichester 005F,E01031516,1459,223,1236
2021,Chichester 002A,E01031517,1911,349,1562
2021,Chichester 002B,E01031518,1577,280,1297
2021,Chichester 001D,E01031519,1360,224,1136
2021,Chichester 003B,E01031520,1287,218,1069
2021,Chichester 003C,E01031521,1103,215,888
2021,Chichester 014A,E01031522,1937,319,1618
2021,Chichester 014B,E01031523,1611,223,1388
2021,Chichester 014C,E01031524,1670,172,1498
2021,Chichester 014D,E01031525,1294,188,1106
2021,Chichester 014E,E01031526,1224,136,1088
2021,Chichester 014F,E01031527,1397,139,1258
2021,Chichester 014G,E01031528,1423,160,1263
2021,Chichester 013D,E01031529,1266,209,1057
2021,Chichester 012D,E01031530,1224,221,1003
2021,Chichester 007C,E01031531,1228,203,1025
2021,Chichester 009C,E01031532,2104,302,1802
2021,Chichester 007D,E01031533,1322,251,1071
2021,Chichester 009D,E01031534,1751,195,1556
2021,Chichester 009E,E01031535,1958,296,1662
2021,Chichester 003D,E01031536,1197,199,998
2021,Chichester 012E,E01031538,1502,315,1187
2021,Chichester 012F,E01031539,1560,306,1254
2021,Chichester 013E,E01031540,1324,165,1159
2021,Chichester 013F,E01031541,1350,155,1195
2021,Chichester 013G,E01031542,1943,290,1653
2021,Chichester 007E,E01031543,2272,381,1891
2021,Chichester 002C,E01031544,1196,192,1004
2021,Chichester 002D,E01031545,1227,206,1021
2021,Crawley 012A,E01031546,1392,377,1015
2021,Crawley 010A,E01031547,1225,261,964
2021,Crawley 010B,E01031548,1573,337,1236
2021,Crawley 010C,E01031549,1642,423,1219
2021,Crawley 010D,E01031550,1306,231,1075
2021,Crawley 012B,E01031551,1503,380,1123
2021,Crawley 013A,E01031552,1717,321,1396
2021,Crawley 012C,E01031553,1421,334,1087
2021,Crawley 012D,E01031554,1717,334,1383
2021,Crawley 012E,E01031555,1489,396,1093
2021,Crawley 013B,E01031556,1511,322,1189
2021,Crawley 013C,E01031557,1700,209,1491
2021,Crawley 013D,E01031558,1510,377,1133
2021,Crawley 013E,E01031559,1541,404,1137
2021,Crawley 009A,E01031560,1486,265,1221
2021,Crawley 009B,E01031561,1455,247,1208
2021,Crawley 009C,E01031562,1266,237,1029
2021,Crawley 009D,E01031563,1464,253,1211
2021,Crawley 006A,E01031564,1422,271,1151
2021,Crawley 006B,E01031565,2160,464,1696
2021,Crawley 006C,E01031566,1596,306,1290
2021,Crawley 006D,E01031567,1297,208,1089
2021,Crawley 006E,E01031568,1393,251,1142
2021,Crawley 010E,E01031569,1527,329,1198
2021,Crawley 003A,E01031570,1322,280,1042
2021,Crawley 003B,E01031571,1700,421,1279
2021,Crawley 003C,E01031572,2049,412,1637
2021,Crawley 001A,E01031573,1714,437,1277
2021,Crawley 001B,E01031574,1882,443,1439
2021,Crawley 001C,E01031575,1692,333,1359
2021,Crawley 001D,E01031576,1739,448,1291
2021,Crawley 001E,E01031577,1346,285,1061
2021,Crawley 008A,E01031578,1665,318,1347
2021,Crawley 009E,E01031579,1523,293,1230
2021,Crawley 008B,E01031580,2218,514,1704
2021,Crawley 008C,E01031581,1669,386,1283
2021,Crawley 009F,E01031582,1732,341,1391
2021,Crawley 004A,E01031583,2148,381,1767
2021,Crawley 004B,E01031584,1778,402,1376
2021,Crawley 004C,E01031585,2460,415,2045
2021,Crawley 002A,E01031586,1606,351,1255
2021,Crawley 002C,E01031588,1437,290,1147
2021,Crawley 005A,E01031589,1695,306,1389
2021,Crawley 002D,E01031590,1495,249,1246
2021,Crawley 005B,E01031591,1795,386,1409
2021,Crawley 008D,E01031592,1889,344,1545
2021,Crawley 002E,E01031593,1380,217,1163
2021,Crawley 005C,E01031594,1408,302,1106
2021,Crawley 011A,E01031595,1694,380,1314
2021,Crawley 007A,E01031596,1860,418,1442
2021,Crawley 007B,E01031597,1605,291,1314
2021,Crawley 007C,E01031598,1768,307,1461
2021,Crawley 007D,E01031599,2025,344,1681
2021,Crawley 005D,E01031600,1521,258,1263
2021,Crawley 004D,E01031601,1395,337,1058
2021,Crawley 005E,E01031603,1497,269,1228
2021,Crawley 011B,E01031604,1518,295,1223
2021,Crawley 011C,E01031605,1521,366,1155
2021,Crawley 011D,E01031606,1605,370,1235
2021,Crawley 011E,E01031607,1499,351,1148
2021,Crawley 007E,E01031608,2353,417,1936
2021,Crawley 003D,E01031609,1555,319,1236
2021,Crawley 003E,E01031610,1870,368,1502
2021,Horsham 010A,E01031611,2664,454,2210
2021,Horsham 010B,E01031612,1994,366,1628
2021,Horsham 010D,E01031614,2408,463,1945
2021,Horsham 010E,E01031615,1704,303,1401
2021,Horsham 016A,E01031616,1534,270,1264
2021,Horsham 016B,E01031617,2287,354,1933
2021,Horsham 014A,E01031618,1285,193,1092
2021,Horsham 003A,E01031620,1973,394,1579
2021,Horsham 012A,E01031621,1683,139,1544
2021,Horsham 015A,E01031622,1548,251,1297
2021,Horsham 012B,E01031623,1673,224,1449
2021,Horsham 015B,E01031624,1638,319,1319
2021,Horsham 015C,E01031625,1833,352,1481
2021,Horsham 013A,E01031626,1432,188,1244
2021,Horsham 012C,E01031627,1824,273,1551
2021,Horsham 015D,E01031628,1772,369,1403
2021,Horsham 015E,E01031629,1502,233,1269
2021,Horsham 013B,E01031630,1648,196,1452
2021,Horsham 013C,E01031631,1585,190,1395
2021,Horsham 011A,E01031632,1544,230,1314
2021,Horsham 011B,E01031633,1191,179,1012
2021,Horsham 011C,E01031634,1258,220,1038
2021,Horsham 011D,E01031635,1257,207,1050
2021,Horsham 007C,E01031638,1665,299,1366
2021,Horsham 008A,E01031639,1927,291,1636
2021,Horsham 008B,E01031640,1731,328,1403
2021,Horsham 014B,E01031641,1506,183,1323
2021,Horsham 014C,E01031642,2380,409,1971
2021,Horsham 014D,E01031643,1784,332,1452
2021,Horsham 002A,E01031644,1755,316,1439
2021,Horsham 002B,E01031645,1311,254,1057
2021,Horsham 002C,E01031646,1390,245,1145
2021,Horsham 002D,E01031647,1135,184,951
2021,Horsham 003B,E01031648,1500,235,1265
2021,Horsham 002E,E01031649,1014,172,842
2021,Horsham 002F,E01031650,1252,232,1020
2021,Horsham 003C,E01031651,1510,282,1228
2021,Horsham 006B,E01031652,1589,386,1203
2021,Horsham 006C,E01031653,1827,240,1587
2021,Horsham 004A,E01031654,1555,289,1266
2021,Horsham 004B,E01031655,1502,293,1209
2021,Horsham 006D,E01031656,1818,275,1543
2021,Horsham 005A,E01031657,1842,307,1535
2021,Horsham 003D,E01031658,1982,328,1654
2021,Horsham 005B,E01031659,1693,323,1370
2021,Horsham 008C,E01031660,1315,202,1113
2021,Horsham 008D,E01031661,1629,284,1345
2021,Horsham 013D,E01031662,1483,175,1308
2021,Horsham 013E,E01031663,2106,417,1689
2021,Horsham 012D,E01031664,1560,207,1353
2021,Horsham 013F,E01031665,1172,153,1019
2021,Horsham 002G,E01031666,1524,276,1248
2021,Horsham 004C,E01031667,1426,224,1202
2021,Horsham 002H,E01031668,1408,225,1183
2021,Horsham 004D,E01031669,1531,267,1264
2021,Horsham 001A,E01031670,1460,212,1248
2021,Horsham 001B,E01031671,1463,220,1243
2021,Horsham 004E,E01031672,1810,248,1562
2021,Horsham 001C,E01031673,1461,281,1180
2021,Horsham 005C,E01031674,1344,306,1038
2021,Horsham 005D,E01031675,1487,261,1226
2021,Horsham 009A,E01031677,1522,286,1236
2021,Horsham 009B,E01031678,1819,412,1407
2021,Horsham 008E,E01031679,1976,940,1036
2021,Horsham 009C,E01031680,1462,301,1161
2021,Horsham 009D,E01031681,1648,300,1348
2021,Horsham 009E,E01031682,1066,215,851
2021,Horsham 009F,E01031683,1375,239,1136
2021,Horsham 016C,E01031684,1376,223,1153
2021,Horsham 016D,E01031685,1609,223,1386
2021,Horsham 016E,E01031686,1350,202,1148
2021,Horsham 014E,E01031687,1567,372,1195
2021,Horsham 006E,E01031688,1309,224,1085
2021,Horsham 003E,E01031689,1397,243,1154
2021,Horsham 007D,E01031690,1482,275,1207
2021,Horsham 006F,E01031691,1683,281,1402
2021,Mid Sussex 007B,E01031693,1795,333,1462
2021,Mid Sussex 006A,E01031694,1804,493,1311
2021,Mid Sussex 003A,E01031695,1384,270,1114
2021,Mid Sussex 003B,E01031696,1265,208,1057
2021,Mid Sussex 007C,E01031697,1124,204,920
2021,Mid Sussex 016A,E01031698,1707,372,1335
2021,Mid Sussex 012A,E01031699,1534,265,1269
2021,Mid Sussex 012B,E01031700,1535,317,1218
2021,Mid Sussex 012C,E01031701,1817,363,1454
2021,Mid Sussex 015A,E01031702,1553,265,1288
2021,Mid Sussex 015B,E01031703,1705,287,1418
2021,Mid Sussex 013A,E01031704,1623,270,1353
2021,Mid Sussex 014A,E01031705,1457,277,1180
2021,Mid Sussex 013B,E01031706,1600,229,1371
2021,Mid Sussex 014B,E01031707,1420,191,1229
2021,Mid Sussex 014C,E01031708,1656,237,1419
2021,Mid Sussex 014D,E01031709,1691,244,1447
2021,Mid Sussex 015C,E01031710,1353,218,1135
2021,Mid Sussex 013D,E01031712,1354,213,1141
2021,Mid Sussex 013E,E01031713,1628,298,1330
2021,Mid Sussex 012D,E01031714,1779,355,1424
2021,Mid Sussex 015D,E01031715,1565,322,1243
2021,Mid Sussex 014E,E01031716,1102,250,852
2021,Mid Sussex 014F,E01031717,1297,220,1077
2021,Mid Sussex 002A,E01031718,1740,310,1430
2021,Mid Sussex 002B,E01031719,1657,270,1387
2021,Mid Sussex 002C,E01031720,1394,230,1164
2021,Mid Sussex 005A,E01031721,1815,285,1530
2021,Mid Sussex 002D,E01031722,1265,355,910
2021,Mid Sussex 005B,E01031723,1560,252,1308
2021,Mid Sussex 005C,E01031724,1223,221,1002
2021,Mid Sussex 005D,E01031725,1406,272,1134
2021,Mid Sussex 011A,E01031726,1538,376,1162
2021,Mid Sussex 007D,E01031727,1655,302,1353
2021,Mid Sussex 003C,E01031729,2112,432,1680
2021,Mid Sussex 003D,E01031730,1664,302,1362
2021,Mid Sussex 001A,E01031731,1877,380,1497
2021,Mid Sussex 001B,E01031732,1708,348,1360
2021,Mid Sussex 001C,E01031733,1635,280,1355
2021,Mid Sussex 001D,E01031734,1507,291,1216
2021,Mid Sussex 003E,E01031735,1507,248,1259
2021,Mid Sussex 004A,E01031736,1591,285,1306
2021,Mid Sussex 004B,E01031737,1496,275,1221
2021,Mid Sussex 004C,E01031738,1460,297,1163
2021,Mid Sussex 004D,E01031739,1794,269,1525
2021,Mid Sussex 004E,E01031740,1248,199,1049
2021,Mid Sussex 001E,E01031741,2037,304,1733
2021,Mid Sussex 001G,E01031743,1605,268,1337
2021,Mid Sussex 017A,E01031744,1653,308,1345
2021,Mid Sussex 017B,E01031745,1973,424,1549
2021,Mid Sussex 017C,E01031746,1595,309,1286
2021,Mid Sussex 017D,E01031747,1509,260,1249
2021,Mid Sussex 017E,E01031748,1333,263,1070
2021,Mid Sussex 011C,E01031749,1433,253,1180
2021,Mid Sussex 011D,E01031750,1405,249,1156
2021,Mid Sussex 009A,E01031751,2454,389,2065
2021,Mid Sussex 010A,E01031752,1741,434,1307
2021,Mid Sussex 010B,E01031753,1349,269,1080
2021,Mid Sussex 010C,E01031754,1524,270,1254
2021,Mid Sussex 010D,E01031755,1341,250,1091
2021,Mid Sussex 010E,E01031757,1333,198,1135
2021,Mid Sussex 008A,E01031758,1344,292,1052
2021,Mid Sussex 009B,E01031759,1630,259,1371
2021,Mid Sussex 008B,E01031760,1679,339,1340
2021,Mid Sussex 011F,E01031763,1941,392,1549
2021,Mid Sussex 006B,E01031764,1319,226,1093
2021,Mid Sussex 006C,E01031765,1500,256,1244
2021,Mid Sussex 006D,E01031766,1963,319,1644
2021,Mid Sussex 016B,E01031767,2134,633,1501
2021,Mid Sussex 017F,E01031768,1486,281,1205
2021,Mid Sussex 016C,E01031769,1643,388,1255
2021,Mid Sussex 016D,E01031770,1687,330,1357
2021,Mid Sussex 016E,E01031771,1465,318,1147
2021,Mid Sussex 008C,E01031772,1937,374,1563
2021,Mid Sussex 008D,E01031773,1798,354,1444
2021,Mid Sussex 008E,E01031774,2303,488,1815
2021,Mid Sussex 008F,E01031775,1708,369,1339
2021,Worthing 005A,E01031776,1468,282,1186
2021,Worthing 005B,E01031777,1705,344,1361
2021,Worthing 004A,E01031778,1461,259,1202
2021,Worthing 009A,E01031779,1214,293,921
2021,Worthing 005C,E01031780,1441,342,1099
2021,Worthing 005D,E01031781,1540,322,1218
2021,Worthing 007A,E01031782,1722,275,1447
2021,Worthing 006A,E01031783,1524,357,1167
2021,Worthing 006B,E01031785,1399,252,1147
2021,Worthing 006C,E01031786,1503,322,1181
2021,Worthing 011A,E01031787,1922,206,1716
2021,Worthing 011B,E01031788,1994,350,1644
2021,Worthing 010A,E01031790,1814,213,1601
2021,Worthing 008A,E01031791,1969,362,1607
2021,Worthing 003A,E01031792,1302,211,1091
2021,Worthing 001A,E01031793,1290,165,1125
2021,Worthing 003B,E01031794,1393,184,1209
2021,Worthing 003C,E01031795,1547,369,1178
2021,Worthing 008B,E01031796,1498,284,1214
2021,Worthing 004B,E01031797,1235,248,987
2021,Worthing 005E,E01031798,1478,256,1222
2021,Worthing 008C,E01031799,1577,343,1234
2021,Worthing 004C,E01031800,1523,326,1197
2021,Worthing 008D,E01031801,1613,323,1290
2021,Worthing 013A,E01031802,1620,159,1461
2021,Worthing 013B,E01031803,1525,250,1275
2021,Worthing 013C,E01031804,1680,246,1434
2021,Worthing 013D,E01031805,1602,188,1414
2021,Worthing 013E,E01031806,1693,355,1338
2021,Worthing 010B,E01031807,1750,190,1560
2021,Worthing 011D,E01031808,1669,170,1499
2021,Worthing 010C,E01031809,1746,127,1619
2021,Worthing 010D,E01031810,1702,295,1407
2021,Worthing 010E,E01031811,1508,134,1374
2021,Worthing 012A,E01031812,1531,141,1390
2021,Worthing 012B,E01031813,1657,278,1379
2021,Worthing 012C,E01031814,1648,186,1462
2021,Worthing 012D,E01031815,1510,155,1355
2021,Worthing 012E,E01031816,1545,368,1177
2021,Worthing 006D,E01031817,1678,361,1317
2021,Worthing 003D,E01031818,1868,411,1457
2021,Worthing 001B,E01031820,1708,189,1519
2021,Worthing 001C,E01031821,1651,245,1406
2021,Worthing 002A,E01031822,1505,284,1221
2021,Worthing 004D,E01031823,1586,349,1237
2021,Worthing 004E,E01031824,1275,264,1011
2021,Worthing 002B,E01031825,1575,154,1421
2021,Worthing 002C,E01031826,1383,270,1113
2021,Worthing 002D,E01031827,1415,235,1180
2021,Worthing 001D,E01031828,1267,151,1116
2021,Worthing 001E,E01031829,1555,194,1361
2021,Worthing 003E,E01031830,1533,297,1236
2021,Worthing 009B,E01031831,1581,273,1308
2021,Worthing 009C,E01031832,1522,190,1332
2021,Worthing 009D,E01031833,1550,329,1221
2021,Worthing 009E,E01031834,1543,324,1219
2021,Worthing 011E,E01031835,1822,244,1578
2021,Worthing 007C,E01031836,1521,288,1233
2021,Worthing 008E,E01031837,1755,376,1379
2021,Worthing 007D,E01031838,1452,241,1211
2021,Worthing 002E,E01031839,1645,345,1300
2021,Worthing 007E,E01031840,1622,272,1350
2021,Wiltshire 012A,E01031841,1798,338,1460
2021,Wiltshire 038A,E01031842,1814,288,1526
2021,Wiltshire 029A,E01031843,1717,303,1414
2021,Wiltshire 028A,E01031845,1617,192,1425
2021,Wiltshire 028B,E01031846,1500,214,1286
2021,Wiltshire 029B,E01031847,1855,353,1502
2021,Wiltshire 028C,E01031848,2083,258,1825
2021,Wiltshire 029C,E01031849,1564,247,1317
2021,Wiltshire 025A,E01031850,1848,220,1628
2021,Wiltshire 025B,E01031851,1442,268,1174
2021,Wiltshire 025C,E01031852,1948,355,1593
2021,Wiltshire 026A,E01031853,1425,206,1219
2021,Wiltshire 026B,E01031854,1700,150,1550
2021,Wiltshire 026C,E01031855,1454,207,1247
2021,Wiltshire 026D,E01031856,1564,250,1314
2021,Wiltshire 034B,E01031857,1459,225,1234
2021,Wiltshire 034C,E01031858,1805,480,1325
2021,Wiltshire 065B,E01031859,1498,220,1278
2021,Wiltshire 065A,E01031860,1435,258,1177
2021,Wiltshire 019A,E01031861,2671,465,2206
2021,Wiltshire 019B,E01031862,1415,232,1183
2021,Wiltshire 019C,E01031863,1071,117,954
2021,Wiltshire 019D,E01031864,1178,231,947
2021,Wiltshire 019E,E01031865,2490,1209,1281
2021,Wiltshire 024A,E01031866,1530,246,1284
2021,Wiltshire 038B,E01031867,1722,248,1474
2021,Wiltshire 012B,E01031868,1679,285,1394
2021,Wiltshire 024B,E01031869,1876,298,1578
2021,Wiltshire 024C,E01031870,1772,215,1557
2021,Wiltshire 024D,E01031871,1632,259,1373
2021,Wiltshire 028D,E01031872,1489,226,1263
2021,Wiltshire 012C,E01031873,1768,264,1504
2021,Wiltshire 012D,E01031874,1467,262,1205
2021,Wiltshire 028E,E01031876,1454,201,1253
2021,Wiltshire 029D,E01031877,1899,332,1567
2021,Wiltshire 066A,E01031879,1671,280,1391
2021,Wiltshire 038C,E01031882,1895,296,1599
2021,Wiltshire 034D,E01031883,1875,300,1575
2021,Wiltshire 012E,E01031884,1514,246,1268
2021,Wiltshire 002A,E01031885,1649,319,1330
2021,Wiltshire 004A,E01031886,1387,241,1146
2021,Wiltshire 001A,E01031887,1726,318,1408
2021,Wiltshire 017A,E01031888,1370,241,1129
2021,Wiltshire 017B,E01031889,2263,438,1825
2021,Wiltshire 017C,E01031890,1694,287,1407
2021,Wiltshire 004B,E01031892,1400,219,1181
2021,Wiltshire 004C,E01031893,1588,250,1338
2021,Wiltshire 004D,E01031894,1526,264,1262
2021,Wiltshire 015A,E01031895,2410,473,1937
2021,Wiltshire 015B,E01031896,1363,230,1133
2021,Wiltshire 015C,E01031897,1887,360,1527
2021,Wiltshire 015D,E01031898,1719,532,1187
2021,Wiltshire 016B,E01031901,1318,212,1106
2021,Wiltshire 016C,E01031902,1672,299,1373
2021,Wiltshire 016D,E01031903,2180,302,1878
2021,Wiltshire 013B,E01031904,2473,414,2059
2021,Wiltshire 010A,E01031905,1300,242,1058
2021,Wiltshire 010B,E01031906,1307,202,1105
2021,Wiltshire 009A,E01031907,2304,464,1840
2021,Wiltshire 010C,E01031908,1633,318,1315
2021,Wiltshire 010D,E01031909,1207,195,1012
2021,Wiltshire 009B,E01031910,1435,264,1171
2021,Wiltshire 011A,E01031911,1293,262,1031
2021,Wiltshire 011B,E01031912,1476,195,1281
2021,Wiltshire 011C,E01031913,1465,230,1235
2021,Wiltshire 009C,E01031914,1252,284,968
2021,Wiltshire 009D,E01031915,1457,200,1257
2021,Wiltshire 014A,E01031916,1246,238,1008
2021,Wiltshire 011D,E01031917,1339,189,1150
2021,Wiltshire 011E,E01031918,2389,331,2058
2021,Wiltshire 009E,E01031919,1605,371,1234
2021,Wiltshire 009F,E01031920,1156,198,958
2021,Wiltshire 014B,E01031921,1262,225,1037
2021,Wiltshire 014C,E01031922,1153,156,997
2021,Wiltshire 014D,E01031923,1193,185,1008
2021,Wiltshire 014E,E01031924,1508,270,1238
2021,Wiltshire 010E,E01031925,1278,271,1007
2021,Wiltshire 010F,E01031926,1433,275,1158
2021,Wiltshire 010G,E01031927,1177,180,997
2021,Wiltshire 011F,E01031928,1161,176,985
2021,Wiltshire 017D,E01031929,1230,182,1048
2021,Wiltshire 017E,E01031930,1278,305,973
2021,Wiltshire 018A,E01031931,1816,306,1510
2021,Wiltshire 018B,E01031932,1492,225,1267
2021,Wiltshire 018C,E01031933,1676,356,1320
2021,Wiltshire 001B,E01031934,1822,296,1526
2021,Wiltshire 001C,E01031935,1649,225,1424
2021,Wiltshire 001D,E01031936,1353,236,1117
2021,Wiltshire 013C,E01031937,1071,173,898
2021,Wiltshire 013D,E01031938,1474,259,1215
2021,Wiltshire 008A,E01031939,2292,425,1867
2021,Wiltshire 008B,E01031940,2111,348,1763
2021,Wiltshire 018D,E01031941,1688,272,1416
2021,Wiltshire 018E,E01031942,1281,226,1055
2021,Wiltshire 007B,E01031944,1012,133,879
2021,Wiltshire 007D,E01031946,3336,666,2670
2021,Wiltshire 002B,E01031947,1577,295,1282
2021,Wiltshire 002C,E01031948,2500,584,1916
2021,Wiltshire 002D,E01031949,1784,295,1489
2021,Wiltshire 008C,E01031950,1306,224,1082
2021,Wiltshire 008D,E01031951,1268,196,1072
2021,Wiltshire 018F,E01031952,2212,356,1856
2021,Wiltshire 003B,E01031955,1556,236,1320
2021,Wiltshire 003C,E01031956,1305,198,1107
2021,Wiltshire 005A,E01031957,1419,274,1145
2021,Wiltshire 005B,E01031958,1342,226,1116
2021,Wiltshire 005C,E01031959,1825,295,1530
2021,Wiltshire 005D,E01031960,1401,284,1117
2021,Wiltshire 007E,E01031961,1337,195,1142
2021,Wiltshire 003D,E01031962,1347,195,1152
2021,Wiltshire 006A,E01031963,2041,451,1590
2021,Wiltshire 006B,E01031964,1857,263,1594
2021,Wiltshire 007F,E01031965,1334,194,1140
2021,Wiltshire 007G,E01031966,2646,566,2080
2021,Wiltshire 006C,E01031967,2086,330,1756
2021,Wiltshire 007H,E01031968,1659,263,1396
2021,Wiltshire 006D,E01031969,1302,194,1108
2021,Wiltshire 060A,E01031970,1585,254,1331
2021,Wiltshire 060B,E01031971,1151,184,967
2021,Wiltshire 060C,E01031972,1508,276,1232
2021,Wiltshire 062A,E01031973,1812,325,1487
2021,Wiltshire 048A,E01031974,1279,167,1112
2021,Wiltshire 048B,E01031975,1189,220,969
2021,Wiltshire 048C,E01031976,2197,587,1610
2021,Wiltshire 048E,E01031978,1530,279,1251
2021,Wiltshire 048F,E01031979,2010,271,1739
2021,Wiltshire 052A,E01031980,2409,563,1846
2021,Wiltshire 052B,E01031981,1473,333,1140
2021,Wiltshire 052C,E01031982,1349,239,1110
2021,Wiltshire 052D,E01031983,1791,412,1379
2021,Wiltshire 051A,E01031984,2637,667,1970
2021,Wiltshire 051B,E01031985,1239,235,1004
2021,Wiltshire 051C,E01031986,1171,183,988
2021,Wiltshire 045B,E01031988,2422,538,1884
2021,Wiltshire 046A,E01031989,1896,419,1477
2021,Wiltshire 054A,E01031990,1897,318,1579
2021,Wiltshire 061A,E01031991,1932,343,1589
2021,Wiltshire 062B,E01031992,1415,208,1207
2021,Wiltshire 062C,E01031993,1377,227,1150
2021,Wiltshire 062D,E01031994,1253,212,1041
2021,Wiltshire 062E,E01031995,1775,286,1489
2021,Wiltshire 046B,E01031996,1381,256,1125
2021,Wiltshire 046C,E01031997,1286,173,1113
2021,Wiltshire 046D,E01031999,2213,407,1806
2021,Wiltshire 057A,E01032000,2079,322,1757
2021,Wiltshire 055A,E01032001,1418,237,1181
2021,Wiltshire 055B,E01032002,1260,143,1117
2021,Wiltshire 055C,E01032003,1683,220,1463
2021,Wiltshire 054B,E01032004,2207,323,1884
2021,Wiltshire 059A,E01032005,1228,207,1021
2021,Wiltshire 059B,E01032006,1153,226,927
2021,Wiltshire 059C,E01032007,1594,314,1280
2021,Wiltshire 058A,E01032008,1433,260,1173
2021,Wiltshire 058B,E01032009,1742,214,1528
2021,Wiltshire 050A,E01032010,2059,270,1789
2021,Wiltshire 057C,E01032012,1744,260,1484
2021,Wiltshire 049A,E01032013,1937,351,1586
2021,Wiltshire 056A,E01032014,1828,192,1636
2021,Wiltshire 056B,E01032015,1250,213,1037
2021,Wiltshire 056C,E01032016,1272,204,1068
2021,Wiltshire 051D,E01032017,1457,257,1200
2021,Wiltshire 053A,E01032018,1541,259,1282
2021,Wiltshire 053B,E01032019,1360,254,1106
2021,Wiltshire 053C,E01032020,1422,250,1172
2021,Wiltshire 056D,E01032021,1570,248,1322
2021,Wiltshire 058C,E01032022,1676,193,1483
2021,Wiltshire 059D,E01032023,1739,342,1397
2021,Wiltshire 055D,E01032024,2201,314,1887
2021,Wiltshire 053D,E01032025,1350,176,1174
2021,Wiltshire 045D,E01032026,1554,231,1323
2021,Wiltshire 054C,E01032027,1274,134,1140
2021,Wiltshire 061B,E01032029,1306,176,1130
2021,Wiltshire 061C,E01032030,1597,222,1375
2021,Wiltshire 061D,E01032031,1099,162,937
2021,Wiltshire 049B,E01032032,1494,200,1294
2021,Wiltshire 049C,E01032033,1329,209,1120
2021,Wiltshire 049D,E01032034,1387,242,1145
2021,Wiltshire 050B,E01032035,1616,201,1415
2021,Wiltshire 050C,E01032036,1394,207,1187
2021,Wiltshire 050D,E01032037,1445,207,1238
2021,Wiltshire 054D,E01032038,1270,168,1102
2021,Wiltshire 054E,E01032039,1960,291,1669
2021,Wiltshire 054F,E01032040,1347,227,1120
2021,Wiltshire 060D,E01032041,1892,281,1611
2021,Wiltshire 060E,E01032042,1652,294,1358
2021,Wiltshire 021A,E01032043,1244,283,961
2021,Wiltshire 021B,E01032044,1489,241,1248
2021,Wiltshire 027A,E01032045,1653,305,1348
2021,Wiltshire 027B,E01032046,1484,275,1209
2021,Wiltshire 027C,E01032047,1435,285,1150
2021,Wiltshire 027D,E01032048,1613,263,1350
2021,Wiltshire 027E,E01032049,1507,232,1275
2021,Wiltshire 047A,E01032051,1342,226,1116
2021,Wiltshire 039A,E01032052,1237,142,1095
2021,Wiltshire 037A,E01032053,1397,248,1149
2021,Wiltshire 039B,E01032054,1207,204,1003
2021,Wiltshire 039C,E01032055,1124,149,975
2021,Wiltshire 039D,E01032056,1282,214,1068
2021,Wiltshire 021C,E01032057,1162,185,977
2021,Wiltshire 023A,E01032058,1298,215,1083
2021,Wiltshire 023B,E01032059,1777,310,1467
2021,Wiltshire 023C,E01032060,1547,267,1280
2021,Wiltshire 023D,E01032061,1095,172,923
2021,Wiltshire 022A,E01032062,1814,300,1514
2021,Wiltshire 020A,E01032063,2071,358,1713
2021,Wiltshire 020B,E01032064,1259,278,981
2021,Wiltshire 020C,E01032065,1477,241,1236
2021,Wiltshire 022B,E01032066,1556,279,1277
2021,Wiltshire 022C,E01032067,1369,180,1189
2021,Wiltshire 022D,E01032068,1331,168,1163
2021,Wiltshire 022E,E01032069,1173,161,1012
2021,Wiltshire 021D,E01032070,1730,278,1452
2021,Wiltshire 021F,E01032072,1826,348,1478
2021,Wiltshire 020D,E01032073,1308,256,1052
2021,Wiltshire 020E,E01032074,1238,146,1092
2021,Wiltshire 047B,E01032075,1252,167,1085
2021,Wiltshire 047C,E01032076,1171,156,1015
2021,Wiltshire 030A,E01032077,1703,255,1448
2021,Wiltshire 030B,E01032078,2704,558,2146
2021,Wiltshire 030C,E01032079,1466,251,1215
2021,Wiltshire 030D,E01032080,1816,425,1391
2021,Wiltshire 047D,E01032081,1272,176,1096
2021,Wiltshire 047E,E01032082,1167,166,1001
2021,Wiltshire 037B,E01032083,2346,409,1937
2021,Wiltshire 031A,E01032085,1523,235,1288
2021,Wiltshire 031C,E01032087,2061,279,1782
2021,Wiltshire 036A,E01032088,1414,204,1210
2021,Wiltshire 036B,E01032089,1371,205,1166
2021,Wiltshire 036C,E01032090,1391,258,1133
2021,Wiltshire 036D,E01032091,1133,161,972
2021,Wiltshire 035A,E01032092,1373,185,1188
2021,Wiltshire 035B,E01032093,2316,512,1804
2021,Wiltshire 035C,E01032094,2275,450,1825
2021,Wiltshire 035D,E01032095,1694,292,1402
2021,Wiltshire 033A,E01032096,1826,386,1440
2021,Wiltshire 033B,E01032097,1808,272,1536
2021,Wiltshire 033C,E01032098,1549,245,1304
2021,Wiltshire 032B,E01032100,1717,273,1444
2021,Wiltshire 032C,E01032101,1587,223,1364
2021,Wiltshire 032D,E01032102,2293,387,1906
2021,Wiltshire 044A,E01032103,1623,154,1469
2021,Wiltshire 042A,E01032104,1462,271,1191
2021,Wiltshire 042B,E01032105,1399,171,1228
2021,Wiltshire 044B,E01032106,1458,183,1275
2021,Wiltshire 042C,E01032107,1145,313,832
2021,Wiltshire 042D,E01032108,1239,162,1077
2021,Wiltshire 044C,E01032109,1365,186,1179
2021,Wiltshire 043A,E01032110,2255,356,1899
2021,Wiltshire 043B,E01032111,1255,201,1054
2021,Wiltshire 043C,E01032112,1371,238,1133
2021,Wiltshire 043D,E01032113,1284,164,1120
2021,Wiltshire 044D,E01032114,1429,268,1161
2021,Wiltshire 064A,E01032115,1611,213,1398
2021,Wiltshire 063D,E01032117,2562,503,2059
2021,Wiltshire 063C,E01032118,1532,326,1206
2021,Wiltshire 064B,E01032119,1795,221,1574
2021,Wiltshire 039E,E01032121,1849,280,1569
2021,Bromsgrove 009A,E01032122,2195,413,1782
2021,Bromsgrove 009B,E01032123,1517,208,1309
2021,Bromsgrove 009C,E01032124,1495,257,1238
2021,Bromsgrove 009D,E01032125,1399,302,1097
2021,Bromsgrove 003A,E01032126,1968,325,1643
2021,Bromsgrove 007A,E01032127,1643,253,1390
2021,Bromsgrove 007B,E01032128,1367,213,1154
2021,Bromsgrove 007C,E01032129,1321,272,1049
2021,Bromsgrove 013B,E01032131,1490,332,1158
2021,Bromsgrove 013C,E01032132,1908,356,1552
2021,Bromsgrove 004A,E01032133,1482,290,1192
2021,Bromsgrove 005A,E01032134,1578,193,1385
2021,Bromsgrove 004B,E01032135,1512,251,1261
2021,Bromsgrove 002A,E01032136,1276,234,1042
2021,Bromsgrove 002B,E01032137,1527,288,1239
2021,Bromsgrove 001A,E01032138,1563,311,1252
2021,Bromsgrove 001B,E01032139,2206,562,1644
2021,Bromsgrove 001C,E01032140,1702,394,1308
2021,Bromsgrove 001D,E01032141,1429,256,1173
2021,Bromsgrove 006A,E01032142,2230,425,1805
2021,Bromsgrove 006B,E01032143,1519,272,1247
2021,Bromsgrove 006C,E01032144,1948,337,1611
2021,Bromsgrove 004C,E01032145,1447,262,1185
2021,Bromsgrove 005B,E01032146,1573,249,1324
2021,Bromsgrove 004D,E01032147,1184,192,992
2021,Bromsgrove 008A,E01032148,1148,178,970
2021,Bromsgrove 006D,E01032149,1211,234,977
2021,Bromsgrove 008B,E01032150,1392,194,1198
2021,Bromsgrove 008C,E01032151,1381,246,1135
2021,Bromsgrove 007D,E01032152,1283,220,1063
2021,Bromsgrove 008D,E01032153,2079,425,1654
2021,Bromsgrove 010A,E01032154,1640,322,1318
2021,Bromsgrove 008E,E01032155,1594,296,1298
2021,Bromsgrove 011A,E01032156,1952,565,1387
2021,Bromsgrove 011B,E01032157,1602,147,1455
2021,Bromsgrove 012A,E01032158,1444,220,1224
2021,Bromsgrove 010B,E01032159,1834,340,1494
2021,Bromsgrove 010C,E01032160,1626,241,1385
2021,Bromsgrove 010D,E01032161,1859,452,1407
2021,Bromsgrove 012B,E01032162,1811,393,1418
2021,Bromsgrove 002C,E01032168,1104,188,916
2021,Bromsgrove 002D,E01032169,1119,164,955
2021,Bromsgrove 003B,E01032170,1293,227,1066
2021,Bromsgrove 003C,E01032171,1389,229,1160
2021,Bromsgrove 003D,E01032172,1448,265,1183
2021,Bromsgrove 011C,E01032173,1582,293,1289
2021,Bromsgrove 013D,E01032174,1536,344,1192
2021,Bromsgrove 011D,E01032175,1522,206,1316
2021,Bromsgrove 002E,E01032176,2131,320,1811
2021,Bromsgrove 005C,E01032177,1718,341,1377
2021,Bromsgrove 005D,E01032178,1167,146,1021
2021,Malvern Hills 003A,E01032179,1540,202,1338
2021,Malvern Hills 003B,E01032180,2018,287,1731
2021,Malvern Hills 002A,E01032181,2142,333,1809
2021,Malvern Hills 003C,E01032182,2265,363,1902
2021,Malvern Hills 003D,E01032183,1494,270,1224
2021,Malvern Hills 009A,E01032184,1429,143,1286
2021,Malvern Hills 009B,E01032185,1440,197,1243
2021,Malvern Hills 009C,E01032186,1321,294,1027
2021,Malvern Hills 009D,E01032187,1605,268,1337
2021,Malvern Hills 006A,E01032188,1830,358,1472
2021,Malvern Hills 006B,E01032189,2651,546,2105
2021,Malvern Hills 002B,E01032190,1991,347,1644
2021,Malvern Hills 008A,E01032191,2738,472,2266
2021,Malvern Hills 008B,E01032192,2021,325,1696
2021,Malvern Hills 001A,E01032193,2212,345,1867
2021,Malvern Hills 004A,E01032194,1527,253,1274
2021,Malvern Hills 004B,E01032195,1460,195,1265
2021,Malvern Hills 004C,E01032196,1652,215,1437
2021,Malvern Hills 004D,E01032197,1424,182,1242
2021,Malvern Hills 011A,E01032198,2104,356,1748
2021,Malvern Hills 002C,E01032199,1921,347,1574
2021,Malvern Hills 011B,E01032200,2342,395,1947
2021,Malvern Hills 007A,E01032201,1591,327,1264
2021,Malvern Hills 007B,E01032202,1570,312,1258
2021,Malvern Hills 007C,E01032203,1387,215,1172
2021,Malvern Hills 007D,E01032204,1511,383,1128
2021,Malvern Hills 005A,E01032205,1022,120,902
2021,Malvern Hills 005B,E01032206,1213,175,1038
2021,Malvern Hills 005C,E01032207,1774,308,1466
2021,Malvern Hills 010A,E01032208,1473,151,1322
2021,Malvern Hills 010B,E01032209,1589,511,1078
2021,Malvern Hills 010C,E01032210,1095,141,954
2021,Malvern Hills 008C,E01032211,1826,245,1581
2021,Malvern Hills 001B,E01032212,2119,372,1747
2021,Malvern Hills 001C,E01032213,1684,229,1455
2021,Malvern Hills 001D,E01032214,2079,325,1754
2021,Malvern Hills 011C,E01032215,1033,114,919
2021,Malvern Hills 011D,E01032216,1535,180,1355
2021,Malvern Hills 005D,E01032217,1643,239,1404
2021,Malvern Hills 010D,E01032218,1490,264,1226
2021,Malvern Hills 010E,E01032219,1571,205,1366
2021,Malvern Hills 006C,E01032220,1354,177,1177
2021,Malvern Hills 006D,E01032221,1189,191,998
2021,Malvern Hills 006E,E01032222,1314,245,1069
2021,Malvern Hills 002D,E01032223,2182,429,1753
2021,Redditch 004A,E01032224,1793,298,1495
2021,Redditch 004B,E01032225,1058,215,843
2021,Redditch 001A,E01032226,2604,522,2082
2021,Redditch 001B,E01032227,1011,119,892
2021,Redditch 013A,E01032228,1269,173,1096
2021,Redditch 013B,E01032229,1306,207,1099
2021,Redditch 013C,E01032230,1433,275,1158
2021,Redditch 013D,E01032231,1774,303,1471
2021,Redditch 003A,E01032232,1453,257,1196
2021,Redditch 003C,E01032234,1810,399,1411
2021,Redditch 003D,E01032235,1661,414,1247
2021,Redditch 006A,E01032236,1714,285,1429
2021,Redditch 006B,E01032237,1359,198,1161
2021,Redditch 006C,E01032238,1285,201,1084
2021,Redditch 004C,E01032239,1728,391,1337
2021,Redditch 002A,E01032240,1171,224,947
2021,Redditch 002B,E01032241,1211,301,910
2021,Redditch 002C,E01032242,1267,264,1003
2021,Redditch 001C,E01032243,1266,156,1110
2021,Redditch 001D,E01032244,1387,291,1096
2021,Redditch 002D,E01032245,1445,326,1119
2021,Redditch 012A,E01032246,1302,236,1066
2021,Redditch 012B,E01032247,1304,207,1097
2021,Redditch 012C,E01032248,1292,214,1078
2021,Redditch 012D,E01032249,1422,230,1192
2021,Redditch 010A,E01032250,1268,330,938
2021,Redditch 010B,E01032251,1658,370,1288
2021,Redditch 010C,E01032252,1288,335,953
2021,Redditch 009A,E01032253,1511,244,1267
2021,Redditch 010D,E01032254,2077,434,1643
2021,Redditch 007A,E01032255,1317,246,1071
2021,Redditch 011A,E01032256,1288,196,1092
2021,Redditch 011B,E01032257,1331,225,1106
2021,Redditch 011C,E01032258,1399,203,1196
2021,Redditch 008A,E01032259,1338,185,1153
2021,Redditch 011D,E01032260,1271,219,1052
2021,Redditch 012E,E01032261,1340,215,1125
2021,Redditch 004D,E01032262,1950,444,1506
2021,Redditch 007B,E01032263,1661,299,1362
2021,Redditch 006D,E01032264,1663,386,1277
2021,Redditch 009B,E01032265,1527,339,1188
2021,Redditch 007C,E01032266,1495,226,1269
2021,Redditch 009C,E01032267,1669,356,1313
2021,Redditch 009D,E01032268,1116,146,970
2021,Redditch 008B,E01032269,1519,208,1311
2021,Redditch 008C,E01032270,1371,244,1127
2021,Redditch 008D,E01032271,1932,378,1554
2021,Redditch 008E,E01032272,1172,167,1005
2021,Redditch 005A,E01032273,1276,182,1094
2021,Redditch 007D,E01032274,1173,172,1001
2021,Redditch 005B,E01032275,1321,226,1095
2021,Redditch 009E,E01032276,1386,237,1149
2021,Redditch 005C,E01032277,1174,245,929
2021,Redditch 005D,E01032278,1449,284,1165
2021,Worcester 004A,E01032279,1219,264,955
2021,Worcester 007A,E01032280,1622,211,1411
2021,Worcester 007B,E01032281,1315,188,1127
2021,Worcester 007C,E01032282,1704,280,1424
2021,Worcester 013A,E01032283,1668,332,1336
2021,Worcester 013B,E01032284,1924,379,1545
2021,Worcester 011A,E01032285,1627,351,1276
2021,Worcester 012A,E01032286,2505,543,1962
2021,Worcester 012B,E01032287,1541,296,1245
2021,Worcester 012C,E01032288,1485,254,1231
2021,Worcester 012D,E01032289,1421,198,1223
2021,Worcester 012E,E01032290,1369,193,1176
2021,Worcester 011B,E01032292,1554,305,1249
2021,Worcester 011D,E01032294,1430,266,1164
2021,Worcester 001A,E01032296,1510,278,1232
2021,Worcester 001B,E01032297,1538,293,1245
2021,Worcester 001C,E01032298,1763,315,1448
2021,Worcester 001D,E01032299,1474,282,1192
2021,Worcester 001E,E01032300,1592,293,1299
2021,Worcester 005A,E01032301,1344,224,1120
2021,Worcester 005B,E01032302,1304,296,1008
2021,Worcester 002A,E01032303,1207,293,914
2021,Worcester 002B,E01032304,1413,332,1081
2021,Worcester 010A,E01032305,1623,275,1348
2021,Worcester 010B,E01032306,1451,315,1136
2021,Worcester 010C,E01032307,1823,498,1325
2021,Worcester 013D,E01032308,1874,343,1531
2021,Worcester 010D,E01032309,1612,334,1278
2021,Worcester 005C,E01032310,1474,282,1192
2021,Worcester 005D,E01032311,1439,314,1125
2021,Worcester 004B,E01032312,1365,217,1148
2021,Worcester 005E,E01032313,1237,342,895
2021,Worcester 006A,E01032314,1140,428,712
2021,Worcester 006B,E01032315,1890,1112,778
2021,Worcester 006C,E01032316,1111,178,933
2021,Worcester 006D,E01032317,1446,269,1177
2021,Worcester 009A,E01032318,1612,459,1153
2021,Worcester 009B,E01032319,1791,521,1270
2021,Worcester 009C,E01032320,1614,539,1075
2021,Worcester 009D,E01032321,1806,436,1370
2021,Worcester 009E,E01032322,1736,394,1342
2021,Worcester 014A,E01032323,1455,286,1169
2021,Worcester 014B,E01032324,1238,177,1061
2021,Worcester 014C,E01032325,1413,267,1146
2021,Worcester 014D,E01032326,1305,178,1127
2021,Worcester 004C,E01032327,1991,326,1665
2021,Worcester 004D,E01032328,1400,232,1168
2021,Worcester 004E,E01032329,1905,322,1583
2021,Worcester 003A,E01032330,1117,149,968
2021,Worcester 002C,E01032331,1282,249,1033
2021,Worcester 002D,E01032332,1177,220,957
2021,Worcester 005F,E01032333,1844,513,1331
2021,Worcester 003B,E01032334,2164,349,1815
2021,Worcester 003C,E01032335,1462,319,1143
2021,Worcester 003D,E01032336,1410,236,1174
2021,Worcester 008A,E01032337,2390,456,1934
2021,Worcester 008B,E01032338,1847,393,1454
2021,Worcester 008C,E01032339,1659,330,1329
2021,Wychavon 013A,E01032340,1780,299,1481
2021,Wychavon 013B,E01032341,1358,186,1172
2021,Wychavon 016A,E01032342,2747,608,2139
2021,Wychavon 016B,E01032344,2162,404,1758
2021,Wychavon 007A,E01032345,1458,234,1224
2021,Wychavon 007B,E01032346,1389,262,1127
2021,Wychavon 019A,E01032347,1256,212,1044
2021,Wychavon 019B,E01032348,1304,212,1092
2021,Wychavon 013C,E01032349,1693,240,1453
2021,Wychavon 013D,E01032350,1145,191,954
2021,Wychavon 018A,E01032351,1840,150,1690
2021,Wychavon 018B,E01032352,1434,181,1253
2021,Wychavon 018C,E01032353,1530,212,1318
2021,Wychavon 009A,E01032355,1484,229,1255
2021,Wychavon 009B,E01032356,1128,196,932
2021,Wychavon 004A,E01032357,1076,161,915
2021,Wychavon 004B,E01032358,1341,213,1128
2021,Wychavon 003A,E01032359,1754,147,1607
2021,Wychavon 003B,E01032360,1813,313,1500
2021,Wychavon 003C,E01032361,1602,224,1378
2021,Wychavon 005B,E01032363,1469,209,1260
2021,Wychavon 005C,E01032364,1613,253,1360
2021,Wychavon 004C,E01032365,1714,342,1372
2021,Wychavon 005D,E01032366,1514,202,1312
2021,Wychavon 004D,E01032367,1489,245,1244
2021,Wychavon 002A,E01032368,1226,297,929
2021,Wychavon 002B,E01032369,1442,362,1080
2021,Wychavon 002C,E01032370,1187,246,941
2021,Wychavon 002D,E01032371,1249,203,1046
2021,Wychavon 019C,E01032372,1429,213,1216
2021,Wychavon 019D,E01032373,1264,164,1100
2021,Wychavon 018D,E01032374,1301,198,1103
2021,Wychavon 010A,E01032375,1138,155,983
2021,Wychavon 015A,E01032376,1469,203,1266
2021,Wychavon 014B,E01032377,1806,285,1521
2021,Wychavon 014C,E01032378,1703,280,1423
2021,Wychavon 016C,E01032379,1657,258,1399
2021,Wychavon 016D,E01032380,1441,185,1256
2021,Wychavon 017A,E01032381,1734,264,1470
2021,Wychavon 010B,E01032382,1261,177,1084
2021,Wychavon 010C,E01032383,1448,177,1271
2021,Wychavon 015B,E01032384,1509,271,1238
2021,Wychavon 015C,E01032385,2058,293,1765
2021,Wychavon 001B,E01032386,1364,211,1153
2021,Wychavon 001C,E01032387,1577,280,1297
2021,Wychavon 013E,E01032388,1319,209,1110
2021,Wychavon 013F,E01032389,1334,199,1135
2021,Wychavon 011A,E01032390,1602,285,1317
2021,Wychavon 011B,E01032391,1299,239,1060
2021,Wychavon 008A,E01032392,1598,209,1389
2021,Wychavon 008B,E01032393,1733,295,1438
2021,Wychavon 008C,E01032394,1182,163,1019
2021,Wychavon 007C,E01032395,1269,196,1073
2021,Wychavon 015D,E01032396,1693,298,1395
2021,Wychavon 017B,E01032397,2202,427,1775
2021,Wychavon 017C,E01032398,1548,258,1290
2021,Wychavon 006A,E01032399,2219,450,1769
2021,Wychavon 006B,E01032400,2402,427,1975
2021,Wychavon 001D,E01032401,2504,449,2055
2021,Wychavon 009C,E01032402,1507,318,1189
2021,Wychavon 009D,E01032403,2193,427,1766
2021,Wychavon 006C,E01032404,2381,321,2060
2021,Wychavon 012A,E01032405,1748,317,1431
2021,Wychavon 012B,E01032406,1286,178,1108
2021,Wychavon 012C,E01032407,1403,217,1186
2021,Wychavon 012D,E01032408,1313,129,1184
2021,Wychavon 012E,E01032409,2262,400,1862
2021,Wychavon 010D,E01032410,1358,172,1186
2021,Wychavon 010E,E01032411,1774,288,1486
2021,Wychavon 019E,E01032412,1208,187,1021
2021,Wychavon 019F,E01032413,1127,166,961
2021,Wychavon 011C,E01032414,1497,218,1279
2021,Wychavon 011D,E01032415,1797,195,1602
2021,Wychavon 008D,E01032416,1152,174,978
2021,Wychavon 007D,E01032417,1462,210,1252
2021,Wyre Forest 010A,E01032418,1224,168,1056
2021,Wyre Forest 010B,E01032419,1229,142,1087
2021,Wyre Forest 010C,E01032420,1186,187,999
2021,Wyre Forest 010D,E01032421,1124,171,953
2021,Wyre Forest 010E,E01032422,1320,269,1051
2021,Wyre Forest 014A,E01032423,1650,206,1444
2021,Wyre Forest 014B,E01032424,1301,237,1064
2021,Wyre Forest 014C,E01032425,1349,177,1172
2021,Wyre Forest 014D,E01032426,1347,171,1176
2021,Wyre Forest 011A,E01032427,1487,202,1285
2021,Wyre Forest 011B,E01032428,1508,141,1367
2021,Wyre Forest 011C,E01032429,1405,184,1221
2021,Wyre Forest 005A,E01032430,1749,263,1486
2021,Wyre Forest 001A,E01032431,1495,207,1288
2021,Wyre Forest 001B,E01032432,1518,424,1094
2021,Wyre Forest 001C,E01032433,1438,301,1137
2021,Wyre Forest 004A,E01032434,2087,523,1564
2021,Wyre Forest 004B,E01032435,1390,249,1141
2021,Wyre Forest 003A,E01032436,1443,222,1221
2021,Wyre Forest 004C,E01032437,1735,363,1372
2021,Wyre Forest 003B,E01032438,1436,219,1217
2021,Wyre Forest 001D,E01032439,1312,204,1108
2021,Wyre Forest 001E,E01032440,1125,175,950
2021,Wyre Forest 002A,E01032441,1157,165,992
2021,Wyre Forest 002B,E01032442,1530,256,1274
2021,Wyre Forest 002C,E01032443,1282,156,1126
2021,Wyre Forest 002D,E01032444,1186,198,988
2021,Wyre Forest 002E,E01032445,1510,321,1189
2021,Wyre Forest 003C,E01032446,1356,207,1149
2021,Wyre Forest 003D,E01032447,1408,243,1165
2021,Wyre Forest 003E,E01032448,1093,185,908
2021,Wyre Forest 007A,E01032449,1493,248,1245
2021,Wyre Forest 006A,E01032451,1446,194,1252
2021,Wyre Forest 006B,E01032452,1496,236,1260
2021,Wyre Forest 006C,E01032453,1713,376,1337
2021,Wyre Forest 006D,E01032454,1722,244,1478
2021,Wyre Forest 012A,E01032455,1377,196,1181
2021,Wyre Forest 012B,E01032456,1192,221,971
2021,Wyre Forest 012C,E01032457,1420,303,1117
2021,Wyre Forest 012D,E01032458,1448,208,1240
2021,Wyre Forest 012E,E01032459,1401,221,1180
2021,Wyre Forest 013A,E01032460,1744,223,1521
2021,Wyre Forest 013B,E01032461,1891,239,1652
2021,Wyre Forest 013C,E01032462,2069,379,1690
2021,Wyre Forest 013D,E01032463,1565,218,1347
2021,Wyre Forest 007B,E01032464,1400,250,1150
2021,Wyre Forest 007C,E01032465,1433,356,1077
2021,Wyre Forest 007D,E01032466,1308,159,1149
2021,Wyre Forest 007E,E01032467,1127,143,984
2021,Wyre Forest 007F,E01032468,1061,119,942
2021,Wyre Forest 009A,E01032469,1608,368,1240
2021,Wyre Forest 009C,E01032471,1495,399,1096
2021,Wyre Forest 011D,E01032472,1219,163,1056
2021,Wyre Forest 011E,E01032473,1365,213,1152
2021,Wyre Forest 008A,E01032474,1683,304,1379
2021,Wyre Forest 008B,E01032475,1558,264,1294
2021,Wyre Forest 008C,E01032476,1322,233,1089
2021,Wyre Forest 008D,E01032477,1129,154,975
2021,Wyre Forest 008E,E01032478,1448,278,1170
2021,Wyre Forest 001F,E01032479,2330,333,1997
2021,Wyre Forest 005B,E01032480,1675,254,1421
2021,Wyre Forest 005C,E01032481,1762,277,1485
2021,Wyre Forest 005D,E01032482,1327,186,1141
2021,Sunderland 032F,E01032483,1569,250,1319
2021,Sunderland 032G,E01032484,1210,157,1053
2021,Blackburn with Darwen 018E,E01032485,1817,322,1495
2021,Blackburn with Darwen 018F,E01032486,1292,191,1101
2021,Leeds 097F,E01032487,976,204,772
2021,Leeds 097G,E01032488,1709,291,1418
2021,Leeds 102F,E01032489,1967,320,1647
2021,Leeds 102G,E01032490,1334,271,1063
2021,Leeds 102H,E01032491,1149,220,929
2021,Leeds 102I,E01032492,2002,332,1670
2021,Leeds 033F,E01032493,1304,160,1144
2021,Leeds 033G,E01032494,1807,451,1356
2021,Leeds 105F,E01032496,2107,437,1670
2021,Leeds 099E,E01032497,1467,376,1091
2021,Leeds 099F,E01032498,1575,264,1311
2021,Leeds 067G,E01032499,1629,272,1357
2021,Leeds 067H,E01032500,1286,251,1035
2021,Leeds 017E,E01032501,1092,169,923
2021,Leeds 017F,E01032502,1745,385,1360
2021,Leeds 007E,E01032503,1387,253,1134
2021,Leeds 007F,E01032504,1675,315,1360
2021,Liverpool 050F,E01032505,1204,228,976
2021,Liverpool 050G,E01032506,1344,258,1086
2021,Liverpool 050H,E01032507,1295,173,1122
2021,Liverpool 027G,E01032508,1637,358,1279
2021,Liverpool 027H,E01032509,1210,229,981
2021,Liverpool 008F,E01032510,1984,369,1615
2021,Liverpool 008G,E01032511,1262,226,1036
2021,Westminster 010F,E01032512,2257,656,1601
2021,Westminster 010G,E01032513,1169,284,885
2021,Bristol 053E,E01032514,1910,513,1397
2021,Bristol 053F,E01032515,1774,409,1365
2021,Bristol 001G,E01032516,1896,353,1543
2021,Bristol 001H,E01032517,1717,391,1326
2021,Bristol 018E,E01032518,1976,575,1401
2021,Bristol 018F,E01032519,1187,254,933
2021,Nottingham 028E,E01032520,1871,503,1368
2021,Nottingham 028F,E01032522,2417,952,1465
2021,West Suffolk 003B,E01032523,1987,371,1616
2021,West Suffolk 003C,E01032524,1122,210,912
2021,West Suffolk 003D,E01032526,1770,291,1479
2021,Coventry 035G,E01032527,1534,323,1211
2021,Coventry 035H,E01032528,1438,283,1155
2021,Coventry 038E,E01032529,1147,140,1007
2021,Coventry 038F,E01032530,1795,315,1480
2021,Coventry 036F,E01032532,1433,219,1214
2021,Coventry 036G,E01032533,1850,553,1297
2021,Coventry 037F,E01032534,1712,427,1285
2021,Coventry 037G,E01032535,1175,228,947
2021,Coventry 001F,E01032536,2028,409,1619
2021,Coventry 001G,E01032537,1827,381,1446
2021,Coventry 001H,E01032538,2120,452,1668
2021,Hartlepool 003G,E01032540,941,191,750
2021,Hartlepool 003H,E01032541,2064,408,1656
2021,Stockton-on-Tees 009F,E01032542,1671,448,1223
2021,Stockton-on-Tees 009G,E01032543,2004,529,1475
2021,Stockton-on-Tees 009H,E01032544,1909,470,1439
2021,Darlington 002E,E01032545,1605,392,1213
2021,Darlington 002F,E01032546,1686,324,1362
2021,Redcar and Cleveland 019E,E01032548,1589,227,1362
2021,Redcar and Cleveland 019F,E01032549,2402,404,1998
2021,Barnsley 010H,E01032551,2450,478,1972
2021,Middlesbrough 018G,E01032552,1570,300,1270
2021,Oxford 002F,E01032554,2097,473,1624
2021,Oxford 002G,E01032555,1856,517,1339
2021,Oldham 026E,E01032556,1404,262,1142
2021,Oldham 026F,E01032557,1663,476,1187
2021,Oldham 007E,E01032558,1542,456,1086
2021,Oldham 007F,E01032559,2595,594,2001
2021,Redcar and Cleveland 003E,E01032560,1086,159,927
2021,Redcar and Cleveland 003F,E01032561,1357,346,1011
2021,Bromley 040D,E01032562,1508,424,1084
2021,Bromley 040E,E01032563,1378,248,1130
2021,Lewisham 037E,E01032564,1235,350,885
2021,Lewisham 038E,E01032565,1379,323,1056
2021,Bexley 029D,E01032566,1760,353,1407
2021,Greenwich 033D,E01032567,1521,280,1241
2021,Bromley 041E,E01032568,1437,280,1157
2021,Croydon 045E,E01032569,1638,447,1191
2021,Bromley 042D,E01032570,1645,301,1344
2021,Tandridge 012D,E01032571,1883,328,1555
2021,Ealing 040D,E01032572,1527,228,1299
2021,Hounslow 029E,E01032573,1719,257,1462
2021,Enfield 037E,E01032574,1936,551,1385
2021,Haringey 037D,E01032575,2026,631,1395
2021,Harrow 032E,E01032576,1593,367,1226
2021,Hillingdon 033E,E01032577,1684,386,1298
2021,Lewisham 039E,E01032579,2027,425,1602
2021,Barking and Dagenham 023F,E01032580,1430,426,1004
2021,Redbridge 034G,E01032581,1775,474,1301
2021,Lambeth 036E,E01032582,2212,574,1638
2021,Southwark 034D,E01032583,1959,511,1448
2021,Southwark 034E,E01032584,1302,346,956
2021,Sheffield 072E,E01032585,1280,152,1128
2021,North East Derbyshire 014D,E01032586,1538,275,1263
2021,Coventry 043E,E01032587,1695,467,1228
2021,Nuneaton and Bedworth 018E,E01032588,1349,225,1124
2021,Birmingham 132E,E01032589,1447,310,1137
2021,Solihull 030D,E01032590,2174,386,1788
2021,Birmingham 133F,E01032591,1510,323,1187
2021,Sandwell 039F,E01032592,1691,343,1348
2021,Middlesbrough 020F,E01032593,2421,506,1915
2021,Redcar and Cleveland 021E,E01032594,1392,234,1158
2021,Kingston upon Hull 033E,E01032595,1745,395,1350
2021,East Riding of Yorkshire 043F,E01032596,1341,232,1109
2021,Leicester 037F,E01032597,1452,371,1081
2021,Leicester 038E,E01032599,1528,359,1169
2021,Oadby and Wigston 008D,E01032600,1897,342,1555
2021,Oadby and Wigston 008E,E01032601,1374,254,1120
2021,Leicester 039E,E01032602,1678,527,1151
2021,Blaby 013F,E01032603,1408,164,1244
2021,Portsmouth 026D,E01032604,1458,254,1204
2021,Havant 018F,E01032605,1583,245,1338
2021,Leeds 067I,E01032606,1941,337,1604
2021,Leeds 067J,E01032607,1220,184,1036
2021,Leeds 067K,E01032608,1057,152,905
2021,Buckinghamshire 039F,E01032609,1256,215,1041
2021,Buckinghamshire 036F,E01032610,1513,293,1220
2021,East Cambridgeshire 011D,E01032611,1589,231,1358
2021,West Suffolk 015F,E01032612,1931,230,1701
2021,Amber Valley 017E,E01032613,1213,165,1048
2021,Erewash 016E,E01032614,1167,199,968
2021,East Hampshire 016D,E01032615,1018,133,885
2021,East Hampshire 016E,E01032616,1456,241,1215
2021,Havant 020D,E01032617,1518,217,1301
2021,Havant 019D,E01032618,1632,300,1332
2021,Sevenoaks 016D,E01032619,1471,267,1204
2021,Tonbridge and Malling 014E,E01032620,2227,330,1897
2021,Nottingham 038E,E01032621,1439,273,1166
2021,Gedling 016D,E01032622,1297,221,1076
2021,Sutton 025E,E01032623,1724,326,1398
2021,Epsom and Ewell 010F,E01032624,1907,371,1536
2021,East Hampshire 017E,E01032625,1337,237,1100
2021,Waverley 018F,E01032626,1591,244,1347
2021,Mendip 011F,E01032627,2104,342,1762
2021,East Devon 004G,E01032628,2463,397,2066
2021,Sedgemoor 011E,E01032631,1303,311,992
2021,Sedgemoor 011F,E01032632,1418,258,1160
2021,Sedgemoor 002G,E01032633,2193,231,1962
2021,Sedgemoor 011G,E01032634,1208,183,1025
2021,Somerset West and Taunton 003E,E01032635,2209,343,1866
2021,Somerset West and Taunton 001D,E01032636,1909,259,1650
2021,Southwark 035E,E01032637,1031,192,839
2021,Southwark 035D,E01032638,1065,78,987
2021,Southwark 014F,E01032639,1851,564,1287
2021,Southwark 035B,E01032640,1012,74,938
2021,Dorset 031A,E01032643,1469,217,1252
2021,Dorset 031B,E01032644,1180,88,1092
2021,Dorset 031C,E01032645,1497,161,1336
2021,Southwark 036B,E01032646,1462,205,1257
2021,North Tyneside 011E,E01032647,2663,634,2029
2021,North Tyneside 011F,E01032648,1448,346,1102
2021,North Tyneside 019F,E01032649,1028,126,902
2021,North Tyneside 019G,E01032650,980,134,846
2021,Somerset West and Taunton 012D,E01032651,1758,218,1540
2021,Somerset West and Taunton 012E,E01032652,2004,417,1587
2021,Swale 004F,E01032653,1441,246,1195
2021,Swale 007G,E01032655,1802,443,1359
2021,Swale 007H,E01032656,2381,556,1825
2021,Plymouth 027F,E01032657,1271,342,929
2021,Plymouth 027G,E01032658,1496,432,1064
2021,"Bournemouth, Christchurch and Poole 044C",E01032659,1184,169,1015
2021,"Bournemouth, Christchurch and Poole 044D",E01032660,1553,359,1194
2021,"Bournemouth, Christchurch and Poole 044E",E01032661,1287,145,1142
2021,"Bournemouth, Christchurch and Poole 044F",E01032662,1114,192,922
2021,East Hampshire 012F,E01032664,1075,91,984
2021,East Hampshire 012G,E01032665,1265,174,1091
2021,North Somerset 026B,E01032666,1244,265,979
2021,North Somerset 026C,E01032667,1090,248,842
2021,North Somerset 026D,E01032668,1391,316,1075
2021,North Somerset 027B,E01032669,1344,333,1011
2021,North Somerset 027C,E01032670,1608,438,1170
2021,North Somerset 027D,E01032671,1229,343,886
2021,North Somerset 026E,E01032672,2538,628,1910
2021,North Somerset 026F,E01032673,1286,192,1094
2021,North Somerset 001E,E01032675,1541,232,1309
2021,North Somerset 001F,E01032676,1908,202,1706
2021,North Somerset 003D,E01032677,1808,444,1364
2021,North Somerset 003E,E01032678,1497,447,1050
2021,North Somerset 027E,E01032679,1091,182,909
2021,North Somerset 006G,E01032680,1845,264,1581
2021,North Somerset 001G,E01032681,1257,234,1023
2021,North Somerset 003F,E01032682,991,215,776
2021,West Lindsey 001G,E01032683,2141,347,1794
2021,Salford 034D,E01032684,1322,346,976
2021,Wiltshire 025E,E01032688,1218,250,968
2021,Wiltshire 025F,E01032689,1225,231,994
2021,Wiltshire 015F,E01032690,1788,467,1321
2021,Wiltshire 015G,E01032691,1360,279,1081
2021,Wiltshire 025G,E01032692,1089,157,932
2021,Wiltshire 025H,E01032693,1698,366,1332
2021,Wiltshire 064D,E01032694,1756,440,1316
2021,Wiltshire 064C,E01032695,1452,213,1239
2021,Wiltshire 045F,E01032696,2165,386,1779
2021,Wiltshire 066C,E01032697,1399,349,1050
2021,Wiltshire 007I,E01032699,2030,247,1783
2021,Swindon 026B,E01032700,1667,477,1190
2021,Swindon 027A,E01032701,1184,262,922
2021,Swindon 027B,E01032702,1345,361,984
2021,Swindon 026C,E01032703,1479,401,1078
2021,Swindon 027C,E01032704,1723,459,1264
2021,Swindon 026D,E01032705,1429,389,1040
2021,Swindon 021E,E01032706,1448,256,1192
2021,Swindon 021F,E01032707,1992,441,1551
2021,Swindon 012F,E01032708,1584,285,1299
2021,Swindon 026E,E01032709,1296,332,964
2021,Swindon 028E,E01032710,1316,282,1034
2021,Swindon 027D,E01032711,1475,352,1123
2021,Swindon 027E,E01032712,2215,579,1636
2021,Swindon 026F,E01032713,1930,550,1380
2021,Swindon 019E,E01032714,1713,256,1457
2021,Swindon 019F,E01032715,1177,139,1038
2021,Swindon 012G,E01032716,1473,284,1189
2021,Southwark 014G,E01032719,1373,309,1064
2021,Bracknell Forest 006F,E01032724,1574,264,1310
2021,Bracknell Forest 009H,E01032726,1654,391,1263
2021,Bracknell Forest 006G,E01032728,1760,267,1493
2021,Slough 009F,E01032729,1627,419,1208
2021,Slough 009G,E01032730,1758,357,1401
2021,Slough 013E,E01032731,1451,409,1042
2021,Slough 013F,E01032732,1648,435,1213
2021,Windsor and Maidenhead 005G,E01032733,1238,197,1041
2021,Windsor and Maidenhead 005H,E01032734,1661,299,1362
2021,Swale 013F,E01032735,1569,339,1230
2021,Swale 013G,E01032737,1451,304,1147
2021,Southampton 022F,E01032738,1861,662,1199
2021,City of London 001F,E01032739,1601,226,1375
2021,City of London 001G,E01032740,1370,252,1118
2021,Havering 013E,E01032741,1342,196,1146
2021,Havering 013F,E01032742,1639,255,1384
2021,Ealing 010F,E01032743,2084,594,1490
2021,Ealing 010G,E01032744,1523,370,1153
2021,Southampton 033C,E01032745,2858,1669,1189
2021,Southampton 034C,E01032746,1221,172,1049
2021,Southampton 034D,E01032748,1835,197,1638
2021,Southampton 022G,E01032750,1488,627,861
2021,Southampton 033D,E01032751,1707,468,1239
2021,Southampton 009F,E01032753,2137,926,1211
2021,Southampton 033A,E01032755,1019,302,717
2021,Wokingham 012H,E01032759,1861,413,1448
2021,Tower Hamlets 004E,E01032764,2265,373,1892
2021,Tower Hamlets 004F,E01032765,1664,294,1370
2021,Tower Hamlets 021F,E01032767,1535,241,1294
2021,Tower Hamlets 025E,E01032768,1249,107,1142
2021,Tower Hamlets 025F,E01032769,1247,189,1058
2021,Tower Hamlets 032B,E01032770,2020,294,1726
2021,Tower Hamlets 033B,E01032771,1462,265,1197
2021,Tower Hamlets 032C,E01032772,2264,574,1690
2021,Tower Hamlets 032E,E01032774,1677,362,1315
2021,Tower Hamlets 031F,E01032775,1073,129,944
2021,Tower Hamlets 034D,E01032776,1951,321,1630
2021,Tower Hamlets 035A,E01032777,1203,207,996
2021,Tower Hamlets 035C,E01032779,1303,250,1053
2021,Tower Hamlets 035D,E01032780,1942,316,1626
2021,Tower Hamlets 033C,E01032781,1604,283,1321
2021,Tower Hamlets 033D,E01032782,2148,465,1683
2021,Tower Hamlets 031G,E01032783,1231,242,989
2021,Tower Hamlets 004G,E01032784,1619,309,1310
2021,Tower Hamlets 010E,E01032785,2275,519,1756
2021,Tower Hamlets 010F,E01032786,1490,413,1077
2021,Tower Hamlets 011F,E01032787,2287,600,1687
2021,Hammersmith and Fulham 023D,E01032788,1476,239,1237
2021,Hammersmith and Fulham 023E,E01032789,1120,229,891
2021,Hammersmith and Fulham 023F,E01032790,1059,281,778
2021,Cambridge 003F,E01032792,1171,203,968
2021,Cambridge 014D,E01032794,1235,241,994
2021,Gravesham 002F,E01032799,1332,226,1106
2021,Gravesham 002G,E01032800,1131,138,993
2021,Cambridge 003G,E01032802,1290,223,1067
2021,Southwark 036C,E01032803,1447,200,1247
2021,Canterbury 020F,E01032807,1414,449,965
2021,Canterbury 020G,E01032808,1577,494,1083
2021,Ashford 001F,E01032810,1465,350,1115
2021,Ashford 003D,E01032811,1505,342,1163
2021,Ashford 001G,E01032812,1719,374,1345
2021,Ashford 012E,E01032813,1758,441,1317
2021,Ashford 012F,E01032814,1968,378,1590
2021,Ashford 009F,E01032815,973,214,759
2021,Ashford 008E,E01032816,1879,401,1478
2021,Ashford 009G,E01032817,1101,239,862
2021,Ashford 009H,E01032818,1421,352,1069
2021,Ashford 009I,E01032819,1634,409,1225
2021,Ashford 016B,E01032820,2332,494,1838
2021,Ashford 016A,E01032821,2789,688,2101
2021,Ashford 003E,E01032822,1381,302,1079
2021,Ashford 008F,E01032823,1518,342,1176
2021,Ashford 009J,E01032824,1349,254,1095
2021,Tonbridge and Malling 007E,E01032825,2733,758,1975
2021,Tonbridge and Malling 007F,E01032826,1649,438,1211
2021,Tonbridge and Malling 007G,E01032827,2003,609,1394
2021,Tonbridge and Malling 007H,E01032828,1115,280,835
2021,Tonbridge and Malling 014F,E01032829,1639,320,1319
2021,Tonbridge and Malling 002G,E01032830,2326,475,1851
2021,Eastbourne 014B,E01032831,1557,193,1364
2021,Eastbourne 014C,E01032832,1429,269,1160
2021,Eastbourne 014D,E01032833,1252,158,1094
2021,Southwark 035C,E01032834,1003,69,934
2021,Crawley 004F,E01032835,1794,319,1475
2021,Crawley 004G,E01032836,2134,406,1728
2021,Mid Sussex 009E,E01032837,2296,465,1831
2021,Mid Sussex 009F,E01032838,1367,306,1061
2021,Mid Sussex 009G,E01032839,1211,187,1024
2021,Basingstoke and Deane 010G,E01032841,2425,427,1998
2021,Basingstoke and Deane 011E,E01032842,1261,148,1113
2021,Basingstoke and Deane 007H,E01032843,1809,376,1433
2021,Basingstoke and Deane 007I,E01032844,2650,558,2092
2021,Basingstoke and Deane 012E,E01032845,1657,270,1387
2021,Basingstoke and Deane 012F,E01032846,1553,232,1321
2021,Basingstoke and Deane 011F,E01032847,1982,186,1796
2021,Basingstoke and Deane 021E,E01032848,1586,456,1130
2021,Basingstoke and Deane 021F,E01032849,1424,327,1097
2021,Basingstoke and Deane 021G,E01032850,1330,262,1068
2021,Hart 005E,E01032852,1616,435,1181
2021,Hart 005F,E01032853,1763,487,1276
2021,Hart 005G,E01032854,1563,427,1136
2021,Hart 011D,E01032855,1143,262,881
2021,Hart 011E,E01032856,1498,238,1260
2021,Hart 005H,E01032857,1001,159,842
2021,Rushmoor 009F,E01032858,2302,453,1849
2021,Winchester 013F,E01032859,1652,363,1289
2021,Winchester 013G,E01032860,1464,296,1168
2021,Leicester 042B,E01032862,2066,580,1486
2021,Leicester 042C,E01032863,2199,638,1561
2021,Leicester 042A,E01032865,1984,560,1424
2021,Leicester 041B,E01032868,2762,2350,412
2021,Test Valley 005F,E01032870,1793,320,1473
2021,Test Valley 005G,E01032871,1423,234,1189
2021,Leicester 041C,E01032872,1148,233,915
2021,Leicester 041D,E01032873,1938,971,967
2021,Leeds 109G,E01032876,1757,579,1178
2021,Fareham 013F,E01032877,2693,407,2286
2021,Gosport 008F,E01032878,971,138,833
2021,Gosport 008G,E01032879,1155,109,1046
2021,Gosport 006F,E01032880,1340,296,1044
2021,Gosport 006G,E01032881,1625,479,1146
2021,Gosport 006H,E01032883,1295,229,1066
2021,Gosport 007F,E01032884,1895,264,1631
2021,Solihull 029F,E01032885,1464,203,1261
2021,Solihull 029G,E01032886,2557,560,1997
2021,Walsall 018F,E01032888,2554,664,1890
2021,Rugby 014C,E01032891,1841,437,1404
2021,Rugby 007F,E01032893,1910,499,1411
2021,Rugby 007G,E01032894,2062,568,1494
2021,Rugby 007H,E01032895,1411,307,1104
2021,East Staffordshire 011F,E01032896,1332,194,1138
2021,East Staffordshire 011G,E01032897,1455,256,1199
2021,East Staffordshire 011H,E01032898,1192,201,991
2021,Lichfield 004F,E01032899,1743,191,1552
2021,Lichfield 004G,E01032900,1921,457,1464
2021,Tamworth 010F,E01032901,1690,395,1295
2021,Tamworth 010G,E01032902,1263,176,1087
2021,St. Helens 025C,E01032904,1780,397,1383
2021,St. Helens 025D,E01032905,2601,601,2000
2021,Salford 034E,E01032906,1987,402,1585
2021,Salford 033F,E01032909,1691,196,1495
2021,Salford 035B,E01032912,2098,619,1479
2021,Salford 035A,E01032914,1988,307,1681
2021,Salford 036C,E01032915,2039,383,1656
2021,Oldham 011E,E01032920,2380,571,1809
2021,Oldham 020E,E01032922,2327,396,1931
2021,Calderdale 008F,E01032923,2010,333,1677
2021,Barnsley 026F,E01032924,1494,311,1183
2021,Barnsley 026G,E01032925,1345,219,1126
2021,Rotherham 012E,E01032926,1660,435,1225
2021,Rotherham 012F,E01032927,1366,283,1083
2021,Cheshire West and Chester 033E,E01032930,2102,429,1673
2021,Cheshire West and Chester 033F,E01032931,1094,141,953
2021,Gloucester 004E,E01032932,1701,287,1414
2021,Gloucester 015E,E01032933,1555,440,1115
2021,Gloucester 015G,E01032935,1456,374,1082
2021,Gloucester 004F,E01032937,1432,279,1153
2021,Tewkesbury 001F,E01032938,2197,407,1790
2021,Tewkesbury 001G,E01032939,1408,325,1083
2021,Tewkesbury 001H,E01032940,1426,375,1051
2021,Cherwell 004G,E01032941,1395,282,1113
2021,Cherwell 004H,E01032942,1390,219,1171
2021,Cherwell 002E,E01032943,2027,433,1594
2021,Cherwell 002F,E01032944,1259,175,1084
2021,Leeds 110G,E01032946,3115,2029,1086
2021,West Oxfordshire 008G,E01032947,1732,469,1263
2021,West Oxfordshire 008H,E01032948,1860,428,1432
2021,West Oxfordshire 013E,E01032949,1279,262,1017
2021,West Oxfordshire 013F,E01032950,1603,355,1248
2021,West Oxfordshire 013G,E01032951,1857,413,1444
2021,West Oxfordshire 008I,E01032952,1298,173,1125
2021,West Oxfordshire 013H,E01032953,2177,463,1714
2021,Buckinghamshire 015D,E01032955,1297,145,1152
2021,Buckinghamshire 016D,E01032956,1514,321,1193
2021,Buckinghamshire 016E,E01032957,1186,197,989
2021,Buckinghamshire 009E,E01032958,1464,218,1246
2021,Buckinghamshire 015E,E01032961,1327,171,1156
2021,Buckinghamshire 016F,E01032962,1372,249,1123
2021,North Northamptonshire 008B,E01032963,1431,266,1165
2021,North Northamptonshire 008C,E01032964,1762,469,1293
2021,North Northamptonshire 008D,E01032965,1757,492,1265
2021,North Northamptonshire 008E,E01032966,2517,649,1868
2021,North Northamptonshire 008F,E01032967,2447,706,1741
2021,North Northamptonshire 013F,E01032969,1502,363,1139
2021,North Northamptonshire 013G,E01032970,1931,470,1461
2021,North Northamptonshire 013H,E01032971,1072,177,895
2021,North Northamptonshire 020B,E01032972,1494,254,1240
2021,North Northamptonshire 020C,E01032973,1623,485,1138
2021,North Northamptonshire 020D,E01032974,1377,266,1111
2021,West Northamptonshire 035A,E01032976,1555,299,1256
2021,West Northamptonshire 032D,E01032978,1656,408,1248
2021,West Northamptonshire 032E,E01032979,1375,274,1101
2021,West Northamptonshire 037D,E01032980,1636,384,1252
2021,West Northamptonshire 037E,E01032981,2599,1243,1356
2021,West Northamptonshire 046E,E01032982,1339,316,1023
2021,West Northamptonshire 046F,E01032983,1506,423,1083
2021,West Northamptonshire 046G,E01032984,1583,491,1092
2021,West Northamptonshire 046H,E01032985,2170,396,1774
2021,East Lindsey 004D,E01032986,1087,149,938
2021,East Lindsey 004E,E01032987,1373,267,1106
2021,North Kesteven 013B,E01032988,1763,342,1421
2021,North Kesteven 013C,E01032989,1927,478,1449
2021,North Kesteven 014E,E01032991,2081,400,1681
2021,North Kesteven 014F,E01032992,1410,202,1208
2021,North Kesteven 013D,E01032993,2351,445,1906
2021,North Kesteven 003H,E01032994,1432,228,1204
2021,South Holland 006F,E01032995,1393,157,1236
2021,South Holland 006G,E01032996,1332,243,1089
2021,South Kesteven 011E,E01032997,1226,296,930
2021,South Kesteven 011F,E01032998,1715,432,1283
2021,South Kesteven 011G,E01032999,1191,171,1020
2021,Hounslow 025F,E01033000,1647,473,1174
2021,Leeds 055F,E01033002,2017,694,1323
2021,Leeds 055G,E01033003,2006,554,1452
2021,Leeds 111A,E01033008,2141,1599,542
2021,Leeds 111B,E01033010,3481,2884,597
2021,Leeds 111C,E01033011,1323,375,948
2021,Leeds 082E,E01033013,1367,340,1027
2021,Leeds 111D,E01033015,1489,206,1283
2021,Leeds 111E,E01033016,1028,165,863
2021,Leeds 075E,E01033021,1963,326,1637
2021,Dacorum 018G,E01033022,1290,198,1092
2021,Dacorum 018H,E01033023,1974,276,1698
2021,North Hertfordshire 017E,E01033024,1488,370,1118
2021,North Hertfordshire 017D,E01033025,1236,284,952
2021,North Hertfordshire 017A,E01033026,1510,342,1168
2021,North Hertfordshire 017C,E01033027,1377,322,1055
2021,St Albans 018F,E01033028,1442,337,1105
2021,St Albans 018G,E01033029,1603,395,1208
2021,Hounslow 025G,E01033030,1653,370,1283
2021,Leeds 064E,E01033031,1490,331,1159
2021,Leeds 075F,E01033033,1566,588,978
2021,Leeds 075G,E01033034,1452,132,1320
2021,Leeds 064F,E01033035,1515,445,1070
2021,King's Lynn and West Norfolk 017E,E01033036,1561,319,1242
2021,King's Lynn and West Norfolk 017F,E01033037,1518,384,1134
2021,King's Lynn and West Norfolk 017G,E01033038,2007,350,1657
2021,King's Lynn and West Norfolk 017H,E01033039,1015,131,884
2021,Breckland 010F,E01033040,2448,369,2079
2021,Breckland 010G,E01033041,1243,221,1022
2021,Breckland 001F,E01033042,2172,383,1789
2021,West Suffolk 011D,E01033043,1084,158,926
2021,West Suffolk 012D,E01033044,1310,337,973
2021,West Suffolk 012E,E01033045,1247,323,924
2021,West Suffolk 011E,E01033046,1035,104,931
2021,West Suffolk 011F,E01033047,1053,174,879
2021,West Suffolk 013E,E01033048,1326,170,1156
2021,West Suffolk 013F,E01033049,1103,77,1026
2021,West Suffolk 012F,E01033050,1135,228,907
2021,Tendring 002F,E01033051,2345,425,1920
2021,Uttlesford 008F,E01033052,1845,563,1282
2021,Uttlesford 008G,E01033053,2018,568,1450
2021,Uttlesford 007D,E01033054,1149,237,912
2021,Uttlesford 007E,E01033055,2123,411,1712
2021,Uttlesford 007F,E01033056,1490,292,1198
2021,Coventry 042F,E01033058,2359,1242,1117
2021,Bromsgrove 012D,E01033059,1459,342,1117
2021,Bromsgrove 014E,E01033060,1098,152,946
2021,Bromsgrove 012E,E01033061,1751,431,1320
2021,Bromsgrove 014F,E01033062,2153,354,1799
2021,Brentwood 007F,E01033063,1336,220,1116
2021,Brentwood 007G,E01033064,1298,195,1103
2021,York 013F,E01033067,1523,444,1079
2021,York 013G,E01033068,1089,222,867
2021,York 013H,E01033069,997,123,874
2021,York 013I,E01033070,2650,1518,1132
2021,Lancaster 014E,E01033071,1649,988,661
2021,Lancaster 016I,E01033072,2393,368,2025
2021,Lancaster 014F,E01033073,1815,960,855
2021,Sunderland 012F,E01033076,2265,531,1734
2021,Sunderland 027F,E01033077,2132,380,1752
2021,Bath and North East Somerset 010G,E01033078,1823,547,1276
2021,Bath and North East Somerset 010H,E01033079,1121,207,914
2021,Bath and North East Somerset 009E,E01033080,2176,575,1601
2021,Hounslow 031D,E01033081,1500,255,1245
2021,Hounslow 031C,E01033082,1181,175,1006
2021,Hounslow 018F,E01033083,1996,478,1518
2021,Hounslow 018G,E01033084,1759,444,1315
2021,Haringey 020F,E01033086,1123,255,868
2021,Maidstone 006F,E01033087,1612,252,1360
2021,Maidstone 008F,E01033088,2159,546,1613
2021,Maidstone 008G,E01033089,1716,412,1304
2021,Maidstone 006G,E01033091,1582,291,1291
2021,Maidstone 004G,E01033092,1387,185,1202
2021,Sefton 004F,E01033094,1142,127,1015
2021,Sefton 033F,E01033095,2314,406,1908
2021,Sefton 004G,E01033097,1113,122,991
2021,Wandsworth 038C,E01033098,1614,231,1383
2021,Wandsworth 004E,E01033099,1766,245,1521
2021,Wandsworth 039B,E01033100,1799,248,1551
2021,North West Leicestershire 011E,E01033102,1480,301,1179
2021,North West Leicestershire 011F,E01033103,2119,387,1732
2021,Kingston upon Hull 029E,E01033104,1407,143,1264
2021,Kingston upon Hull 035D,E01033105,1472,318,1154
2021,Kingston upon Hull 035E,E01033107,1244,320,924
2021,Kingston upon Hull 029F,E01033109,1416,213,1203
2021,Fenland 003H,E01033111,1589,210,1379
2021,Fenland 003I,E01033112,1386,167,1219
2021,South Cambridgeshire 020A,E01033113,1172,333,839
2021,South Cambridgeshire 020B,E01033114,1343,342,1001
2021,South Cambridgeshire 020C,E01033115,1334,446,888
2021,South Cambridgeshire 021D,E01033116,2604,651,1953
2021,South Cambridgeshire 020D,E01033117,1243,375,868
2021,South Cambridgeshire 021E,E01033118,1442,326,1116
2021,South Cambridgeshire 006G,E01033120,1357,299,1058
2021,South Cambridgeshire 006H,E01033121,2025,461,1564
2021,Ipswich 012F,E01033122,2079,534,1545
2021,Ipswich 011E,E01033123,1644,297,1347
2021,Ipswich 007F,E01033124,1028,67,961
2021,Ipswich 007G,E01033125,1316,157,1159
2021,Ipswich 011F,E01033126,1806,576,1230
2021,Ipswich 014E,E01033127,1583,352,1231
2021,Ipswich 014F,E01033128,1090,211,879
2021,Ipswich 007H,E01033129,1556,289,1267
2021,Ipswich 012G,E01033130,1078,159,919
2021,Ipswich 014G,E01033131,1647,428,1219
2021,Wandsworth 038D,E01033132,1925,269,1656
2021,Wandsworth 004G,E01033133,1141,123,1018
2021,Wandsworth 010G,E01033135,1097,168,929
2021,Chelmsford 014F,E01033137,1502,292,1210
2021,Chelmsford 009F,E01033138,1408,260,1148
2021,Chelmsford 009G,E01033139,1535,296,1239
2021,Chelmsford 022D,E01033140,1925,224,1701
2021,Chelmsford 005E,E01033142,2033,599,1434
2021,Chelmsford 005F,E01033144,1691,455,1236
2021,Chelmsford 014G,E01033145,1448,277,1171
2021,Enfield 025F,E01033146,1414,407,1007
2021,Enfield 003F,E01033148,2066,605,1461
2021,Enfield 003G,E01033150,1496,425,1071
2021,Enfield 025G,E01033151,1372,473,899
2021,Dorset 002D,E01033156,1623,376,1247
2021,Dorset 002E,E01033158,1320,222,1098
2021,Barrow-in-Furness 009F,E01033160,2149,377,1772
2021,County Durham 021D,E01033161,1426,269,1157
2021,County Durham 016F,E01033163,1903,431,1472
2021,Derby 018F,E01033166,1208,185,1023
2021,Derby 018G,E01033167,1173,204,969
2021,Derby 030E,E01033168,1253,315,938
2021,Derby 030F,E01033169,1699,526,1173
2021,Derby 030G,E01033170,1199,243,956
2021,Derby 024E,E01033171,1534,286,1248
2021,Derby 024F,E01033172,1493,329,1164
2021,Peterborough 016F,E01033173,2108,574,1534
2021,Peterborough 022C,E01033174,2331,475,1856
2021,Peterborough 023B,E01033175,1429,362,1067
2021,Peterborough 023D,E01033177,1659,470,1189
2021,Peterborough 022D,E01033179,2708,617,2091
2021,Peterborough 023F,E01033180,1683,553,1130
2021,Peterborough 022E,E01033181,1563,388,1175
2021,Peterborough 016G,E01033182,1489,355,1134
2021,Richmondshire 004H,E01033184,1895,309,1586
2021,Richmondshire 006F,E01033185,1325,143,1182
2021,Richmondshire 006G,E01033186,1378,128,1250
2021,Central Bedfordshire 014E,E01033188,1419,281,1138
2021,Central Bedfordshire 014F,E01033189,2641,658,1983
2021,Central Bedfordshire 014G,E01033190,1425,345,1080
2021,Central Bedfordshire 024E,E01033191,1656,395,1261
2021,Central Bedfordshire 024F,E01033192,1535,421,1114
2021,County Durham 030E,E01033195,1538,1042,496
2021,County Durham 030F,E01033197,2074,1250,824
2021,County Durham 021E,E01033198,1196,200,996
2021,Dorset 047C,E01033200,2689,347,2342
2021,County Durham 021F,E01033205,1339,236,1103
2021,County Durham 021G,E01033206,1393,288,1105
2021,Lambeth 004G,E01033208,1645,324,1321
2021,Dover 012E,E01033209,1090,104,986
2021,Dover 010G,E01033210,2329,333,1996
2021,Dover 012F,E01033211,1289,159,1130
2021,Folkestone and Hythe 014C,E01033212,1418,218,1200
2021,Folkestone and Hythe 002E,E01033213,1843,464,1379
2021,Folkestone and Hythe 002F,E01033214,1965,348,1617
2021,Folkestone and Hythe 014D,E01033215,1211,105,1106
2021,Bolton 016E,E01033217,1107,193,914
2021,Bolton 028F,E01033218,1475,356,1119
2021,Bolton 028G,E01033219,1353,230,1123
2021,Bolton 016F,E01033220,1230,227,1003
2021,Preston 017F,E01033223,1550,941,609
2021,Preston 017G,E01033224,1067,289,778
2021,Preston 017H,E01033226,1118,271,847
2021,Knowsley 008F,E01033228,2464,584,1880
2021,Isle of Wight 003D,E01033229,1800,229,1571
2021,Exeter 011F,E01033232,1381,326,1055
2021,Exeter 011G,E01033234,1941,359,1582
2021,Exeter 015E,E01033235,1160,114,1046
2021,Exeter 015F,E01033236,981,105,876
2021,Isle of Wight 003E,E01033237,1654,369,1285
2021,Isle of Wight 012H,E01033239,2284,160,2124
2021,"Bournemouth, Christchurch and Poole 037D",E01033241,1046,99,947
2021,"Bournemouth, Christchurch and Poole 038C",E01033242,980,105,875
2021,Bromsgrove 014G,E01033243,2118,295,1823
2021,North Northamptonshire 035D,E01033244,2565,563,2002
2021,North Northamptonshire 035E,E01033245,1017,165,852
2021,Worcester 007E,E01033246,1231,170,1061
2021,Worcester 007F,E01033247,1207,421,786
2021,Worcester 011E,E01033248,1163,191,972
2021,Worcester 011F,E01033249,1290,179,1111
2021,Stratford-on-Avon 010D,E01033250,1249,251,998
2021,Stratford-on-Avon 010E,E01033251,1595,333,1262
2021,Stratford-on-Avon 010F,E01033252,1350,215,1135
2021,Warwick 007H,E01033253,1436,563,873
2021,Warwick 011G,E01033254,1327,338,989
2021,Warwick 011H,E01033255,2566,696,1870
2021,Warwick 007I,E01033256,1248,382,866
2021,Newcastle-under-Lyme 015H,E01033257,2359,367,1992
2021,Doncaster 014E,E01033259,1531,306,1225
2021,Doncaster 014F,E01033260,1536,352,1184
2021,Sheffield 073A,E01033261,2363,1857,506
2021,Sheffield 073B,E01033262,2214,1093,1121
2021,Sheffield 073C,E01033263,1964,623,1341
2021,Sheffield 073D,E01033264,1961,878,1083
2021,Sheffield 074C,E01033265,1441,795,646
2021,Sheffield 075G,E01033268,2593,1002,1591
2021,Sheffield 022G,E01033269,1682,586,1096
2021,Sheffield 022H,E01033270,1523,315,1208
2021,Sheffield 040E,E01033271,1897,996,901
2021,Sheffield 040F,E01033272,1523,494,1029
2021,Sheffield 042F,E01033273,2176,1431,745
2021,Sheffield 042G,E01033274,2457,1939,518
2021,Sheffield 008F,E01033275,1514,318,1196
2021,Sheffield 073E,E01033276,1831,1407,424
2021,Sheffield 011E,E01033277,2722,762,1960
2021,Sheffield 076F,E01033279,2170,438,1732
2021,Sheffield 008G,E01033280,1497,308,1189
2021,Rossendale 004G,E01033281,2531,530,2001
2021,"Bournemouth, Christchurch and Poole 037E",E01033283,1148,124,1024
2021,"Bournemouth, Christchurch and Poole 038D",E01033285,1277,192,1085
2021,"Bournemouth, Christchurch and Poole 040C",E01033286,1085,145,940
2021,"Bournemouth, Christchurch and Poole 040D",E01033288,1132,81,1051
2021,Cornwall 007E,E01033289,1983,314,1669
2021,Cornwall 004D,E01033291,1741,268,1473
2021,Cornwall 004E,E01033292,1443,342,1101
2021,Cornwall 034E,E01033294,2080,323,1757
2021,North Lincolnshire 018F,E01033296,1326,249,1077
2021,North Lincolnshire 018G,E01033297,1596,419,1177
2021,Warrington 017F,E01033299,2216,488,1728
2021,Warrington 018F,E01033300,1541,143,1398
2021,Warrington 018G,E01033302,1495,249,1246
2021,Warrington 017G,E01033303,1055,135,920
2021,Vale of White Horse 006G,E01033305,1238,176,1062
2021,Vale of White Horse 006H,E01033306,1762,244,1518
2021,Welwyn Hatfield 010E,E01033308,2842,1911,931
2021,Welwyn Hatfield 002E,E01033310,1676,378,1298
2021,Welwyn Hatfield 010F,E01033311,1437,336,1101
2021,Welwyn Hatfield 002F,E01033313,1463,367,1096
2021,Welwyn Hatfield 010G,E01033314,2159,1003,1156
2021,Mid Suffolk 010F,E01033316,1899,435,1464
2021,Mid Suffolk 010G,E01033317,1689,333,1356
2021,Mid Suffolk 010H,E01033319,2545,603,1942
2021,Lewisham 017E,E01033320,1454,282,1172
2021,Lewisham 017F,E01033322,1141,156,985
2021,Lewisham 008E,E01033324,1460,285,1175
2021,Lewisham 008F,E01033325,1293,162,1131
2021,Lewisham 041B,E01033327,2030,261,1769
2021,Brighton and Hove 027F,E01033328,1254,250,1004
2021,Brighton and Hove 027G,E01033329,1813,701,1112
2021,Salford 033E,E01033330,1463,303,1160
2021,South Gloucestershire 021F,E01033334,1452,346,1106
2021,South Gloucestershire 021G,E01033336,1620,401,1219
2021,South Gloucestershire 019F,E01033338,1592,331,1261
2021,South Gloucestershire 019G,E01033339,1400,303,1097
2021,Lewisham 041C,E01033341,1240,266,974
2021,Bristol 025E,E01033342,1926,1162,764
2021,Bristol 060D,E01033344,1792,984,808
2021,Bristol 059D,E01033347,2119,582,1537
2021,Bristol 059C,E01033348,1138,289,849
2021,Bristol 061D,E01033350,1169,106,1063
2021,Bristol 054A,E01033352,1682,272,1410
2021,Bristol 054B,E01033353,1949,747,1202
2021,Bristol 056C,E01033356,1566,481,1085
2021,Bristol 054D,E01033358,2374,1102,1272
2021,Bristol 039E,E01033359,1624,215,1409
2021,Bristol 039F,E01033361,1452,157,1295
2021,Bristol 039G,E01033362,1242,113,1129
2021,Bristol 039H,E01033364,1675,208,1467
2021,Bristol 059B,E01033366,1449,501,948
2021,Bristol 025F,E01033367,1309,305,1004
2021,Bristol 056D,E01033369,1338,379,959
2021,Bristol 054E,E01033370,1247,289,958
2021,Cheshire East 050E,E01033372,1103,152,951
2021,Cheshire East 050F,E01033373,1402,178,1224
2021,Cheshire East 053B,E01033375,1929,524,1405
2021,Cheshire East 053A,E01033376,1100,304,796
2021,Cheshire East 053E,E01033378,1449,290,1159
2021,Portsmouth 024E,E01033380,1114,224,890
2021,Portsmouth 027D,E01033381,1402,496,906
2021,Portsmouth 027B,E01033383,1210,353,857
2021,Portsmouth 024F,E01033384,1307,145,1162
2021,Charnwood 001E,E01033386,1930,280,1650
2021,Chesterfield 010F,E01033387,1136,173,963
2021,Chesterfield 010G,E01033388,1613,311,1302
2021,Mansfield 013G,E01033389,1334,277,1057
2021,Mansfield 013H,E01033390,1588,410,1178
2021,Mansfield 013I,E01033391,1142,173,969
2021,Mansfield 006G,E01033392,2487,353,2134
2021,Newark and Sherwood 012G,E01033394,1404,195,1209
2021,Nottingham 026G,E01033395,3209,2901,308
2021,Nottingham 026H,E01033396,1029,474,555
2021,Nottingham 006F,E01033397,1814,483,1331
2021,Nottingham 006G,E01033398,1099,210,889
2021,Nottingham 023E,E01033399,2549,1957,592
2021,Nottingham 039B,E01033400,2665,1495,1170
2021,Nottingham 039C,E01033402,1339,577,762
2021,Nottingham 039F,E01033407,1176,458,718
2021,Nottingham 023H,E01033409,1535,999,536
2021,Nottingham 031I,E01033410,2627,1961,666
2021,Nottingham 023I,E01033411,1077,269,808
2021,Broxtowe 016F,E01033412,2183,286,1897
2021,Broxtowe 016G,E01033413,2052,332,1720
2021,North East Lincolnshire 009E,E01033414,2640,482,2158
2021,Reading 019B,E01033415,2066,365,1701
2021,Reading 010F,E01033417,1152,141,1011
2021,Reading 019A,E01033418,1339,208,1131
2021,Reading 020B,E01033420,1219,189,1030
2021,Reading 010G,E01033421,2263,456,1807
2021,Reading 019D,E01033422,1283,134,1149
2021,Reading 020A,E01033423,1711,429,1282
2021,East Cambridgeshire 004F,E01033425,1907,517,1390
2021,East Cambridgeshire 003F,E01033426,1531,438,1093
2021,East Cambridgeshire 006G,E01033427,1212,288,924
2021,East Cambridgeshire 006H,E01033429,1894,318,1576
2021,East Cambridgeshire 003G,E01033430,1345,319,1026
2021,Bedford 004F,E01033431,1654,465,1189
2021,Norwich 011G,E01033434,1117,191,926
2021,Norwich 005G,E01033435,1930,807,1123
2021,Norwich 005H,E01033436,1936,613,1323
2021,Norwich 011H,E01033437,1421,294,1127
2021,Norwich 014A,E01033438,1884,325,1559
2021,Norwich 014C,E01033440,1477,254,1223
2021,Norwich 014D,E01033441,1356,161,1195
2021,East Suffolk 025F,E01033442,1495,451,1044
2021,East Suffolk 023B,E01033443,1460,231,1229
2021,East Suffolk 025G,E01033444,1447,449,998
2021,East Suffolk 023C,E01033445,1645,376,1269
2021,East Suffolk 023D,E01033446,2802,344,2458
2021,East Suffolk 025H,E01033447,1399,294,1105
2021,East Suffolk 023E,E01033448,1242,185,1057
2021,East Suffolk 023F,E01033449,1787,377,1410
2021,East Suffolk 028E,E01033450,2251,247,2004
2021,West Suffolk 007C,E01033452,1554,286,1268
2021,West Suffolk 007D,E01033454,1637,312,1325
2021,Brent 031G,E01033455,1051,232,819
2021,Brent 027F,E01033456,2499,825,1674
2021,Brent 035A,E01033457,1861,376,1485
2021,Braintree 009E,E01033458,1496,216,1280
2021,Braintree 009F,E01033459,1657,247,1410
2021,Braintree 017F,E01033460,1887,391,1496
2021,Braintree 017G,E01033461,1383,341,1042
2021,Braintree 017H,E01033462,966,161,805
2021,Brent 003G,E01033463,3010,584,2426
2021,Hartlepool 001F,E01033465,1853,489,1364
2021,Hartlepool 003I,E01033466,2120,545,1575
2021,Hartlepool 001G,E01033467,2116,441,1675
2021,Middlesbrough 006E,E01033469,2034,572,1462
2021,Redcar and Cleveland 022G,E01033470,1743,353,1390
2021,Redcar and Cleveland 009F,E01033471,1955,539,1416
2021,Redcar and Cleveland 019G,E01033472,2277,474,1803
2021,Redcar and Cleveland 013E,E01033473,2075,501,1574
2021,Stockton-on-Tees 027C,E01033474,2524,785,1739
2021,Stockton-on-Tees 028A,E01033475,1792,593,1199
2021,Stockton-on-Tees 005F,E01033476,1845,399,1446
2021,Stockton-on-Tees 027A,E01033479,1675,456,1219
2021,Stockton-on-Tees 005G,E01033480,2741,536,2205
2021,Darlington 001E,E01033481,1634,351,1283
2021,Darlington 001F,E01033482,1572,295,1277
2021,Brent 031H,E01033485,1561,341,1220
2021,Islington 011E,E01033486,992,252,740
2021,Islington 011F,E01033487,1137,169,968
2021,Islington 011G,E01033488,1583,501,1082
2021,Islington 022G,E01033489,1402,392,1010
2021,Islington 022H,E01033490,1348,459,889
2021,Islington 011H,E01033491,1840,270,1570
2021,Islington 006F,E01033493,1242,83,1159
2021,Islington 006G,E01033494,1455,260,1195
2021,East Riding of Yorkshire 032G,E01033495,1419,388,1031
2021,East Riding of Yorkshire 032H,E01033496,1514,290,1224
2021,Milton Keynes 023E,E01033497,1437,244,1193
2021,Milton Keynes 023F,E01033498,1789,419,1370
2021,Milton Keynes 014E,E01033499,1937,289,1648
2021,Milton Keynes 014F,E01033500,1382,194,1188
2021,Milton Keynes 016E,E01033501,2029,607,1422
2021,Milton Keynes 033A,E01033503,2423,689,1734
2021,Milton Keynes 016F,E01033506,1964,531,1433
2021,Milton Keynes 034C,E01033508,2607,849,1758
2021,Milton Keynes 033B,E01033511,1631,458,1173
2021,Milton Keynes 025E,E01033514,1658,502,1156
2021,Milton Keynes 025F,E01033515,2009,599,1410
2021,Milton Keynes 025G,E01033517,1524,426,1098
2021,Milton Keynes 028E,E01033519,2761,854,1907
2021,Milton Keynes 028F,E01033520,1765,445,1320
2021,Milton Keynes 036E,E01033522,1788,524,1264
2021,Milton Keynes 036D,E01033523,1389,390,999
2021,Shropshire 038H,E01033526,1019,94,925
2021,Shropshire 038I,E01033527,1236,82,1154
2021,Shropshire 006H,E01033528,2243,335,1908
2021,Shropshire 030E,E01033530,1827,239,1588
2021,South Derbyshire 002F,E01033532,1451,319,1132
2021,South Derbyshire 002G,E01033533,1524,411,1113
2021,South Derbyshire 002H,E01033534,960,204,756
2021,South Derbyshire 013D,E01033535,1415,289,1126
2021,South Derbyshire 012D,E01033536,1712,366,1346
2021,South Derbyshire 012E,E01033537,1534,263,1271
2021,South Norfolk 015G,E01033539,2001,352,1649
2021,South Norfolk 016E,E01033540,1443,222,1221
2021,South Norfolk 015H,E01033541,1369,186,1183
2021,Newcastle upon Tyne 036C,E01033543,1808,1088,720
2021,Newcastle upon Tyne 036D,E01033545,2024,838,1186
2021,Newcastle upon Tyne 025E,E01033547,2496,578,1918
2021,Newcastle upon Tyne 037C,E01033548,1434,469,965
2021,Newcastle upon Tyne 002F,E01033550,1957,576,1381
2021,Newcastle upon Tyne 002G,E01033551,1738,298,1440
2021,Newcastle upon Tyne 037B,E01033553,2971,2199,772
2021,Newcastle upon Tyne 022H,E01033556,2511,1159,1352
2021,Birmingham 134B,E01033557,2070,855,1215
2021,Birmingham 049E,E01033559,1436,193,1243
2021,Birmingham 050E,E01033561,2504,1958,546
2021,Birmingham 087F,E01033562,2433,906,1527
2021,Birmingham 136C,E01033564,1126,191,935
2021,Birmingham 137B,E01033565,1377,230,1147
2021,Birmingham 135B,E01033567,1076,392,684
2021,Kingston upon Thames 004G,E01033569,1719,411,1308
2021,Richmond upon Thames 004G,E01033570,1749,361,1388
2021,Richmond upon Thames 004H,E01033571,1415,276,1139
2021,Newham 040C,E01033579,1811,279,1532
2021,Newham 042A,E01033580,1314,206,1108
2021,Newham 041A,E01033581,1769,454,1315
2021,Newham 041B,E01033582,1323,235,1088
2021,Newham 034I,E01033584,1618,477,1141
2021,Newham 040D,E01033586,2006,420,1586
2021,Barking and Dagenham 021E,E01033587,2153,571,1582
2021,Redbridge 039B,E01033589,1724,518,1206
2021,Redbridge 037C,E01033590,1090,352,738
2021,Redbridge 039A,E01033591,2679,756,1923
2021,Redbridge 037D,E01033592,1867,530,1337
2021,Westminster 015F,E01033593,1645,442,1203
2021,Westminster 015G,E01033594,1456,412,1044
2021,Westminster 023F,E01033597,963,150,813
2021,Westminster 009F,E01033598,1324,373,951
2021,Westminster 023G,E01033599,1258,368,890
2021,Westminster 009G,E01033601,1807,421,1386
2021,Westminster 009H,E01033602,1451,414,1037
2021,Westminster 009I,E01033603,1205,271,934
2021,Westminster 009J,E01033604,1132,237,895
2021,Westminster 009K,E01033605,1554,383,1171
2021,East Hertfordshire 010E,E01033609,2475,460,2015
2021,Thurrock 019B,E01033610,1576,459,1117
2021,Thurrock 019C,E01033611,1584,436,1148
2021,Thurrock 020D,E01033612,1497,375,1122
2021,Thurrock 019D,E01033613,1480,360,1120
2021,Thurrock 020E,E01033614,1735,504,1231
2021,Birmingham 135C,E01033615,1061,324,737
2021,Birmingham 135D,E01033616,1199,272,927
2021,Birmingham 050F,E01033617,5621,4781,840
2021,Birmingham 137C,E01033618,1196,163,1033
2021,Birmingham 138A,E01033620,1058,245,813
2021,Birmingham 138B,E01033622,1824,411,1413
2021,Birmingham 138C,E01033623,1444,165,1279
2021,Birmingham 134C,E01033624,1490,343,1147
2021,Birmingham 138D,E01033625,1655,417,1238
2021,Birmingham 134D,E01033626,1109,291,818
2021,Birmingham 137E,E01033627,1068,294,774
2021,Birmingham 106F,E01033629,2389,721,1668
2021,Birmingham 031H,E01033630,1143,225,918
2021,Birmingham 049F,E01033638,1781,663,1118
2021,Birmingham 134E,E01033640,1867,593,1274
2021,Birmingham 063F,E01033642,3136,1152,1984
2021,Birmingham 082F,E01033643,3021,1064,1957
2021,Birmingham 031I,E01033646,1705,305,1400
2021,Birmingham 084F,E01033648,2537,722,1815
2021,Birmingham 058F,E01033649,1922,794,1128
2021,Birmingham 077F,E01033650,2610,864,1746
2021,Manchester 054B,E01033651,1657,249,1408
2021,Manchester 055B,E01033653,1832,438,1394
2021,Manchester 055C,E01033654,1780,1072,708
2021,Manchester 056B,E01033655,1240,110,1130
2021,Manchester 057B,E01033656,2709,2050,659
2021,Manchester 054C,E01033658,1381,415,966
2021,Manchester 059B,E01033660,1427,118,1309
2021,Manchester 055E,E01033661,1972,162,1810
2021,Manchester 057C,E01033662,1998,1047,951
2021,Manchester 054D,E01033664,1792,391,1401
2021,Manchester 056C,E01033665,1484,153,1331
2021,Manchester 054E,E01033667,1475,257,1218
2021,Manchester 015F,E01033668,1089,199,890
2021,Manchester 015G,E01033669,1333,315,1018
2021,Manchester 039E,E01033670,1376,138,1238
2021,Manchester 039F,E01033671,1680,188,1492
2021,Manchester 059C,E01033672,1622,305,1317
2021,Manchester 059D,E01033673,1431,163,1268
2021,Manchester 058C,E01033674,2011,296,1715
2021,Manchester 058D,E01033675,2009,643,1366
2021,Manchester 056D,E01033676,1840,573,1267
2021,Manchester 060A,E01033677,990,255,735
2021,Manchester 009F,E01033678,1652,592,1060
2021,Manchester 009G,E01033679,1302,341,961
2021,Manchester 028E,E01033680,1189,202,987
2021,Manchester 060B,E01033681,1308,123,1185
2021,Manchester 060C,E01033682,1205,123,1082
2021,Manchester 062D,E01033684,1791,204,1587
2021,Manchester 003F,E01033685,1477,386,1091
2021,Manchester 028F,E01033686,1244,235,1009
2021,Manchester 003G,E01033687,1287,167,1120
2021,Manchester 062B,E01033688,1598,399,1199
2021,Bradford 020E,E01033689,1200,107,1093
2021,Bradford 065C,E01033690,1715,317,1398
2021,Bradford 065B,E01033691,2101,592,1509
2021,Bradford 064D,E01033692,1048,213,835
2021,Bradford 064A,E01033693,2636,849,1787
2021,Bradford 020F,E01033694,1006,147,859
2021,Bradford 049H,E01033695,2010,544,1466
2021,Bradford 049I,E01033696,1527,294,1233
2021,Bradford 049J,E01033697,2588,813,1775
2021,Hackney 030A,E01033699,1344,139,1205
2021,Hackney 030B,E01033700,2401,267,2134
2021,Hackney 028C,E01033702,1316,364,952
2021,Hackney 010F,E01033703,1343,258,1085
2021,Hackney 023F,E01033704,2260,338,1922
2021,Hackney 028D,E01033705,1350,349,1001
2021,Hackney 033B,E01033706,1408,247,1161
2021,Hackney 033C,E01033708,1839,404,1435
2021,Hackney 032B,E01033709,1706,321,1385
2021,Hackney 028E,E01033710,1075,246,829
2021,Hackney 032C,E01033711,1876,613,1263
2021,Hackney 023G,E01033712,1467,278,1189
2021,Hackney 010G,E01033713,1246,174,1072
2021,Northumberland 033F,E01033714,2800,487,2313
2021,Northumberland 005D,E01033715,1025,126,899
2021,Northumberland 013F,E01033716,2170,438,1732
2021,Northumberland 005E,E01033717,1490,201,1289
2021,Northumberland 016F,E01033718,1873,338,1535
2021,Colchester 008G,E01033719,1992,1447,545
2021,Colchester 002F,E01033720,1911,522,1389
2021,Colchester 002G,E01033721,1655,464,1191
2021,Colchester 008H,E01033722,1569,776,793
2021,Greenwich 035B,E01033727,2576,921,1655
2021,Greenwich 035C,E01033728,1664,226,1438
2021,Greenwich 030E,E01033729,2353,1029,1324
2021,Greenwich 041E,E01033732,1003,211,792
2021,Greenwich 039B,E01033734,1369,247,1122
2021,Greenwich 042D,E01033735,1145,214,931
2021,Greenwich 039A,E01033736,2116,174,1942
2021,Greenwich 042B,E01033737,1806,399,1407
2021,Greenwich 037D,E01033738,1725,345,1380
2021,Greenwich 002E,E01033739,1546,415,1131
2021,Greenwich 002F,E01033740,1497,452,1045
2021,Greenwich 002G,E01033741,2569,473,2096
2021,Greenwich 007F,E01033742,1241,238,1003
2021,Greenwich 002H,E01033743,1796,586,1210
2021,Greenwich 007G,E01033744,1681,449,1232
2021,Greenwich 002I,E01033745,1638,514,1124
2021,Greenwich 038E,E01033746,1360,218,1142
2021,Liverpool 018F,E01033747,1767,396,1371
2021,Liverpool 050I,E01033748,1167,106,1061
2021,Liverpool 061A,E01033750,2145,525,1620
2021,Liverpool 062A,E01033751,2460,1188,1272
2021,Liverpool 061C,E01033756,993,248,745
2021,Liverpool 037E,E01033757,1285,793,492
2021,Liverpool 060B,E01033758,1941,1372,569
2021,Liverpool 060C,E01033760,2473,1967,506
2021,Liverpool 060D,E01033761,2128,925,1203
2021,Liverpool 060E,E01033762,3655,2893,762
2021,Liverpool 031G,E01033763,2364,827,1537
2021,Liverpool 061D,E01033765,1431,297,1134
2021,Liverpool 050J,E01033767,929,156,773
2021,Liverpool 037F,E01033768,1113,196,917
2021,Bassetlaw 014F,E01033769,1906,311,1595
2021,Newark and Sherwood 001G,E01033770,1226,173,1053
2021,Newark and Sherwood 001H,E01033771,1229,123,1106
2021,Newark and Sherwood 002F,E01033772,1240,235,1005
2021,Newark and Sherwood 002G,E01033773,1457,366,1091
2021,Newark and Sherwood 002H,E01033774,1335,282,1053
2021,Mansfield 007G,E01033775,1586,391,1195
2021,Mansfield 007H,E01033776,1449,290,1159
2021,Newark and Sherwood 012H,E01033777,1369,345,1024
2021,Ashfield 013F,E01033778,1256,352,904
2021,Ashfield 013G,E01033779,1168,225,943
2021,Newark and Sherwood 012I,E01033780,1542,389,1153
2021,Ashfield 013H,E01033781,1155,152,1003
2021,Ashfield 013I,E01033782,1300,234,1066
2021,Ashfield 013J,E01033783,1318,263,1055
2021,Havering 007F,E01033784,1433,251,1182
2021,Havering 007G,E01033785,1218,153,1065
2021,Havering 017G,E01033786,1163,254,909
2021,Havering 017H,E01033787,1323,331,992
2021,Havering 017I,E01033788,1452,339,1113
2021,Bexley 008H,E01033789,1592,453,1139
2021,Bexley 008I,E01033790,1254,333,921
2021,Bexley 019G,E01033791,1268,258,1010
2021,Bexley 019H,E01033792,1297,247,1050
2021,St. Helens 013D,E01033793,1139,170,969
2021,St. Helens 013E,E01033794,1593,326,1267
2021,St. Helens 022G,E01033795,1422,329,1093
2021,St. Helens 022H,E01033796,1546,295,1251
2021,Sefton 004H,E01033797,1101,81,1020
2021,Sefton 004I,E01033798,1005,111,894
2021,Sefton 018G,E01033799,1321,254,1067
2021,Sefton 018H,E01033800,1621,212,1409
2021,Luton 022C,E01033801,1675,379,1296
2021,Luton 022D,E01033802,1469,332,1137
2021,Luton 023A,E01033803,1451,406,1045
2021,Luton 023B,E01033804,1085,229,856
2021,Luton 023C,E01033805,1193,293,900
2021,Luton 021G,E01033806,1367,479,888
2021,Luton 021H,E01033807,1611,432,1179
2021,Central Bedfordshire 006E,E01033808,1192,237,955
2021,Central Bedfordshire 006F,E01033809,1276,271,1005
2021,Central Bedfordshire 006G,E01033810,1365,257,1108
2021,Central Bedfordshire 006H,E01033811,1418,267,1151
2021,Central Bedfordshire 006I,E01033812,1229,222,1007
2021,Central Bedfordshire 006J,E01033813,1085,187,898
2021,Central Bedfordshire 007H,E01033814,1793,1021,772
2021,Central Bedfordshire 007I,E01033815,1216,303,913
2021,Central Bedfordshire 007J,E01033816,1197,233,964
2021,Central Bedfordshire 008F,E01033817,1402,252,1150
2021,Central Bedfordshire 008G,E01033818,1361,258,1103
2021,Central Bedfordshire 009F,E01033819,1507,339,1168
2021,Central Bedfordshire 009G,E01033820,1568,302,1266
2021,Central Bedfordshire 009H,E01033821,1164,216,948
2021,Central Bedfordshire 009I,E01033822,1246,312,934
2021,Central Bedfordshire 009J,E01033823,960,198,762
2021,Central Bedfordshire 017F,E01033824,1593,408,1185
2021,Central Bedfordshire 017G,E01033825,1580,270,1310
2021,Central Bedfordshire 019F,E01033826,1041,161,880
2021,Central Bedfordshire 019G,E01033827,1885,279,1606
2021,Central Bedfordshire 024H,E01033828,1193,218,975
2021,Central Bedfordshire 024I,E01033829,1116,220,896
2021,Central Bedfordshire 024J,E01033830,992,172,820
2021,Central Bedfordshire 024K,E01033831,953,166,787
2021,Central Bedfordshire 024L,E01033832,1088,231,857
2021,Central Bedfordshire 024M,E01033833,1391,383,1008
2021,Central Bedfordshire 028G,E01033834,1474,326,1148
2021,Central Bedfordshire 028H,E01033835,1364,318,1046
2021,Central Bedfordshire 029F,E01033836,1540,264,1276
2021,Central Bedfordshire 029G,E01033837,1431,246,1185
2021,Reading 020C,E01033838,1277,315,962
2021,Reading 020D,E01033839,1615,660,955
2021,Swindon 008E,E01033840,1423,379,1044
2021,Swindon 008F,E01033841,1333,307,1026
2021,Swindon 008G,E01033842,1430,375,1055
2021,Swindon 008H,E01033843,1274,195,1079
2021,Swindon 008I,E01033844,1459,387,1072
2021,Swindon 015E,E01033845,1578,264,1314
2021,Swindon 015F,E01033846,1468,231,1237
2021,Swindon 024E,E01033847,1565,255,1310
2021,Swindon 024F,E01033848,1808,461,1347
2021,Swindon 025G,E01033849,1995,463,1532
2021,Swindon 025H,E01033850,2043,452,1591
2021,West Berkshire 007F,E01033851,3137,1005,2132
2021,West Berkshire 019E,E01033852,1502,262,1240
2021,West Berkshire 019F,E01033853,1639,313,1326
2021,West Berkshire 019G,E01033854,1489,201,1288
2021,West Berkshire 019H,E01033855,1120,112,1008
2021,West Berkshire 019I,E01033856,1028,95,933
2021,Reading 017G,E01033857,2000,467,1533
2021,Reading 017H,E01033858,1548,322,1226
2021,Reading 017I,E01033859,1279,141,1138
2021,Swindon 028F,E01033860,1707,398,1309
2021,Swindon 028G,E01033861,1707,351,1356
2021,Lambeth 003F,E01033862,1356,340,1016
2021,Lambeth 003G,E01033863,1263,262,1001
2021,Lambeth 004H,E01033864,986,170,816
2021,Lambeth 004I,E01033865,1485,493,992
2021,Lambeth 004J,E01033866,1087,294,793
2021,Southwark 002F,E01033867,1497,539,958
2021,Southwark 002G,E01033868,1368,551,817
2021,Southwark 004F,E01033869,1375,375,1000
2021,Southwark 004G,E01033870,1684,255,1429
2021,Southwark 004H,E01033871,1433,278,1155
2021,Southwark 004I,E01033872,1247,215,1032
2021,Southwark 009G,E01033873,1661,573,1088
2021,Southwark 009H,E01033874,1117,363,754
2021,Southwark 012G,E01033875,1243,255,988
2021,Southwark 012H,E01033876,1207,224,983
2021,Southwark 012I,E01033877,1457,259,1198
2021,Southwark 015F,E01033878,1043,291,752
2021,Southwark 015G,E01033879,2365,765,1600
2021,Southwark 015H,E01033880,1995,392,1603
2021,Southwark 016F,E01033881,1795,478,1317
2021,Southwark 022G,E01033882,1330,280,1050
2021,Southwark 022H,E01033883,1530,341,1189
2021,Southwark 035A,E01033884,1066,189,877
2021,Southwark 036A,E01033885,1278,287,991
2021,Sandwell 014F,E01033886,1500,399,1101
2021,Sandwell 014G,E01033887,1444,353,1091
2021,Sandwell 018F,E01033888,1424,392,1032
2021,Sandwell 018G,E01033889,1816,552,1264
2021,Sandwell 040B,E01033890,1344,520,824
2021,Sandwell 040C,E01033891,1507,588,919
2021,Sandwell 041A,E01033892,1884,687,1197
2021,Sandwell 041C,E01033893,1501,517,984
2021,Walsall 013F,E01033894,1637,593,1044
2021,Walsall 013G,E01033895,1492,479,1013
2021,Walsall 030F,E01033896,1436,392,1044
2021,Walsall 030G,E01033897,1302,431,871
2021,Bradford 030E,E01033898,1397,446,951
2021,Bradford 030F,E01033899,1420,608,812
2021,Bradford 044G,E01033900,1454,548,906
2021,Bradford 044H,E01033901,1517,486,1031
2021,Bristol 054F,E01033902,1266,149,1117
2021,Bristol 054G,E01033903,1122,429,693
2021,Bristol 060B,E01033904,2355,1743,612
2021,Bristol 060C,E01033905,1370,932,438
2021,Bristol 060E,E01033906,1079,163,916
2021,Bristol 061A,E01033907,1801,1106,695
2021,Bristol 061B,E01033908,1464,939,525
2021,Bristol 061C,E01033909,2127,1481,646
2021,Bristol 061E,E01033910,1315,278,1037
2021,Barnet 017E,E01033911,1778,383,1395
2021,Barnet 017F,E01033912,1541,399,1142
2021,Barnet 024G,E01033913,1430,435,995
2021,Barnet 024H,E01033914,1655,442,1213
2021,Barnet 042A,E01033915,1354,457,897
2021,Barnet 042B,E01033916,1666,364,1302
2021,Barnet 042C,E01033917,1418,286,1132
2021,Barnet 042D,E01033918,1469,495,974
2021,Barnet 042E,E01033919,1234,217,1017
2021,Barnet 042F,E01033920,1379,212,1167
2021,Barnet 043A,E01033921,1530,392,1138
2021,Barnet 043B,E01033922,1559,354,1205
2021,Barnet 043C,E01033923,1451,377,1074
2021,Barnet 043D,E01033924,1447,391,1056
2021,Barnet 043E,E01033925,1604,367,1237
2021,Enfield 014E,E01033926,2396,728,1668
2021,Enfield 020F,E01033927,1529,350,1179
2021,Enfield 020G,E01033928,1220,239,981
2021,Brent 002F,E01033929,1225,276,949
2021,Brent 002G,E01033930,1739,365,1374
2021,Brent 009F,E01033931,1264,330,934
2021,Brent 009G,E01033932,1590,394,1196
2021,Brent 010G,E01033933,1382,451,931
2021,Brent 010H,E01033934,1550,501,1049
2021,Brent 020F,E01033935,1903,402,1501
2021,Brent 020G,E01033936,1545,336,1209
2021,Brent 027G,E01033937,1102,257,845
2021,Brent 027H,E01033938,1143,273,870
2021,Brent 027I,E01033939,1693,346,1347
2021,Brent 035B,E01033940,2252,1103,1149
2021,Brent 035C,E01033941,1464,339,1125
2021,Brent 035D,E01033942,1520,528,992
2021,Haringey 015E,E01033943,2364,777,1587
2021,Haringey 015F,E01033944,2388,1054,1334
2021,Haringey 020G,E01033945,1297,204,1093
2021,Haringey 020H,E01033946,1266,180,1086
2021,Stockport 014E,E01033947,1455,200,1255
2021,Stockport 014F,E01033948,1247,150,1097
2021,Tameside 013F,E01033949,1114,236,878
2021,Tameside 013G,E01033950,1291,289,1002
2021,Buckinghamshire 001C,E01033951,1553,702,851
2021,Buckinghamshire 001D,E01033952,1361,259,1102
2021,Buckinghamshire 001E,E01033953,1525,496,1029
2021,Buckinghamshire 001F,E01033954,1644,363,1281
2021,Buckinghamshire 007E,E01033955,1330,230,1100
2021,Buckinghamshire 007F,E01033956,1481,315,1166
2021,Buckinghamshire 007G,E01033957,954,195,759
2021,Buckinghamshire 009F,E01033958,1462,441,1021
2021,Buckinghamshire 009G,E01033959,1391,404,987
2021,Buckinghamshire 011D,E01033960,1479,315,1164
2021,Buckinghamshire 011E,E01033961,1510,390,1120
2021,Buckinghamshire 011F,E01033962,1483,442,1041
2021,Buckinghamshire 011G,E01033963,1403,389,1014
2021,Buckinghamshire 011H,E01033964,1345,349,996
2021,Buckinghamshire 021F,E01033965,1396,259,1137
2021,Buckinghamshire 021G,E01033966,1507,349,1158
2021,Buckinghamshire 011I,E01033967,1351,238,1113
2021,Buckinghamshire 024E,E01033968,1833,281,1552
2021,Buckinghamshire 024F,E01033969,1355,341,1014
2021,Buckinghamshire 040D,E01033970,1468,248,1220
2021,Buckinghamshire 040E,E01033971,1616,244,1372
2021,Buckinghamshire 051C,E01033972,1596,373,1223
2021,Buckinghamshire 051D,E01033973,1157,223,934
2021,Buckinghamshire 051E,E01033974,1294,222,1072
2021,Buckinghamshire 051F,E01033975,1291,220,1071
2021,Salford 003D,E01033976,1796,334,1462
2021,Salford 003E,E01033977,1065,178,887
2021,Salford 008E,E01033978,957,210,747
2021,Salford 008F,E01033979,1937,220,1717
2021,Salford 017G,E01033980,958,351,607
2021,Salford 017H,E01033981,2665,1700,965
2021,Salford 021H,E01033982,1751,484,1267
2021,Salford 021I,E01033983,1181,239,942
2021,Salford 024E,E01033984,2226,590,1636
2021,Salford 032A,E01033985,1572,423,1149
2021,Salford 032B,E01033986,1439,359,1080
2021,Salford 033A,E01033987,1109,200,909
2021,Salford 033B,E01033988,1274,226,1048
2021,Salford 033C,E01033989,1115,156,959
2021,Salford 033D,E01033990,1171,285,886
2021,Salford 034A,E01033991,1474,214,1260
2021,Salford 034B,E01033992,1341,194,1147
2021,Salford 036A,E01033993,1758,393,1365
2021,Salford 036B,E01033994,1163,166,997
2021,Salford 037A,E01033995,1172,188,984
2021,Salford 037B,E01033996,1181,145,1036
2021,Salford 037C,E01033997,988,112,876
2021,Salford 037D,E01033998,1298,176,1122
2021,Salford 037E,E01033999,1166,122,1044
2021,Trafford 001G,E01034000,1196,331,865
2021,Trafford 001H,E01034001,1533,363,1170
2021,Charnwood 009G,E01034002,1610,443,1167
2021,Charnwood 009H,E01034003,1447,339,1108
2021,Charnwood 010G,E01034004,1578,383,1195
2021,Charnwood 010H,E01034005,1404,280,1124
2021,Charnwood 019E,E01034006,2268,538,1730
2021,Charnwood 019F,E01034007,1683,280,1403
2021,Leicester 006F,E01034008,1745,430,1315
2021,Leicester 006G,E01034009,1548,331,1217
2021,Leicester 008F,E01034010,1671,334,1337
2021,Leicester 008G,E01034011,1335,272,1063
2021,Leicester 008H,E01034012,1192,512,680
2021,Leicester 023H,E01034013,1884,1233,651
2021,Leicester 023I,E01034014,1414,760,654
2021,Leicester 029E,E01034015,1362,652,710
2021,Leicester 029F,E01034016,1745,555,1190
2021,Leicester 037G,E01034017,1534,436,1098
2021,Leicester 037H,E01034018,1379,360,1019
2021,Leicester 040E,E01034019,1721,877,844
2021,Leicester 040F,E01034020,3432,1977,1455
2021,Leicester 040G,E01034021,1269,764,505
2021,Leicester 041E,E01034022,2780,1790,990
2021,Leicester 041F,E01034023,1189,395,794
2021,Leicester 043A,E01034024,1757,483,1274
2021,Leicester 043B,E01034025,1905,414,1491
2021,Ealing 015F,E01034026,2449,1523,926
2021,Ealing 015G,E01034027,2406,984,1422
2021,Ealing 019F,E01034028,1175,173,1002
2021,Ealing 019G,E01034029,1405,249,1156
2021,Ealing 042A,E01034030,1755,289,1466
2021,Ealing 042B,E01034031,1167,170,997
2021,Hounslow 006G,E01034032,1686,339,1347
2021,Hounslow 006H,E01034033,1629,217,1412
2021,Hounslow 014F,E01034034,1519,352,1167
2021,Hounslow 014G,E01034035,1482,300,1182
2021,Hounslow 015F,E01034036,1666,401,1265
2021,Hounslow 015G,E01034037,1702,399,1303
2021,Hounslow 017F,E01034038,1646,466,1180
2021,Hounslow 017G,E01034039,1548,413,1135
2021,Hounslow 018H,E01034040,1539,380,1159
2021,Hounslow 018I,E01034041,1372,316,1056
2021,Hounslow 030A,E01034042,1113,199,914
2021,Hounslow 030B,E01034043,1350,289,1061
2021,Hounslow 030C,E01034044,1142,182,960
2021,Hounslow 031A,E01034045,1647,294,1353
2021,Hounslow 031B,E01034046,1841,491,1350
2021,Stafford 010F,E01034047,1076,84,992
2021,Stafford 010G,E01034048,964,122,842
2021,Stafford 011F,E01034049,1399,331,1068
2021,Stafford 011G,E01034050,1643,291,1352
2021,Stafford 014I,E01034051,2543,450,2093
2021,Stoke-on-Trent 009F,E01034052,1070,286,784
2021,Stoke-on-Trent 009G,E01034053,1320,295,1025
2021,Stoke-on-Trent 016H,E01034054,970,193,777
2021,Stoke-on-Trent 016I,E01034055,1166,171,995
2021,Stoke-on-Trent 016J,E01034056,1414,234,1180
2021,Stoke-on-Trent 016K,E01034057,1347,305,1042
2021,Stoke-on-Trent 032E,E01034058,1626,396,1230
2021,Stoke-on-Trent 032F,E01034059,1897,474,1423
2021,Gosport 004H,E01034060,1949,468,1481
2021,Gosport 004I,E01034061,1040,266,774
2021,Gosport 005F,E01034062,1325,229,1096
2021,Gosport 005G,E01034063,1117,160,957
2021,Gosport 008H,E01034064,1297,218,1079
2021,Gosport 008I,E01034065,986,129,857
2021,Havant 014G,E01034066,947,129,818
2021,Havant 014H,E01034067,1330,161,1169
2021,Allerdale 012F,E01034068,2046,279,1767
2021,Barrow-in-Furness 007G,E01034069,1885,377,1508
2021,Carlisle 013F,E01034070,1055,211,844
2021,Carlisle 013G,E01034071,1457,298,1159
2021,Carlisle 013H,E01034072,1145,202,943
2021,Carlisle 013I,E01034073,1342,192,1150
2021,Carlisle 013J,E01034074,1683,297,1386
2021,Copeland 001E,E01034075,2270,302,1968
2021,Copeland 004J,E01034076,1934,302,1632
2021,South Lakeland 002F,E01034077,2012,321,1691
2021,South Lakeland 006H,E01034078,1170,202,968
2021,South Lakeland 006I,E01034079,1706,268,1438
2021,South Lakeland 011F,E01034080,2453,278,2175
2021,Chelmsford 001E,E01034081,1538,285,1253
2021,Chelmsford 001F,E01034082,1476,395,1081
2021,Chelmsford 004G,E01034083,1329,342,987
2021,Chelmsford 004H,E01034084,1682,342,1340
2021,Chelmsford 018F,E01034085,1452,99,1353
2021,Chelmsford 018G,E01034086,1631,267,1364
2021,Chelmsford 021D,E01034087,1359,138,1221
2021,Chelmsford 021E,E01034088,1454,295,1159
2021,Chelmsford 022A,E01034089,2143,715,1428
2021,Chelmsford 022C,E01034090,1227,153,1074
2021,Chelmsford 023A,E01034091,1211,158,1053
2021,Chelmsford 023B,E01034092,1159,169,990
2021,Maldon 008H,E01034093,1598,278,1320
2021,Maldon 008I,E01034094,1500,264,1236
2021,Southend-on-Sea 010G,E01034095,1416,161,1255
2021,Southend-on-Sea 010H,E01034096,1552,381,1171
2021,Cannock Chase 005E,E01034097,1079,213,866
2021,Cannock Chase 005F,E01034098,2143,406,1737
2021,Lichfield 001E,E01034099,1571,362,1209
2021,Lichfield 001F,E01034100,1487,187,1300
2021,Lichfield 002E,E01034101,1822,401,1421
2021,Lichfield 002F,E01034102,1551,348,1203
2021,Lichfield 006F,E01034103,1175,208,967
2021,Lichfield 006G,E01034104,1730,338,1392
2021,Lichfield 008E,E01034105,1398,218,1180
2021,Lichfield 008F,E01034106,1681,314,1367
2021,Manchester 002F,E01034107,1298,309,989
2021,Manchester 002G,E01034108,1909,517,1392
2021,Manchester 008G,E01034109,1381,432,949
2021,Manchester 008H,E01034110,1356,451,905
2021,Manchester 017G,E01034111,1451,492,959
2021,Manchester 017H,E01034112,1719,502,1217
2021,Manchester 017I,E01034113,1360,416,944
2021,Manchester 017J,E01034114,1765,417,1348
2021,Manchester 018F,E01034115,1815,1145,670
2021,Manchester 018G,E01034116,1047,422,625
2021,Manchester 019E,E01034117,2148,1623,525
2021,Manchester 019F,E01034118,960,255,705
2021,Manchester 022H,E01034119,2565,1408,1157
2021,Manchester 023F,E01034120,1646,628,1018
2021,Manchester 023G,E01034121,1300,475,825
2021,Manchester 024E,E01034122,1726,700,1026
2021,Manchester 024F,E01034123,1610,557,1053
2021,Manchester 025F,E01034124,1414,569,845
2021,Manchester 025G,E01034125,1386,528,858
2021,Manchester 025H,E01034126,1513,530,983
2021,Manchester 025I,E01034127,1249,344,905
2021,Manchester 032F,E01034128,3601,2218,1383
2021,Manchester 055F,E01034129,1074,116,958
2021,Manchester 055G,E01034130,1377,229,1148
2021,Manchester 060E,E01034131,1012,278,734
2021,Manchester 060F,E01034132,1806,642,1164
2021,Manchester 061C,E01034133,1792,330,1462
2021,Manchester 061D,E01034134,1177,67,1110
2021,Manchester 062A,E01034135,1071,85,986
2021,Manchester 062C,E01034136,992,94,898
2021,Manchester 063C,E01034137,1580,547,1033
2021,Manchester 064B,E01034138,1248,424,824
2021,Croydon 015F,E01034139,1685,426,1259
2021,Croydon 015G,E01034140,1129,264,865
2021,Croydon 020F,E01034141,1275,257,1018
2021,Croydon 020G,E01034142,1334,257,1077
2021,Croydon 020H,E01034143,1206,175,1031
2021,Croydon 024F,E01034144,1203,222,981
2021,Croydon 024G,E01034145,1205,287,918
2021,Croydon 024H,E01034146,1290,329,961
2021,Croydon 046A,E01034147,1061,102,959
2021,Croydon 046B,E01034148,1535,179,1356
2021,Croydon 046C,E01034149,1980,280,1700
2021,Croydon 046D,E01034150,1227,213,1014
2021,Croydon 046E,E01034151,1096,182,914
2021,Croydon 047B,E01034152,1449,303,1146
2021,Sutton 004F,E01034153,1306,284,1022
2021,Sutton 004G,E01034154,1359,235,1124
2021,Sutton 012F,E01034155,1886,448,1438
2021,Sutton 012G,E01034156,1283,205,1078
2021,Plymouth 031G,E01034157,1690,390,1300
2021,Plymouth 031H,E01034158,1071,183,888
2021,Plymouth 034B,E01034159,1113,117,996
2021,Plymouth 034C,E01034160,1422,173,1249
2021,Plymouth 034D,E01034161,1186,147,1039
2021,Plymouth 034E,E01034162,1008,121,887
2021,Teignbridge 005E,E01034165,1478,174,1304
2021,Teignbridge 005F,E01034166,1742,304,1438
2021,Teignbridge 013E,E01034167,1807,379,1428
2021,Teignbridge 013F,E01034168,1572,347,1225
2021,Torbay 003G,E01034169,1442,326,1116
2021,Torbay 003H,E01034170,1300,243,1057
2021,Torbay 013H,E01034171,1110,211,899
2021,Torbay 013I,E01034172,1827,481,1346
2021,Greenwich 005F,E01034173,1741,455,1286
2021,Greenwich 034F,E01034174,1159,173,986
2021,Greenwich 034G,E01034175,1207,111,1096
2021,Greenwich 034H,E01034176,1947,544,1403
2021,Greenwich 034I,E01034177,1479,360,1119
2021,Greenwich 035E,E01034178,1571,286,1285
2021,Greenwich 035F,E01034179,1361,432,929
2021,Greenwich 035G,E01034180,1194,362,832
2021,Greenwich 035H,E01034181,1715,499,1216
2021,Greenwich 035I,E01034182,1330,207,1123
2021,Greenwich 037E,E01034183,1382,252,1130
2021,Greenwich 037F,E01034184,1179,260,919
2021,Greenwich 037G,E01034185,1113,145,968
2021,Greenwich 039C,E01034186,1299,114,1185
2021,Greenwich 039D,E01034187,1190,141,1049
2021,Greenwich 040A,E01034188,1275,214,1061
2021,Greenwich 040B,E01034189,1116,145,971
2021,Greenwich 040C,E01034190,1590,392,1198
2021,Greenwich 040D,E01034191,1512,242,1270
2021,Greenwich 040E,E01034192,2112,322,1790
2021,Greenwich 041A,E01034193,1369,290,1079
2021,Greenwich 041B,E01034194,1212,194,1018
2021,Greenwich 041C,E01034195,1203,446,757
2021,Greenwich 041D,E01034196,1188,201,987
2021,Greenwich 042C,E01034198,2156,499,1657
2021,Newham 012E,E01034199,1676,374,1302
2021,Newham 012F,E01034200,1501,304,1197
2021,Newham 022E,E01034201,1348,427,921
2021,Newham 022F,E01034202,1538,418,1120
2021,Newham 025E,E01034203,1226,233,993
2021,Newham 025F,E01034204,1822,523,1299
2021,Newham 033E,E01034205,1431,365,1066
2021,Newham 033F,E01034206,1635,418,1217
2021,Newham 033G,E01034207,1395,208,1187
2021,Newham 034J,E01034208,1807,542,1265
2021,Newham 034K,E01034209,1420,219,1201
2021,Newham 034L,E01034210,1452,220,1232
2021,Newham 034M,E01034211,1382,138,1244
2021,Newham 034N,E01034212,1804,190,1614
2021,Newham 038A,E01034213,1618,389,1229
2021,Newham 038B,E01034214,1499,273,1226
2021,Newham 038C,E01034215,1464,316,1148
2021,Newham 038D,E01034216,1648,387,1261
2021,Newham 038E,E01034217,1968,692,1276
2021,Newham 039B,E01034218,1685,382,1303
2021,Newham 039C,E01034219,1775,588,1187
2021,Newham 039D,E01034220,1204,264,940
2021,Newham 039E,E01034221,1713,514,1199
2021,Newham 040A,E01034222,1433,272,1161
2021,Newham 040B,E01034223,1292,184,1108
2021,Newham 041D,E01034224,1635,440,1195
2021,Newham 042B,E01034225,1381,286,1095
2021,Newham 042C,E01034226,1303,260,1043
2021,Newham 042D,E01034227,1378,410,968
2021,Newham 042E,E01034228,1234,147,1087
2021,Newham 042F,E01034229,1327,224,1103
2021,Newham 042G,E01034230,1176,81,1095
2021,Newham 042H,E01034231,1228,114,1114
2021,Oldham 036A,E01034232,1532,528,1004
2021,Oldham 036B,E01034233,1466,422,1044
2021,Rochdale 008H,E01034234,1614,507,1107
2021,Rochdale 008I,E01034235,1531,470,1061
2021,Doncaster 019G,E01034236,1060,143,917
2021,Doncaster 019H,E01034237,1011,128,883
2021,Doncaster 022G,E01034238,1146,117,1029
2021,Doncaster 022H,E01034239,1379,276,1103
2021,Doncaster 027E,E01034240,1379,232,1147
2021,Doncaster 027F,E01034241,1283,236,1047
2021,Doncaster 028E,E01034242,1596,419,1177
2021,Doncaster 028F,E01034243,1807,339,1468
2021,Doncaster 038D,E01034244,1036,241,795
2021,Doncaster 038E,E01034245,1723,416,1307
2021,Rotherham 001F,E01034246,1658,322,1336
2021,Rotherham 001G,E01034247,1992,564,1428
2021,Rotherham 027F,E01034248,1367,292,1075
2021,Rotherham 027G,E01034249,1379,229,1150
2021,Rotherham 027H,E01034250,1004,210,794
2021,Rotherham 028E,E01034251,1026,109,917
2021,Rotherham 028F,E01034252,1963,415,1548
2021,Rotherham 034G,E01034253,2256,364,1892
2021,Amber Valley 016E,E01034254,2681,450,2231
2021,Amber Valley 016F,E01034255,1133,261,872
2021,Derby 013G,E01034256,1544,690,854
2021,Derby 013H,E01034257,1519,426,1093
2021,Barnsley 010I,E01034258,1383,257,1126
2021,Barnsley 010J,E01034259,1381,269,1112
2021,Wakefield 002F,E01034260,1302,215,1087
2021,Wakefield 002G,E01034261,1170,150,1020
2021,Wakefield 005E,E01034262,1262,215,1047
2021,Wakefield 005F,E01034263,1407,238,1169
2021,Wakefield 017E,E01034264,1275,183,1092
2021,Wakefield 017F,E01034265,1153,82,1071
2021,Wakefield 024G,E01034266,1517,333,1184
2021,Wakefield 024H,E01034267,1266,221,1045
2021,Wakefield 024I,E01034268,1248,246,1002
2021,Wakefield 034G,E01034269,1439,255,1184
2021,Wakefield 034H,E01034270,1544,314,1230
2021,"Bournemouth, Christchurch and Poole 038E",E01034271,2762,2113,649
2021,"Bournemouth, Christchurch and Poole 038F",E01034272,1212,394,818
2021,"Bournemouth, Christchurch and Poole 038G",E01034273,1190,196,994
2021,"Bournemouth, Christchurch and Poole 038H",E01034274,1530,346,1184
2021,"Bournemouth, Christchurch and Poole 037F",E01034275,1036,130,906
2021,"Bournemouth, Christchurch and Poole 037G",E01034276,1030,171,859
2021,"Bournemouth, Christchurch and Poole 041E",E01034277,2388,1408,980
2021,"Bournemouth, Christchurch and Poole 041F",E01034278,1958,965,993
2021,"Bournemouth, Christchurch and Poole 031E",E01034279,1453,260,1193
2021,"Bournemouth, Christchurch and Poole 031F",E01034280,1034,173,861
2021,"Bournemouth, Christchurch and Poole 044G",E01034281,1121,91,1030
2021,"Bournemouth, Christchurch and Poole 044H",E01034282,1173,197,976
2021,"Bournemouth, Christchurch and Poole 046D",E01034283,1426,240,1186
2021,"Bournemouth, Christchurch and Poole 046E",E01034284,1062,169,893
2021,Elmbridge 007E,E01034285,941,90,851
2021,Elmbridge 007F,E01034286,1477,335,1142
2021,Epsom and Ewell 005E,E01034287,1568,396,1172
2021,Epsom and Ewell 005F,E01034288,1410,328,1082
2021,Epsom and Ewell 008E,E01034289,1369,271,1098
2021,Epsom and Ewell 008F,E01034290,1316,406,910
2021,Spelthorne 004F,E01034291,1410,223,1187
2021,Spelthorne 004G,E01034292,1127,134,993
2021,Woking 004G,E01034293,2687,611,2076
2021,Woking 008F,E01034294,1509,151,1358
2021,Woking 008G,E01034295,1550,195,1355
2021,Woking 011F,E01034296,1158,202,956
2021,Woking 011G,E01034297,1679,554,1125
2021,Eastbourne 012F,E01034298,2188,262,1926
2021,Wealden 018G,E01034299,1406,186,1220
2021,Wealden 018H,E01034300,1461,342,1119
2021,Wealden 018I,E01034301,1053,230,823
2021,Wealden 018J,E01034302,1718,359,1359
2021,Wealden 018K,E01034303,1238,407,831
2021,Wealden 019F,E01034304,1291,127,1164
2021,Wealden 019G,E01034305,1769,431,1338
2021,Dudley 006H,E01034306,1534,549,985
2021,Dudley 006I,E01034307,1585,467,1118
2021,Dudley 011E,E01034308,1285,250,1035
2021,Dudley 011F,E01034309,1182,190,992
2021,Wolverhampton 006E,E01034310,943,263,680
2021,Wolverhampton 006F,E01034311,2062,499,1563
2021,Wolverhampton 020G,E01034312,1815,914,901
2021,Wolverhampton 020H,E01034313,1217,464,753
2021,Wolverhampton 035I,E01034314,1540,428,1112
2021,Wolverhampton 035J,E01034315,1202,354,848
2021,Bromsgrove 013E,E01034316,1249,268,981
2021,Bromsgrove 013F,E01034317,1318,261,1057
2021,Bromsgrove 014H,E01034318,1371,211,1160
2021,Bromsgrove 014I,E01034319,1173,189,984
2021,Redditch 003E,E01034320,1354,331,1023
2021,Redditch 003F,E01034321,1089,205,884
2021,Redditch 003G,E01034322,1334,258,1076
2021,Worcester 013E,E01034323,1623,252,1371
2021,Worcester 013F,E01034324,1449,190,1259
2021,Wychavon 001E,E01034325,1524,262,1262
2021,Wychavon 001F,E01034326,1302,228,1074
2021,Wychavon 005E,E01034327,1605,326,1279
2021,Wychavon 005F,E01034328,1625,358,1267
2021,Wychavon 014D,E01034329,1226,138,1088
2021,Wychavon 014E,E01034330,1235,167,1068
2021,Wyre Forest 004E,E01034331,1029,145,884
2021,Wyre Forest 004F,E01034332,1536,321,1215
2021,Wyre Forest 009D,E01034333,1259,207,1052
2021,Wyre Forest 009E,E01034334,1362,268,1094
2021,Hyndburn 006I,E01034335,1564,577,987
2021,Hyndburn 006J,E01034336,1848,597,1251
2021,Chorley 004E,E01034337,1752,421,1331
2021,Chorley 004F,E01034338,1199,270,929
2021,Chorley 006G,E01034339,2181,394,1787
2021,Chorley 008E,E01034340,1507,327,1180
2021,Chorley 008F,E01034341,1496,352,1144
2021,Chorley 008G,E01034342,1550,408,1142
2021,Chorley 008H,E01034343,1294,306,988
2021,Chorley 012E,E01034344,1621,379,1242
2021,Chorley 012F,E01034345,1192,211,981
2021,Preston 002E,E01034346,1077,198,879
2021,Preston 002F,E01034347,2309,487,1822
2021,South Ribble 005E,E01034348,1837,331,1506
2021,South Ribble 012E,E01034349,1638,258,1380
2021,South Ribble 012F,E01034350,2021,429,1592
2021,South Ribble 016F,E01034351,2821,509,2312
2021,South Ribble 016G,E01034352,1360,327,1033
2021,South Ribble 016H,E01034353,1347,330,1017
2021,Basildon 014F,E01034354,1672,343,1329
2021,Basildon 014G,E01034355,1550,332,1218
2021,Basildon 020F,E01034356,1325,176,1149
2021,Basildon 020G,E01034357,1517,279,1238
2021,Brentwood 007H,E01034358,1122,143,979
2021,Brentwood 007I,E01034359,1330,200,1130
2021,Brentwood 007J,E01034360,1355,185,1170
2021,Brentwood 007K,E01034361,1065,155,910
2021,Harlow 001E,E01034362,1347,243,1104
2021,Harlow 001F,E01034363,1195,176,1019
2021,Harlow 001G,E01034364,1489,369,1120
2021,Harlow 001H,E01034365,1344,316,1028
2021,Harlow 007F,E01034366,1005,173,832
2021,Harlow 007G,E01034367,1570,418,1152
2021,Thurrock 006G,E01034368,1554,344,1210
2021,Thurrock 006H,E01034369,1698,514,1184
2021,Thurrock 022C,E01034370,1675,411,1264
2021,Thurrock 022D,E01034371,1948,523,1425
2021,Dorset 024E,E01034372,1374,234,1140
2021,Dorset 024F,E01034373,1551,306,1245
2021,Dorset 003D,E01034374,1985,552,1433
2021,Dorset 003E,E01034375,1470,210,1260
2021,Dorset 005E,E01034376,1263,245,1018
2021,Dorset 005F,E01034377,1273,157,1116
2021,Dorset 009D,E01034378,2482,537,1945
2021,Dorset 004F,E01034379,1646,554,1092
2021,Dorset 004G,E01034380,1550,295,1255
2021,Dorset 031D,E01034381,1371,193,1178
2021,Dorset 032D,E01034382,1479,248,1231
2021,Bromley 005F,E01034383,1233,253,980
2021,Bromley 005G,E01034384,1192,216,976
2021,Bromley 018F,E01034385,1379,275,1104
2021,Bromley 018G,E01034386,1161,148,1013
2021,Lewisham 001F,E01034387,1510,129,1381
2021,Lewisham 001G,E01034388,1218,170,1048
2021,Lewisham 001H,E01034389,1569,338,1231
2021,Lewisham 020F,E01034390,1360,236,1124
2021,Lewisham 020G,E01034391,1485,288,1197
2021,Lewisham 040A,E01034392,1631,540,1091
2021,Lewisham 040B,E01034393,1042,47,995
2021,Lewisham 040C,E01034394,1184,113,1071
2021,Lewisham 040D,E01034395,1581,457,1124
2021,Liverpool 010G,E01034396,1674,406,1268
2021,Liverpool 010H,E01034397,1644,465,1179
2021,Liverpool 022F,E01034398,1054,255,799
2021,Liverpool 022G,E01034399,1022,184,838
2021,Liverpool 022H,E01034400,1006,218,788
2021,Liverpool 035G,E01034401,3515,1120,2395
2021,Liverpool 037G,E01034402,1085,526,559
2021,Liverpool 037H,E01034403,1187,293,894
2021,Liverpool 042H,E01034404,2139,1400,739
2021,Liverpool 060F,E01034405,2371,1997,374
2021,Liverpool 060G,E01034406,1448,957,491
2021,Liverpool 061E,E01034407,1228,208,1020
2021,Liverpool 061F,E01034408,1254,192,1062
2021,Liverpool 062E,E01034409,1995,359,1636
2021,Liverpool 062F,E01034410,1016,181,835
2021,Liverpool 062G,E01034411,1097,304,793
2021,Bedford 004H,E01034412,1985,418,1567
2021,Bedford 004I,E01034413,1071,259,812
2021,Bedford 008F,E01034414,1422,243,1179
2021,Bedford 008G,E01034415,1374,400,974
2021,Bedford 008H,E01034416,1350,260,1090
2021,Bedford 008I,E01034417,1167,267,900
2021,Bedford 012G,E01034418,1087,129,958
2021,Bedford 012H,E01034419,1207,179,1028
2021,Bedford 015G,E01034420,1768,353,1415
2021,Bedford 015H,E01034421,1413,280,1133
2021,Bedford 018F,E01034422,1415,318,1097
2021,Bedford 018G,E01034423,1020,187,833
2021,Bedford 018H,E01034424,1351,286,1065
2021,Bedford 020E,E01034425,1757,366,1391
2021,Bedford 020F,E01034426,2045,538,1507
2021,Bedford 021A,E01034427,1322,296,1026
2021,Bedford 021C,E01034428,1261,254,1007
2021,Bedford 021D,E01034429,1099,202,897
2021,Bedford 021E,E01034430,972,175,797
2021,Bedford 022A,E01034431,1815,403,1412
2021,Bedford 022B,E01034432,1201,170,1031
2021,Bedford 022C,E01034433,2146,645,1501
2021,Bedford 022D,E01034434,1767,456,1311
2021,Huntingdonshire 010H,E01034435,1505,236,1269
2021,Huntingdonshire 010I,E01034436,1679,324,1355
2021,Huntingdonshire 012F,E01034437,1053,121,932
2021,Huntingdonshire 012G,E01034438,1257,135,1122
2021,Huntingdonshire 014E,E01034439,1232,148,1084
2021,Huntingdonshire 014F,E01034440,1382,304,1078
2021,Huntingdonshire 018E,E01034441,1615,345,1270
2021,Huntingdonshire 018F,E01034442,1598,477,1121
2021,Huntingdonshire 018G,E01034443,1558,381,1177
2021,Huntingdonshire 021G,E01034444,1541,239,1302
2021,Huntingdonshire 021H,E01034445,1551,315,1236
2021,Milton Keynes 002G,E01034446,1425,331,1094
2021,Milton Keynes 002H,E01034447,1219,227,992
2021,Milton Keynes 002I,E01034448,1456,377,1079
2021,Milton Keynes 010E,E01034449,1915,385,1530
2021,Milton Keynes 010F,E01034450,1527,326,1201
2021,Milton Keynes 024E,E01034451,1739,337,1402
2021,Milton Keynes 024F,E01034452,2088,447,1641
2021,Milton Keynes 032E,E01034453,1693,405,1288
2021,Milton Keynes 032F,E01034454,1783,576,1207
2021,Milton Keynes 032G,E01034455,1558,336,1222
2021,Milton Keynes 033C,E01034456,1690,476,1214
2021,Milton Keynes 033D,E01034457,1850,565,1285
2021,Milton Keynes 034A,E01034458,1615,426,1189
2021,Milton Keynes 034B,E01034459,1718,526,1192
2021,Milton Keynes 034D,E01034460,1550,422,1128
2021,Milton Keynes 034E,E01034461,1650,465,1185
2021,Milton Keynes 036A,E01034462,1357,186,1171
2021,Milton Keynes 036B,E01034463,1392,296,1096
2021,Milton Keynes 036C,E01034464,1233,204,1029
2021,Milton Keynes 036F,E01034465,1698,515,1183
2021,Milton Keynes 037A,E01034466,2276,649,1627
2021,Milton Keynes 037B,E01034467,1946,551,1395
2021,Milton Keynes 037E,E01034468,1281,121,1160
2021,Barking and Dagenham 004F,E01034469,1516,466,1050
2021,Barking and Dagenham 004G,E01034470,1381,368,1013
2021,Barking and Dagenham 008G,E01034471,2467,905,1562
2021,Barking and Dagenham 008H,E01034472,1675,547,1128
2021,Barking and Dagenham 015E,E01034473,1163,318,845
2021,Barking and Dagenham 015F,E01034474,1997,504,1493
2021,Barking and Dagenham 019F,E01034475,1726,508,1218
2021,Barking and Dagenham 019G,E01034476,1667,589,1078
2021,Barking and Dagenham 019H,E01034477,1366,410,956
2021,Barking and Dagenham 019I,E01034478,1025,208,817
2021,Barking and Dagenham 021G,E01034479,1973,710,1263
2021,Redbridge 023E,E01034480,1229,422,807
2021,Redbridge 023F,E01034481,1556,580,976
2021,Redbridge 032F,E01034482,961,232,729
2021,Redbridge 032G,E01034483,1273,414,859
2021,Redbridge 032H,E01034484,1593,449,1144
2021,Waltham Forest 014F,E01034485,1897,328,1569
2021,Waltham Forest 014G,E01034486,1581,351,1230
2021,Waltham Forest 020H,E01034487,1179,321,858
2021,Waltham Forest 020I,E01034488,1782,592,1190
2021,County Durham 014F,E01034489,1164,266,898
2021,County Durham 014G,E01034490,1413,304,1109
2021,County Durham 014H,E01034491,1182,267,915
2021,County Durham 016H,E01034492,2045,368,1677
2021,County Durham 030H,E01034493,6452,5790,662
2021,County Durham 031D,E01034494,1429,292,1137
2021,County Durham 031E,E01034495,1397,282,1115
2021,County Durham 033F,E01034496,1557,692,865
2021,County Durham 033G,E01034497,1475,291,1184
2021,County Durham 033H,E01034498,1889,990,899
2021,County Durham 033I,E01034499,1643,390,1253
2021,County Durham 039F,E01034500,2101,301,1800
2021,County Durham 049E,E01034501,1771,352,1419
2021,County Durham 049F,E01034502,1228,226,1002
2021,County Durham 052F,E01034503,1525,340,1185
2021,County Durham 052G,E01034504,1289,244,1045
2021,County Durham 053F,E01034505,1413,230,1183
2021,County Durham 053G,E01034506,1084,189,895
2021,County Durham 053H,E01034507,1160,171,989
2021,County Durham 053I,E01034508,1473,228,1245
2021,County Durham 057F,E01034509,1589,354,1235
2021,County Durham 057G,E01034510,1112,264,848
2021,County Durham 067A,E01034511,2127,303,1824
2021,South Tyneside 013F,E01034512,1377,251,1126
2021,South Tyneside 013G,E01034513,1420,377,1043
2021,Sunderland 005H,E01034514,3037,546,2491
2021,Sunderland 017F,E01034515,1411,261,1150
2021,Sunderland 017G,E01034516,1463,355,1108
2021,Sunderland 021G,E01034517,2095,470,1625
2021,Sunderland 030F,E01034518,1662,316,1346
2021,Sunderland 030G,E01034519,1431,307,1124
2021,Wiltshire 003E,E01034520,1546,277,1269
2021,Wiltshire 003F,E01034521,2003,596,1407
2021,Wiltshire 013E,E01034522,1393,239,1154
2021,Wiltshire 013F,E01034523,1412,155,1257
2021,Wiltshire 016E,E01034524,1173,121,1052
2021,Wiltshire 016F,E01034525,1196,166,1030
2021,Wiltshire 018H,E01034526,1235,179,1056
2021,Wiltshire 018I,E01034527,1414,332,1082
2021,Wiltshire 021G,E01034528,1376,242,1134
2021,Wiltshire 021H,E01034529,1339,337,1002
2021,Wiltshire 021I,E01034530,1617,304,1313
2021,Wiltshire 027G,E01034531,1093,137,956
2021,Wiltshire 027H,E01034532,1140,136,1004
2021,Wiltshire 031D,E01034533,1938,359,1579
2021,Wiltshire 031E,E01034534,982,137,845
2021,Wiltshire 032E,E01034535,1267,260,1007
2021,Wiltshire 032F,E01034536,1317,362,955
2021,Wiltshire 032G,E01034537,1347,361,986
2021,Wiltshire 034E,E01034538,1234,207,1027
2021,Wiltshire 034F,E01034539,1500,283,1217
2021,Wiltshire 037D,E01034540,1452,191,1261
2021,Wiltshire 037E,E01034541,1476,334,1142
2021,Wiltshire 045G,E01034542,1720,265,1455
2021,Wiltshire 045H,E01034543,1169,333,836
2021,Wiltshire 048G,E01034544,1509,203,1306
2021,Wiltshire 048H,E01034545,1239,319,920
2021,Wiltshire 048I,E01034546,1372,340,1032
2021,Wiltshire 057D,E01034547,1225,304,921
2021,Wiltshire 057E,E01034548,1437,351,1086
2021,Wiltshire 057F,E01034549,1340,331,1009
2021,Wiltshire 057G,E01034550,1090,196,894
2021,Wiltshire 063A,E01034551,1623,296,1327
2021,Wiltshire 063B,E01034552,1635,330,1305
2021,Wiltshire 065C,E01034553,1361,362,999
2021,Wiltshire 065D,E01034554,1612,496,1116
2021,Wiltshire 065E,E01034555,2035,427,1608
2021,Wiltshire 066B,E01034556,1482,355,1127
2021,Wiltshire 066D,E01034557,2022,367,1655
2021,Wiltshire 066E,E01034558,1355,436,919
2021,Babergh 004G,E01034559,1596,404,1192
2021,Babergh 004H,E01034560,1389,219,1170
2021,West Suffolk 001C,E01034561,1531,242,1289
2021,West Suffolk 001D,E01034562,2272,613,1659
2021,West Suffolk 001E,E01034563,1160,293,867
2021,West Suffolk 003E,E01034564,1098,231,867
2021,West Suffolk 003F,E01034565,1228,223,1005
2021,West Suffolk 007E,E01034566,1730,421,1309
2021,West Suffolk 007F,E01034567,994,210,784
2021,West Suffolk 008E,E01034568,1153,126,1027
2021,West Suffolk 008F,E01034569,1186,235,951
2021,Mid Suffolk 003D,E01034570,1689,258,1431
2021,Mid Suffolk 003E,E01034571,961,130,831
2021,West Suffolk 016C,E01034572,1595,183,1412
2021,West Suffolk 016D,E01034573,1426,253,1173
2021,West Suffolk 018C,E01034574,2309,182,2127
2021,West Suffolk 018D,E01034575,1069,165,904
2021,Kingston upon Thames 004H,E01034576,1176,236,940
2021,Kingston upon Thames 004I,E01034577,1277,312,965
2021,Merton 001F,E01034578,994,211,783
2021,Merton 001G,E01034579,1742,284,1458
2021,Merton 005F,E01034580,1413,200,1213
2021,Merton 005G,E01034581,1410,183,1227
2021,Calderdale 008G,E01034582,1239,125,1114
2021,Calderdale 008H,E01034583,996,130,866
2021,Kirklees 017F,E01034584,1558,356,1202
2021,Kirklees 017G,E01034585,1264,331,933
2021,Kirklees 030E,E01034586,1398,230,1168
2021,Kirklees 030F,E01034587,1390,342,1048
2021,Kirklees 053G,E01034588,2228,394,1834
2021,Harrow 002F,E01034589,1910,436,1474
2021,Harrow 002G,E01034590,1234,231,1003
2021,Harrow 013F,E01034591,1671,396,1275
2021,Harrow 013G,E01034592,1144,296,848
2021,Harrow 015E,E01034593,1390,298,1092
2021,Harrow 015F,E01034594,1413,353,1060
2021,Harrow 023E,E01034595,1269,265,1004
2021,Harrow 023F,E01034596,1160,215,945
2021,Harrow 023G,E01034597,1321,277,1044
2021,Harrow 023H,E01034598,1173,177,996
2021,Harrow 027E,E01034599,1575,377,1198
2021,Harrow 027F,E01034600,1763,390,1373
2021,Hillingdon 015G,E01034601,1324,300,1024
2021,Hillingdon 015H,E01034602,1294,276,1018
2021,Hillingdon 015I,E01034603,1219,254,965
2021,Hillingdon 015J,E01034604,1320,324,996
2021,Hillingdon 015K,E01034605,1516,402,1114
2021,Hillingdon 016G,E01034606,2545,1662,883
2021,Hillingdon 016H,E01034607,2160,1098,1062
2021,Hillingdon 022G,E01034608,2179,500,1679
2021,Hillingdon 022H,E01034609,1756,382,1374
2021,Hillingdon 027G,E01034610,1645,439,1206
2021,Hillingdon 027H,E01034611,1146,287,859
2021,Hillingdon 027I,E01034612,1948,499,1449
2021,Hillingdon 027J,E01034613,923,182,741
2021,Hillingdon 028F,E01034614,1784,448,1336
2021,Hillingdon 028G,E01034615,1992,574,1418
2021,Hillingdon 030F,E01034616,1379,268,1111
2021,Hillingdon 030G,E01034617,2168,535,1633
2021,East Devon 005F,E01034618,1652,323,1329
2021,East Devon 005G,E01034619,1640,290,1350
2021,East Devon 021C,E01034620,1693,321,1372
2021,East Devon 021D,E01034621,1559,327,1232
2021,East Devon 021E,E01034622,1581,316,1265
2021,East Devon 021F,E01034623,1629,323,1306
2021,East Devon 022A,E01034624,1552,292,1260
2021,East Devon 022B,E01034625,1451,363,1088
2021,East Devon 022C,E01034626,1291,347,944
2021,East Devon 022D,E01034627,1123,341,782
2021,Exeter 001G,E01034628,3539,2575,964
2021,Exeter 001H,E01034629,3390,2586,804
2021,Exeter 008F,E01034630,1405,621,784
2021,Exeter 008G,E01034631,1306,371,935
2021,Exeter 011H,E01034632,1123,188,935
2021,Exeter 011I,E01034633,1959,477,1482
2021,Exeter 015G,E01034634,1695,394,1301
2021,Exeter 015H,E01034635,1248,187,1061
2021,Mid Devon 002E,E01034636,1513,260,1253
2021,Mid Devon 002F,E01034637,1421,275,1146
2021,North Devon 012F,E01034638,1493,268,1225
2021,North Devon 012G,E01034639,1294,233,1061
2021,Torridge 002D,E01034640,1109,82,1027
2021,Torridge 002E,E01034641,1244,141,1103
2021,West Devon 001E,E01034642,1501,244,1257
2021,West Devon 001F,E01034643,1652,355,1297
2021,Bolsover 001F,E01034644,1233,219,1014
2021,Bolsover 001G,E01034645,1395,217,1178
2021,Bolsover 006E,E01034646,1513,292,1221
2021,Bolsover 006F,E01034647,1435,248,1187
2021,North East Derbyshire 012E,E01034648,1346,256,1090
2021,North East Derbyshire 012F,E01034649,1035,97,938
2021,South Derbyshire 003F,E01034650,2167,497,1670
2021,South Derbyshire 003G,E01034651,1269,182,1087
2021,South Derbyshire 004E,E01034652,1404,252,1152
2021,South Derbyshire 004F,E01034653,1380,322,1058
2021,South Derbyshire 012F,E01034654,1664,348,1316
2021,South Derbyshire 012G,E01034655,1551,341,1210
2021,South Derbyshire 013E,E01034656,1518,289,1229
2021,South Derbyshire 013F,E01034657,1575,359,1216
2021,Cheshire East 003F,E01034658,2374,406,1968
2021,Cheshire East 016F,E01034659,1222,183,1039
2021,Cheshire East 016G,E01034660,1039,163,876
2021,Cheshire East 020E,E01034661,993,184,809
2021,Cheshire East 020F,E01034662,1835,313,1522
2021,Cheshire East 022D,E01034663,2039,410,1629
2021,Cheshire East 022E,E01034664,1347,221,1126
2021,Cheshire East 031E,E01034665,1224,214,1010
2021,Cheshire East 031F,E01034666,1452,310,1142
2021,Cheshire East 033H,E01034667,1264,227,1037
2021,Cheshire East 033I,E01034668,1597,245,1352
2021,Cheshire East 036F,E01034669,1230,234,996
2021,Cheshire East 036G,E01034670,1411,280,1131
2021,Cheshire East 041F,E01034671,1172,222,950
2021,Cheshire East 041G,E01034672,987,111,876
2021,Cheshire East 041H,E01034673,1229,268,961
2021,Cheshire East 052A,E01034674,1412,274,1138
2021,Cheshire East 052B,E01034675,1999,787,1212
2021,Cheshire East 052C,E01034676,1023,188,835
2021,Cheshire East 052D,E01034677,1302,155,1147
2021,Cheshire East 052E,E01034678,1246,275,971
2021,Boston 002F,E01034679,1311,247,1064
2021,Boston 002G,E01034680,1544,404,1140
2021,Boston 003E,E01034681,1258,216,1042
2021,Boston 003F,E01034682,1488,262,1226
2021,Boston 009E,E01034683,1470,261,1209
2021,Boston 009F,E01034684,1336,298,1038
2021,East Lindsey 012E,E01034685,1208,72,1136
2021,East Lindsey 012F,E01034686,1522,248,1274
2021,Lincoln 005E,E01034687,1227,580,647
2021,Lincoln 005F,E01034688,1801,1259,542
2021,Lincoln 007E,E01034689,1109,251,858
2021,Lincoln 007F,E01034690,1470,246,1224
2021,Lincoln 008E,E01034691,2848,2130,718
2021,Lincoln 008F,E01034692,1383,410,973
2021,North Kesteven 003I,E01034693,1610,374,1236
2021,North Kesteven 003J,E01034694,1734,466,1268
2021,North Kesteven 011F,E01034695,1843,459,1384
2021,North Kesteven 011G,E01034696,1456,247,1209
2021,South Holland 006H,E01034697,1437,268,1169
2021,South Holland 006I,E01034698,1629,394,1235
2021,South Holland 009F,E01034699,1329,274,1055
2021,South Holland 009G,E01034700,1362,174,1188
2021,South Kesteven 004F,E01034701,1385,304,1081
2021,South Kesteven 004G,E01034702,1613,267,1346
2021,South Kesteven 010E,E01034703,1280,190,1090
2021,South Kesteven 010F,E01034704,1311,338,973
2021,South Kesteven 010G,E01034705,1234,267,967
2021,West Lindsey 009E,E01034706,1546,293,1253
2021,West Lindsey 009F,E01034707,1188,117,1071
2021,Basingstoke and Deane 005F,E01034708,1204,216,988
2021,Basingstoke and Deane 005G,E01034709,1151,199,952
2021,Basingstoke and Deane 005H,E01034710,1211,254,957
2021,Basingstoke and Deane 006E,E01034711,1531,311,1220
2021,Basingstoke and Deane 006F,E01034712,1798,393,1405
2021,Basingstoke and Deane 007K,E01034713,1397,261,1136
2021,Basingstoke and Deane 007L,E01034714,1715,476,1239
2021,Basingstoke and Deane 009E,E01034715,1567,294,1273
2021,Basingstoke and Deane 009F,E01034716,1150,129,1021
2021,Basingstoke and Deane 010H,E01034717,960,208,752
2021,Basingstoke and Deane 010I,E01034718,2016,464,1552
2021,East Hampshire 003G,E01034719,1646,296,1350
2021,East Hampshire 003H,E01034720,1605,344,1261
2021,East Hampshire 008F,E01034721,1096,178,918
2021,East Hampshire 008G,E01034722,1676,282,1394
2021,Hart 008F,E01034723,1310,233,1077
2021,Hart 008G,E01034724,1551,362,1189
2021,Hart 010F,E01034725,1916,551,1365
2021,Hart 010G,E01034726,2070,556,1514
2021,Rushmoor 008E,E01034727,1965,415,1550
2021,Rushmoor 008F,E01034728,1491,437,1054
2021,Rushmoor 008G,E01034729,1280,300,980
2021,Rushmoor 008H,E01034730,1378,122,1256
2021,Winchester 013H,E01034731,1390,254,1136
2021,Winchester 013I,E01034732,1295,200,1095
2021,Winchester 014F,E01034733,1734,256,1478
2021,Winchester 014G,E01034734,1414,318,1096
2021,Coventry 015G,E01034735,1470,424,1046
2021,Coventry 015H,E01034736,1556,542,1014
2021,Coventry 020F,E01034737,1739,532,1207
2021,Coventry 020G,E01034738,1320,403,917
2021,Coventry 025E,E01034739,1456,363,1093
2021,Coventry 025F,E01034740,1725,336,1389
2021,Coventry 028E,E01034741,1895,1456,439
2021,Coventry 028F,E01034742,1119,663,456
2021,Coventry 031E,E01034743,2035,1627,408
2021,Coventry 031F,E01034744,2842,2348,494
2021,Coventry 035I,E01034745,1268,399,869
2021,Coventry 035J,E01034746,1504,592,912
2021,Coventry 036H,E01034747,1883,774,1109
2021,Coventry 036I,E01034748,1261,483,778
2021,Coventry 038G,E01034749,1796,615,1181
2021,Coventry 038H,E01034750,2529,725,1804
2021,West Oxfordshire 004I,E01034751,1462,282,1180
2021,East Riding of Yorkshire 001G,E01034752,1388,250,1138
2021,East Riding of Yorkshire 001H,E01034753,1122,108,1014
2021,East Riding of Yorkshire 011H,E01034754,1170,203,967
2021,East Riding of Yorkshire 011I,E01034755,1506,290,1216
2021,East Riding of Yorkshire 024F,E01034756,2412,413,1999
2021,East Riding of Yorkshire 032I,E01034757,1170,169,1001
2021,East Riding of Yorkshire 032J,E01034758,1533,399,1134
2021,East Riding of Yorkshire 044E,E01034759,1454,221,1233
2021,East Riding of Yorkshire 044F,E01034760,1366,256,1110
2021,York 023D,E01034761,1602,377,1225
2021,York 023E,E01034762,1339,265,1074
2021,Lancaster 015E,E01034763,2228,1203,1025
2021,Ribble Valley 008H,E01034764,1991,328,1663
2021,Broadland 013F,E01034765,1519,317,1202
2021,Broadland 013G,E01034766,1417,144,1273
2021,Great Yarmouth 013E,E01034767,2091,280,1811
2021,King's Lynn and West Norfolk 011G,E01034768,1077,95,982
2021,King's Lynn and West Norfolk 011H,E01034769,993,103,890
2021,King's Lynn and West Norfolk 017I,E01034770,1138,77,1061
2021,King's Lynn and West Norfolk 017J,E01034771,1278,220,1058
2021,King's Lynn and West Norfolk 017K,E01034772,1093,59,1034
2021,King's Lynn and West Norfolk 017L,E01034773,1196,87,1109
2021,North Norfolk 005D,E01034774,1167,95,1072
2021,North Norfolk 005E,E01034775,1324,181,1143
2021,North Norfolk 006E,E01034776,2200,272,1928
2021,Cheltenham 007G,E01034777,1254,187,1067
2021,Cheltenham 007H,E01034778,1008,100,908
2021,Cheltenham 012H,E01034779,1504,311,1193
2021,Cheltenham 012I,E01034780,1395,243,1152
2021,Cotswold 002F,E01034781,1617,358,1259
2021,Cotswold 002G,E01034782,1258,156,1102
2021,Cotswold 003E,E01034783,1266,236,1030
2021,Cotswold 003F,E01034784,1365,225,1140
2021,Cotswold 003G,E01034785,1397,233,1164
2021,Cotswold 003H,E01034786,1475,372,1103
2021,Cotswold 010D,E01034787,1629,254,1375
2021,Cotswold 010E,E01034788,1182,236,946
2021,Cotswold 011G,E01034789,1195,173,1022
2021,Cotswold 011H,E01034790,1470,264,1206
2021,Gloucester 004G,E01034791,1412,231,1181
2021,Gloucester 004H,E01034792,1480,524,956
2021,Gloucester 004I,E01034793,1409,217,1192
2021,Gloucester 004J,E01034794,1811,331,1480
2021,Gloucester 015I,E01034795,1985,585,1400
2021,Gloucester 015J,E01034796,1899,588,1311
2021,Gloucester 015K,E01034797,1370,252,1118
2021,Gloucester 015L,E01034798,1684,443,1241
2021,Stroud 001E,E01034799,1582,424,1158
2021,Stroud 001F,E01034800,1723,328,1395
2021,Stroud 001G,E01034801,1921,286,1635
2021,Stroud 001H,E01034802,1768,449,1319
2021,Stroud 006F,E01034803,1147,243,904
2021,Stroud 006G,E01034804,1219,122,1097
2021,Tewkesbury 008D,E01034805,1743,264,1479
2021,Tewkesbury 008E,E01034806,1058,193,865
2021,Tewkesbury 009F,E01034807,1466,239,1227
2021,Tewkesbury 009G,E01034808,1570,347,1223
2021,Tewkesbury 009H,E01034809,1235,309,926
2021,Tewkesbury 009I,E01034810,1920,360,1560
2021,Tewkesbury 010A,E01034811,1483,369,1114
2021,Tewkesbury 010B,E01034812,1048,265,783
2021,Tewkesbury 011A,E01034813,1106,226,880
2021,Tewkesbury 011B,E01034814,1196,142,1054
2021,Tewkesbury 011D,E01034815,1385,296,1089
2021,Arun 004F,E01034816,1912,528,1384
2021,Arun 004G,E01034817,1885,413,1472
2021,Arun 004H,E01034818,1493,303,1190
2021,Arun 004I,E01034819,1582,300,1282
2021,Arun 005F,E01034820,2049,507,1542
2021,Arun 005G,E01034821,1554,285,1269
2021,Arun 012F,E01034822,1806,410,1396
2021,Arun 012G,E01034823,1680,249,1431
2021,Arun 015F,E01034824,1751,479,1272
2021,Arun 015G,E01034825,1689,309,1380
2021,Worthing 006F,E01034826,1670,469,1201
2021,Worthing 006G,E01034827,1632,411,1221
2021,Worthing 007F,E01034828,1520,237,1283
2021,Worthing 007G,E01034829,1234,247,987
2021,Worthing 011F,E01034830,1155,155,1000
2021,Worthing 011G,E01034831,1143,117,1026
2021,Knowsley 006E,E01034832,954,171,783
2021,Knowsley 006F,E01034833,2004,452,1552
2021,Knowsley 007F,E01034834,1158,139,1019
2021,Knowsley 007G,E01034835,1039,203,836
2021,Wirral 010G,E01034836,1151,306,845
2021,Wirral 010H,E01034837,1543,330,1213
2021,Wirral 016F,E01034838,962,141,821
2021,Wirral 016G,E01034839,994,76,918
2021,Wirral 036F,E01034840,1303,225,1078
2021,Wirral 036G,E01034841,1219,232,987
2021,Sheffield 022I,E01034842,3066,1042,2024
2021,Sheffield 036F,E01034843,2999,1715,1284
2021,Sheffield 074F,E01034844,2098,1419,679
2021,Sheffield 076G,E01034845,1244,223,1021
2021,Sheffield 076H,E01034846,1288,264,1024
2021,Cornwall 005F,E01034847,1688,353,1335
2021,Cornwall 005G,E01034848,1995,431,1564
2021,Cornwall 016E,E01034849,1333,220,1113
2021,Cornwall 016F,E01034850,1307,232,1075
2021,Cornwall 016G,E01034851,1135,159,976
2021,Cornwall 016H,E01034852,1500,216,1284
2021,Cornwall 018E,E01034853,1254,242,1012
2021,Cornwall 018F,E01034854,1373,338,1035
2021,Cornwall 018G,E01034855,1397,304,1093
2021,Cornwall 036F,E01034856,1549,193,1356
2021,Cornwall 036G,E01034857,1171,160,1011
2021,Cornwall 037E,E01034858,2227,242,1985
2021,Cornwall 040E,E01034859,1452,300,1152
2021,Cornwall 040F,E01034860,1453,285,1168
2021,Cornwall 043G,E01034862,1343,449,894
2021,Cornwall 043H,E01034863,2106,474,1632
2021,Cornwall 044E,E01034864,997,76,921
2021,Cornwall 044F,E01034865,1062,154,908
2021,Cornwall 052E,E01034866,1556,298,1258
2021,Cornwall 052F,E01034867,1259,284,975
2021,Cornwall 057F,E01034868,1328,312,1016
2021,Cornwall 057G,E01034869,1587,315,1272
2021,Birmingham 014F,E01034913,1082,301,781
2021,Birmingham 014G,E01034914,1754,543,1211
2021,Birmingham 023G,E01034915,1585,643,942
2021,Birmingham 023H,E01034916,1427,271,1156
2021,Birmingham 035H,E01034917,1524,472,1052
2021,Birmingham 035I,E01034918,1612,479,1133
2021,Birmingham 037G,E01034919,1551,459,1092
2021,Birmingham 037H,E01034920,1746,573,1173
2021,Birmingham 039I,E01034921,1299,373,926
2021,Birmingham 039J,E01034922,1470,426,1044
2021,Birmingham 041H,E01034923,1652,553,1099
2021,Birmingham 041I,E01034924,1462,448,1014
2021,Birmingham 041J,E01034925,1513,549,964
2021,Birmingham 041K,E01034926,1443,452,991
2021,Birmingham 043D,E01034927,1582,614,968
2021,Birmingham 043E,E01034928,1339,566,773
2021,Birmingham 050G,E01034929,1374,565,809
2021,Birmingham 050H,E01034930,2155,1321,834
2021,Birmingham 051F,E01034931,1769,653,1116
2021,Birmingham 051G,E01034932,1377,468,909
2021,Birmingham 052G,E01034933,1395,421,974
2021,Birmingham 052H,E01034934,1480,560,920
2021,Birmingham 058G,E01034935,3115,1231,1884
2021,Birmingham 079G,E01034936,2653,1879,774
2021,Birmingham 079H,E01034937,2388,1628,760
2021,Birmingham 088F,E01034938,1806,565,1241
2021,Birmingham 088G,E01034939,1563,443,1120
2021,Birmingham 096H,E01034940,2155,1807,348
2021,Birmingham 096I,E01034941,2084,1835,249
2021,Birmingham 125H,E01034942,1699,558,1141
2021,Birmingham 125I,E01034943,1583,367,1216
2021,Birmingham 129E,E01034944,1211,238,973
2021,Birmingham 129F,E01034945,1396,269,1127
2021,Birmingham 135E,E01034946,993,160,833
2021,Birmingham 135F,E01034947,1458,400,1058
2021,Birmingham 136E,E01034948,1690,572,1118
2021,Birmingham 136F,E01034949,1245,395,850
2021,Birmingham 137F,E01034950,1089,145,944
2021,Birmingham 137G,E01034951,1065,163,902
2021,Birmingham 142B,E01034952,1145,377,768
2021,Birmingham 142C,E01034953,1452,460,992
2021,Birmingham 143A,E01034954,1594,593,1001
2021,Birmingham 143B,E01034955,1948,721,1227
2021,Craven 006E,E01034956,1333,281,1052
2021,Craven 006F,E01034957,1243,127,1116
2021,Hambleton 007F,E01034958,2523,382,2141
2021,Hambleton 009E,E01034959,1760,378,1382
2021,Hambleton 009F,E01034960,1456,175,1281
2021,Hambleton 012A,E01034961,1456,186,1270
2021,Hambleton 012B,E01034962,1079,192,887
2021,Harrogate 008E,E01034963,1245,245,1000
2021,Harrogate 008F,E01034964,2563,1348,1215
2021,Richmondshire 004I,E01034965,2456,677,1779
2021,Richmondshire 004J,E01034966,1714,276,1438
2021,Richmondshire 004K,E01034967,1581,424,1157
2021,Ryedale 009B,E01034968,1475,308,1167
2021,Ryedale 009C,E01034969,1471,282,1189
2021,Ryedale 009D,E01034970,1201,135,1066
2021,Ryedale 009E,E01034971,1364,275,1089
2021,Scarborough 001F,E01034972,2082,135,1947
2021,Scarborough 004G,E01034973,1892,288,1604
2021,Scarborough 006F,E01034974,2615,470,2145
2021,Selby 004F,E01034975,1386,272,1114
2021,Selby 004G,E01034976,1675,343,1332
2021,Selby 004H,E01034977,1352,229,1123
2021,Selby 004I,E01034978,1286,269,1017
2021,Selby 005G,E01034979,1307,210,1097
2021,Selby 005H,E01034980,1037,136,901
2021,Selby 005I,E01034981,1401,337,1064
2021,Selby 005J,E01034982,1138,219,919
2021,Selby 005K,E01034983,1398,398,1000
2021,Selby 006F,E01034984,2316,301,2015
2021,Ashford 005F,E01034985,1297,251,1046
2021,Ashford 005G,E01034986,1233,153,1080
2021,Ashford 010E,E01034987,1385,323,1062
2021,Ashford 010F,E01034988,1557,278,1279
2021,Ashford 010G,E01034989,1576,309,1267
2021,Maidstone 001F,E01034990,2192,395,1797
2021,Maidstone 004H,E01034991,1069,126,943
2021,Maidstone 004I,E01034992,1019,120,899
2021,Maidstone 011E,E01034993,1517,209,1308
2021,Maidstone 011F,E01034994,1704,331,1373
2021,Maidstone 013H,E01034995,1373,368,1005
2021,Maidstone 013I,E01034996,1298,382,916
2021,Maidstone 015F,E01034997,1383,307,1076
2021,Maidstone 015G,E01034998,1329,312,1017
2021,Maidstone 015H,E01034999,1383,337,1046
2021,Sevenoaks 008F,E01035000,1442,283,1159
2021,Sevenoaks 008G,E01035001,1241,223,1018
2021,Tonbridge and Malling 001G,E01035002,1318,250,1068
2021,Tonbridge and Malling 001H,E01035003,1184,232,952
2021,Tonbridge and Malling 001I,E01035004,1183,167,1016
2021,Tonbridge and Malling 002H,E01035005,1167,167,1000
2021,Tonbridge and Malling 002I,E01035006,1195,229,966
2021,Tonbridge and Malling 002J,E01035007,1322,283,1039
2021,Tonbridge and Malling 012G,E01035008,1386,202,1184
2021,Tonbridge and Malling 012H,E01035009,1596,261,1335
2021,Tonbridge and Malling 014G,E01035010,1256,250,1006
2021,Tonbridge and Malling 014H,E01035011,1382,224,1158
2021,Tunbridge Wells 008E,E01035012,1122,181,941
2021,Tunbridge Wells 008F,E01035013,1584,159,1425
2021,Nuneaton and Bedworth 001F,E01035014,1912,477,1435
2021,Nuneaton and Bedworth 001G,E01035015,1607,318,1289
2021,Nuneaton and Bedworth 002G,E01035016,1632,444,1188
2021,Nuneaton and Bedworth 002H,E01035017,1751,431,1320
2021,Nuneaton and Bedworth 003F,E01035018,1621,396,1225
2021,Nuneaton and Bedworth 003G,E01035019,1485,326,1159
2021,Rugby 002G,E01035020,1514,327,1187
2021,Rugby 002H,E01035021,1776,383,1393
2021,Rugby 007I,E01035022,1531,436,1095
2021,Rugby 007J,E01035023,1581,303,1278
2021,Rugby 012F,E01035024,1780,486,1294
2021,Rugby 012G,E01035025,1416,220,1196
2021,Rugby 013D,E01035026,1388,201,1187
2021,Rugby 014A,E01035027,1335,272,1063
2021,Rugby 014B,E01035028,1432,354,1078
2021,Rugby 014E,E01035029,1559,323,1236
2021,Stratford-on-Avon 008H,E01035030,1405,215,1190
2021,Stratford-on-Avon 008I,E01035031,1542,348,1194
2021,Stratford-on-Avon 009G,E01035032,1573,307,1266
2021,Stratford-on-Avon 009H,E01035033,1664,337,1327
2021,Stratford-on-Avon 014E,E01035034,1397,225,1172
2021,Stratford-on-Avon 014F,E01035035,1595,407,1188
2021,Stratford-on-Avon 014G,E01035036,1360,253,1107
2021,Warwick 012G,E01035037,1280,310,970
2021,Warwick 012H,E01035038,1604,370,1234
2021,Warwick 012I,E01035039,1161,269,892
2021,Leeds 044G,E01035040,1718,1116,602
2021,Leeds 044H,E01035041,1279,739,540
2021,Leeds 055I,E01035042,2248,1738,510
2021,Leeds 055J,E01035043,1390,1006,384
2021,Leeds 063F,E01035044,2619,2155,464
2021,Leeds 063G,E01035045,1282,705,577
2021,Leeds 082G,E01035046,1126,144,982
2021,Leeds 082H,E01035047,1262,304,958
2021,Leeds 099G,E01035048,1759,373,1386
2021,Leeds 099H,E01035049,1398,256,1142
2021,Leeds 105G,E01035050,1487,384,1103
2021,Leeds 105H,E01035051,1491,347,1144
2021,Leeds 105I,E01035052,1340,286,1054
2021,Leeds 105J,E01035053,1606,425,1181
2021,Leeds 112F,E01035054,2527,476,2051
2021,Herefordshire 011E,E01035055,1494,232,1262
2021,Herefordshire 011F,E01035056,1435,294,1141
2021,Shropshire 009E,E01035057,1399,141,1258
2021,Shropshire 009F,E01035058,1668,239,1429
2021,Shropshire 016E,E01035059,1920,275,1645
2021,Shropshire 016F,E01035060,1578,245,1333
2021,Shropshire 019E,E01035061,1033,57,976
2021,Shropshire 019F,E01035062,1304,158,1146
2021,Shropshire 019G,E01035063,1167,175,992
2021,Shropshire 019H,E01035064,989,62,927
2021,Shropshire 020F,E01035065,1388,275,1113
2021,Shropshire 020G,E01035066,1673,411,1262
2021,Shropshire 024E,E01035067,1585,254,1331
2021,Shropshire 024F,E01035068,1445,253,1192
2021,Shropshire 025F,E01035069,1421,301,1120
2021,Shropshire 025G,E01035070,1634,280,1354
2021,Shropshire 030F,E01035071,2166,298,1868
2021,Shropshire 036F,E01035072,2280,284,1996
2021,Telford and Wrekin 009F,E01035073,1396,324,1072
2021,Telford and Wrekin 009G,E01035074,1799,437,1362
2021,Telford and Wrekin 009H,E01035075,1027,263,764
2021,Telford and Wrekin 024A,E01035076,1723,377,1346
2021,Telford and Wrekin 024B,E01035077,1227,282,945
2021,Telford and Wrekin 024D,E01035078,1590,393,1197
2021,Telford and Wrekin 025A,E01035079,1297,317,980
2021,Telford and Wrekin 025B,E01035080,1303,268,1035
2021,Telford and Wrekin 025C,E01035081,1405,330,1075
2021,Telford and Wrekin 025D,E01035082,1776,409,1367
2021,Telford and Wrekin 025E,E01035083,2117,492,1625
2021,Harborough 003G,E01035084,1636,347,1289
2021,Harborough 003H,E01035085,1500,298,1202
2021,Harborough 005G,E01035086,1588,298,1290
2021,Harborough 005H,E01035087,1377,216,1161
2021,Harborough 007G,E01035088,1550,242,1308
2021,Harborough 007H,E01035089,1300,273,1027
2021,Harborough 010E,E01035090,1529,308,1221
2021,Harborough 010F,E01035091,1455,283,1172
2021,Harborough 011E,E01035092,1572,309,1263
2021,Harborough 011F,E01035093,1456,268,1188
2021,Hinckley and Bosworth 001F,E01035094,1255,367,888
2021,Hinckley and Bosworth 001G,E01035095,1575,286,1289
2021,Hinckley and Bosworth 011F,E01035096,1444,281,1163
2021,Hinckley and Bosworth 011G,E01035097,1384,293,1091
2021,North West Leicestershire 001F,E01035098,1093,135,958
2021,North West Leicestershire 001G,E01035099,1337,190,1147
2021,North West Leicestershire 003E,E01035100,1675,332,1343
2021,North West Leicestershire 003F,E01035101,1787,385,1402
2021,Rutland 002E,E01035102,1447,348,1099
2021,Rutland 002F,E01035103,1116,219,897
2021,Rutland 002G,E01035104,1303,242,1061
2021,Rutland 003E,E01035105,1309,192,1117
2021,Rutland 003F,E01035106,1226,149,1077
2021,Mendip 002F,E01035107,2010,284,1726
2021,Mendip 005E,E01035108,1557,297,1260
2021,Mendip 005F,E01035109,1310,217,1093
2021,Mendip 007G,E01035110,1247,284,963
2021,Mendip 007H,E01035111,1725,395,1330
2021,Sedgemoor 002H,E01035112,1708,193,1515
2021,Sedgemoor 002I,E01035113,1442,320,1122
2021,Sedgemoor 010E,E01035114,1133,303,830
2021,Sedgemoor 010F,E01035115,1297,208,1089
2021,Sedgemoor 010G,E01035116,1063,130,933
2021,Sedgemoor 014H,E01035117,1590,364,1226
2021,Sedgemoor 014I,E01035118,1283,296,987
2021,Sedgemoor 014J,E01035119,1542,356,1186
2021,Sedgemoor 014K,E01035120,1474,226,1248
2021,South Somerset 011E,E01035121,1424,194,1230
2021,South Somerset 011F,E01035122,1848,397,1451
2021,South Somerset 012E,E01035123,1572,372,1200
2021,South Somerset 012F,E01035124,1314,318,996
2021,South Somerset 015E,E01035125,1058,103,955
2021,South Somerset 015F,E01035126,1062,133,929
2021,Somerset West and Taunton 008E,E01035127,1831,346,1485
2021,Somerset West and Taunton 008F,E01035128,1901,471,1430
2021,Somerset West and Taunton 018E,E01035129,1838,419,1419
2021,Somerset West and Taunton 018F,E01035130,1272,221,1051
2021,Somerset West and Taunton 017E,E01035131,1315,266,1049
2021,Somerset West and Taunton 017F,E01035132,1398,226,1172
2021,Breckland 007F,E01035133,1166,156,1010
2021,Breckland 007G,E01035134,1425,269,1156
2021,Breckland 011F,E01035135,1067,202,865
2021,Breckland 011G,E01035136,1905,206,1699
2021,Norwich 014E,E01035137,986,129,857
2021,Norwich 014F,E01035138,1179,149,1030
2021,Norwich 017B,E01035139,2740,1437,1303
2021,Norwich 017C,E01035140,1088,179,909
2021,South Norfolk 002F,E01035141,1721,417,1304
2021,South Norfolk 002G,E01035142,1395,227,1168
2021,South Norfolk 006H,E01035143,1322,243,1079
2021,South Norfolk 006I,E01035144,1542,292,1250
2021,South Norfolk 007F,E01035145,1309,308,1001
2021,South Norfolk 007G,E01035146,1337,364,973
2021,South Norfolk 007H,E01035147,992,139,853
2021,South Norfolk 007I,E01035148,1386,321,1065
2021,South Norfolk 007J,E01035149,3093,561,2532
2021,South Norfolk 016A,E01035150,1036,255,781
2021,South Norfolk 016B,E01035151,1272,314,958
2021,South Norfolk 016C,E01035152,1369,330,1039
2021,South Norfolk 016F,E01035153,1318,320,998
2021,East Suffolk 014C,E01035154,2129,188,1941
2021,Braintree 011F,E01035155,1317,281,1036
2021,Braintree 011G,E01035156,1393,237,1156
2021,Colchester 007F,E01035157,1122,176,946
2021,Colchester 007G,E01035158,1069,156,913
2021,Colchester 010F,E01035159,2357,572,1785
2021,Colchester 010G,E01035160,1660,323,1337
2021,Colchester 011G,E01035161,1447,524,923
2021,Colchester 011H,E01035162,1201,255,946
2021,Colchester 011I,E01035163,1373,387,986
2021,Colchester 011J,E01035164,1622,968,654
2021,Colchester 015H,E01035165,2105,620,1485
2021,Colchester 015I,E01035166,1079,331,748
2021,Colchester 023A,E01035167,1019,251,768
2021,Colchester 023B,E01035168,1526,420,1106
2021,Colchester 023C,E01035169,1208,238,970
2021,Colchester 023D,E01035170,1348,294,1054
2021,Colchester 023E,E01035171,1031,215,816
2021,Colchester 023F,E01035172,1764,349,1415
2021,Colchester 024B,E01035173,1218,209,1009
2021,Colchester 024C,E01035174,1386,357,1029
2021,Colchester 024D,E01035175,1609,441,1168
2021,Colchester 024E,E01035176,1620,323,1297
2021,Colchester 024F,E01035177,1232,226,1006
2021,Uttlesford 006E,E01035178,1779,395,1384
2021,Uttlesford 006F,E01035179,1277,346,931
2021,Uttlesford 006G,E01035180,1115,238,877
2021,Uttlesford 006H,E01035181,1232,278,954
2021,Uttlesford 006I,E01035182,1216,192,1024
2021,Darlington 009E,E01035183,1369,276,1093
2021,Darlington 009F,E01035184,1281,196,1085
2021,Darlington 010D,E01035185,1475,325,1150
2021,Darlington 010E,E01035186,1077,163,914
2021,Darlington 016H,E01035187,2019,271,1748
2021,Hartlepool 015C,E01035188,1836,374,1462
2021,Middlesbrough 001H,E01035189,1287,342,945
2021,Middlesbrough 001I,E01035190,1608,612,996
2021,Middlesbrough 001J,E01035191,1626,421,1205
2021,Middlesbrough 001K,E01035192,1205,410,795
2021,Middlesbrough 018I,E01035193,1600,208,1392
2021,Middlesbrough 018J,E01035194,1166,180,986
2021,Middlesbrough 020G,E01035195,1481,356,1125
2021,Middlesbrough 020H,E01035196,1195,208,987
2021,Stockton-on-Tees 025A,E01035197,1518,333,1185
2021,Stockton-on-Tees 025B,E01035198,1439,324,1115
2021,Stockton-on-Tees 025D,E01035199,1083,196,887
2021,Stockton-on-Tees 026A,E01035200,1900,452,1448
2021,Stockton-on-Tees 026C,E01035201,1584,302,1282
2021,Stockton-on-Tees 026D,E01035202,1786,429,1357
2021,Stockton-on-Tees 027B,E01035203,1505,429,1076
2021,Stockton-on-Tees 028B,E01035204,2312,709,1603
2021,Bath and North East Somerset 002D,E01035205,1564,263,1301
2021,Bath and North East Somerset 002E,E01035206,1307,275,1032
2021,Bath and North East Somerset 013E,E01035207,1409,413,996
2021,Bath and North East Somerset 013F,E01035208,2225,1422,803
2021,Bath and North East Somerset 022F,E01035209,973,192,781
2021,Bath and North East Somerset 022G,E01035210,2277,1382,895
2021,North Somerset 006H,E01035211,1241,315,926
2021,North Somerset 006I,E01035212,1708,434,1274
2021,North Somerset 023G,E01035213,1755,449,1306
2021,North Somerset 023H,E01035214,1603,332,1271
2021,North Somerset 027F,E01035215,1367,218,1149
2021,North Somerset 027G,E01035216,2173,516,1657
2021,South Gloucestershire 019H,E01035217,1376,312,1064
2021,South Gloucestershire 019I,E01035218,1490,281,1209
2021,South Gloucestershire 019J,E01035219,1006,192,814
2021,South Gloucestershire 021H,E01035220,1898,442,1456
2021,South Gloucestershire 021I,E01035221,1432,356,1076
2021,South Gloucestershire 033E,E01035222,1570,254,1316
2021,South Gloucestershire 034A,E01035223,1416,238,1178
2021,South Gloucestershire 034C,E01035224,1336,296,1040
2021,South Gloucestershire 034D,E01035225,1494,346,1148
2021,South Gloucestershire 034E,E01035226,1651,417,1234
2021,South Gloucestershire 035A,E01035227,1241,253,988
2021,South Gloucestershire 035B,E01035228,2397,1383,1014
2021,South Gloucestershire 035C,E01035229,2715,2121,594
2021,South Gloucestershire 035D,E01035230,1120,319,801
2021,South Gloucestershire 035E,E01035231,1245,536,709
2021,South Gloucestershire 036B,E01035232,1614,375,1239
2021,South Gloucestershire 036C,E01035233,1711,425,1286
2021,Bracknell Forest 001F,E01035234,1018,177,841
2021,Bracknell Forest 001G,E01035235,1754,276,1478
2021,Bracknell Forest 002F,E01035236,1727,329,1398
2021,Bracknell Forest 002G,E01035237,1230,202,1028
2021,Bracknell Forest 002H,E01035238,1204,263,941
2021,Bracknell Forest 002I,E01035239,1042,169,873
2021,Bracknell Forest 002J,E01035240,1357,282,1075
2021,Bracknell Forest 007F,E01035241,1211,125,1086
2021,Bracknell Forest 007G,E01035242,1470,176,1294
2021,Bracknell Forest 007H,E01035243,1658,442,1216
2021,Bracknell Forest 007I,E01035244,1251,241,1010
2021,Bracknell Forest 009I,E01035245,1483,354,1129
2021,Bracknell Forest 009J,E01035246,1670,454,1216
2021,Slough 011F,E01035247,1298,253,1045
2021,Slough 011G,E01035248,1471,320,1151
2021,Slough 011H,E01035249,1264,299,965
2021,Slough 011I,E01035250,1696,632,1064
2021,Slough 015B,E01035251,2140,577,1563
2021,Slough 015C,E01035252,1207,268,939
2021,Slough 015D,E01035253,1349,253,1096
2021,Slough 016B,E01035254,1571,405,1166
2021,West Oxfordshire 012D,E01035255,1088,125,963
2021,Wokingham 001E,E01035256,2405,410,1995
2021,Wokingham 008H,E01035257,2725,1761,964
2021,Wokingham 008I,E01035258,1380,340,1040
2021,Wokingham 012I,E01035259,1573,309,1264
2021,Wokingham 012J,E01035260,1504,355,1149
2021,Wokingham 014F,E01035261,1757,454,1303
2021,Wokingham 014G,E01035262,1959,418,1541
2021,Wokingham 017E,E01035263,1445,288,1157
2021,Wokingham 017F,E01035264,1749,353,1396
2021,Wokingham 017G,E01035265,1788,346,1442
2021,Wokingham 017H,E01035266,1549,281,1268
2021,Wokingham 018E,E01035267,1510,336,1174
2021,Wokingham 018F,E01035268,1320,354,966
2021,Wokingham 018G,E01035269,3102,702,2400
2021,Dartford 001E,E01035270,1398,345,1053
2021,Dartford 001F,E01035271,1489,447,1042
2021,Dartford 001G,E01035272,1463,353,1110
2021,Dartford 001H,E01035273,1144,302,842
2021,Dartford 001I,E01035274,1154,284,870
2021,Dartford 001J,E01035275,1312,305,1007
2021,Dartford 001K,E01035276,1407,437,970
2021,Dartford 002E,E01035277,1601,329,1272
2021,Dartford 002F,E01035278,1624,331,1293
2021,Dartford 002G,E01035279,1819,389,1430
2021,Dartford 002H,E01035280,1706,371,1335
2021,Dartford 002I,E01035281,1634,275,1359
2021,Dartford 004E,E01035282,1455,257,1198
2021,Dartford 004F,E01035283,1429,304,1125
2021,Gravesham 006F,E01035284,1279,278,1001
2021,Gravesham 006G,E01035285,1447,333,1114
2021,Medway 003F,E01035286,1576,404,1172
2021,Medway 003G,E01035287,1736,346,1390
2021,Medway 004D,E01035288,1298,287,1011
2021,Medway 004E,E01035289,1436,281,1155
2021,Medway 007F,E01035290,1747,368,1379
2021,Medway 007G,E01035291,1744,329,1415
2021,Medway 007H,E01035292,1986,491,1495
2021,Medway 007I,E01035293,1511,324,1187
2021,Medway 009E,E01035294,1665,688,977
2021,Medway 009F,E01035295,1533,472,1061
2021,Medway 015F,E01035296,1485,391,1094
2021,Medway 015G,E01035297,1356,232,1124
2021,Swale 004H,E01035298,1338,350,988
2021,Swale 004I,E01035299,1606,389,1217
2021,Swale 006E,E01035300,2388,165,2223
2021,Swale 006F,E01035301,2061,223,1838
2021,Swale 007I,E01035302,1474,376,1098
2021,Swale 007J,E01035303,1385,340,1045
2021,Swale 009F,E01035304,1773,391,1382
2021,Swale 009G,E01035305,1621,445,1176
2021,Swale 009H,E01035306,1571,349,1222
2021,Swale 009I,E01035307,1294,262,1032
2021,Canterbury 012G,E01035308,1127,170,957
2021,Canterbury 012H,E01035309,5382,4538,844
2021,Canterbury 019D,E01035310,1489,336,1153
2021,Canterbury 019E,E01035311,1287,339,948
2021,Dover 005F,E01035312,1631,379,1252
2021,Dover 005G,E01035313,1327,275,1052
2021,Dover 006E,E01035314,1856,405,1451
2021,Dover 006F,E01035315,1637,353,1284
2021,Thanet 001F,E01035316,1036,150,886
2021,Thanet 001G,E01035317,1078,186,892
2021,Thanet 014E,E01035318,1439,218,1221
2021,Thanet 014F,E01035319,1433,272,1161
2021,Chichester 004G,E01035320,1833,233,1600
2021,Chichester 004H,E01035321,994,162,832
2021,Chichester 006E,E01035322,1358,220,1138
2021,Chichester 006F,E01035323,1408,224,1184
2021,Chichester 008G,E01035324,1489,478,1011
2021,Chichester 008H,E01035325,1713,391,1322
2021,Chichester 012G,E01035326,1606,296,1310
2021,Chichester 012H,E01035327,1718,246,1472
2021,Crawley 002F,E01035328,1913,386,1527
2021,Crawley 002G,E01035329,2075,499,1576
2021,Horsham 001E,E01035330,1294,210,1084
2021,Horsham 001F,E01035331,1244,182,1062
2021,Horsham 001G,E01035332,1346,227,1119
2021,Horsham 001H,E01035333,1479,284,1195
2021,Horsham 006G,E01035334,1117,152,965
2021,Horsham 006H,E01035335,1311,147,1164
2021,Horsham 007E,E01035336,1085,179,906
2021,Horsham 007F,E01035337,1164,245,919
2021,Horsham 007G,E01035338,1643,311,1332
2021,Horsham 007H,E01035339,1598,411,1187
2021,Horsham 007I,E01035340,1556,303,1253
2021,Horsham 010F,E01035341,1510,344,1166
2021,Horsham 010G,E01035342,1330,239,1091
2021,Mid Sussex 001H,E01035343,1108,100,1008
2021,Mid Sussex 001I,E01035344,1132,181,951
2021,Mid Sussex 007E,E01035345,1573,287,1286
2021,Mid Sussex 007F,E01035346,1318,269,1049
2021,Mid Sussex 009H,E01035347,1145,139,1006
2021,Mid Sussex 009I,E01035348,985,88,897
2021,Mid Sussex 011G,E01035349,1378,268,1110
2021,Mid Sussex 011H,E01035350,1212,209,1003
2021,Mid Sussex 011I,E01035351,1540,339,1201
2021,Mid Sussex 011J,E01035352,1595,391,1204
2021,Mid Sussex 013F,E01035353,1462,232,1230
2021,Mid Sussex 013G,E01035354,1508,309,1199
2021,Reigate and Banstead 011F,E01035355,1449,281,1168
2021,Reigate and Banstead 011G,E01035356,1433,220,1213
2021,Reigate and Banstead 011H,E01035357,1478,302,1176
2021,Reigate and Banstead 011I,E01035358,1223,136,1087
2021,Reigate and Banstead 016F,E01035359,1700,327,1373
2021,Reigate and Banstead 016G,E01035360,1784,297,1487
2021,Reigate and Banstead 018F,E01035361,1320,222,1098
2021,Reigate and Banstead 018G,E01035362,1165,153,1012
2021,Tandridge 002E,E01035363,1178,186,992
2021,Tandridge 002F,E01035364,1126,179,947
2021,Cheshire West and Chester 007F,E01035365,1173,186,987
2021,Cheshire West and Chester 007G,E01035366,1835,358,1477
2021,Cheshire West and Chester 007H,E01035367,1246,249,997
2021,Cheshire West and Chester 007I,E01035368,1142,243,899
2021,Cheshire West and Chester 018D,E01035369,1079,167,912
2021,Cheshire West and Chester 018E,E01035370,1467,334,1133
2021,Cheshire West and Chester 018F,E01035371,1114,196,918
2021,Cheshire West and Chester 018G,E01035372,1404,278,1126
2021,Cheshire West and Chester 033G,E01035373,1175,131,1044
2021,Cheshire West and Chester 033H,E01035374,1095,246,849
2021,Cheshire West and Chester 034F,E01035375,1314,731,583
2021,Cheshire West and Chester 034G,E01035376,1495,364,1131
2021,Cheshire West and Chester 034H,E01035377,1632,560,1072
2021,Cheshire West and Chester 034I,E01035378,1178,148,1030
2021,Cheshire West and Chester 041E,E01035379,1285,297,988
2021,Cheshire West and Chester 041F,E01035380,1443,389,1054
2021,Cheshire West and Chester 041G,E01035381,1364,274,1090
2021,Halton 012G,E01035382,1171,212,959
2021,Halton 012H,E01035383,1223,161,1062
2021,Warrington 009E,E01035384,1199,283,916
2021,Warrington 009F,E01035385,1483,371,1112
2021,Warrington 009G,E01035386,1422,302,1120
2021,Warrington 009H,E01035387,1389,363,1026
2021,Warrington 009I,E01035388,1488,334,1154
2021,Warrington 010G,E01035389,1461,299,1162
2021,Warrington 010H,E01035390,1417,379,1038
2021,Warrington 020F,E01035391,1545,409,1136
2021,Warrington 020G,E01035392,1299,220,1079
2021,North Northamptonshire 006C,E01035393,1531,346,1185
2021,North Northamptonshire 006D,E01035394,1504,337,1167
2021,North Northamptonshire 006E,E01035395,1383,278,1105
2021,North Northamptonshire 006F,E01035396,1134,200,934
2021,North Northamptonshire 006G,E01035397,1753,467,1286
2021,North Northamptonshire 006H,E01035398,1815,264,1551
2021,West Northamptonshire 004D,E01035399,1243,167,1076
2021,West Northamptonshire 004E,E01035400,2243,203,2040
2021,West Northamptonshire 003E,E01035401,1538,266,1272
2021,West Northamptonshire 003F,E01035402,1228,241,987
2021,West Northamptonshire 010D,E01035403,1453,294,1159
2021,West Northamptonshire 010E,E01035404,1511,300,1211
2021,West Northamptonshire 010F,E01035405,1593,296,1297
2021,West Northamptonshire 010G,E01035406,1607,275,1332
2021,North Northamptonshire 011E,E01035407,1450,303,1147
2021,North Northamptonshire 011F,E01035408,1384,249,1135
2021,North Northamptonshire 039E,E01035409,1416,291,1125
2021,North Northamptonshire 039F,E01035410,1611,295,1316
2021,North Northamptonshire 014D,E01035411,1388,245,1143
2021,North Northamptonshire 014E,E01035412,1180,203,977
2021,North Northamptonshire 018F,E01035413,946,105,841
2021,North Northamptonshire 018G,E01035414,1050,126,924
2021,North Northamptonshire 023D,E01035415,2410,546,1864
2021,North Northamptonshire 023E,E01035416,1914,396,1518
2021,West Northamptonshire 034D,E01035417,1334,260,1074
2021,West Northamptonshire 034E,E01035418,1961,675,1286
2021,West Northamptonshire 044D,E01035419,1818,513,1305
2021,West Northamptonshire 044E,E01035420,1103,216,887
2021,West Northamptonshire 035B,E01035421,1762,508,1254
2021,West Northamptonshire 035C,E01035422,1417,414,1003
2021,West Northamptonshire 035D,E01035423,2320,678,1642
2021,West Northamptonshire 039D,E01035424,2116,591,1525
2021,West Northamptonshire 050D,E01035425,1330,224,1106
2021,West Northamptonshire 050E,E01035426,1556,305,1251
2021,West Northamptonshire 051E,E01035427,2032,457,1575
2021,West Northamptonshire 051F,E01035428,2098,380,1718
2021,North Northamptonshire 030D,E01035429,1378,266,1112
2021,North Northamptonshire 030E,E01035430,2048,396,1652
2021,North Northamptonshire 032D,E01035431,1302,187,1115
2021,North Northamptonshire 032E,E01035432,1061,161,900
2021,Eastleigh 006F,E01035433,1284,284,1000
2021,Eastleigh 006G,E01035434,1809,422,1387
2021,Eastleigh 006H,E01035435,1114,190,924
2021,Eastleigh 006I,E01035436,1120,261,859
2021,Eastleigh 006J,E01035437,1546,412,1134
2021,Eastleigh 010F,E01035438,1872,479,1393
2021,Eastleigh 010G,E01035439,1842,491,1351
2021,Eastleigh 010H,E01035440,1356,355,1001
2021,Eastleigh 010I,E01035441,1409,274,1135
2021,Southampton 005G,E01035442,1698,1005,693
2021,Southampton 005H,E01035443,1291,732,559
2021,Southampton 023E,E01035444,1495,625,870
2021,Southampton 023F,E01035445,1723,883,840
2021,Southampton 031F,E01035446,1146,132,1014
2021,Southampton 031G,E01035447,1485,281,1204
2021,Southampton 034A,E01035448,988,123,865
2021,Southampton 034B,E01035449,1043,127,916
2021,Test Valley 013E,E01035450,1446,261,1185
2021,Test Valley 013F,E01035451,1448,325,1123
2021,Test Valley 013G,E01035452,1447,266,1181
2021,Test Valley 016A,E01035453,1243,216,1027
2021,Test Valley 016B,E01035454,1357,217,1140
2021,Test Valley 016C,E01035455,1521,351,1170
2021,Test Valley 016D,E01035456,1522,381,1141
2021,Test Valley 016E,E01035457,1302,270,1032
2021,Test Valley 017A,E01035458,1423,340,1083
2021,Test Valley 017B,E01035459,1472,269,1203
2021,Test Valley 017C,E01035460,1266,257,1009
2021,Test Valley 017D,E01035461,1135,250,885
2021,Test Valley 017E,E01035462,1385,308,1077
2021,Kingston upon Hull 011F,E01035463,2320,496,1824
2021,Kingston upon Hull 017G,E01035464,2113,617,1496
2021,Kingston upon Hull 029G,E01035465,1110,159,951
2021,Kingston upon Hull 029H,E01035466,1284,155,1129
2021,Kingston upon Hull 031H,E01035467,1496,349,1147
2021,Kingston upon Hull 031I,E01035468,1150,271,879
2021,Kingston upon Hull 034C,E01035469,1909,436,1473
2021,Kingston upon Hull 035A,E01035470,2238,525,1713
2021,Kingston upon Hull 035B,E01035471,1240,252,988
2021,Kingston upon Hull 035C,E01035472,1632,406,1226
2021,North East Lincolnshire 002E,E01035473,1947,354,1593
2021,North East Lincolnshire 007E,E01035474,1423,256,1167
2021,North East Lincolnshire 007F,E01035475,1612,353,1259
2021,North East Lincolnshire 020F,E01035476,2398,294,2104
2021,North East Lincolnshire 021F,E01035477,1779,358,1421
2021,North East Lincolnshire 021G,E01035478,1854,500,1354
2021,North East Lincolnshire 022F,E01035479,1270,173,1097
2021,North East Lincolnshire 022G,E01035480,1526,362,1164
2021,North Lincolnshire 015E,E01035481,1307,284,1023
2021,North Lincolnshire 015F,E01035482,1108,239,869
2021,North Lincolnshire 015G,E01035483,1298,355,943
2021,Hammersmith and Fulham 001F,E01035484,1635,593,1042
2021,Hammersmith and Fulham 001G,E01035485,1066,210,856
2021,Hammersmith and Fulham 023G,E01035486,1663,365,1298
2021,Hammersmith and Fulham 023H,E01035487,1468,232,1236
2021,Wandsworth 004H,E01035488,1399,121,1278
2021,Wandsworth 004I,E01035489,1252,178,1074
2021,Wandsworth 010H,E01035490,1618,203,1415
2021,Wandsworth 010I,E01035491,1162,77,1085
2021,Wandsworth 010J,E01035492,1574,182,1392
2021,Wandsworth 010K,E01035493,1586,233,1353
2021,Wandsworth 018E,E01035494,1731,151,1580
2021,Wandsworth 018F,E01035495,1264,368,896
2021,Wandsworth 038A,E01035496,1199,198,1001
2021,Wandsworth 038B,E01035497,1389,375,1014
2021,Wandsworth 038E,E01035498,1120,222,898
2021,Wandsworth 039C,E01035499,1525,364,1161
2021,Nottingham 023J,E01035500,2036,959,1077
2021,Nottingham 028H,E01035501,2285,1489,796
2021,Nottingham 028I,E01035502,2885,2568,317
2021,Nottingham 031J,E01035503,2047,1708,339
2021,Nottingham 031K,E01035504,1646,1104,542
2021,Nottingham 031L,E01035505,2943,2020,923
2021,Nottingham 039G,E01035506,2191,1105,1086
2021,Nottingham 041E,E01035507,4643,2977,1666
2021,Nottingham 041F,E01035508,4786,3278,1508
2021,Rushcliffe 008F,E01035509,1316,262,1054
2021,Rushcliffe 008G,E01035510,1555,364,1191
2021,Cambridge 005E,E01035511,1123,251,872
2021,Cambridge 005F,E01035512,953,350,603
2021,Cambridge 005G,E01035513,985,238,747
2021,Cambridge 005H,E01035514,8162,6524,1638
2021,Cambridge 007H,E01035515,2596,2088,508
2021,Cambridge 007I,E01035516,5648,4043,1605
2021,Cambridge 007J,E01035517,3238,2647,591
2021,Cambridge 010F,E01035518,1598,326,1272
2021,Cambridge 010G,E01035519,2289,479,1810
2021,Cambridge 013F,E01035520,1929,1065,864
2021,Cambridge 013G,E01035521,1761,630,1131
2021,Cambridge 014B,E01035522,1944,1154,790
2021,Cambridge 014C,E01035523,1102,281,821
2021,Cambridge 015A,E01035524,1373,406,967
2021,Cambridge 015B,E01035525,1466,338,1128
2021,Cambridge 015C,E01035526,1834,464,1370
2021,Cambridge 015D,E01035527,1324,352,972
2021,Cambridge 015E,E01035528,1397,327,1070
2021,Cambridge 015F,E01035529,1435,396,1039
2021,Cambridge 015G,E01035530,1320,305,1015
2021,East Cambridgeshire 001F,E01035531,1205,270,935
2021,East Cambridgeshire 001G,E01035532,1621,376,1245
2021,East Cambridgeshire 003H,E01035533,1442,288,1154
2021,East Cambridgeshire 003I,E01035534,1174,177,997
2021,East Cambridgeshire 004H,E01035535,2293,427,1866
2021,Fenland 011F,E01035536,1620,262,1358
2021,Fenland 011G,E01035537,1233,253,980
2021,Peterborough 007G,E01035538,1539,405,1134
2021,Peterborough 007H,E01035539,1632,480,1152
2021,Peterborough 013G,E01035540,1397,278,1119
2021,Peterborough 013H,E01035541,1413,305,1108
2021,Peterborough 014F,E01035542,1459,286,1173
2021,Peterborough 014G,E01035543,1096,177,919
2021,Peterborough 017F,E01035544,1458,264,1194
2021,Peterborough 017G,E01035545,1525,307,1218
2021,Peterborough 019G,E01035546,1330,203,1127
2021,Peterborough 019H,E01035547,1412,297,1115
2021,Peterborough 019I,E01035548,1401,398,1003
2021,Peterborough 019J,E01035549,1551,422,1129
2021,Peterborough 023G,E01035551,1592,363,1229
2021,Peterborough 023H,E01035552,1513,346,1167
2021,Peterborough 023I,E01035553,1316,443,873
2021,Peterborough 023J,E01035554,1433,440,993
2021,South Cambridgeshire 003E,E01035555,1472,315,1157
2021,South Cambridgeshire 003F,E01035556,1360,365,995
2021,South Cambridgeshire 003G,E01035557,1199,226,973
2021,South Cambridgeshire 003H,E01035558,1187,219,968
2021,South Cambridgeshire 020F,E01035559,1887,593,1294
2021,South Cambridgeshire 020G,E01035560,2185,707,1478
2021,South Cambridgeshire 022D,E01035561,2069,342,1727
2021,Dacorum 015F,E01035562,1407,276,1131
2021,Dacorum 015G,E01035563,1249,276,973
2021,Dacorum 015H,E01035564,1113,134,979
2021,West Oxfordshire 012E,E01035565,2317,216,2101
2021,St Albans 012E,E01035566,1213,196,1017
2021,St Albans 012F,E01035567,1183,144,1039
2021,Stevenage 001E,E01035568,1352,307,1045
2021,Stevenage 001F,E01035569,1678,387,1291
2021,Stevenage 008E,E01035570,1191,128,1063
2021,Stevenage 008F,E01035571,1265,219,1046
2021,Watford 007E,E01035572,1308,342,966
2021,Watford 007F,E01035573,1489,291,1198
2021,Watford 009E,E01035574,1205,178,1027
2021,Watford 009F,E01035575,1203,262,941
2021,Watford 009G,E01035576,984,127,857
2021,Watford 009H,E01035577,1548,278,1270
2021,Watford 009I,E01035578,1241,185,1056
2021,Watford 011F,E01035579,1691,364,1327
2021,Watford 011G,E01035580,1164,283,881
2021,St Albans 021C,E01035581,1488,305,1183
2021,Stevenage 013A,E01035582,1582,251,1331
2021,Broxbourne 005F,E01035583,1226,284,942
2021,Broxbourne 005G,E01035584,1430,301,1129
2021,Broxbourne 013E,E01035585,1358,277,1081
2021,Broxbourne 013F,E01035586,1235,265,970
2021,East Hertfordshire 001E,E01035587,1554,353,1201
2021,East Hertfordshire 001F,E01035588,1193,274,919
2021,East Hertfordshire 001G,E01035589,1056,196,860
2021,East Hertfordshire 004D,E01035590,1481,288,1193
2021,East Hertfordshire 004E,E01035591,1078,118,960
2021,East Hertfordshire 006D,E01035592,988,199,789
2021,East Hertfordshire 006E,E01035593,1800,347,1453
2021,East Hertfordshire 007G,E01035594,1373,185,1188
2021,East Hertfordshire 007H,E01035595,1044,108,936
2021,East Hertfordshire 017F,E01035596,1271,128,1143
2021,East Hertfordshire 017G,E01035597,1264,114,1150
2021,Hertsmere 011F,E01035598,1580,291,1289
2021,Hertsmere 011G,E01035599,1506,305,1201
2021,Three Rivers 001F,E01035600,1412,215,1197
2021,Three Rivers 001G,E01035601,1151,186,965
2021,Three Rivers 002F,E01035602,1187,210,977
2021,Three Rivers 002G,E01035603,2226,607,1619
2021,Welwyn Hatfield 007F,E01035604,1198,154,1044
2021,Welwyn Hatfield 007G,E01035605,1566,311,1255
2021,Welwyn Hatfield 009E,E01035606,1706,423,1283
2021,Welwyn Hatfield 009F,E01035607,1113,206,907
2021,Welwyn Hatfield 017C,E01035608,1562,396,1166
2021,East Hertfordshire 019C,E01035609,1362,219,1143
2021,Gateshead 008F,E01035610,2451,842,1609
2021,Gateshead 027E,E01035611,1079,111,968
2021,Gateshead 027F,E01035612,1157,367,790
2021,Newcastle upon Tyne 032C,E01035613,1324,234,1090
2021,Newcastle upon Tyne 032D,E01035614,1554,426,1128
2021,Newcastle upon Tyne 032E,E01035615,1370,361,1009
2021,Newcastle upon Tyne 032F,E01035616,1321,315,1006
2021,Newcastle upon Tyne 036A,E01035617,3518,2342,1176
2021,Newcastle upon Tyne 038B,E01035618,1377,544,833
2021,Newcastle upon Tyne 038C,E01035619,1410,459,951
2021,Newcastle upon Tyne 039B,E01035620,1731,1344,387
2021,Newcastle upon Tyne 039C,E01035621,1962,1340,622
2021,Newcastle upon Tyne 040A,E01035622,1134,228,906
2021,Newcastle upon Tyne 040B,E01035623,1121,273,848
2021,Gateshead 029D,E01035624,1500,248,1252
2021,North Tyneside 007E,E01035625,1694,348,1346
2021,North Tyneside 007F,E01035626,1721,360,1361
2021,North Tyneside 018F,E01035627,1563,335,1228
2021,North Tyneside 018G,E01035628,1510,338,1172
2021,Northumberland 015E,E01035629,1649,331,1318
2021,Northumberland 015F,E01035630,1532,260,1272
2021,Northumberland 023F,E01035631,1480,222,1258
2021,Northumberland 023G,E01035632,1612,345,1267
2021,Northumberland 025E,E01035633,1305,188,1117
2021,Northumberland 025F,E01035634,1004,175,829
2021,Northumberland 025G,E01035635,1420,305,1115
2021,Northumberland 038G,E01035636,2003,312,1691
2021,Northumberland 043F,E01035637,1058,184,874
2021,Hackney 002G,E01035638,1745,317,1428
2021,Hackney 002H,E01035639,1614,307,1307
2021,Hackney 020F,E01035640,1328,213,1115
2021,Hackney 020G,E01035641,1363,228,1135
2021,Hackney 025G,E01035642,1751,318,1433
2021,Hackney 025H,E01035643,1625,302,1323
2021,Hackney 025I,E01035644,1124,123,1001
2021,Hackney 025J,E01035645,1246,247,999
2021,Hackney 026E,E01035646,1483,260,1223
2021,Hackney 026F,E01035647,1067,126,941
2021,Hackney 026G,E01035648,1471,336,1135
2021,Hackney 026H,E01035649,1375,311,1064
2021,Hackney 031C,E01035650,1938,314,1624
2021,Islington 007E,E01035651,1475,314,1161
2021,Islington 007F,E01035652,1238,209,1029
2021,Islington 011J,E01035653,1334,133,1201
2021,Islington 011K,E01035654,1075,281,794
2021,Islington 020F,E01035655,1632,308,1324
2021,Islington 020G,E01035656,1392,393,999
2021,Tower Hamlets 001E,E01035657,996,85,911
2021,Tower Hamlets 001F,E01035658,1193,192,1001
2021,Tower Hamlets 001G,E01035659,1494,349,1145
2021,Tower Hamlets 002E,E01035660,1371,271,1100
2021,Tower Hamlets 002F,E01035661,1544,371,1173
2021,Tower Hamlets 004H,E01035662,1078,50,1028
2021,Tower Hamlets 004I,E01035663,1220,270,950
2021,Tower Hamlets 006E,E01035664,2379,479,1900
2021,Tower Hamlets 008F,E01035665,1333,238,1095
2021,Tower Hamlets 008G,E01035666,1801,467,1334
2021,Tower Hamlets 008H,E01035667,1840,529,1311
2021,Tower Hamlets 009E,E01035668,1993,360,1633
2021,Tower Hamlets 009F,E01035669,1337,263,1074
2021,Tower Hamlets 010G,E01035670,4105,2262,1843
2021,Tower Hamlets 012F,E01035671,2018,467,1551
2021,Tower Hamlets 012G,E01035672,2743,889,1854
2021,Tower Hamlets 012H,E01035673,1079,265,814
2021,Tower Hamlets 014F,E01035674,1300,308,992
2021,Tower Hamlets 014G,E01035675,1712,552,1160
2021,Tower Hamlets 014H,E01035676,1415,389,1026
2021,Tower Hamlets 014I,E01035677,1431,358,1073
2021,Tower Hamlets 018E,E01035678,1795,458,1337
2021,Tower Hamlets 018F,E01035679,1503,362,1141
2021,Tower Hamlets 019E,E01035680,1742,444,1298
2021,Tower Hamlets 019F,E01035681,1864,516,1348
2021,Tower Hamlets 019G,E01035682,1374,456,918
2021,Tower Hamlets 019H,E01035683,1716,565,1151
2021,Tower Hamlets 020E,E01035684,1463,455,1008
2021,Tower Hamlets 020F,E01035685,1341,440,901
2021,Tower Hamlets 021G,E01035686,1436,406,1030
2021,Tower Hamlets 021H,E01035687,1661,635,1026
2021,Tower Hamlets 021I,E01035688,1589,708,881
2021,Tower Hamlets 021J,E01035689,1527,429,1098
2021,Tower Hamlets 023E,E01035690,1950,332,1618
2021,Tower Hamlets 023F,E01035691,1823,303,1520
2021,Tower Hamlets 024E,E01035692,1382,326,1056
2021,Tower Hamlets 024F,E01035693,1438,318,1120
2021,Tower Hamlets 024G,E01035694,2025,540,1485
2021,Tower Hamlets 024H,E01035695,1522,414,1108
2021,Tower Hamlets 026E,E01035696,1128,200,928
2021,Tower Hamlets 026F,E01035697,1597,272,1325
2021,Tower Hamlets 032F,E01035698,887,149,738
2021,Tower Hamlets 032G,E01035699,1642,383,1259
2021,Tower Hamlets 034A,E01035700,1121,111,1010
2021,Tower Hamlets 034B,E01035701,1141,124,1017
2021,Tower Hamlets 034C,E01035702,1412,341,1071
2021,Tower Hamlets 036B,E01035703,1080,401,679
2021,Tower Hamlets 036C,E01035704,1690,779,911
2021,Tower Hamlets 036D,E01035705,1349,336,1013
2021,Tower Hamlets 036E,E01035706,1204,256,948
2021,Camden 015F,E01035707,2366,478,1888
2021,Camden 022F,E01035708,1861,857,1004
2021,Camden 022G,E01035709,1463,413,1050
2021,Camden 023F,E01035710,2467,1058,1409
2021,Camden 026E,E01035711,2379,1213,1166
2021,Camden 029E,E01035712,2381,1127,1254
2021,Kensington and Chelsea 016F,E01035713,1898,411,1487
2021,Kensington and Chelsea 020F,E01035714,1978,483,1495
2021,Westminster 007H,E01035715,2677,294,2383
2021,Westminster 013G,E01035716,2134,439,1695
2021,Westminster 014H,E01035717,1820,242,1578
2021,Westminster 019G,E01035718,2475,1089,1386
2021,Westminster 021F,E01035719,1220,231,989
2021,Westminster 021G,E01035720,1190,277,913
2021,Westminster 023H,E01035721,2231,398,1833
2021,Westminster 024G,E01035722,1950,306,1644
2021,Cherwell 001E,E01035723,1175,159,1016
2021,Cherwell 001F,E01035724,1532,257,1275
2021,Cherwell 004I,E01035725,1064,179,885
2021,Cherwell 004J,E01035726,1559,211,1348
2021,Cherwell 008E,E01035727,1641,407,1234
2021,Cherwell 008F,E01035728,1281,237,1044
2021,Cherwell 008G,E01035729,1435,232,1203
2021,Cherwell 010F,E01035730,1589,377,1212
2021,Cherwell 010G,E01035731,1381,248,1133
2021,Cherwell 011G,E01035733,1547,288,1259
2021,Cherwell 011H,E01035734,1177,307,870
2021,Cherwell 015E,E01035735,1683,175,1508
2021,Cherwell 015F,E01035736,1096,211,885
2021,Cherwell 016G,E01035737,1688,407,1281
2021,Cherwell 016H,E01035738,1472,355,1117
2021,Cherwell 016I,E01035739,1775,355,1420
2021,Oxford 003E,E01035740,2478,1214,1264
2021,Oxford 008F,E01035741,2116,1110,1006
2021,Oxford 008G,E01035742,2206,1322,884
2021,Oxford 019C,E01035743,1570,451,1119
2021,Oxford 019D,E01035744,1405,220,1185
2021,South Oxfordshire 010E,E01035745,1665,350,1315
2021,South Oxfordshire 010F,E01035746,1652,394,1258
2021,South Oxfordshire 011E,E01035747,982,186,796
2021,South Oxfordshire 011F,E01035748,2013,298,1715
2021,South Oxfordshire 015F,E01035749,2312,489,1823
2021,South Oxfordshire 015G,E01035750,1127,193,934
2021,South Oxfordshire 015H,E01035751,1486,342,1144
2021,South Oxfordshire 015I,E01035752,1477,303,1174
2021,Vale of White Horse 007D,E01035753,1861,411,1450
2021,Vale of White Horse 007E,E01035754,1762,287,1475
2021,Vale of White Horse 010F,E01035755,1467,288,1179
2021,Vale of White Horse 010G,E01035756,1435,245,1190
2021,Vale of White Horse 014G,E01035757,1080,139,941
2021,Vale of White Horse 014H,E01035758,1127,146,981
2021,Vale of White Horse 015G,E01035759,1403,261,1142
2021,Vale of White Horse 015H,E01035760,1407,302,1105
2021,Vale of White Horse 015I,E01035761,1425,282,1143
2021,West Oxfordshire 004H,E01035762,1394,254,1140
2021,Isle of Anglesey 001A,W01000003,2308,417,1891
2021,Isle of Anglesey 001B,W01000004,1217,178,1039
2021,Isle of Anglesey 005A,W01000005,1563,234,1329
2021,Isle of Anglesey 006A,W01000006,1461,230,1231
2021,Isle of Anglesey 009A,W01000007,1708,275,1433
2021,Isle of Anglesey 008A,W01000008,1397,241,1156
2021,Isle of Anglesey 007C,W01000009,1778,331,1447
2021,Isle of Anglesey 002A,W01000010,1741,220,1521
2021,Isle of Anglesey 008B,W01000011,989,149,840
2021,Isle of Anglesey 006B,W01000012,1617,317,1300
2021,Isle of Anglesey 005B,W01000013,2098,387,1711
2021,Isle of Anglesey 006C,W01000014,2071,419,1652
2021,Isle of Anglesey 008C,W01000015,1405,204,1201
2021,Isle of Anglesey 003A,W01000016,1134,230,904
2021,Isle of Anglesey 003B,W01000017,1588,357,1231
2021,Isle of Anglesey 001C,W01000018,1133,160,973
2021,Isle of Anglesey 005C,W01000019,1312,110,1202
2021,Isle of Anglesey 002C,W01000021,2226,336,1890
2021,Isle of Anglesey 004A,W01000022,1541,259,1282
2021,Isle of Anglesey 007D,W01000023,1479,288,1191
2021,Isle of Anglesey 007E,W01000024,1251,289,962
2021,Isle of Anglesey 009B,W01000025,2044,394,1650
2021,Isle of Anglesey 005D,W01000026,1213,174,1039
2021,Isle of Anglesey 009C,W01000027,1770,317,1453
2021,Isle of Anglesey 001D,W01000028,1870,350,1520
2021,Isle of Anglesey 003C,W01000029,1505,354,1151
2021,Isle of Anglesey 003D,W01000030,2175,482,1693
2021,Isle of Anglesey 001E,W01000031,1482,218,1264
2021,Isle of Anglesey 003E,W01000033,1459,301,1158
2021,Isle of Anglesey 004B,W01000034,1364,277,1087
2021,Isle of Anglesey 005E,W01000035,1712,260,1452
2021,Isle of Anglesey 003F,W01000036,1035,226,809
2021,Isle of Anglesey 003G,W01000037,1104,216,888
2021,Isle of Anglesey 009D,W01000038,2138,339,1799
2021,Isle of Anglesey 004D,W01000040,1031,119,912
2021,Isle of Anglesey 006D,W01000041,1466,430,1036
2021,Isle of Anglesey 008D,W01000042,1941,392,1549
2021,Isle of Anglesey 004F,W01000044,1059,151,908
2021,Gwynedd 011A,W01000047,1213,195,1018
2021,Gwynedd 003A,W01000050,1365,249,1116
2021,Gwynedd 015A,W01000051,1898,335,1563
2021,Gwynedd 004A,W01000052,1035,215,820
2021,Gwynedd 004B,W01000053,1121,179,942
2021,Gwynedd 007A,W01000054,973,152,821
2021,Gwynedd 009A,W01000056,1678,386,1292
2021,Gwynedd 016C,W01000057,1336,194,1142
2021,Gwynedd 006A,W01000059,1972,382,1590
2021,Gwynedd 015B,W01000060,1209,145,1064
2021,Gwynedd 011B,W01000061,1668,255,1413
2021,Gwynedd 001A,W01000062,1948,1365,583
2021,Gwynedd 005A,W01000063,1799,394,1405
2021,Gwynedd 002A,W01000064,1898,551,1347
2021,Gwynedd 009B,W01000065,973,156,817
2021,Gwynedd 010A,W01000066,1122,185,937
2021,Gwynedd 016D,W01000067,1151,178,973
2021,Gwynedd 016E,W01000068,1345,200,1145
2021,Gwynedd 012A,W01000070,1239,187,1052
2021,Gwynedd 003B,W01000071,2126,431,1695
2021,Gwynedd 002B,W01000072,1604,440,1164
2021,Gwynedd 008A,W01000073,1584,270,1314
2021,Gwynedd 013B,W01000074,1744,231,1513
2021,Gwynedd 002C,W01000075,1338,441,897
2021,Gwynedd 001B,W01000076,1260,628,632
2021,Gwynedd 001C,W01000077,1126,469,657
2021,Gwynedd 011C,W01000078,1477,227,1250
2021,Gwynedd 014C,W01000080,1404,219,1185
2021,Gwynedd 005B,W01000081,1913,341,1572
2021,Gwynedd 015C,W01000082,1045,170,875
2021,Gwynedd 015D,W01000083,1292,278,1014
2021,Gwynedd 014D,W01000084,1028,127,901
2021,Gwynedd 017C,W01000085,1860,230,1630
2021,Gwynedd 008B,W01000086,2068,420,1648
2021,Gwynedd 004C,W01000087,1730,381,1349
2021,Gwynedd 007B,W01000088,1959,415,1544
2021,Gwynedd 011D,W01000089,1829,313,1516
2021,Gwynedd 002D,W01000090,1264,331,933
2021,Gwynedd 001D,W01000091,1014,241,773
2021,Gwynedd 001E,W01000092,3029,2381,648
2021,Gwynedd 006B,W01000093,2143,303,1840
2021,Gwynedd 012B,W01000094,1171,208,963
2021,Gwynedd 012C,W01000095,1239,223,1016
2021,Gwynedd 003C,W01000096,1202,261,941
2021,Gwynedd 003D,W01000097,1069,201,868
2021,Gwynedd 006C,W01000098,2346,625,1721
2021,Gwynedd 005C,W01000099,1590,277,1313
2021,Gwynedd 010B,W01000100,1013,175,838
2021,Gwynedd 013D,W01000101,1304,248,1056
2021,Gwynedd 002E,W01000102,1776,359,1417
2021,Gwynedd 005D,W01000103,1119,199,920
2021,Gwynedd 008C,W01000104,1705,329,1376
2021,Gwynedd 010C,W01000105,1654,358,1296
2021,Gwynedd 010D,W01000106,1465,126,1339
2021,Gwynedd 010E,W01000107,1138,168,970
2021,Gwynedd 012D,W01000108,2001,321,1680
2021,Gwynedd 012E,W01000109,1773,340,1433
2021,Gwynedd 006D,W01000110,1513,328,1185
2021,Gwynedd 007C,W01000111,1496,226,1270
2021,Gwynedd 008D,W01000112,1831,347,1484
2021,Gwynedd 009C,W01000113,1763,320,1443
2021,Gwynedd 009D,W01000114,1361,214,1147
2021,Gwynedd 003E,W01000115,2025,408,1617
2021,Gwynedd 017D,W01000116,1625,183,1442
2021,Gwynedd 017E,W01000117,1410,245,1165
2021,Gwynedd 007D,W01000118,1614,308,1306
2021,Gwynedd 004D,W01000119,2211,402,1809
2021,Conwy 015A,W01000121,1107,157,950
2021,Conwy 014A,W01000122,1883,290,1593
2021,Conwy 013A,W01000123,1667,299,1368
2021,Conwy 012A,W01000124,1890,276,1614
2021,Conwy 013B,W01000125,1466,208,1258
2021,Conwy 009A,W01000126,1613,331,1282
2021,Conwy 009B,W01000127,1307,277,1030
2021,Conwy 009C,W01000128,1416,275,1141
2021,Conwy 012B,W01000129,1137,215,922
2021,Conwy 012C,W01000130,1372,167,1205
2021,Conwy 012D,W01000131,1585,334,1251
2021,Conwy 001A,W01000132,1483,203,1280
2021,Conwy 002A,W01000133,1733,199,1534
2021,Conwy 015B,W01000134,1942,326,1616
2021,Conwy 006A,W01000135,1940,199,1741
2021,Conwy 006B,W01000136,1703,256,1447
2021,Conwy 015C,W01000137,1480,246,1234
2021,Conwy 008A,W01000138,1843,305,1538
2021,Conwy 007A,W01000139,1546,282,1264
2021,Conwy 010B,W01000140,1693,311,1382
2021,Conwy 010C,W01000141,1484,135,1349
2021,Conwy 010D,W01000142,1477,178,1299
2021,Conwy 007B,W01000143,1473,329,1144
2021,Conwy 007C,W01000144,1550,327,1223
2021,Conwy 008B,W01000145,1238,259,979
2021,Conwy 001B,W01000146,1974,223,1751
2021,Conwy 001C,W01000147,1454,177,1277
2021,Conwy 015D,W01000148,1024,190,834
2021,Conwy 005A,W01000149,1431,225,1206
2021,Conwy 005B,W01000150,1428,237,1191
2021,Conwy 005C,W01000151,1441,325,1116
2021,Conwy 005D,W01000152,1361,233,1128
2021,Conwy 009D,W01000153,1544,213,1331
2021,Conwy 003A,W01000154,1353,140,1213
2021,Conwy 004A,W01000155,1355,193,1162
2021,Conwy 004B,W01000156,1459,161,1298
2021,Conwy 004C,W01000157,1336,256,1080
2021,Conwy 004D,W01000158,1518,184,1334
2021,Conwy 014B,W01000159,1360,218,1142
2021,Conwy 014C,W01000162,1744,306,1438
2021,Conwy 009E,W01000163,1277,346,931
2021,Conwy 009F,W01000164,1281,289,992
2021,Conwy 006C,W01000165,1803,249,1554
2021,Conwy 006D,W01000166,2590,536,2054
2021,Conwy 011C,W01000167,1876,408,1468
2021,Conwy 002B,W01000168,1732,364,1368
2021,Conwy 001D,W01000169,1708,232,1476
2021,Conwy 013C,W01000170,1727,320,1407
2021,Conwy 013D,W01000171,1436,218,1218
2021,Conwy 013E,W01000172,1187,229,958
2021,Conwy 003B,W01000173,1398,289,1109
2021,Conwy 003C,W01000174,1527,231,1296
2021,Conwy 003D,W01000175,1485,156,1329
2021,Conwy 011D,W01000176,1508,290,1218
2021,Conwy 011E,W01000177,1358,255,1103
2021,Conwy 010E,W01000178,1888,402,1486
2021,Conwy 010F,W01000179,1912,266,1646
2021,Conwy 008C,W01000180,1461,263,1198
2021,Conwy 008D,W01000181,1383,265,1118
2021,Conwy 007D,W01000182,1996,284,1712
2021,Conwy 008E,W01000183,1423,212,1211
2021,Conwy 005E,W01000184,2191,333,1858
2021,Conwy 015E,W01000185,1186,201,985
2021,Conwy 001E,W01000186,1531,269,1262
2021,Conwy 002C,W01000187,1431,386,1045
2021,Conwy 002D,W01000188,1534,258,1276
2021,Conwy 015F,W01000189,1392,215,1177
2021,Conwy 014D,W01000190,1334,214,1120
2021,Denbighshire 009A,W01000191,1986,358,1628
2021,Denbighshire 016A,W01000192,955,141,814
2021,Denbighshire 015A,W01000193,1197,228,969
2021,Denbighshire 011A,W01000194,1823,297,1526
2021,Denbighshire 012A,W01000195,1388,221,1167
2021,Denbighshire 012B,W01000196,1317,292,1025
2021,Denbighshire 012C,W01000197,1618,313,1305
2021,Denbighshire 011B,W01000198,1269,292,977
2021,Denbighshire 011C,W01000199,1618,318,1300
2021,Denbighshire 008A,W01000200,1236,218,1018
2021,Denbighshire 008B,W01000201,1625,343,1282
2021,Denbighshire 015B,W01000202,1565,293,1272
2021,Denbighshire 013A,W01000203,2357,363,1994
2021,Denbighshire 013B,W01000204,1403,202,1201
2021,Denbighshire 016B,W01000205,1152,192,960
2021,Denbighshire 013C,W01000206,2131,360,1771
2021,Denbighshire 015C,W01000207,2194,400,1794
2021,Denbighshire 016C,W01000208,1237,143,1094
2021,Denbighshire 016D,W01000209,1350,247,1103
2021,Denbighshire 016E,W01000210,1283,171,1112
2021,Denbighshire 012D,W01000211,1727,266,1461
2021,Denbighshire 003A,W01000212,2095,345,1750
2021,Denbighshire 002A,W01000213,1244,246,998
2021,Denbighshire 002B,W01000214,1099,199,900
2021,Denbighshire 002C,W01000215,1418,211,1207
2021,Denbighshire 002D,W01000216,1236,228,1008
2021,Denbighshire 008C,W01000217,1901,354,1547
2021,Denbighshire 001A,W01000218,1529,240,1289
2021,Denbighshire 001B,W01000219,2482,537,1945
2021,Denbighshire 001C,W01000220,1587,120,1467
2021,Denbighshire 003B,W01000221,1277,198,1079
2021,Denbighshire 003C,W01000222,1716,265,1451
2021,Denbighshire 009B,W01000223,1248,180,1068
2021,Denbighshire 009C,W01000224,1480,280,1200
2021,Denbighshire 009D,W01000225,1385,214,1171
2021,Denbighshire 004A,W01000226,1460,218,1242
2021,Denbighshire 004B,W01000227,1422,217,1205
2021,Denbighshire 004C,W01000228,1573,219,1354
2021,Denbighshire 017E,W01000229,1466,196,1270
2021,Denbighshire 017F,W01000230,1836,278,1558
2021,Denbighshire 017A,W01000231,1259,216,1043
2021,Denbighshire 017B,W01000232,1551,261,1290
2021,Denbighshire 017C,W01000233,1235,197,1038
2021,Denbighshire 017G,W01000234,2087,563,1524
2021,Denbighshire 017D,W01000235,1259,244,1015
2021,Denbighshire 006A,W01000236,1837,500,1337
2021,Denbighshire 006B,W01000237,1637,498,1139
2021,Denbighshire 006C,W01000238,1683,407,1276
2021,Denbighshire 004D,W01000239,1596,319,1277
2021,Denbighshire 004E,W01000240,1549,332,1217
2021,Denbighshire 004F,W01000241,1400,396,1004
2021,Denbighshire 014A,W01000242,1863,316,1547
2021,Denbighshire 014B,W01000243,1990,476,1514
2021,Denbighshire 014C,W01000244,1547,255,1292
2021,Denbighshire 010A,W01000245,1763,281,1482
2021,Denbighshire 010B,W01000246,1566,258,1308
2021,Denbighshire 010C,W01000247,1756,222,1534
2021,Denbighshire 008D,W01000248,1581,252,1329
2021,Flintshire 014A,W01000249,1142,190,952
2021,Flintshire 014B,W01000250,1373,216,1157
2021,Flintshire 013A,W01000251,1461,336,1125
2021,Flintshire 010A,W01000252,1579,231,1348
2021,Flintshire 003A,W01000253,1754,277,1477
2021,Flintshire 003B,W01000254,1999,348,1651
2021,Flintshire 015A,W01000255,2146,400,1746
2021,Flintshire 015B,W01000256,1455,316,1139
2021,Flintshire 015C,W01000257,2552,427,2125
2021,Flintshire 006A,W01000258,2028,298,1730
2021,Flintshire 017A,W01000259,1596,269,1327
2021,Flintshire 017B,W01000260,1643,247,1396
2021,Flintshire 014C,W01000261,1352,206,1146
2021,Flintshire 017C,W01000262,1330,261,1069
2021,Flintshire 017D,W01000263,1266,241,1025
2021,Flintshire 012A,W01000264,1612,334,1278
2021,Flintshire 012B,W01000265,1406,202,1204
2021,Flintshire 017E,W01000266,1554,274,1280
2021,Flintshire 017F,W01000267,1929,351,1578
2021,Flintshire 013B,W01000268,1599,296,1303
2021,Flintshire 020A,W01000269,1497,236,1261
2021,Flintshire 006B,W01000270,1208,181,1027
2021,Flintshire 006C,W01000271,1206,195,1011
2021,Flintshire 006D,W01000272,1739,261,1478
2021,Flintshire 007A,W01000273,1468,302,1166
2021,Flintshire 007B,W01000274,1794,344,1450
2021,Flintshire 007C,W01000275,1139,176,963
2021,Flintshire 008A,W01000276,1133,236,897
2021,Flintshire 008B,W01000277,1296,244,1052
2021,Flintshire 007D,W01000278,1379,313,1066
2021,Flintshire 008C,W01000279,1134,162,972
2021,Flintshire 010B,W01000280,1637,321,1316
2021,Flintshire 008D,W01000281,1117,192,925
2021,Flintshire 010C,W01000282,1552,343,1209
2021,Flintshire 008E,W01000283,2198,406,1792
2021,Flintshire 013C,W01000284,1648,313,1335
2021,Flintshire 013D,W01000285,1538,228,1310
2021,Flintshire 013E,W01000286,2087,441,1646
2021,Flintshire 001A,W01000287,1787,248,1539
2021,Flintshire 004A,W01000288,2055,398,1657
2021,Flintshire 005A,W01000289,1274,249,1025
2021,Flintshire 004B,W01000290,1219,168,1051
2021,Flintshire 005B,W01000291,1242,210,1032
2021,Flintshire 004C,W01000292,1383,348,1035
2021,Flintshire 004D,W01000293,2480,462,2018
2021,Flintshire 005C,W01000294,1812,295,1517
2021,Flintshire 005D,W01000295,1513,237,1276
2021,Flintshire 003C,W01000296,1453,294,1159
2021,Flintshire 003D,W01000297,1168,249,919
2021,Flintshire 001B,W01000298,1419,206,1213
2021,Flintshire 019A,W01000299,1832,261,1571
2021,Flintshire 019B,W01000300,1575,225,1350
2021,Flintshire 006E,W01000301,1669,250,1419
2021,Flintshire 013F,W01000302,1859,295,1564
2021,Flintshire 018A,W01000303,1656,298,1358
2021,Flintshire 003E,W01000304,1956,413,1543
2021,Flintshire 003F,W01000305,1800,394,1406
2021,Flintshire 002A,W01000306,2303,470,1833
2021,Flintshire 020B,W01000307,1372,268,1104
2021,Flintshire 020C,W01000308,1133,238,895
2021,Flintshire 019C,W01000309,2005,359,1646
2021,Flintshire 020D,W01000310,1822,345,1477
2021,Flintshire 011A,W01000311,1596,276,1320
2021,Flintshire 011B,W01000312,1534,244,1290
2021,Flintshire 016A,W01000313,1518,326,1192
2021,Flintshire 016B,W01000314,1088,148,940
2021,Flintshire 016C,W01000315,1857,327,1530
2021,Flintshire 016D,W01000316,1180,196,984
2021,Flintshire 016E,W01000317,1531,293,1238
2021,Flintshire 016F,W01000318,1135,291,844
2021,Flintshire 016G,W01000319,1377,236,1141
2021,Flintshire 002B,W01000320,1790,314,1476
2021,Flintshire 014D,W01000321,1573,250,1323
2021,Flintshire 014E,W01000322,1316,196,1120
2021,Flintshire 012C,W01000323,1513,253,1260
2021,Flintshire 012D,W01000324,1447,243,1204
2021,Flintshire 010D,W01000325,1719,320,1399
2021,Flintshire 018B,W01000326,2083,421,1662
2021,Flintshire 018C,W01000327,2325,419,1906
2021,Flintshire 011C,W01000328,1835,247,1588
2021,Flintshire 015D,W01000329,1499,277,1222
2021,Flintshire 015E,W01000330,1971,384,1587
2021,Flintshire 015F,W01000331,1392,234,1158
2021,Flintshire 009A,W01000332,1713,331,1382
2021,Flintshire 009B,W01000333,1372,293,1079
2021,Flintshire 009C,W01000334,1672,255,1417
2021,Flintshire 009D,W01000335,1115,249,866
2021,Flintshire 009E,W01000336,1350,325,1025
2021,Flintshire 009F,W01000337,2047,302,1745
2021,Flintshire 001C,W01000338,1698,261,1437
2021,Flintshire 019D,W01000339,1598,282,1316
2021,Flintshire 002C,W01000340,2160,341,1819
2021,Wrexham 023C,W01000341,1468,308,1160
2021,Wrexham 023E,W01000342,1449,315,1134
2021,Wrexham 023B,W01000343,990,149,841
2021,Wrexham 023A,W01000344,1204,155,1049
2021,Wrexham 018A,W01000345,1536,248,1288
2021,Wrexham 018B,W01000346,1438,207,1231
2021,Wrexham 006A,W01000347,2625,547,2078
2021,Wrexham 006B,W01000348,1328,321,1007
2021,Wrexham 011A,W01000349,2142,446,1696
2021,Wrexham 011B,W01000350,1715,405,1310
2021,Wrexham 005A,W01000351,1954,358,1596
2021,Wrexham 017A,W01000354,1573,253,1320
2021,Wrexham 017B,W01000355,1644,330,1314
2021,Wrexham 017C,W01000356,1539,324,1215
2021,Wrexham 019C,W01000359,1136,194,942
2021,Wrexham 019D,W01000360,1171,246,925
2021,Wrexham 019E,W01000361,1889,345,1544
2021,Wrexham 006C,W01000362,1392,364,1028
2021,Wrexham 006D,W01000363,1402,196,1206
2021,Wrexham 006E,W01000364,1421,222,1199
2021,Wrexham 011C,W01000365,1946,337,1609
2021,Wrexham 014A,W01000366,1391,291,1100
2021,Wrexham 014B,W01000367,1222,228,994
2021,Wrexham 008A,W01000368,1909,313,1596
2021,Wrexham 021B,W01000369,1222,167,1055
2021,Wrexham 021D,W01000370,1489,214,1275
2021,Wrexham 008B,W01000371,1005,182,823
2021,Wrexham 008C,W01000372,1459,307,1152
2021,Wrexham 005B,W01000373,1638,383,1255
2021,Wrexham 003A,W01000374,1301,251,1050
2021,Wrexham 003B,W01000375,1980,418,1562
2021,Wrexham 003C,W01000376,1268,241,1027
2021,Wrexham 004A,W01000377,1463,295,1168
2021,Wrexham 004B,W01000378,1192,312,880
2021,Wrexham 004C,W01000379,1514,328,1186
2021,Wrexham 004D,W01000380,1391,212,1179
2021,Wrexham 012A,W01000381,1065,166,899
2021,Wrexham 012B,W01000382,1300,307,993
2021,Wrexham 022C,W01000384,1058,178,880
2021,Wrexham 014C,W01000385,1653,253,1400
2021,Wrexham 015A,W01000386,1363,284,1079
2021,Wrexham 008D,W01000387,1091,167,924
2021,Wrexham 008E,W01000388,1043,203,840
2021,Wrexham 017D,W01000389,1912,321,1591
2021,Wrexham 021A,W01000390,1654,257,1397
2021,Wrexham 003D,W01000391,1366,244,1122
2021,Wrexham 003E,W01000392,1511,408,1103
2021,Wrexham 023G,W01000393,1845,381,1464
2021,Wrexham 016A,W01000394,1122,164,958
2021,Wrexham 016B,W01000395,986,185,801
2021,Wrexham 013A,W01000398,1166,184,982
2021,Wrexham 013B,W01000399,1040,160,880
2021,Wrexham 005C,W01000400,1721,336,1385
2021,Wrexham 005D,W01000401,1881,413,1468
2021,Wrexham 011D,W01000402,2414,423,1991
2021,Wrexham 018C,W01000403,1263,204,1059
2021,Wrexham 018D,W01000404,1915,379,1536
2021,Wrexham 015B,W01000405,2156,495,1661
2021,Wrexham 013C,W01000406,2036,481,1555
2021,Wrexham 016C,W01000407,1331,215,1116
2021,Wrexham 013D,W01000408,1174,266,908
2021,Wrexham 017E,W01000409,1710,512,1198
2021,Wrexham 014D,W01000410,1606,285,1321
2021,Wrexham 015C,W01000411,1443,271,1172
2021,Wrexham 015D,W01000412,1417,263,1154
2021,Wrexham 010C,W01000413,1186,403,783
2021,Wrexham 010D,W01000414,1117,296,821
2021,Wrexham 023F,W01000415,1359,194,1165
2021,Wrexham 023D,W01000416,1128,182,946
2021,Wrexham 022B,W01000417,1477,235,1242
2021,Wrexham 022A,W01000418,1663,319,1344
2021,Wrexham 016D,W01000419,1348,308,1040
2021,Wrexham 016E,W01000420,1448,291,1157
2021,Wrexham 008F,W01000422,2047,331,1716
2021,Wrexham 012D,W01000423,2024,515,1509
2021,Wrexham 012E,W01000424,1221,218,1003
2021,Wrexham 010E,W01000425,1915,562,1353
2021,Powys 021A,W01000426,1348,223,1125
2021,Powys 011A,W01000427,1287,179,1108
2021,Powys 005A,W01000428,1281,177,1104
2021,Powys 010A,W01000429,2233,325,1908
2021,Powys 015A,W01000430,1263,174,1089
2021,Powys 014A,W01000431,1203,216,987
2021,Powys 014B,W01000432,1155,174,981
2021,Powys 006A,W01000433,2182,347,1835
2021,Powys 007A,W01000434,1669,232,1437
2021,Powys 012A,W01000438,1178,119,1059
2021,Powys 007B,W01000439,1952,295,1657
2021,Powys 020A,W01000440,1267,184,1083
2021,Powys 005B,W01000441,1466,215,1251
2021,Powys 004A,W01000442,1962,270,1692
2021,Powys 015B,W01000443,2197,329,1868
2021,Powys 002A,W01000444,2154,307,1847
2021,Powys 015C,W01000445,1431,206,1225
2021,Powys 015D,W01000446,1619,217,1402
2021,Powys 007C,W01000447,1908,282,1626
2021,Powys 011B,W01000448,1314,202,1112
2021,Powys 011C,W01000449,1478,214,1264
2021,Powys 014C,W01000450,1339,204,1135
2021,Powys 012B,W01000451,1146,209,937
2021,Powys 004B,W01000452,1934,289,1645
2021,Powys 010B,W01000453,1331,186,1145
2021,Powys 013A,W01000454,1227,155,1072
2021,Powys 013B,W01000455,2065,437,1628
2021,Powys 013C,W01000456,2089,235,1854
2021,Powys 002B,W01000457,2053,311,1742
2021,Powys 002C,W01000458,1775,286,1489
2021,Powys 014D,W01000459,1166,185,981
2021,Powys 006B,W01000460,1646,273,1373
2021,Powys 001A,W01000461,1514,256,1258
2021,Powys 011D,W01000464,1140,135,1005
2021,Powys 018E,W01000465,1002,171,831
2021,Powys 010C,W01000466,1262,231,1031
2021,Powys 010D,W01000467,1405,185,1220
2021,Powys 001D,W01000470,1911,318,1593
2021,Powys 014E,W01000471,1696,203,1493
2021,Powys 012C,W01000472,1138,166,972
2021,Powys 004C,W01000473,2052,307,1745
2021,Powys 020B,W01000474,1679,260,1419
2021,Powys 001E,W01000475,2307,330,1977
2021,Powys 005C,W01000476,1234,170,1064
2021,Powys 012D,W01000477,1459,207,1252
2021,Powys 009A,W01000478,1732,416,1316
2021,Powys 009B,W01000479,1365,291,1074
2021,Powys 008A,W01000480,1993,351,1642
2021,Powys 008B,W01000481,2113,275,1838
2021,Powys 008C,W01000482,1820,308,1512
2021,Powys 009C,W01000483,1725,413,1312
2021,Powys 011E,W01000484,1623,242,1381
2021,Powys 011F,W01000485,1527,178,1349
2021,Powys 011G,W01000486,1025,144,881
2021,Powys 012E,W01000487,1986,288,1698
2021,Powys 006C,W01000488,2083,309,1774
2021,Powys 017A,W01000489,1700,357,1343
2021,Powys 017D,W01000492,1463,169,1294
2021,Powys 017E,W01000493,1668,237,1431
2021,Powys 015E,W01000494,1624,269,1355
2021,Powys 021B,W01000496,1997,271,1726
2021,Powys 005D,W01000497,1308,207,1101
2021,Powys 003A,W01000498,1412,246,1166
2021,Powys 003B,W01000499,1184,185,999
2021,Powys 003C,W01000500,1602,276,1326
2021,Powys 003D,W01000501,2127,332,1795
2021,Powys 021C,W01000502,1976,296,1680
2021,Powys 020C,W01000503,1019,143,876
2021,Powys 021D,W01000504,1075,205,870
2021,Powys 021E,W01000505,1369,188,1181
2021,Ceredigion 005A,W01000506,1234,170,1064
2021,Ceredigion 009A,W01000507,1100,158,942
2021,Ceredigion 009B,W01000508,989,157,832
2021,Ceredigion 009C,W01000509,1780,294,1486
2021,Ceredigion 009D,W01000510,1126,193,933
2021,Ceredigion 009E,W01000511,1104,243,861
2021,Ceredigion 002A,W01000512,1324,537,787
2021,Ceredigion 002B,W01000513,2070,1087,983
2021,Ceredigion 003A,W01000515,1242,279,963
2021,Ceredigion 003B,W01000516,1535,357,1178
2021,Ceredigion 002D,W01000517,1148,473,675
2021,Ceredigion 003C,W01000518,980,229,751
2021,Ceredigion 010A,W01000519,1688,256,1432
2021,Ceredigion 010B,W01000522,1168,130,1038
2021,Ceredigion 001C,W01000523,1813,323,1490
2021,Ceredigion 005B,W01000524,1837,279,1558
2021,Ceredigion 011A,W01000525,1196,237,959
2021,Ceredigion 008A,W01000527,1113,407,706
2021,Ceredigion 008B,W01000528,1278,267,1011
2021,Ceredigion 010C,W01000531,1693,229,1464
2021,Ceredigion 010D,W01000533,1290,211,1079
2021,Ceredigion 011B,W01000534,1455,272,1183
2021,Ceredigion 008C,W01000535,1955,295,1660
2021,Ceredigion 011E,W01000536,1320,189,1131
2021,Ceredigion 008D,W01000537,1344,199,1145
2021,Ceredigion 005C,W01000538,1480,234,1246
2021,Ceredigion 005D,W01000539,1133,117,1016
2021,Ceredigion 005E,W01000540,1093,131,962
2021,Ceredigion 008E,W01000541,1670,265,1405
2021,Ceredigion 011F,W01000542,2119,333,1786
2021,Ceredigion 011C,W01000543,1922,343,1579
2021,Ceredigion 007D,W01000545,1914,223,1691
2021,Ceredigion 009F,W01000546,1097,154,943
2021,Ceredigion 009G,W01000547,1101,152,949
2021,Ceredigion 001D,W01000548,1693,300,1393
2021,Ceredigion 001E,W01000549,1683,295,1388
2021,Ceredigion 011G,W01000550,1105,165,940
2021,Ceredigion 010E,W01000551,1317,210,1107
2021,Ceredigion 011D,W01000552,1919,313,1606
2021,Pembrokeshire 011A,W01000553,1195,189,1006
2021,Pembrokeshire 009A,W01000554,1779,261,1518
2021,Pembrokeshire 008A,W01000555,1469,205,1264
2021,Pembrokeshire 008B,W01000556,1139,176,963
2021,Pembrokeshire 014A,W01000557,1453,273,1180
2021,Pembrokeshire 001A,W01000558,2026,380,1646
2021,Pembrokeshire 001B,W01000559,1396,224,1172
2021,Pembrokeshire 001C,W01000560,1248,195,1053
2021,Pembrokeshire 001D,W01000561,1248,204,1044
2021,Pembrokeshire 002A,W01000562,1551,226,1325
2021,Pembrokeshire 011B,W01000563,1079,176,903
2021,Pembrokeshire 011C,W01000564,1251,190,1061
2021,Pembrokeshire 002B,W01000565,1761,276,1485
2021,Pembrokeshire 002C,W01000566,1518,240,1278
2021,Pembrokeshire 002D,W01000567,1928,327,1601
2021,Pembrokeshire 005B,W01000569,1029,224,805
2021,Pembrokeshire 005C,W01000570,1312,348,964
2021,Pembrokeshire 006A,W01000571,2307,442,1865
2021,Pembrokeshire 005D,W01000572,1749,323,1426
2021,Pembrokeshire 006B,W01000573,2426,454,1972
2021,Pembrokeshire 015A,W01000574,1660,231,1429
2021,Pembrokeshire 008C,W01000575,2653,498,2155
2021,Pembrokeshire 011D,W01000576,2199,290,1909
2021,Pembrokeshire 007A,W01000577,1498,246,1252
2021,Pembrokeshire 014B,W01000578,1655,207,1448
2021,Pembrokeshire 003A,W01000579,2260,386,1874
2021,Pembrokeshire 009B,W01000580,2210,401,1809
2021,Pembrokeshire 003B,W01000581,1354,148,1206
2021,Pembrokeshire 004A,W01000582,1611,260,1351
2021,Pembrokeshire 004B,W01000583,1359,274,1085
2021,Pembrokeshire 014C,W01000584,1989,347,1642
2021,Pembrokeshire 007B,W01000585,1319,183,1136
2021,Pembrokeshire 006C,W01000586,2091,408,1683
2021,Pembrokeshire 010A,W01000587,1904,270,1634
2021,Pembrokeshire 010B,W01000588,2194,466,1728
2021,Pembrokeshire 012A,W01000589,1076,197,879
2021,Pembrokeshire 012B,W01000590,1092,152,940
2021,Pembrokeshire 012C,W01000591,1542,311,1231
2021,Pembrokeshire 012D,W01000592,1248,331,917
2021,Pembrokeshire 012E,W01000594,2055,351,1704
2021,Pembrokeshire 007C,W01000595,2232,367,1865
2021,Pembrokeshire 007D,W01000596,1650,266,1384
2021,Pembrokeshire 002E,W01000597,1018,129,889
2021,Pembrokeshire 009C,W01000598,2068,316,1752
2021,Pembrokeshire 009D,W01000599,1906,319,1587
2021,Pembrokeshire 013A,W01000600,1531,235,1296
2021,Pembrokeshire 013B,W01000601,1416,357,1059
2021,Pembrokeshire 013C,W01000602,1171,169,1002
2021,Pembrokeshire 013D,W01000603,1715,292,1423
2021,Pembrokeshire 013E,W01000604,1604,346,1258
2021,Pembrokeshire 013F,W01000605,1708,331,1377
2021,Pembrokeshire 015B,W01000606,1543,385,1158
2021,Pembrokeshire 015C,W01000607,2308,504,1804
2021,Pembrokeshire 015D,W01000608,1371,203,1168
2021,Pembrokeshire 014D,W01000609,2337,279,2058
2021,Pembrokeshire 016A,W01000610,1658,231,1427
2021,Pembrokeshire 004C,W01000611,1994,319,1675
2021,Pembrokeshire 003C,W01000612,1710,225,1485
2021,Pembrokeshire 001E,W01000613,1980,293,1687
2021,Pembrokeshire 008D,W01000614,1329,207,1122
2021,Pembrokeshire 002F,W01000617,1452,263,1189
2021,Pembrokeshire 003D,W01000618,1651,226,1425
2021,Pembrokeshire 016B,W01000619,1927,281,1646
2021,Pembrokeshire 008E,W01000622,1372,187,1185
2021,Pembrokeshire 004D,W01000623,1927,306,1621
2021,Carmarthenshire 005A,W01000624,2226,356,1870
2021,Carmarthenshire 013A,W01000625,1056,224,832
2021,Carmarthenshire 013B,W01000626,1532,303,1229
2021,Carmarthenshire 013C,W01000627,2268,439,1829
2021,Carmarthenshire 024A,W01000628,1466,258,1208
2021,Carmarthenshire 024B,W01000629,1559,285,1274
2021,Carmarthenshire 024C,W01000630,1499,314,1185
2021,Carmarthenshire 024D,W01000631,1687,391,1296
2021,Carmarthenshire 021A,W01000632,1282,231,1051
2021,Carmarthenshire 021B,W01000633,1364,232,1132
2021,Carmarthenshire 021C,W01000634,1257,163,1094
2021,Carmarthenshire 025A,W01000635,2272,404,1868
2021,Carmarthenshire 025B,W01000636,2206,434,1772
2021,Carmarthenshire 007A,W01000637,1289,255,1034
2021,Carmarthenshire 007B,W01000638,1061,261,800
2021,Carmarthenshire 007C,W01000639,1415,313,1102
2021,Carmarthenshire 007D,W01000640,1170,187,983
2021,Carmarthenshire 008A,W01000641,1952,246,1706
2021,Carmarthenshire 008B,W01000642,1678,235,1443
2021,Carmarthenshire 006A,W01000643,1579,405,1174
2021,Carmarthenshire 006B,W01000644,1770,518,1252
2021,Carmarthenshire 006C,W01000645,1849,449,1400
2021,Carmarthenshire 003A,W01000646,2052,303,1749
2021,Carmarthenshire 002A,W01000647,1372,211,1161
2021,Carmarthenshire 006D,W01000648,1373,205,1168
2021,Carmarthenshire 006E,W01000649,1490,236,1254
2021,Carmarthenshire 002B,W01000650,1500,180,1320
2021,Carmarthenshire 020A,W01000651,1447,241,1206
2021,Carmarthenshire 020B,W01000652,1697,347,1350
2021,Carmarthenshire 023A,W01000653,1408,233,1175
2021,Carmarthenshire 023B,W01000654,1582,291,1291
2021,Carmarthenshire 020C,W01000655,1811,434,1377
2021,Carmarthenshire 010A,W01000656,1943,374,1569
2021,Carmarthenshire 010B,W01000657,1112,188,924
2021,Carmarthenshire 010C,W01000658,1251,225,1026
2021,Carmarthenshire 026A,W01000659,1668,372,1296
2021,Carmarthenshire 026B,W01000660,1414,265,1149
2021,Carmarthenshire 016A,W01000662,2060,367,1693
2021,Carmarthenshire 016B,W01000663,2340,356,1984
2021,Carmarthenshire 016C,W01000664,2440,457,1983
2021,Carmarthenshire 017A,W01000665,1722,282,1440
2021,Carmarthenshire 017B,W01000666,1547,303,1244
2021,Carmarthenshire 023C,W01000667,1983,357,1626
2021,Carmarthenshire 018A,W01000670,1494,301,1193
2021,Carmarthenshire 018B,W01000671,2045,367,1678
2021,Carmarthenshire 027E,W01000672,1442,219,1223
2021,Carmarthenshire 027F,W01000673,1065,161,904
2021,Carmarthenshire 027A,W01000674,2006,314,1692
2021,Carmarthenshire 012A,W01000675,1996,317,1679
2021,Carmarthenshire 004A,W01000676,1465,250,1215
2021,Carmarthenshire 004B,W01000677,1384,242,1142
2021,Carmarthenshire 002C,W01000678,1319,193,1126
2021,Carmarthenshire 002D,W01000679,1179,264,915
2021,Carmarthenshire 011A,W01000680,2211,457,1754
2021,Carmarthenshire 011B,W01000681,1970,380,1590
2021,Carmarthenshire 005B,W01000682,1343,226,1117
2021,Carmarthenshire 005C,W01000683,1028,133,895
2021,Carmarthenshire 005D,W01000684,1700,241,1459
2021,Carmarthenshire 001A,W01000685,1464,249,1215
2021,Carmarthenshire 001B,W01000686,1164,147,1017
2021,Carmarthenshire 004C,W01000687,1874,290,1584
2021,Carmarthenshire 003B,W01000688,1620,289,1331
2021,Carmarthenshire 003C,W01000689,1677,213,1464
2021,Carmarthenshire 019A,W01000690,1687,296,1391
2021,Carmarthenshire 019B,W01000691,1748,359,1389
2021,Carmarthenshire 019C,W01000692,1468,326,1142
2021,Carmarthenshire 008C,W01000693,1081,202,879
2021,Carmarthenshire 008D,W01000694,1427,233,1194
2021,Carmarthenshire 012B,W01000695,2115,370,1745
2021,Carmarthenshire 012C,W01000696,1573,277,1296
2021,Carmarthenshire 015A,W01000697,1828,318,1510
2021,Carmarthenshire 015B,W01000698,1864,394,1470
2021,Carmarthenshire 015C,W01000699,1407,227,1180
2021,Carmarthenshire 027G,W01000700,1904,266,1638
2021,Carmarthenshire 001C,W01000701,1545,241,1304
2021,Carmarthenshire 001D,W01000702,1126,199,927
2021,Carmarthenshire 022A,W01000703,1679,310,1369
2021,Carmarthenshire 022B,W01000704,1576,290,1286
2021,Carmarthenshire 022C,W01000705,1797,423,1374
2021,Carmarthenshire 025C,W01000706,1470,303,1167
2021,Carmarthenshire 025D,W01000707,1340,305,1035
2021,Carmarthenshire 025E,W01000708,1293,317,976
2021,Carmarthenshire 004D,W01000709,2109,300,1809
2021,Carmarthenshire 021D,W01000710,2097,340,1757
2021,Carmarthenshire 021E,W01000711,1932,338,1594
2021,Carmarthenshire 015D,W01000712,1605,297,1308
2021,Carmarthenshire 015E,W01000713,1300,219,1081
2021,Carmarthenshire 013D,W01000714,1339,256,1083
2021,Carmarthenshire 013E,W01000715,1236,200,1036
2021,Carmarthenshire 016D,W01000716,1338,218,1120
2021,Carmarthenshire 016E,W01000717,1369,268,1101
2021,Carmarthenshire 010D,W01000718,1332,246,1086
2021,Carmarthenshire 010E,W01000719,1367,223,1144
2021,Carmarthenshire 027B,W01000720,1727,282,1445
2021,Carmarthenshire 027C,W01000721,1313,261,1052
2021,Carmarthenshire 012D,W01000722,1308,184,1124
2021,Carmarthenshire 012E,W01000723,1326,181,1145
2021,Carmarthenshire 011C,W01000724,1854,339,1515
2021,Carmarthenshire 011D,W01000725,2229,349,1880
2021,Carmarthenshire 003D,W01000728,1991,270,1721
2021,Carmarthenshire 018C,W01000729,1166,241,925
2021,Carmarthenshire 018D,W01000730,1213,210,1003
2021,Carmarthenshire 017C,W01000731,2283,392,1891
2021,Carmarthenshire 026D,W01000732,1240,200,1040
2021,Carmarthenshire 026E,W01000733,1129,208,921
2021,Carmarthenshire 026F,W01000734,1309,268,1041
2021,Carmarthenshire 027D,W01000735,2273,376,1897
2021,Swansea 028A,W01000736,1700,341,1359
2021,Swansea 028B,W01000737,1439,241,1198
2021,Swansea 014A,W01000738,1619,378,1241
2021,Swansea 014B,W01000739,2077,423,1654
2021,Swansea 014C,W01000740,1512,175,1337
2021,Swansea 014D,W01000741,1745,312,1433
2021,Swansea 016A,W01000742,1574,349,1225
2021,Swansea 016B,W01000744,1431,275,1156
2021,Swansea 025B,W01000745,2357,1108,1249
2021,Swansea 025C,W01000746,1357,340,1017
2021,Swansea 024A,W01000747,1526,615,911
2021,Swansea 026A,W01000749,1919,608,1311
2021,Swansea 002A,W01000750,1392,208,1184
2021,Swansea 002B,W01000751,1343,204,1139
2021,Swansea 002C,W01000752,1390,350,1040
2021,Swansea 002D,W01000753,1352,321,1031
2021,Swansea 002E,W01000754,1492,281,1211
2021,Swansea 017A,W01000755,1863,362,1501
2021,Swansea 017B,W01000756,1398,254,1144
2021,Swansea 017C,W01000757,1375,204,1171
2021,Swansea 017D,W01000758,1802,386,1416
2021,Swansea 012A,W01000759,1487,218,1269
2021,Swansea 013A,W01000760,1486,294,1192
2021,Swansea 013B,W01000761,1473,323,1150
2021,Swansea 013C,W01000762,1570,427,1143
2021,Swansea 015A,W01000763,1332,271,1061
2021,Swansea 015B,W01000764,1482,282,1200
2021,Swansea 015C,W01000765,1543,259,1284
2021,Swansea 015D,W01000766,1417,289,1128
2021,Swansea 015E,W01000767,1369,204,1165
2021,Swansea 032A,W01000768,1294,232,1062
2021,Swansea 032B,W01000769,1332,249,1083
2021,Swansea 032D,W01000770,1448,259,1189
2021,Swansea 032G,W01000771,1251,240,1011
2021,Swansea 018A,W01000772,1422,251,1171
2021,Swansea 005B,W01000774,1536,264,1272
2021,Swansea 030A,W01000775,1589,261,1328
2021,Swansea 030B,W01000776,1729,277,1452
2021,Swansea 012B,W01000777,1650,289,1361
2021,Swansea 012C,W01000778,1701,319,1382
2021,Swansea 012D,W01000779,1382,292,1090
2021,Swansea 032E,W01000781,1557,275,1282
2021,Swansea 032F,W01000782,1031,140,891
2021,Swansea 007A,W01000784,1235,211,1024
2021,Swansea 007B,W01000785,1664,322,1342
2021,Swansea 007C,W01000786,1205,162,1043
2021,Swansea 016C,W01000787,1358,247,1111
2021,Swansea 016D,W01000788,1416,268,1148
2021,Swansea 016E,W01000789,1340,280,1060
2021,Swansea 016F,W01000790,2584,1122,1462
2021,Swansea 004A,W01000791,1355,244,1111
2021,Swansea 004B,W01000792,1501,228,1273
2021,Swansea 004C,W01000793,1769,392,1377
2021,Swansea 010A,W01000794,2098,438,1660
2021,Swansea 006A,W01000795,1489,246,1243
2021,Swansea 010B,W01000797,1442,224,1218
2021,Swansea 010C,W01000798,1349,209,1140
2021,Swansea 010D,W01000799,1708,424,1284
2021,Swansea 006C,W01000800,1404,238,1166
2021,Swansea 006D,W01000801,1626,326,1300
2021,Swansea 007D,W01000802,2222,447,1775
2021,Swansea 002F,W01000803,1740,310,1430
2021,Swansea 028C,W01000804,1382,226,1156
2021,Swansea 028D,W01000805,1096,200,896
2021,Swansea 003A,W01000806,1330,216,1114
2021,Swansea 003B,W01000807,1246,201,1045
2021,Swansea 003C,W01000808,1337,217,1120
2021,Swansea 008A,W01000809,1439,241,1198
2021,Swansea 003D,W01000810,1269,301,968
2021,Swansea 008B,W01000811,1315,221,1094
2021,Swansea 008C,W01000812,1385,284,1101
2021,Swansea 008D,W01000813,1492,258,1234
2021,Swansea 008E,W01000814,1345,221,1124
2021,Swansea 003E,W01000815,1434,236,1198
2021,Swansea 003F,W01000816,1691,314,1377
2021,Swansea 009A,W01000817,1784,411,1373
2021,Swansea 009B,W01000818,1401,313,1088
2021,Swansea 009C,W01000819,1395,196,1199
2021,Swansea 009D,W01000820,1323,222,1101
2021,Swansea 009E,W01000821,1398,264,1134
2021,Swansea 009F,W01000822,1157,157,1000
2021,Swansea 031A,W01000823,1750,335,1415
2021,Swansea 031B,W01000824,1604,286,1318
2021,Swansea 031C,W01000825,1234,191,1043
2021,Swansea 031D,W01000826,1216,190,1026
2021,Swansea 031E,W01000827,1211,204,1007
2021,Swansea 018B,W01000828,1579,221,1358
2021,Swansea 018C,W01000829,1839,323,1516
2021,Swansea 011A,W01000830,1644,508,1136
2021,Swansea 013D,W01000831,1615,390,1225
2021,Swansea 011B,W01000832,1491,333,1158
2021,Swansea 011C,W01000833,1520,400,1120
2021,Swansea 011D,W01000834,1351,368,983
2021,Swansea 013E,W01000835,1363,307,1056
2021,Swansea 011E,W01000836,2217,658,1559
2021,Swansea 004D,W01000837,2182,461,1721
2021,Swansea 004E,W01000838,1174,246,928
2021,Swansea 030C,W01000839,1007,174,833
2021,Swansea 030D,W01000840,1571,268,1303
2021,Swansea 005C,W01000841,1399,248,1151
2021,Swansea 005D,W01000842,1362,228,1134
2021,Swansea 005E,W01000843,1318,263,1055
2021,Swansea 005F,W01000844,1424,326,1098
2021,Swansea 001A,W01000845,1923,387,1536
2021,Swansea 001B,W01000846,1932,406,1526
2021,Swansea 001C,W01000847,1208,215,993
2021,Swansea 001D,W01000848,1134,301,833
2021,Swansea 021A,W01000849,2066,552,1514
2021,Swansea 021C,W01000851,1507,338,1169
2021,Swansea 021D,W01000852,1408,393,1015
2021,Swansea 022A,W01000853,1599,313,1286
2021,Swansea 022B,W01000854,1424,309,1115
2021,Swansea 022C,W01000855,1371,207,1164
2021,Swansea 022D,W01000856,1669,333,1336
2021,Swansea 022E,W01000857,1840,352,1488
2021,Swansea 027A,W01000858,1578,424,1154
2021,Swansea 027B,W01000859,1350,201,1149
2021,Swansea 027C,W01000860,1471,259,1212
2021,Swansea 027D,W01000861,1916,1168,748
2021,Swansea 019A,W01000862,1407,421,986
2021,Swansea 019B,W01000863,1476,379,1097
2021,Swansea 019C,W01000864,1505,459,1046
2021,Swansea 019D,W01000865,1311,336,975
2021,Swansea 019E,W01000866,1109,297,812
2021,Swansea 019F,W01000867,1206,302,904
2021,Swansea 024B,W01000868,1049,186,863
2021,Swansea 024C,W01000869,1486,436,1050
2021,Swansea 024D,W01000870,1331,521,810
2021,Swansea 026B,W01000871,1722,792,930
2021,Swansea 024E,W01000872,1342,281,1061
2021,Swansea 026C,W01000873,1500,945,555
2021,Swansea 024F,W01000874,1756,1007,749
2021,Swansea 026D,W01000875,1863,1079,784
2021,Swansea 026E,W01000876,1608,1042,566
2021,Swansea 007E,W01000877,1596,332,1264
2021,Swansea 007F,W01000878,1217,210,1007
2021,Swansea 029A,W01000879,1617,292,1325
2021,Swansea 029B,W01000880,1490,197,1293
2021,Swansea 029C,W01000881,1272,214,1058
2021,Swansea 029D,W01000882,1640,363,1277
2021,Neath Port Talbot 016A,W01000883,1287,151,1136
2021,Neath Port Talbot 017A,W01000884,1196,242,954
2021,Neath Port Talbot 017B,W01000885,1355,265,1090
2021,Neath Port Talbot 017C,W01000886,1508,320,1188
2021,Neath Port Talbot 021C,W01000887,2262,526,1736
2021,Neath Port Talbot 004A,W01000888,2573,465,2108
2021,Neath Port Talbot 015A,W01000889,1731,290,1441
2021,Neath Port Talbot 015B,W01000890,1477,203,1274
2021,Neath Port Talbot 015C,W01000891,1375,239,1136
2021,Neath Port Talbot 015D,W01000892,1854,348,1506
2021,Neath Port Talbot 003A,W01000893,1836,349,1487
2021,Neath Port Talbot 013A,W01000894,1385,231,1154
2021,Neath Port Talbot 013B,W01000895,1391,214,1177
2021,Neath Port Talbot 013C,W01000896,1471,335,1136
2021,Neath Port Talbot 013D,W01000897,1248,219,1029
2021,Neath Port Talbot 014A,W01000898,1390,224,1166
2021,Neath Port Talbot 014B,W01000899,1773,328,1445
2021,Neath Port Talbot 014C,W01000900,1498,248,1250
2021,Neath Port Talbot 014D,W01000901,1579,302,1277
2021,Neath Port Talbot 006C,W01000904,1417,262,1155
2021,Neath Port Talbot 006D,W01000905,1418,274,1144
2021,Neath Port Talbot 007B,W01000907,1649,332,1317
2021,Neath Port Talbot 006E,W01000908,1541,215,1326
2021,Neath Port Talbot 009A,W01000909,1130,181,949
2021,Neath Port Talbot 009B,W01000910,1317,172,1145
2021,Neath Port Talbot 009C,W01000911,1108,187,921
2021,Neath Port Talbot 010A,W01000912,1146,177,969
2021,Neath Port Talbot 010B,W01000913,1088,189,899
2021,Neath Port Talbot 010C,W01000914,1565,339,1226
2021,Neath Port Talbot 010D,W01000915,1060,192,868
2021,Neath Port Talbot 010E,W01000916,1130,208,922
2021,Neath Port Talbot 002A,W01000918,1840,290,1550
2021,Neath Port Talbot 020A,W01000919,1101,181,920
2021,Neath Port Talbot 021G,W01000921,1367,295,1072
2021,Neath Port Talbot 007C,W01000922,1511,263,1248
2021,Neath Port Talbot 003B,W01000925,1448,282,1166
2021,Neath Port Talbot 003C,W01000926,1765,261,1504
2021,Neath Port Talbot 020B,W01000927,1938,419,1519
2021,Neath Port Talbot 020C,W01000928,1514,246,1268
2021,Neath Port Talbot 020D,W01000929,1192,196,996
2021,Neath Port Talbot 021F,W01000930,1087,198,889
2021,Neath Port Talbot 020E,W01000931,1289,226,1063
2021,Neath Port Talbot 019A,W01000932,975,175,800
2021,Neath Port Talbot 019B,W01000933,1903,416,1487
2021,Neath Port Talbot 008A,W01000934,1181,189,992
2021,Neath Port Talbot 008B,W01000935,1475,242,1233
2021,Neath Port Talbot 012A,W01000936,1288,254,1034
2021,Neath Port Talbot 013E,W01000937,1826,346,1480
2021,Neath Port Talbot 008C,W01000938,1338,204,1134
2021,Neath Port Talbot 008D,W01000939,1108,133,975
2021,Neath Port Talbot 008E,W01000940,1193,267,926
2021,Neath Port Talbot 012B,W01000941,1454,339,1115
2021,Neath Port Talbot 012C,W01000942,1684,384,1300
2021,Neath Port Talbot 012D,W01000943,1418,239,1179
2021,Neath Port Talbot 002B,W01000944,1114,219,895
2021,Neath Port Talbot 014E,W01000945,1109,196,913
2021,Neath Port Talbot 004B,W01000946,1709,340,1369
2021,Neath Port Talbot 004C,W01000947,2046,491,1555
2021,Neath Port Talbot 004D,W01000948,1739,266,1473
2021,Neath Port Talbot 018A,W01000949,1264,209,1055
2021,Neath Port Talbot 018B,W01000950,1378,237,1141
2021,Neath Port Talbot 018C,W01000951,1699,289,1410
2021,Neath Port Talbot 018D,W01000952,1102,211,891
2021,Neath Port Talbot 021B,W01000953,1533,251,1282
2021,Neath Port Talbot 021A,W01000954,1281,187,1094
2021,Neath Port Talbot 004E,W01000955,1307,229,1078
2021,Neath Port Talbot 004F,W01000956,1158,153,1005
2021,Neath Port Talbot 017D,W01000957,1533,245,1288
2021,Neath Port Talbot 016B,W01000958,1486,365,1121
2021,Neath Port Talbot 017E,W01000959,1653,298,1355
2021,Neath Port Talbot 017F,W01000960,1679,323,1356
2021,Neath Port Talbot 016C,W01000961,1503,297,1206
2021,Neath Port Talbot 016D,W01000962,1443,398,1045
2021,Neath Port Talbot 016E,W01000963,1757,366,1391
2021,Neath Port Talbot 016F,W01000964,1708,315,1393
2021,Neath Port Talbot 002C,W01000965,1933,376,1557
2021,Neath Port Talbot 018E,W01000966,1376,230,1146
2021,Neath Port Talbot 019C,W01000967,1340,248,1092
2021,Neath Port Talbot 019D,W01000968,1859,361,1498
2021,Neath Port Talbot 009D,W01000969,1464,240,1224
2021,Neath Port Talbot 021D,W01000970,1064,192,872
2021,Neath Port Talbot 004G,W01000971,1329,243,1086
2021,Neath Port Talbot 020F,W01000973,1269,210,1059
2021,Bridgend 006A,W01000974,2259,366,1893
2021,Bridgend 004A,W01000975,2110,464,1646
2021,Bridgend 003A,W01000976,1033,211,822
2021,Bridgend 003B,W01000977,1352,244,1108
2021,Bridgend 004B,W01000978,1687,324,1363
2021,Bridgend 015A,W01000979,1516,308,1208
2021,Bridgend 016A,W01000980,1267,255,1012
2021,Bridgend 016B,W01000981,1156,311,845
2021,Bridgend 016C,W01000982,1371,180,1191
2021,Bridgend 015B,W01000983,1428,273,1155
2021,Bridgend 016D,W01000984,2057,426,1631
2021,Bridgend 015C,W01000985,1207,200,1007
2021,Bridgend 007A,W01000986,1581,287,1294
2021,Bridgend 007B,W01000987,2268,455,1813
2021,Bridgend 013A,W01000989,1504,221,1283
2021,Bridgend 017B,W01000990,1473,285,1188
2021,Bridgend 001A,W01000991,1068,273,795
2021,Bridgend 001B,W01000992,1313,247,1066
2021,Bridgend 001C,W01000993,1281,236,1045
2021,Bridgend 001D,W01000994,1306,286,1020
2021,Bridgend 001E,W01000995,1295,225,1070
2021,Bridgend 008A,W01000996,1456,265,1191
2021,Bridgend 012A,W01000997,1617,251,1366
2021,Bridgend 010A,W01000999,1331,243,1088
2021,Bridgend 010B,W01001000,1646,287,1359
2021,Bridgend 010C,W01001001,1704,349,1355
2021,Bridgend 010D,W01001002,2262,532,1730
2021,Bridgend 015D,W01001003,1291,146,1145
2021,Bridgend 009A,W01001004,992,178,814
2021,Bridgend 009B,W01001005,1527,227,1300
2021,Bridgend 009C,W01001006,2147,342,1805
2021,Bridgend 009D,W01001007,1773,439,1334
2021,Bridgend 011B,W01001008,2418,336,2082
2021,Bridgend 004C,W01001009,1181,222,959
2021,Bridgend 012B,W01001010,1099,228,871
2021,Bridgend 012C,W01001011,1214,207,1007
2021,Bridgend 005A,W01001012,1444,285,1159
2021,Bridgend 005B,W01001013,1404,245,1159
2021,Bridgend 002A,W01001014,1545,252,1293
2021,Bridgend 002B,W01001015,1399,293,1106
2021,Bridgend 005C,W01001016,1565,240,1325
2021,Bridgend 002C,W01001017,1403,263,1140
2021,Bridgend 002D,W01001018,1227,185,1042
2021,Bridgend 005D,W01001019,1504,309,1195
2021,Bridgend 002E,W01001020,1294,235,1059
2021,Bridgend 014A,W01001021,1528,249,1279
2021,Bridgend 014B,W01001022,1345,309,1036
2021,Bridgend 014C,W01001023,1567,262,1305
2021,Bridgend 003C,W01001024,1080,199,881
2021,Bridgend 003D,W01001025,1167,231,936
2021,Bridgend 012D,W01001026,1900,371,1529
2021,Bridgend 017C,W01001027,1440,203,1237
2021,Bridgend 014D,W01001028,1806,243,1563
2021,Bridgend 019A,W01001029,1670,186,1484
2021,Bridgend 019B,W01001030,1880,295,1585
2021,Bridgend 018A,W01001031,1422,171,1251
2021,Bridgend 018B,W01001032,1700,245,1455
2021,Bridgend 003E,W01001033,1663,327,1336
2021,Bridgend 003F,W01001034,1274,206,1068
2021,Bridgend 014E,W01001035,1638,327,1311
2021,Bridgend 017D,W01001036,1548,268,1280
2021,Bridgend 013B,W01001037,1724,282,1442
2021,Bridgend 011C,W01001038,2431,426,2005
2021,Bridgend 009E,W01001039,1627,312,1315
2021,Bridgend 009F,W01001040,1500,264,1236
2021,Bridgend 013C,W01001041,2205,374,1831
2021,Bridgend 004D,W01001042,1200,208,992
2021,Bridgend 004E,W01001043,1102,203,899
2021,Bridgend 019C,W01001044,1528,234,1294
2021,Bridgend 019D,W01001045,1647,268,1379
2021,Bridgend 018C,W01001046,1871,225,1646
2021,Bridgend 018D,W01001047,1613,267,1346
2021,Bridgend 008B,W01001048,1350,211,1139
2021,Bridgend 008C,W01001049,1234,278,956
2021,Bridgend 008D,W01001050,1458,283,1175
2021,Bridgend 008E,W01001051,1715,379,1336
2021,Bridgend 008F,W01001052,1218,230,988
2021,Bridgend 018E,W01001053,977,106,871
2021,Bridgend 018F,W01001054,1313,183,1130
2021,Bridgend 007C,W01001055,1141,242,899
2021,Bridgend 007D,W01001056,1136,154,982
2021,Bridgend 006B,W01001057,1635,284,1351
2021,Bridgend 006C,W01001058,1793,337,1456
2021,Vale of Glamorgan 015A,W01001059,1669,340,1329
2021,Vale of Glamorgan 015B,W01001060,1351,188,1163
2021,Vale of Glamorgan 013A,W01001062,1282,240,1042
2021,Vale of Glamorgan 012A,W01001063,1489,291,1198
2021,Vale of Glamorgan 013B,W01001064,1344,254,1090
2021,Vale of Glamorgan 012B,W01001065,1480,311,1169
2021,Vale of Glamorgan 015D,W01001066,1536,284,1252
2021,Vale of Glamorgan 009A,W01001067,1312,256,1056
2021,Vale of Glamorgan 009B,W01001068,1543,310,1233
2021,Vale of Glamorgan 012C,W01001069,1440,268,1172
2021,Vale of Glamorgan 009C,W01001070,961,178,783
2021,Vale of Glamorgan 009D,W01001071,1406,262,1144
2021,Vale of Glamorgan 009E,W01001072,2562,550,2012
2021,Vale of Glamorgan 015E,W01001073,1966,369,1597
2021,Vale of Glamorgan 004A,W01001075,1115,223,892
2021,Vale of Glamorgan 004B,W01001076,1305,268,1037
2021,Vale of Glamorgan 004C,W01001077,1355,238,1117
2021,Vale of Glamorgan 004D,W01001078,1224,247,977
2021,Vale of Glamorgan 012E,W01001079,1379,301,1078
2021,Vale of Glamorgan 012F,W01001080,1486,336,1150
2021,Vale of Glamorgan 007A,W01001081,1629,386,1243
2021,Vale of Glamorgan 002A,W01001082,1505,241,1264
2021,Vale of Glamorgan 002B,W01001083,1630,298,1332
2021,Vale of Glamorgan 002C,W01001084,1605,288,1317
2021,Vale of Glamorgan 002D,W01001085,1563,320,1243
2021,Vale of Glamorgan 006A,W01001086,1439,221,1218
2021,Vale of Glamorgan 006B,W01001087,1439,259,1180
2021,Vale of Glamorgan 006C,W01001088,2009,351,1658
2021,Vale of Glamorgan 006D,W01001089,1518,217,1301
2021,Vale of Glamorgan 006E,W01001090,1377,212,1165
2021,Vale of Glamorgan 010A,W01001091,1569,193,1376
2021,Vale of Glamorgan 007B,W01001092,1973,424,1549
2021,Vale of Glamorgan 013C,W01001093,1677,300,1377
2021,Vale of Glamorgan 007C,W01001094,1157,276,881
2021,Vale of Glamorgan 007D,W01001095,1289,301,988
2021,Vale of Glamorgan 007E,W01001096,1244,205,1039
2021,Vale of Glamorgan 007F,W01001097,1415,352,1063
2021,Vale of Glamorgan 010B,W01001098,992,143,849
2021,Vale of Glamorgan 013D,W01001099,1130,215,915
2021,Vale of Glamorgan 010C,W01001100,1433,239,1194
2021,Vale of Glamorgan 013E,W01001101,1438,286,1152
2021,Vale of Glamorgan 013F,W01001102,1431,292,1139
2021,Vale of Glamorgan 010D,W01001103,1131,160,971
2021,Vale of Glamorgan 004E,W01001104,2001,387,1614
2021,Vale of Glamorgan 001A,W01001105,2698,493,2205
2021,Vale of Glamorgan 011A,W01001106,1389,219,1170
2021,Vale of Glamorgan 011B,W01001107,1448,198,1250
2021,Vale of Glamorgan 014A,W01001108,1704,368,1336
2021,Vale of Glamorgan 011C,W01001109,1326,210,1116
2021,Vale of Glamorgan 011D,W01001110,1635,456,1179
2021,Vale of Glamorgan 011E,W01001111,1286,274,1012
2021,Vale of Glamorgan 011F,W01001112,1252,224,1028
2021,Vale of Glamorgan 003A,W01001113,2226,436,1790
2021,Vale of Glamorgan 008A,W01001114,1518,269,1249
2021,Vale of Glamorgan 008B,W01001115,2049,464,1585
2021,Vale of Glamorgan 005A,W01001116,1874,321,1553
2021,Vale of Glamorgan 014B,W01001117,1238,169,1069
2021,Vale of Glamorgan 003B,W01001119,1786,327,1459
2021,Vale of Glamorgan 014D,W01001120,1299,184,1115
2021,Vale of Glamorgan 014E,W01001121,1631,313,1318
2021,Vale of Glamorgan 014F,W01001122,2287,537,1750
2021,Vale of Glamorgan 005B,W01001123,1433,217,1216
2021,Vale of Glamorgan 005C,W01001124,1392,264,1128
2021,Vale of Glamorgan 005D,W01001125,1360,257,1103
2021,Vale of Glamorgan 001B,W01001127,1554,261,1293
2021,Vale of Glamorgan 001C,W01001128,1595,283,1312
2021,Vale of Glamorgan 004F,W01001129,1555,439,1116
2021,Vale of Glamorgan 005F,W01001130,1213,280,933
2021,Vale of Glamorgan 008C,W01001131,1607,366,1241
2021,Vale of Glamorgan 008D,W01001132,1278,225,1053
2021,Vale of Glamorgan 008E,W01001133,2150,416,1734
2021,Vale of Glamorgan 008F,W01001134,1063,180,883
2021,Vale of Glamorgan 003C,W01001135,2190,351,1839
2021,Vale of Glamorgan 003D,W01001136,1428,196,1232
2021,Rhondda Cynon Taf 005A,W01001137,2234,399,1835
2021,Rhondda Cynon Taf 005B,W01001138,1242,230,1012
2021,Rhondda Cynon Taf 005C,W01001139,1316,251,1065
2021,Rhondda Cynon Taf 005D,W01001140,1329,195,1134
2021,Rhondda Cynon Taf 005E,W01001141,1413,278,1135
2021,Rhondda Cynon Taf 005F,W01001142,1791,364,1427
2021,Rhondda Cynon Taf 012A,W01001143,1410,254,1156
2021,Rhondda Cynon Taf 012B,W01001144,1608,368,1240
2021,Rhondda Cynon Taf 012C,W01001145,1645,314,1331
2021,Rhondda Cynon Taf 012D,W01001146,1335,227,1108
2021,Rhondda Cynon Taf 004A,W01001147,1735,245,1490
2021,Rhondda Cynon Taf 002A,W01001148,1648,296,1352
2021,Rhondda Cynon Taf 003A,W01001149,1338,245,1093
2021,Rhondda Cynon Taf 003B,W01001150,1742,337,1405
2021,Rhondda Cynon Taf 003C,W01001151,1740,305,1435
2021,Rhondda Cynon Taf 002B,W01001152,1841,299,1542
2021,Rhondda Cynon Taf 002C,W01001153,1485,315,1170
2021,Rhondda Cynon Taf 003D,W01001154,1332,203,1129
2021,Rhondda Cynon Taf 002D,W01001155,1452,216,1236
2021,Rhondda Cynon Taf 003E,W01001156,1357,259,1098
2021,Rhondda Cynon Taf 028A,W01001157,1240,185,1055
2021,Rhondda Cynon Taf 028B,W01001158,1397,265,1132
2021,Rhondda Cynon Taf 028C,W01001159,1474,272,1202
2021,Rhondda Cynon Taf 029A,W01001160,1558,271,1287
2021,Rhondda Cynon Taf 025A,W01001162,2357,556,1801
2021,Rhondda Cynon Taf 019A,W01001164,1472,279,1193
2021,Rhondda Cynon Taf 019B,W01001165,1277,239,1038
2021,Rhondda Cynon Taf 016A,W01001166,1291,306,985
2021,Rhondda Cynon Taf 016B,W01001167,1334,260,1074
2021,Rhondda Cynon Taf 004B,W01001168,1324,249,1075
2021,Rhondda Cynon Taf 004C,W01001169,2365,539,1826
2021,Rhondda Cynon Taf 004D,W01001170,1147,170,977
2021,Rhondda Cynon Taf 017A,W01001171,1238,183,1055
2021,Rhondda Cynon Taf 020A,W01001172,1328,237,1091
2021,Rhondda Cynon Taf 020B,W01001173,1288,238,1050
2021,Rhondda Cynon Taf 020C,W01001174,1322,269,1053
2021,Rhondda Cynon Taf 009A,W01001175,1237,205,1032
2021,Rhondda Cynon Taf 013A,W01001176,1362,283,1079
2021,Rhondda Cynon Taf 009B,W01001177,1237,212,1025
2021,Rhondda Cynon Taf 023A,W01001178,1532,292,1240
2021,Rhondda Cynon Taf 023B,W01001179,1629,316,1313
2021,Rhondda Cynon Taf 015A,W01001180,1432,353,1079
2021,Rhondda Cynon Taf 015B,W01001181,1316,198,1118
2021,Rhondda Cynon Taf 026A,W01001184,1986,310,1676
2021,Rhondda Cynon Taf 022A,W01001185,1922,328,1594
2021,Rhondda Cynon Taf 001A,W01001186,1654,391,1263
2021,Rhondda Cynon Taf 001B,W01001187,1298,210,1088
2021,Rhondda Cynon Taf 001C,W01001188,1235,234,1001
2021,Rhondda Cynon Taf 029C,W01001189,1431,272,1159
2021,Rhondda Cynon Taf 029D,W01001190,2794,579,2215
2021,Rhondda Cynon Taf 031B,W01001192,1351,304,1047
2021,Rhondda Cynon Taf 030A,W01001193,1101,207,894
2021,Rhondda Cynon Taf 030B,W01001194,2012,403,1609
2021,Rhondda Cynon Taf 030C,W01001195,1398,233,1165
2021,Rhondda Cynon Taf 027B,W01001196,1375,232,1143
2021,Rhondda Cynon Taf 027C,W01001197,1166,200,966
2021,Rhondda Cynon Taf 027D,W01001198,1430,243,1187
2021,Rhondda Cynon Taf 027E,W01001199,1578,278,1300
2021,Rhondda Cynon Taf 009C,W01001202,1665,292,1373
2021,Rhondda Cynon Taf 009D,W01001203,1279,261,1018
2021,Rhondda Cynon Taf 006A,W01001204,1446,249,1197
2021,Rhondda Cynon Taf 006B,W01001205,1402,224,1178
2021,Rhondda Cynon Taf 006C,W01001206,1392,273,1119
2021,Rhondda Cynon Taf 006D,W01001207,1198,237,961
2021,Rhondda Cynon Taf 006E,W01001208,1431,253,1178
2021,Rhondda Cynon Taf 008A,W01001209,1381,338,1043
2021,Rhondda Cynon Taf 008B,W01001210,1378,248,1130
2021,Rhondda Cynon Taf 008C,W01001211,1444,323,1121
2021,Rhondda Cynon Taf 008D,W01001212,1232,265,967
2021,Rhondda Cynon Taf 011B,W01001214,1251,252,999
2021,Rhondda Cynon Taf 011D,W01001216,1433,272,1161
2021,Rhondda Cynon Taf 018A,W01001217,1055,227,828
2021,Rhondda Cynon Taf 018B,W01001218,1444,270,1174
2021,Rhondda Cynon Taf 018C,W01001219,1155,188,967
2021,Rhondda Cynon Taf 018D,W01001220,1415,292,1123
2021,Rhondda Cynon Taf 001D,W01001221,1355,284,1071
2021,Rhondda Cynon Taf 001E,W01001222,1445,378,1067
2021,Rhondda Cynon Taf 031C,W01001223,1665,275,1390
2021,Rhondda Cynon Taf 031D,W01001224,1943,499,1444
2021,Rhondda Cynon Taf 031E,W01001225,1508,261,1247
2021,Rhondda Cynon Taf 031F,W01001226,1616,391,1225
2021,Rhondda Cynon Taf 021C,W01001227,1206,194,1012
2021,Rhondda Cynon Taf 021D,W01001228,1556,289,1267
2021,Rhondda Cynon Taf 017B,W01001229,1345,238,1107
2021,Rhondda Cynon Taf 017C,W01001230,1480,266,1214
2021,Rhondda Cynon Taf 017D,W01001231,1361,239,1122
2021,Rhondda Cynon Taf 020D,W01001232,1204,205,999
2021,Rhondda Cynon Taf 001F,W01001233,1747,305,1442
2021,Rhondda Cynon Taf 021E,W01001234,1420,255,1165
2021,Rhondda Cynon Taf 021F,W01001235,1555,294,1261
2021,Rhondda Cynon Taf 021G,W01001236,1529,273,1256
2021,Rhondda Cynon Taf 022B,W01001237,1381,281,1100
2021,Rhondda Cynon Taf 022C,W01001238,1612,435,1177
2021,Rhondda Cynon Taf 026B,W01001239,1246,254,992
2021,Rhondda Cynon Taf 026C,W01001240,1829,270,1559
2021,Rhondda Cynon Taf 026D,W01001241,1573,286,1287
2021,Rhondda Cynon Taf 030D,W01001242,1302,229,1073
2021,Rhondda Cynon Taf 030E,W01001243,1343,218,1125
2021,Rhondda Cynon Taf 025B,W01001244,1338,202,1136
2021,Rhondda Cynon Taf 025C,W01001245,1178,175,1003
2021,Rhondda Cynon Taf 025D,W01001246,1290,214,1076
2021,Rhondda Cynon Taf 016C,W01001247,1507,294,1213
2021,Rhondda Cynon Taf 016D,W01001248,1890,358,1532
2021,Rhondda Cynon Taf 024A,W01001249,1393,217,1176
2021,Rhondda Cynon Taf 024B,W01001250,1462,266,1196
2021,Rhondda Cynon Taf 024C,W01001251,1407,295,1112
2021,Rhondda Cynon Taf 024D,W01001252,1490,241,1249
2021,Rhondda Cynon Taf 023C,W01001253,1375,285,1090
2021,Rhondda Cynon Taf 023E,W01001255,1878,406,1472
2021,Rhondda Cynon Taf 019C,W01001256,1130,213,917
2021,Rhondda Cynon Taf 019D,W01001257,1187,195,992
2021,Rhondda Cynon Taf 019E,W01001258,1194,198,996
2021,Rhondda Cynon Taf 018E,W01001259,1524,280,1244
2021,Rhondda Cynon Taf 014C,W01001260,1105,247,858
2021,Rhondda Cynon Taf 018F,W01001261,1181,232,949
2021,Rhondda Cynon Taf 022D,W01001262,1492,664,828
2021,Rhondda Cynon Taf 022E,W01001263,1619,858,761
2021,Rhondda Cynon Taf 022F,W01001264,1869,1242,627
2021,Rhondda Cynon Taf 007A,W01001265,1445,242,1203
2021,Rhondda Cynon Taf 007B,W01001266,1299,269,1030
2021,Rhondda Cynon Taf 007C,W01001267,1393,234,1159
2021,Rhondda Cynon Taf 007D,W01001268,1240,222,1018
2021,Rhondda Cynon Taf 010A,W01001269,1375,213,1162
2021,Rhondda Cynon Taf 010B,W01001270,1379,191,1188
2021,Rhondda Cynon Taf 010C,W01001271,1445,245,1200
2021,Rhondda Cynon Taf 010D,W01001272,1393,291,1102
2021,Rhondda Cynon Taf 010E,W01001273,1680,341,1339
2021,Rhondda Cynon Taf 013B,W01001274,1115,262,853
2021,Rhondda Cynon Taf 013C,W01001275,1687,340,1347
2021,Rhondda Cynon Taf 013D,W01001276,1215,199,1016
2021,Rhondda Cynon Taf 028D,W01001277,1072,181,891
2021,Rhondda Cynon Taf 028E,W01001278,1083,253,830
2021,Rhondda Cynon Taf 028F,W01001279,1045,208,837
2021,Rhondda Cynon Taf 017E,W01001280,1468,265,1203
2021,Rhondda Cynon Taf 017F,W01001281,1600,304,1296
2021,Rhondda Cynon Taf 015C,W01001282,1915,377,1538
2021,Rhondda Cynon Taf 015D,W01001283,1378,254,1124
2021,Rhondda Cynon Taf 015E,W01001284,1029,184,845
2021,Rhondda Cynon Taf 014D,W01001285,1314,196,1118
2021,Rhondda Cynon Taf 014E,W01001286,1385,323,1062
2021,Rhondda Cynon Taf 014F,W01001287,1388,221,1167
2021,Rhondda Cynon Taf 014G,W01001288,1362,263,1099
2021,Merthyr Tydfil 006A,W01001289,1288,237,1051
2021,Merthyr Tydfil 007A,W01001290,2243,445,1798
2021,Merthyr Tydfil 003A,W01001291,1954,441,1513
2021,Merthyr Tydfil 004A,W01001292,1692,440,1252
2021,Merthyr Tydfil 004B,W01001293,1602,308,1294
2021,Merthyr Tydfil 003B,W01001294,1596,292,1304
2021,Merthyr Tydfil 002A,W01001295,1417,260,1157
2021,Merthyr Tydfil 002B,W01001296,1489,248,1241
2021,Merthyr Tydfil 002C,W01001297,1729,305,1424
2021,Merthyr Tydfil 002D,W01001298,1629,290,1339
2021,Merthyr Tydfil 008A,W01001299,1546,376,1170
2021,Merthyr Tydfil 008B,W01001300,1630,401,1229
2021,Merthyr Tydfil 008C,W01001301,1787,448,1339
2021,Merthyr Tydfil 006B,W01001302,1323,242,1081
2021,Merthyr Tydfil 003C,W01001305,1163,219,944
2021,Merthyr Tydfil 003D,W01001306,1352,192,1160
2021,Merthyr Tydfil 004C,W01001307,1460,266,1194
2021,Merthyr Tydfil 008D,W01001308,1168,290,878
2021,Merthyr Tydfil 008E,W01001309,1223,290,933
2021,Merthyr Tydfil 002E,W01001310,1454,267,1187
2021,Merthyr Tydfil 002F,W01001311,1044,211,833
2021,Merthyr Tydfil 006E,W01001312,1397,180,1217
2021,Merthyr Tydfil 006F,W01001313,1412,219,1193
2021,Merthyr Tydfil 005A,W01001314,2005,394,1611
2021,Merthyr Tydfil 004D,W01001315,1630,204,1426
2021,Merthyr Tydfil 005C,W01001317,1650,318,1332
2021,Merthyr Tydfil 005D,W01001318,1395,227,1168
2021,Merthyr Tydfil 007B,W01001319,1540,229,1311
2021,Merthyr Tydfil 007C,W01001320,1368,216,1152
2021,Merthyr Tydfil 007D,W01001321,1520,314,1206
2021,Merthyr Tydfil 007E,W01001322,1539,275,1264
2021,Merthyr Tydfil 003E,W01001324,1837,305,1532
2021,Caerphilly 003A,W01001325,1562,349,1213
2021,Caerphilly 003B,W01001326,2026,412,1614
2021,Caerphilly 014A,W01001327,2287,392,1895
2021,Caerphilly 014B,W01001328,1433,255,1178
2021,Caerphilly 014C,W01001329,1420,292,1128
2021,Caerphilly 018A,W01001330,1366,275,1091
2021,Caerphilly 018B,W01001331,1624,343,1281
2021,Caerphilly 018C,W01001332,1721,374,1347
2021,Caerphilly 018D,W01001333,1377,329,1048
2021,Caerphilly 005A,W01001334,1359,301,1058
2021,Caerphilly 005B,W01001335,1217,205,1012
2021,Caerphilly 004A,W01001336,1337,249,1088
2021,Caerphilly 004B,W01001337,1381,248,1133
2021,Caerphilly 004C,W01001338,1621,283,1338
2021,Caerphilly 004D,W01001339,1306,264,1042
2021,Caerphilly 020A,W01001340,1787,295,1492
2021,Caerphilly 020B,W01001341,1616,303,1313
2021,Caerphilly 021A,W01001342,1134,230,904
2021,Caerphilly 021B,W01001343,1042,177,865
2021,Caerphilly 020C,W01001344,1605,290,1315
2021,Caerphilly 021C,W01001345,1294,359,935
2021,Caerphilly 020D,W01001346,1432,311,1121
2021,Caerphilly 005C,W01001347,1435,227,1208
2021,Caerphilly 009A,W01001348,1669,396,1273
2021,Caerphilly 009B,W01001349,1652,322,1330
2021,Caerphilly 009C,W01001350,1644,271,1373
2021,Caerphilly 005D,W01001351,1355,157,1198
2021,Caerphilly 007A,W01001352,1656,287,1369
2021,Caerphilly 007B,W01001353,1473,225,1248
2021,Caerphilly 014D,W01001354,1598,273,1325
2021,Caerphilly 015A,W01001355,1470,230,1240
2021,Caerphilly 006A,W01001356,1147,210,937
2021,Caerphilly 006B,W01001357,1608,302,1306
2021,Caerphilly 006C,W01001358,1399,289,1110
2021,Caerphilly 006D,W01001359,1333,193,1140
2021,Caerphilly 002A,W01001360,1244,209,1035
2021,Caerphilly 002B,W01001361,1099,194,905
2021,Caerphilly 003C,W01001362,1903,327,1576
2021,Caerphilly 012A,W01001363,1686,341,1345
2021,Caerphilly 012B,W01001364,1671,407,1264
2021,Caerphilly 012C,W01001365,1855,336,1519
2021,Caerphilly 019A,W01001366,1502,257,1245
2021,Caerphilly 019B,W01001367,1371,244,1127
2021,Caerphilly 019C,W01001368,1357,252,1105
2021,Caerphilly 012D,W01001369,2307,391,1916
2021,Caerphilly 023A,W01001370,1756,312,1444
2021,Caerphilly 022A,W01001371,1785,374,1411
2021,Caerphilly 022B,W01001372,1734,291,1443
2021,Caerphilly 022C,W01001373,1822,369,1453
2021,Caerphilly 001A,W01001374,1348,257,1091
2021,Caerphilly 001B,W01001375,1402,193,1209
2021,Caerphilly 001C,W01001376,1343,242,1101
2021,Caerphilly 013A,W01001377,1392,189,1203
2021,Caerphilly 013B,W01001378,1431,205,1226
2021,Caerphilly 013C,W01001379,1449,284,1165
2021,Caerphilly 010A,W01001380,1690,280,1410
2021,Caerphilly 010B,W01001381,1391,315,1076
2021,Caerphilly 010C,W01001382,1480,267,1213
2021,Caerphilly 010D,W01001383,1385,257,1128
2021,Caerphilly 002C,W01001384,1406,228,1178
2021,Caerphilly 002D,W01001385,1442,251,1191
2021,Caerphilly 002E,W01001386,1490,312,1178
2021,Caerphilly 007C,W01001387,1133,216,917
2021,Caerphilly 007D,W01001388,1689,358,1331
2021,Caerphilly 007E,W01001389,1059,187,872
2021,Caerphilly 006E,W01001390,1988,450,1538
2021,Caerphilly 006F,W01001391,1543,317,1226
2021,Caerphilly 009D,W01001392,1867,338,1529
2021,Caerphilly 019D,W01001393,1268,265,1003
2021,Caerphilly 023B,W01001394,1231,235,996
2021,Caerphilly 023C,W01001395,1255,217,1038
2021,Caerphilly 023D,W01001396,1462,332,1130
2021,Caerphilly 019E,W01001397,1498,261,1237
2021,Caerphilly 024A,W01001398,2614,620,1994
2021,Caerphilly 023E,W01001399,1205,208,997
2021,Caerphilly 019F,W01001400,1316,320,996
2021,Caerphilly 011A,W01001401,1954,340,1614
2021,Caerphilly 011B,W01001402,1503,330,1173
2021,Caerphilly 011C,W01001403,1506,289,1217
2021,Caerphilly 011D,W01001404,1298,173,1125
2021,Caerphilly 011E,W01001405,1697,329,1368
2021,Caerphilly 001D,W01001406,1743,260,1483
2021,Caerphilly 016A,W01001407,1251,198,1053
2021,Caerphilly 016B,W01001408,1359,285,1074
2021,Caerphilly 016C,W01001409,1504,233,1271
2021,Caerphilly 016D,W01001410,1697,300,1397
2021,Caerphilly 017A,W01001411,1543,230,1313
2021,Caerphilly 017B,W01001412,1579,216,1363
2021,Caerphilly 017C,W01001413,1725,317,1408
2021,Caerphilly 008A,W01001414,1480,274,1206
2021,Caerphilly 008B,W01001415,1632,325,1307
2021,Caerphilly 008C,W01001416,1322,169,1153
2021,Caerphilly 008D,W01001417,1309,213,1096
2021,Caerphilly 008E,W01001418,1316,223,1093
2021,Caerphilly 021D,W01001419,1545,288,1257
2021,Caerphilly 022D,W01001420,1156,179,977
2021,Caerphilly 022E,W01001421,1345,313,1032
2021,Caerphilly 022F,W01001422,1389,296,1093
2021,Caerphilly 024B,W01001423,1313,155,1158
2021,Caerphilly 024C,W01001424,1335,230,1105
2021,Caerphilly 024D,W01001425,1654,298,1356
2021,Caerphilly 024E,W01001426,1376,246,1130
2021,Caerphilly 024F,W01001427,1754,401,1353
2021,Caerphilly 001E,W01001428,1156,250,906
2021,Caerphilly 001F,W01001429,1113,186,927
2021,Caerphilly 015B,W01001430,2244,447,1797
2021,Caerphilly 015C,W01001431,1502,251,1251
2021,Caerphilly 013D,W01001432,2579,590,1989
2021,Caerphilly 013E,W01001433,1298,221,1077
2021,Caerphilly 013F,W01001434,1310,254,1056
2021,Blaenau Gwent 008A,W01001435,1282,210,1072
2021,Blaenau Gwent 008B,W01001436,1297,205,1092
2021,Blaenau Gwent 008C,W01001437,1373,224,1149
2021,Blaenau Gwent 004A,W01001438,1410,227,1183
2021,Blaenau Gwent 004B,W01001439,1522,252,1270
2021,Blaenau Gwent 001A,W01001440,1276,220,1056
2021,Blaenau Gwent 001B,W01001441,1080,212,868
2021,Blaenau Gwent 001C,W01001442,1042,161,881
2021,Blaenau Gwent 005A,W01001443,1175,163,1012
2021,Blaenau Gwent 005B,W01001444,1862,381,1481
2021,Blaenau Gwent 005C,W01001445,1279,232,1047
2021,Blaenau Gwent 002A,W01001446,1178,192,986
2021,Blaenau Gwent 002B,W01001447,1393,308,1085
2021,Blaenau Gwent 002C,W01001448,1108,161,947
2021,Blaenau Gwent 002D,W01001449,1301,186,1115
2021,Blaenau Gwent 007A,W01001450,1157,193,964
2021,Blaenau Gwent 007B,W01001451,1230,187,1043
2021,Blaenau Gwent 007C,W01001452,1379,226,1153
2021,Blaenau Gwent 008D,W01001453,1409,291,1118
2021,Blaenau Gwent 008E,W01001454,1210,200,1010
2021,Blaenau Gwent 008F,W01001455,1580,254,1326
2021,Blaenau Gwent 004C,W01001456,1195,191,1004
2021,Blaenau Gwent 004D,W01001457,1677,353,1324
2021,Blaenau Gwent 004E,W01001458,1536,253,1283
2021,Blaenau Gwent 007D,W01001459,1122,285,837
2021,Blaenau Gwent 007E,W01001460,1645,258,1387
2021,Blaenau Gwent 007F,W01001461,1204,222,982
2021,Blaenau Gwent 006A,W01001462,1707,310,1397
2021,Blaenau Gwent 006B,W01001463,1709,305,1404
2021,Blaenau Gwent 009A,W01001464,1369,245,1124
2021,Blaenau Gwent 009B,W01001465,1453,259,1194
2021,Blaenau Gwent 009C,W01001466,1378,204,1174
2021,Blaenau Gwent 005D,W01001467,1786,391,1395
2021,Blaenau Gwent 005E,W01001468,1255,182,1073
2021,Blaenau Gwent 005F,W01001469,1232,226,1006
2021,Blaenau Gwent 001D,W01001470,1336,165,1171
2021,Blaenau Gwent 001E,W01001471,1534,306,1228
2021,Blaenau Gwent 003A,W01001472,1313,181,1132
2021,Blaenau Gwent 003B,W01001473,1188,233,955
2021,Blaenau Gwent 003C,W01001474,1359,225,1134
2021,Blaenau Gwent 003D,W01001475,1065,177,888
2021,Blaenau Gwent 006C,W01001478,1298,183,1115
2021,Blaenau Gwent 006D,W01001479,1364,293,1071
2021,Blaenau Gwent 003E,W01001480,1382,254,1128
2021,Blaenau Gwent 006E,W01001481,1570,247,1323
2021,Torfaen 002A,W01001482,1163,242,921
2021,Torfaen 002B,W01001483,1335,326,1009
2021,Torfaen 002C,W01001484,1568,272,1296
2021,Torfaen 002D,W01001485,1188,234,954
2021,Torfaen 002E,W01001486,1405,258,1147
2021,Torfaen 001A,W01001487,1577,297,1280
2021,Torfaen 001B,W01001488,1397,280,1117
2021,Torfaen 001C,W01001489,1364,249,1115
2021,Torfaen 001D,W01001490,1335,276,1059
2021,Torfaen 004A,W01001491,1596,298,1298
2021,Torfaen 012A,W01001492,2301,461,1840
2021,Torfaen 008A,W01001493,1700,264,1436
2021,Torfaen 008B,W01001494,1468,267,1201
2021,Torfaen 008C,W01001495,1725,275,1450
2021,Torfaen 004B,W01001496,1369,250,1119
2021,Torfaen 011A,W01001497,1307,257,1050
2021,Torfaen 011B,W01001498,1175,258,917
2021,Torfaen 011C,W01001499,1088,187,901
2021,Torfaen 011D,W01001500,1194,203,991
2021,Torfaen 009A,W01001501,1239,282,957
2021,Torfaen 011E,W01001502,1156,204,952
2021,Torfaen 009B,W01001503,1152,276,876
2021,Torfaen 013A,W01001504,2185,418,1767
2021,Torfaen 013B,W01001505,2484,397,2087
2021,Torfaen 010A,W01001506,1441,182,1259
2021,Torfaen 008D,W01001507,1843,326,1517
2021,Torfaen 013C,W01001508,1133,169,964
2021,Torfaen 013D,W01001509,1342,196,1146
2021,Torfaen 005A,W01001510,1519,253,1266
2021,Torfaen 005B,W01001511,1463,240,1223
2021,Torfaen 005C,W01001512,1252,130,1122
2021,Torfaen 005D,W01001513,1403,211,1192
2021,Torfaen 006A,W01001514,1039,137,902
2021,Torfaen 006B,W01001515,1334,200,1134
2021,Torfaen 006C,W01001516,1348,242,1106
2021,Torfaen 006D,W01001517,2308,461,1847
2021,Torfaen 006E,W01001518,1090,204,886
2021,Torfaen 007A,W01001519,1202,237,965
2021,Torfaen 007B,W01001520,2437,457,1980
2021,Torfaen 007C,W01001521,1336,248,1088
2021,Torfaen 007D,W01001522,1534,259,1275
2021,Torfaen 004C,W01001523,1348,230,1118
2021,Torfaen 004D,W01001524,1778,242,1536
2021,Torfaen 003A,W01001525,1736,376,1360
2021,Torfaen 010B,W01001526,1299,266,1033
2021,Torfaen 010C,W01001527,1130,154,976
2021,Torfaen 010D,W01001528,1628,300,1328
2021,Torfaen 003B,W01001529,1892,312,1580
2021,Torfaen 003C,W01001530,1642,469,1173
2021,Torfaen 003D,W01001531,1585,325,1260
2021,Torfaen 010E,W01001532,1661,352,1309
2021,Torfaen 012B,W01001533,1444,244,1200
2021,Torfaen 012C,W01001534,1334,234,1100
2021,Torfaen 012D,W01001535,1192,158,1034
2021,Torfaen 009C,W01001536,1060,255,805
2021,Torfaen 007E,W01001537,1124,171,953
2021,Torfaen 009D,W01001538,1245,274,971
2021,Torfaen 009E,W01001539,1356,293,1063
2021,Torfaen 004E,W01001540,1205,229,976
2021,Torfaen 004F,W01001541,1115,197,918
2021,Monmouthshire 009A,W01001542,2021,350,1671
2021,Monmouthshire 009B,W01001543,1701,339,1362
2021,Monmouthshire 001A,W01001545,1467,212,1255
2021,Monmouthshire 002A,W01001546,1460,317,1143
2021,Monmouthshire 001B,W01001548,2013,268,1745
2021,Monmouthshire 007A,W01001549,1358,204,1154
2021,Monmouthshire 010C,W01001551,1110,231,879
2021,Monmouthshire 004A,W01001552,1471,254,1217
2021,Monmouthshire 004C,W01001554,1493,303,1190
2021,Monmouthshire 006A,W01001555,1106,136,970
2021,Monmouthshire 006B,W01001556,1307,194,1113
2021,Monmouthshire 001C,W01001557,1729,240,1489
2021,Monmouthshire 002C,W01001558,1512,276,1236
2021,Monmouthshire 008A,W01001559,1229,204,1025
2021,Monmouthshire 006C,W01001560,1330,192,1138
2021,Monmouthshire 003A,W01001561,1544,213,1331
2021,Monmouthshire 003B,W01001562,1318,197,1121
2021,Monmouthshire 003C,W01001563,1085,188,897
2021,Monmouthshire 006D,W01001565,1757,238,1519
2021,Monmouthshire 005C,W01001568,1729,262,1467
2021,Monmouthshire 003E,W01001569,1293,176,1117
2021,Monmouthshire 001D,W01001571,1436,203,1233
2021,Monmouthshire 011A,W01001572,1536,266,1270
2021,Monmouthshire 011B,W01001573,1367,239,1128
2021,Monmouthshire 011C,W01001574,1251,194,1057
2021,Monmouthshire 005D,W01001575,1199,204,995
2021,Monmouthshire 004D,W01001576,1021,174,847
2021,Monmouthshire 004E,W01001577,1223,221,1002
2021,Monmouthshire 009C,W01001578,2376,360,2016
2021,Monmouthshire 001E,W01001579,1518,148,1370
2021,Monmouthshire 002E,W01001580,1691,305,1386
2021,Monmouthshire 005E,W01001581,1874,280,1594
2021,Monmouthshire 011D,W01001582,1695,319,1376
2021,Monmouthshire 007B,W01001583,1469,220,1249
2021,Monmouthshire 008B,W01001584,1687,300,1387
2021,Monmouthshire 007C,W01001585,1228,207,1021
2021,Monmouthshire 007D,W01001586,2375,480,1895
2021,Monmouthshire 008C,W01001587,1782,210,1572
2021,Monmouthshire 010D,W01001588,1565,201,1364
2021,Monmouthshire 010E,W01001589,1366,225,1141
2021,Monmouthshire 009D,W01001590,2042,276,1766
2021,Monmouthshire 011E,W01001591,1498,274,1224
2021,Monmouthshire 008D,W01001592,1545,342,1203
2021,Monmouthshire 008E,W01001593,1538,208,1330
2021,Monmouthshire 007E,W01001594,1341,208,1133
2021,Monmouthshire 007F,W01001595,1246,161,1085
2021,Monmouthshire 006E,W01001596,1194,92,1102
2021,Monmouthshire 006F,W01001597,1362,186,1176
2021,Monmouthshire 010F,W01001598,1566,287,1279
2021,Monmouthshire 004F,W01001599,2038,338,1700
2021,Newport 012A,W01001600,1740,261,1479
2021,Newport 006A,W01001601,1463,398,1065
2021,Newport 012B,W01001602,1529,234,1295
2021,Newport 012C,W01001603,1453,281,1172
2021,Newport 012D,W01001604,1429,279,1150
2021,Newport 014A,W01001605,1402,227,1175
2021,Newport 008A,W01001606,1208,203,1005
2021,Newport 015A,W01001607,1245,357,888
2021,Newport 008B,W01001608,1428,268,1160
2021,Newport 015B,W01001609,1767,491,1276
2021,Newport 015C,W01001610,1254,250,1004
2021,Newport 011A,W01001611,1132,208,924
2021,Newport 011B,W01001612,1451,225,1226
2021,Newport 011C,W01001613,1418,284,1134
2021,Newport 005A,W01001614,1479,301,1178
2021,Newport 005B,W01001615,1482,332,1150
2021,Newport 005C,W01001616,1343,202,1141
2021,Newport 003A,W01001617,1359,277,1082
2021,Newport 003B,W01001618,1057,214,843
2021,Newport 003C,W01001619,1281,275,1006
2021,Newport 003D,W01001620,1562,360,1202
2021,Newport 003E,W01001621,1348,290,1058
2021,Newport 003F,W01001622,1149,194,955
2021,Newport 001A,W01001623,1343,216,1127
2021,Newport 001B,W01001624,1155,216,939
2021,Newport 001C,W01001625,1146,150,996
2021,Newport 001D,W01001626,1438,281,1157
2021,Newport 001E,W01001627,1542,240,1302
2021,Newport 001F,W01001628,996,157,839
2021,Newport 017A,W01001629,1318,195,1123
2021,Newport 017B,W01001630,1542,269,1273
2021,Newport 017C,W01001631,1269,190,1079
2021,Newport 017D,W01001632,1333,287,1046
2021,Newport 019A,W01001633,1541,359,1182
2021,Newport 019B,W01001634,1399,301,1098
2021,Newport 016A,W01001635,1269,193,1076
2021,Newport 020A,W01001636,1826,420,1406
2021,Newport 016B,W01001637,2010,439,1571
2021,Newport 016C,W01001638,1162,251,911
2021,Newport 004A,W01001639,2035,375,1660
2021,Newport 004B,W01001640,1069,120,949
2021,Newport 004C,W01001641,1306,202,1104
2021,Newport 013A,W01001642,1543,264,1279
2021,Newport 013B,W01001643,1726,470,1256
2021,Newport 015D,W01001645,1218,251,967
2021,Newport 015E,W01001646,1534,399,1135
2021,Newport 015G,W01001648,1475,252,1223
2021,Newport 004E,W01001650,1563,386,1177
2021,Newport 002A,W01001651,1374,187,1187
2021,Newport 002B,W01001652,1542,313,1229
2021,Newport 002C,W01001653,1297,174,1123
2021,Newport 002D,W01001654,1505,261,1244
2021,Newport 002E,W01001655,1497,274,1223
2021,Newport 020C,W01001657,1383,261,1122
2021,Newport 020D,W01001658,1971,445,1526
2021,Newport 018A,W01001659,1776,514,1262
2021,Newport 018B,W01001660,2493,547,1946
2021,Newport 018C,W01001661,2775,760,2015
2021,Newport 018D,W01001662,1584,527,1057
2021,Newport 008C,W01001663,1318,202,1116
2021,Newport 010A,W01001664,1131,220,911
2021,Newport 008D,W01001665,1566,257,1309
2021,Newport 010B,W01001666,1405,371,1034
2021,Newport 010C,W01001667,1226,326,900
2021,Newport 010D,W01001668,1150,262,888
2021,Newport 009A,W01001669,1204,154,1050
2021,Newport 009B,W01001670,2191,478,1713
2021,Newport 016D,W01001671,2146,385,1761
2021,Newport 009D,W01001673,1363,202,1161
2021,Newport 009E,W01001674,1482,326,1156
2021,Newport 007A,W01001675,1485,306,1179
2021,Newport 007B,W01001676,1740,356,1384
2021,Newport 007C,W01001677,1326,213,1113
2021,Newport 005D,W01001678,1527,346,1181
2021,Newport 007D,W01001679,1058,193,865
2021,Newport 007E,W01001680,1218,277,941
2021,Newport 006B,W01001681,1235,256,979
2021,Newport 006C,W01001682,1327,268,1059
2021,Newport 006D,W01001683,1026,193,833
2021,Newport 006E,W01001684,1321,207,1114
2021,Newport 014B,W01001685,1600,300,1300
2021,Newport 014C,W01001686,1243,192,1051
2021,Newport 014D,W01001687,2213,329,1884
2021,Newport 019D,W01001689,1975,592,1383
2021,Newport 013D,W01001690,2038,488,1550
2021,Newport 011D,W01001691,1607,283,1324
2021,Newport 011E,W01001692,2118,517,1601
2021,Newport 013E,W01001693,2666,666,2000
2021,Cardiff 036A,W01001694,1892,497,1395
2021,Cardiff 036B,W01001695,3877,2461,1416
2021,Cardiff 036C,W01001696,1433,381,1052
2021,Cardiff 036D,W01001697,1835,395,1440
2021,Cardiff 036E,W01001698,1973,431,1542
2021,Cardiff 049A,W01001699,2358,730,1628
2021,Cardiff 045A,W01001702,1683,354,1329
2021,Cardiff 045B,W01001703,1123,264,859
2021,Cardiff 041A,W01001704,1560,537,1023
2021,Cardiff 045C,W01001705,1835,498,1337
2021,Cardiff 041B,W01001706,1302,266,1036
2021,Cardiff 041C,W01001707,1904,529,1375
2021,Cardiff 045D,W01001708,1564,349,1215
2021,Cardiff 040B,W01001710,1719,365,1354
2021,Cardiff 040C,W01001711,1952,499,1453
2021,Cardiff 040D,W01001712,1392,207,1185
2021,Cardiff 040E,W01001713,1644,316,1328
2021,Cardiff 035A,W01001714,1508,347,1161
2021,Cardiff 035B,W01001715,1490,244,1246
2021,Cardiff 035C,W01001716,1212,215,997
2021,Cardiff 035D,W01001717,1434,259,1175
2021,Cardiff 028A,W01001718,1713,936,777
2021,Cardiff 028B,W01001719,1967,1225,742
2021,Cardiff 028C,W01001720,2220,1696,524
2021,Cardiff 032A,W01001721,2863,2285,578
2021,Cardiff 028D,W01001722,1739,1306,433
2021,Cardiff 032C,W01001724,2388,2021,367
2021,Cardiff 032D,W01001725,2283,1940,343
2021,Cardiff 028E,W01001726,1741,1025,716
2021,Cardiff 014A,W01001727,1142,190,952
2021,Cardiff 014B,W01001728,1351,259,1092
2021,Cardiff 014C,W01001729,2734,493,2241
2021,Cardiff 008A,W01001730,1497,300,1197
2021,Cardiff 008B,W01001731,1376,322,1054
2021,Cardiff 019A,W01001732,1657,413,1244
2021,Cardiff 019B,W01001733,1434,437,997
2021,Cardiff 019C,W01001734,1528,371,1157
2021,Cardiff 019D,W01001735,1963,764,1199
2021,Cardiff 008C,W01001736,1420,324,1096
2021,Cardiff 039A,W01001737,1517,442,1075
2021,Cardiff 039B,W01001738,1311,476,835
2021,Cardiff 039C,W01001739,1348,443,905
2021,Cardiff 039D,W01001740,1401,322,1079
2021,Cardiff 039E,W01001741,1486,476,1010
2021,Cardiff 043A,W01001742,1495,435,1060
2021,Cardiff 043B,W01001743,1380,230,1150
2021,Cardiff 043C,W01001744,1586,448,1138
2021,Cardiff 043D,W01001745,1215,178,1037
2021,Cardiff 041D,W01001746,1414,321,1093
2021,Cardiff 027A,W01001747,1595,255,1340
2021,Cardiff 027B,W01001748,1459,305,1154
2021,Cardiff 027C,W01001749,1447,300,1147
2021,Cardiff 031A,W01001750,1533,289,1244
2021,Cardiff 027D,W01001751,1665,459,1206
2021,Cardiff 031B,W01001752,1517,269,1248
2021,Cardiff 031C,W01001753,1560,446,1114
2021,Cardiff 031D,W01001754,1540,233,1307
2021,Cardiff 025A,W01001755,1421,412,1009
2021,Cardiff 025B,W01001756,4174,3018,1156
2021,Cardiff 025C,W01001757,1399,374,1025
2021,Cardiff 025D,W01001758,2106,1035,1071
2021,Cardiff 046A,W01001759,1498,265,1233
2021,Cardiff 046B,W01001760,1560,318,1242
2021,Cardiff 046C,W01001761,1664,419,1245
2021,Cardiff 046D,W01001762,1691,486,1205
2021,Cardiff 044A,W01001764,1918,777,1141
2021,Cardiff 044B,W01001765,1359,372,987
2021,Cardiff 044C,W01001766,1583,458,1125
2021,Cardiff 044D,W01001767,1718,445,1273
2021,Cardiff 044E,W01001768,1560,461,1099
2021,Cardiff 018A,W01001769,1506,307,1199
2021,Cardiff 018B,W01001770,996,178,818
2021,Cardiff 018C,W01001771,1563,273,1290
2021,Cardiff 021A,W01001772,1339,221,1118
2021,Cardiff 012A,W01001773,2400,559,1841
2021,Cardiff 018D,W01001774,1322,278,1044
2021,Cardiff 021B,W01001775,1494,290,1204
2021,Cardiff 021C,W01001776,1228,265,963
2021,Cardiff 001A,W01001777,1677,332,1345
2021,Cardiff 001B,W01001778,1684,303,1381
2021,Cardiff 026A,W01001779,1448,292,1156
2021,Cardiff 026B,W01001780,1587,530,1057
2021,Cardiff 026C,W01001781,1615,281,1334
2021,Cardiff 026D,W01001782,1374,246,1128
2021,Cardiff 026E,W01001783,1167,233,934
2021,Cardiff 026F,W01001784,1249,208,1041
2021,Cardiff 023A,W01001785,1135,286,849
2021,Cardiff 023B,W01001786,1419,287,1132
2021,Cardiff 023C,W01001787,1310,317,993
2021,Cardiff 023D,W01001788,1494,353,1141
2021,Cardiff 023E,W01001789,1455,261,1194
2021,Cardiff 023F,W01001790,1141,256,885
2021,Cardiff 005A,W01001791,1729,310,1419
2021,Cardiff 005B,W01001792,1531,345,1186
2021,Cardiff 002A,W01001793,1277,236,1041
2021,Cardiff 001C,W01001794,1263,222,1041
2021,Cardiff 002B,W01001795,1426,248,1178
2021,Cardiff 002C,W01001796,1360,240,1120
2021,Cardiff 005C,W01001797,1351,276,1075
2021,Cardiff 002D,W01001798,1326,211,1115
2021,Cardiff 001D,W01001799,1227,177,1050
2021,Cardiff 005D,W01001800,1339,215,1124
2021,Cardiff 007A,W01001802,1612,310,1302
2021,Cardiff 015A,W01001803,1570,351,1219
2021,Cardiff 015B,W01001804,1495,389,1106
2021,Cardiff 015C,W01001805,1458,355,1103
2021,Cardiff 015D,W01001806,1621,299,1322
2021,Cardiff 007B,W01001807,1549,476,1073
2021,Cardiff 007C,W01001808,1599,513,1086
2021,Cardiff 017A,W01001809,1164,214,950
2021,Cardiff 017B,W01001810,1633,535,1098
2021,Cardiff 009A,W01001811,1471,470,1001
2021,Cardiff 017C,W01001812,1200,305,895
2021,Cardiff 017D,W01001813,1709,483,1226
2021,Cardiff 017E,W01001814,1378,283,1095
2021,Cardiff 008D,W01001815,1315,283,1032
2021,Cardiff 009B,W01001816,2588,751,1837
2021,Cardiff 009C,W01001817,1320,267,1053
2021,Cardiff 009D,W01001818,1448,372,1076
2021,Cardiff 014D,W01001819,2289,447,1842
2021,Cardiff 006A,W01001820,1151,270,881
2021,Cardiff 024A,W01001821,1673,693,980
2021,Cardiff 029A,W01001822,1749,367,1382
2021,Cardiff 029B,W01001823,1198,275,923
2021,Cardiff 029C,W01001824,1482,294,1188
2021,Cardiff 029D,W01001825,1855,409,1446
2021,Cardiff 024B,W01001826,1308,303,1005
2021,Cardiff 024C,W01001827,1566,320,1246
2021,Cardiff 024D,W01001828,1445,226,1219
2021,Cardiff 033A,W01001829,1947,913,1034
2021,Cardiff 033B,W01001830,1573,396,1177
2021,Cardiff 030A,W01001831,1445,401,1044
2021,Cardiff 033C,W01001832,1727,948,779
2021,Cardiff 033D,W01001833,1475,326,1149
2021,Cardiff 033E,W01001834,1589,488,1101
2021,Cardiff 033F,W01001835,2140,807,1333
2021,Cardiff 030B,W01001836,1278,336,942
2021,Cardiff 030C,W01001837,1418,630,788
2021,Cardiff 030D,W01001838,1575,540,1035
2021,Cardiff 030E,W01001839,1540,585,955
2021,Cardiff 007D,W01001840,1828,332,1496
2021,Cardiff 003A,W01001841,1817,382,1435
2021,Cardiff 003B,W01001842,1632,336,1296
2021,Cardiff 003D,W01001844,1792,343,1449
2021,Cardiff 006C,W01001846,1658,422,1236
2021,Cardiff 006D,W01001847,1472,249,1223
2021,Cardiff 012B,W01001848,1384,274,1110
2021,Cardiff 004A,W01001849,1473,266,1207
2021,Cardiff 012C,W01001850,1823,356,1467
2021,Cardiff 012D,W01001851,1494,269,1225
2021,Cardiff 004B,W01001852,1787,370,1417
2021,Cardiff 004C,W01001853,1537,254,1283
2021,Cardiff 004D,W01001854,1475,188,1287
2021,Cardiff 042A,W01001855,1679,506,1173
2021,Cardiff 042B,W01001856,1615,455,1160
2021,Cardiff 042C,W01001857,1962,534,1428
2021,Cardiff 034A,W01001858,1533,211,1322
2021,Cardiff 034B,W01001859,1439,202,1237
2021,Cardiff 034C,W01001860,1586,261,1325
2021,Cardiff 034D,W01001861,1474,272,1202
2021,Cardiff 042D,W01001862,1762,416,1346
2021,Cardiff 022A,W01001863,1427,229,1198
2021,Cardiff 022B,W01001864,1408,193,1215
2021,Cardiff 022C,W01001865,1228,201,1027
2021,Cardiff 016A,W01001866,1487,285,1202
2021,Cardiff 016B,W01001867,1325,390,935
2021,Cardiff 022D,W01001868,1435,374,1061
2021,Cardiff 038A,W01001869,1316,174,1142
2021,Cardiff 037A,W01001870,1374,296,1078
2021,Cardiff 037B,W01001871,1536,403,1133
2021,Cardiff 038B,W01001872,1513,311,1202
2021,Cardiff 038C,W01001873,1713,348,1365
2021,Cardiff 038D,W01001874,1432,355,1077
2021,Cardiff 037D,W01001876,1527,436,1091
2021,Cardiff 011A,W01001877,1718,293,1425
2021,Cardiff 011B,W01001878,1482,327,1155
2021,Cardiff 013A,W01001879,1771,484,1287
2021,Cardiff 013B,W01001880,1533,478,1055
2021,Cardiff 013C,W01001881,1387,331,1056
2021,Cardiff 011C,W01001882,1640,298,1342
2021,Cardiff 016C,W01001883,1569,388,1181
2021,Cardiff 013D,W01001884,1295,463,832
2021,Cardiff 011D,W01001885,2424,679,1745
2021,Cardiff 016D,W01001886,1216,356,860
2021,Cardiff 020A,W01001887,1536,290,1246
2021,Cardiff 010A,W01001888,1569,331,1238
2021,Cardiff 020B,W01001889,1402,214,1188
2021,Cardiff 021D,W01001890,1499,436,1063
2021,Cardiff 020C,W01001891,1547,282,1265
2021,Cardiff 020D,W01001892,1352,222,1130
2021,Cardiff 010B,W01001893,1712,327,1385
2021,Cardiff 010C,W01001894,1455,264,1191
2021,Cardiff 010D,W01001895,1558,309,1249
2021,Cardiff 020E,W01001896,1387,285,1102
2021,Powys 020D,W01001897,1796,256,1540
2021,Merthyr Tydfil 008F,W01001898,1407,243,1164
2021,Powys 021F,W01001899,2087,372,1715
2021,Neath Port Talbot 020G,W01001900,1337,224,1113
2021,Powys 017F,W01001901,1725,252,1473
2021,Powys 017G,W01001902,1305,310,995
2021,Powys 018F,W01001903,2038,300,1738
2021,Powys 018G,W01001904,1592,241,1351
2021,Powys 018H,W01001905,2066,281,1785
2021,Powys 001F,W01001906,1879,266,1613
2021,Powys 001G,W01001907,1319,231,1088
2021,Monmouthshire 010G,W01001908,2018,397,1621
2021,Vale of Glamorgan 012G,W01001910,1556,314,1242
2021,Vale of Glamorgan 012H,W01001911,1076,217,859
2021,Newport 020E,W01001912,1461,234,1227
2021,Newport 020F,W01001913,1379,285,1094
2021,Rhondda Cynon Taf 023F,W01001914,1846,404,1442
2021,Rhondda Cynon Taf 027F,W01001915,1564,390,1174
2021,Rhondda Cynon Taf 027G,W01001916,1407,346,1061
2021,Rhondda Cynon Taf 023G,W01001917,1403,230,1173
2021,Bridgend 017E,W01001918,1778,500,1278
2021,Bridgend 017F,W01001919,1295,283,1012
2021,Bridgend 017G,W01001920,1134,257,877
2021,Bridgend 017H,W01001921,1442,348,1094
2021,Cardiff 032E,W01001922,2006,1710,296
2021,Carmarthenshire 026G,W01001923,1649,276,1373
2021,Carmarthenshire 026H,W01001924,1278,296,982
2021,Carmarthenshire 023F,W01001925,2103,320,1783
2021,Conwy 011F,W01001926,2026,278,1748
2021,Conwy 010G,W01001927,1286,217,1069
2021,Conwy 010H,W01001928,1040,90,950
2021,Wrexham 012F,W01001929,1110,165,945
2021,Wrexham 019F,W01001930,1991,299,1692
2021,Wrexham 012G,W01001931,1333,252,1081
2021,Gwynedd 014E,W01001932,2635,483,2152
2021,Gwynedd 017F,W01001933,1856,219,1637
2021,Ceredigion 003E,W01001935,982,250,732
2021,Ceredigion 003F,W01001936,1417,687,730
2021,Ceredigion 001F,W01001937,1893,309,1584
2021,Cardiff 048A,W01001940,1018,78,940
2021,Cardiff 049B,W01001942,1503,233,1270
2021,Cardiff 048B,W01001943,1151,195,956
2021,Cardiff 048C,W01001944,1133,186,947
2021,Cardiff 049C,W01001946,1246,277,969
2021,Cardiff 048E,W01001947,1619,201,1418
2021,Cardiff 006E,W01001948,2111,532,1579
2021,Cardiff 005F,W01001949,1240,224,1016
2021,Cardiff 049D,W01001950,1116,190,926
2021,Cardiff 049E,W01001951,1485,662,823
2021,Cardiff 049F,W01001952,1833,662,1171
2021,Cardiff 005G,W01001953,1407,312,1095
2021,Cardiff 006F,W01001954,1483,273,1210
2021,Swansea 025F,W01001955,1896,432,1464
2021,Swansea 032C,W01001956,2166,778,1388
2021,Swansea 025H,W01001958,1278,309,969
2021,Merthyr Tydfil 005E,W01001959,1461,303,1158
2021,Merthyr Tydfil 005F,W01001960,1359,242,1117
2021,Merthyr Tydfil 006G,W01001961,2228,431,1797
2021,Rhondda Cynon Taf 011E,W01001962,2302,447,1855
2021,Rhondda Cynon Taf 014H,W01001963,2140,410,1730
2021,Rhondda Cynon Taf 021H,W01001964,2149,398,1751
2021,Rhondda Cynon Taf 029E,W01001965,1614,339,1275
2021,Rhondda Cynon Taf 029F,W01001966,1569,407,1162
2021,Rhondda Cynon Taf 031G,W01001967,1424,275,1149
2021,Rhondda Cynon Taf 031H,W01001968,1387,294,1093
2021,Wrexham 010F,W01001969,2153,490,1663
2021,Wrexham 021C,W01001970,2076,336,1740
2021,Wrexham 022D,W01001971,2627,218,2409
2021,Wrexham 022E,W01001972,1247,269,978
2021,Blaenau Gwent 009F,W01001973,2137,329,1808
2021,Monmouthshire 002G,W01001974,1323,280,1043
2021,Monmouthshire 002H,W01001975,1251,210,1041
2021,Monmouthshire 003F,W01001976,1539,234,1305
2021,Monmouthshire 003G,W01001977,1361,254,1107
2021,Monmouthshire 004G,W01001978,1429,240,1189
2021,Monmouthshire 004H,W01001979,1899,408,1491
2021,Monmouthshire 005F,W01001980,2118,279,1839
2021,Bridgend 011D,W01001981,2823,340,2483
2021,Bridgend 011E,W01001982,1209,207,1002
2021,Bridgend 011F,W01001983,1348,282,1066
2021,Bridgend 011G,W01001984,1105,269,836
2021,Neath Port Talbot 006F,W01001985,1985,277,1708
2021,Neath Port Talbot 007E,W01001986,2349,306,2043
2021,Neath Port Talbot 010G,W01001987,1389,294,1095
2021,Neath Port Talbot 010H,W01001988,1331,279,1052
2021,Neath Port Talbot 010I,W01001989,3327,2238,1089
2021,Neath Port Talbot 021E,W01001990,2045,317,1728
2021,Swansea 005G,W01001991,1335,329,1006
2021,Swansea 005H,W01001992,1339,305,1034
2021,Swansea 006E,W01001993,1592,498,1094
2021,Swansea 006F,W01001994,1405,278,1127
2021,Swansea 021E,W01001995,1301,325,976
2021,Swansea 021F,W01001996,1372,318,1054
2021,Swansea 025I,W01001997,1941,414,1527
2021,Vale of Glamorgan 015G,W01001998,2096,380,1716
2021,Carmarthenshire 019F,W01001999,2396,373,2023
2021,Ceredigion 002G,W01002000,2880,2078,802
2021,Ceredigion 002H,W01002001,1400,872,528
2021,Ceredigion 007E,W01002002,4170,582,3588
2021,Gwynedd 013E,W01002003,2306,295,2011
2021,Gwynedd 016F,W01002004,2053,379,1674
2021,Isle of Anglesey 002E,W01002005,2147,292,1855
2021,Isle of Anglesey 004G,W01002007,2121,336,1785
2021,Isle of Anglesey 007F,W01002008,2018,283,1735
2021,Pembrokeshire 005E,W01002009,1149,185,964
2021,Pembrokeshire 005F,W01002010,1054,195,859
2021,Pembrokeshire 010D,W01002011,1484,270,1214
2021,Pembrokeshire 010E,W01002012,1361,302,1059
2021,Pembrokeshire 011G,W01002013,2302,268,2034
2021,Pembrokeshire 016E,W01002014,2016,287,1729
2021,Cardiff 003E,W01002016,1115,171,944
2021,Cardiff 003F,W01002017,1234,261,973
2021,Cardiff 003G,W01002018,1435,320,1115
2021,Cardiff 032H,W01002019,2551,1411,1140
2021,Cardiff 037E,W01002020,1445,410,1035
2021,Cardiff 037F,W01002021,1389,321,1068
2021,Cardiff 040F,W01002022,1108,210,898
2021,Cardiff 040G,W01002023,1703,383,1320
2021,Cardiff 048F,W01002024,1077,135,942
2021,Cardiff 048G,W01002025,1030,139,891
2021,Newport 004F,W01002026,1667,321,1346
2021,Newport 004G,W01002027,1691,267,1424
2021,Newport 009F,W01002028,1848,411,1437
2021,Newport 009G,W01002029,1531,387,1144
2021,Newport 013F,W01002030,1320,290,1030
2021,Newport 013G,W01002031,1550,353,1197
2021,Newport 015H,W01002032,1222,211,1011
2021,Newport 015I,W01002033,1284,219,1065
2021,Newport 019E,W01002034,1588,297,1291
2021,Newport 019F,W01002035,1467,392,1075
2021,Vale of Glamorgan 005G,W01002036,1468,267,1201
2021,Vale of Glamorgan 005H,W01002037,1027,168,859
2021,Vale of Glamorgan 014G,W01002038,1222,184,1038
2021,Vale of Glamorgan 014H,W01002039,1638,421,1217
2021,Vale of Glamorgan 015F,W01002040,1743,273,1470
