date,geography,geography code,Welsh reading ability: Total: All usual residents aged 3 years and over,Welsh reading ability: Cannot read Welsh,Welsh reading ability: Can read Welsh
2021,Isle of Anglesey 001A,W01000003,2370,1117,1253
2021,Isle of Anglesey 001B,W01000004,1229,671,558
2021,Isle of Anglesey 005A,W01000005,1585,1062,523
2021,Isle of Anglesey 006A,W01000006,1494,479,1015
2021,Isle of Anglesey 009A,W01000007,1738,705,1033
2021,Isle of Anglesey 008A,W01000008,1417,471,946
2021,Isle of Anglesey 007C,W01000009,1818,665,1153
2021,Isle of Anglesey 002A,W01000010,1775,978,797
2021,Isle of Anglesey 008B,W01000011,999,585,414
2021,Isle of Anglesey 006B,W01000012,1656,544,1112
2021,Isle of Anglesey 005B,W01000013,2130,998,1132
2021,Isle of Anglesey 006C,W01000014,2128,577,1551
2021,Isle of Anglesey 008C,W01000015,1431,538,893
2021,Isle of Anglesey 003A,W01000016,1157,777,380
2021,Isle of Anglesey 003B,W01000017,1636,955,681
2021,Isle of Anglesey 001C,W01000018,1148,662,486
2021,Isle of Anglesey 005C,W01000019,1325,844,481
2021,Isle of Anglesey 002C,W01000021,2266,1182,1084
2021,Isle of Anglesey 004A,W01000022,1576,670,906
2021,Isle of Anglesey 007D,W01000023,1525,587,938
2021,Isle of Anglesey 007E,W01000024,1293,850,443
2021,Isle of Anglesey 009B,W01000025,2097,632,1465
2021,Isle of Anglesey 005D,W01000026,1229,722,507
2021,Isle of Anglesey 009C,W01000027,1810,779,1031
2021,Isle of Anglesey 001D,W01000028,1921,732,1189
2021,Isle of Anglesey 003C,W01000029,1541,922,619
2021,Isle of Anglesey 003D,W01000030,2236,1425,811
2021,Isle of Anglesey 001E,W01000031,1512,718,794
2021,Isle of Anglesey 003E,W01000033,1504,1039,465
2021,Isle of Anglesey 004B,W01000034,1398,820,578
2021,Isle of Anglesey 005E,W01000035,1743,893,850
2021,Isle of Anglesey 003F,W01000036,1070,743,327
2021,Isle of Anglesey 003G,W01000037,1126,718,408
2021,Isle of Anglesey 009D,W01000038,2177,950,1227
2021,Isle of Anglesey 004D,W01000040,1041,730,311
2021,Isle of Anglesey 006D,W01000041,1529,520,1009
2021,Isle of Anglesey 008D,W01000042,1982,935,1047
2021,Isle of Anglesey 004F,W01000044,1070,600,470
2021,Gwynedd 011A,W01000047,1233,328,905
2021,Gwynedd 003A,W01000050,1397,655,742
2021,Gwynedd 015A,W01000051,1945,651,1294
2021,Gwynedd 004A,W01000052,1061,192,869
2021,Gwynedd 004B,W01000053,1144,405,739
2021,Gwynedd 007A,W01000054,989,212,777
2021,Gwynedd 009A,W01000056,1720,496,1224
2021,Gwynedd 016C,W01000057,1358,586,772
2021,Gwynedd 006A,W01000059,2028,557,1471
2021,Gwynedd 015B,W01000060,1227,650,577
2021,Gwynedd 011B,W01000061,1697,746,951
2021,Gwynedd 001A,W01000062,1964,1582,382
2021,Gwynedd 005A,W01000063,1847,618,1229
2021,Gwynedd 002A,W01000064,1943,1029,914
2021,Gwynedd 009B,W01000065,995,319,676
2021,Gwynedd 010A,W01000066,1143,466,677
2021,Gwynedd 016D,W01000067,1165,500,665
2021,Gwynedd 016E,W01000068,1375,603,772
2021,Gwynedd 012A,W01000070,1263,388,875
2021,Gwynedd 003B,W01000071,2174,704,1470
2021,Gwynedd 002B,W01000072,1633,838,795
2021,Gwynedd 008A,W01000073,1620,418,1202
2021,Gwynedd 013B,W01000074,1770,887,883
2021,Gwynedd 002C,W01000075,1368,896,472
2021,Gwynedd 001B,W01000076,1273,873,400
2021,Gwynedd 001C,W01000077,1146,783,363
2021,Gwynedd 011C,W01000078,1517,538,979
2021,Gwynedd 014C,W01000080,1423,677,746
2021,Gwynedd 005B,W01000081,1958,679,1279
2021,Gwynedd 015C,W01000082,1067,402,665
2021,Gwynedd 015D,W01000083,1318,298,1020
2021,Gwynedd 014D,W01000084,1047,438,609
2021,Gwynedd 017C,W01000085,1888,1208,680
2021,Gwynedd 008B,W01000086,2113,688,1425
2021,Gwynedd 004C,W01000087,1778,350,1428
2021,Gwynedd 007B,W01000088,2009,478,1531
2021,Gwynedd 011D,W01000089,1869,530,1339
2021,Gwynedd 002D,W01000090,1315,707,608
2021,Gwynedd 001D,W01000091,1048,602,446
2021,Gwynedd 001E,W01000092,3035,2329,706
2021,Gwynedd 006B,W01000093,2184,562,1622
2021,Gwynedd 012B,W01000094,1188,361,827
2021,Gwynedd 012C,W01000095,1258,364,894
2021,Gwynedd 003C,W01000096,1220,280,940
2021,Gwynedd 003D,W01000097,1104,341,763
2021,Gwynedd 006C,W01000098,2422,619,1803
2021,Gwynedd 005C,W01000099,1617,570,1047
2021,Gwynedd 010B,W01000100,1032,346,686
2021,Gwynedd 013D,W01000101,1330,406,924
2021,Gwynedd 002E,W01000102,1832,806,1026
2021,Gwynedd 005D,W01000103,1141,535,606
2021,Gwynedd 008C,W01000104,1745,379,1366
2021,Gwynedd 010C,W01000105,1689,474,1215
2021,Gwynedd 010D,W01000106,1475,715,760
2021,Gwynedd 010E,W01000107,1167,460,707
2021,Gwynedd 012D,W01000108,2032,572,1460
2021,Gwynedd 012E,W01000109,1815,578,1237
2021,Gwynedd 006D,W01000110,1544,292,1252
2021,Gwynedd 007C,W01000111,1530,473,1057
2021,Gwynedd 008D,W01000112,1877,666,1211
2021,Gwynedd 009C,W01000113,1793,544,1249
2021,Gwynedd 009D,W01000114,1378,399,979
2021,Gwynedd 003E,W01000115,2066,749,1317
2021,Gwynedd 017D,W01000116,1650,1108,542
2021,Gwynedd 017E,W01000117,1437,924,513
2021,Gwynedd 007D,W01000118,1653,503,1150
2021,Gwynedd 004D,W01000119,2257,821,1436
2021,Conwy 015A,W01000121,1126,635,491
2021,Conwy 014A,W01000122,1916,1172,744
2021,Conwy 013A,W01000123,1700,1041,659
2021,Conwy 012A,W01000124,1906,1238,668
2021,Conwy 013B,W01000125,1494,1082,412
2021,Conwy 009A,W01000126,1640,1271,369
2021,Conwy 009B,W01000127,1334,1145,189
2021,Conwy 009C,W01000128,1449,1152,297
2021,Conwy 012B,W01000129,1151,907,244
2021,Conwy 012C,W01000130,1391,1093,298
2021,Conwy 012D,W01000131,1623,1127,496
2021,Conwy 001A,W01000132,1500,1238,262
2021,Conwy 002A,W01000133,1754,1431,323
2021,Conwy 015B,W01000134,1990,966,1024
2021,Conwy 006A,W01000135,1966,1597,369
2021,Conwy 006B,W01000136,1723,1342,381
2021,Conwy 015C,W01000137,1509,744,765
2021,Conwy 008A,W01000138,1889,1457,432
2021,Conwy 007A,W01000139,1576,1217,359
2021,Conwy 010B,W01000140,1721,1342,379
2021,Conwy 010C,W01000141,1501,1213,288
2021,Conwy 010D,W01000142,1493,1137,356
2021,Conwy 007B,W01000143,1525,1221,304
2021,Conwy 007C,W01000144,1594,1358,236
2021,Conwy 008B,W01000145,1259,984,275
2021,Conwy 001B,W01000146,2002,1697,305
2021,Conwy 001C,W01000147,1473,1241,232
2021,Conwy 015D,W01000148,1046,465,581
2021,Conwy 005A,W01000149,1456,1332,124
2021,Conwy 005B,W01000150,1451,1269,182
2021,Conwy 005C,W01000151,1475,1305,170
2021,Conwy 005D,W01000152,1383,1236,147
2021,Conwy 009D,W01000153,1572,1288,284
2021,Conwy 003A,W01000154,1375,1133,242
2021,Conwy 004A,W01000155,1381,1151,230
2021,Conwy 004B,W01000156,1470,1254,216
2021,Conwy 004C,W01000157,1378,1184,194
2021,Conwy 004D,W01000158,1530,1240,290
2021,Conwy 014B,W01000159,1388,570,818
2021,Conwy 014C,W01000162,1772,783,989
2021,Conwy 009E,W01000163,1325,1100,225
2021,Conwy 009F,W01000164,1315,1061,254
2021,Conwy 006C,W01000165,1831,1367,464
2021,Conwy 006D,W01000166,2664,1999,665
2021,Conwy 011C,W01000167,1933,1550,383
2021,Conwy 002B,W01000168,1776,1448,328
2021,Conwy 001D,W01000169,1737,1471,266
2021,Conwy 013C,W01000170,1753,1050,703
2021,Conwy 013D,W01000171,1452,1055,397
2021,Conwy 013E,W01000172,1220,849,371
2021,Conwy 003B,W01000173,1418,1109,309
2021,Conwy 003C,W01000174,1557,1235,322
2021,Conwy 003D,W01000175,1502,1217,285
2021,Conwy 011D,W01000176,1556,1149,407
2021,Conwy 011E,W01000177,1392,1027,365
2021,Conwy 010E,W01000178,1947,1562,385
2021,Conwy 010F,W01000179,1949,1563,386
2021,Conwy 008C,W01000180,1477,1194,283
2021,Conwy 008D,W01000181,1425,1124,301
2021,Conwy 007D,W01000182,2036,1737,299
2021,Conwy 008E,W01000183,1445,1188,257
2021,Conwy 005E,W01000184,2223,1983,240
2021,Conwy 015E,W01000185,1205,747,458
2021,Conwy 001E,W01000186,1552,1285,267
2021,Conwy 002C,W01000187,1465,1196,269
2021,Conwy 002D,W01000188,1549,1258,291
2021,Conwy 015F,W01000189,1428,596,832
2021,Conwy 014D,W01000190,1359,516,843
2021,Denbighshire 009A,W01000191,2027,1714,313
2021,Denbighshire 016A,W01000192,974,600,374
2021,Denbighshire 015A,W01000193,1220,778,442
2021,Denbighshire 011A,W01000194,1849,1368,481
2021,Denbighshire 012A,W01000195,1412,799,613
2021,Denbighshire 012B,W01000196,1360,879,481
2021,Denbighshire 012C,W01000197,1647,1096,551
2021,Denbighshire 011B,W01000198,1324,1048,276
2021,Denbighshire 011C,W01000199,1661,1159,502
2021,Denbighshire 008A,W01000200,1256,1020,236
2021,Denbighshire 008B,W01000201,1667,1416,251
2021,Denbighshire 015B,W01000202,1597,888,709
2021,Denbighshire 013A,W01000203,2389,1906,483
2021,Denbighshire 013B,W01000204,1424,966,458
2021,Denbighshire 016B,W01000205,1173,576,597
2021,Denbighshire 013C,W01000206,2171,1450,721
2021,Denbighshire 015C,W01000207,2243,1312,931
2021,Denbighshire 016C,W01000208,1257,1045,212
2021,Denbighshire 016D,W01000209,1373,1107,266
2021,Denbighshire 016E,W01000210,1306,1031,275
2021,Denbighshire 012D,W01000211,1761,990,771
2021,Denbighshire 003A,W01000212,2132,1732,400
2021,Denbighshire 002A,W01000213,1277,1095,182
2021,Denbighshire 002B,W01000214,1124,986,138
2021,Denbighshire 002C,W01000215,1437,1193,244
2021,Denbighshire 002D,W01000216,1258,1082,176
2021,Denbighshire 008C,W01000217,1950,1651,299
2021,Denbighshire 001A,W01000218,1548,1359,189
2021,Denbighshire 001B,W01000219,2546,2208,338
2021,Denbighshire 001C,W01000220,1611,1456,155
2021,Denbighshire 003B,W01000221,1304,1144,160
2021,Denbighshire 003C,W01000222,1749,1504,245
2021,Denbighshire 009B,W01000223,1271,1079,192
2021,Denbighshire 009C,W01000224,1521,1268,253
2021,Denbighshire 009D,W01000225,1404,1156,248
2021,Denbighshire 004A,W01000226,1485,1342,143
2021,Denbighshire 004B,W01000227,1454,1283,171
2021,Denbighshire 004C,W01000228,1598,1421,177
2021,Denbighshire 017E,W01000229,1494,1268,226
2021,Denbighshire 017F,W01000230,1865,1561,304
2021,Denbighshire 017A,W01000231,1297,1110,187
2021,Denbighshire 017B,W01000232,1584,1347,237
2021,Denbighshire 017C,W01000233,1261,1096,165
2021,Denbighshire 017G,W01000234,2182,1886,296
2021,Denbighshire 017D,W01000235,1290,1072,218
2021,Denbighshire 006A,W01000236,1902,1647,255
2021,Denbighshire 006B,W01000237,1704,1554,150
2021,Denbighshire 006C,W01000238,1734,1505,229
2021,Denbighshire 004D,W01000239,1652,1507,145
2021,Denbighshire 004E,W01000240,1590,1432,158
2021,Denbighshire 004F,W01000241,1449,1293,156
2021,Denbighshire 014A,W01000242,1909,1316,593
2021,Denbighshire 014B,W01000243,2049,1415,634
2021,Denbighshire 014C,W01000244,1567,829,738
2021,Denbighshire 010A,W01000245,1796,1395,401
2021,Denbighshire 010B,W01000246,1600,1340,260
2021,Denbighshire 010C,W01000247,1781,1308,473
2021,Denbighshire 008D,W01000248,1600,1210,390
2021,Flintshire 014A,W01000249,1167,1022,145
2021,Flintshire 014B,W01000250,1396,1193,203
2021,Flintshire 013A,W01000251,1503,1380,123
2021,Flintshire 010A,W01000252,1602,1474,128
2021,Flintshire 003A,W01000253,1787,1597,190
2021,Flintshire 003B,W01000254,2052,1831,221
2021,Flintshire 015A,W01000255,2207,2042,165
2021,Flintshire 015B,W01000256,1500,1378,122
2021,Flintshire 015C,W01000257,2612,2453,159
2021,Flintshire 006A,W01000258,2061,1755,306
2021,Flintshire 017A,W01000259,1628,1468,160
2021,Flintshire 017B,W01000260,1673,1508,165
2021,Flintshire 014C,W01000261,1378,1214,164
2021,Flintshire 017C,W01000262,1376,1258,118
2021,Flintshire 017D,W01000263,1298,1192,106
2021,Flintshire 012A,W01000264,1663,1471,192
2021,Flintshire 012B,W01000265,1445,1293,152
2021,Flintshire 017E,W01000266,1597,1407,190
2021,Flintshire 017F,W01000267,1979,1779,200
2021,Flintshire 013B,W01000268,1619,1416,203
2021,Flintshire 020A,W01000269,1522,1341,181
2021,Flintshire 006B,W01000270,1217,988,229
2021,Flintshire 006C,W01000271,1217,985,232
2021,Flintshire 006D,W01000272,1757,1462,295
2021,Flintshire 007A,W01000273,1498,1384,114
2021,Flintshire 007B,W01000274,1836,1720,116
2021,Flintshire 007C,W01000275,1159,1070,89
2021,Flintshire 008A,W01000276,1165,1054,111
2021,Flintshire 008B,W01000277,1327,1188,139
2021,Flintshire 007D,W01000278,1418,1319,99
2021,Flintshire 008C,W01000279,1151,1057,94
2021,Flintshire 010B,W01000280,1686,1533,153
2021,Flintshire 008D,W01000281,1142,1050,92
2021,Flintshire 010C,W01000282,1589,1435,154
2021,Flintshire 008E,W01000283,2252,2090,162
2021,Flintshire 013C,W01000284,1685,1525,160
2021,Flintshire 013D,W01000285,1566,1437,129
2021,Flintshire 013E,W01000286,2130,1884,246
2021,Flintshire 001A,W01000287,1820,1553,267
2021,Flintshire 004A,W01000288,2111,1910,201
2021,Flintshire 005A,W01000289,1300,1139,161
2021,Flintshire 004B,W01000290,1240,1112,128
2021,Flintshire 005B,W01000291,1266,1114,152
2021,Flintshire 004C,W01000292,1419,1270,149
2021,Flintshire 004D,W01000293,2558,2264,294
2021,Flintshire 005C,W01000294,1844,1619,225
2021,Flintshire 005D,W01000295,1537,1368,169
2021,Flintshire 003C,W01000296,1490,1331,159
2021,Flintshire 003D,W01000297,1195,1033,162
2021,Flintshire 001B,W01000298,1439,1233,206
2021,Flintshire 019A,W01000299,1859,1592,267
2021,Flintshire 019B,W01000300,1592,1318,274
2021,Flintshire 006E,W01000301,1688,1400,288
2021,Flintshire 013F,W01000302,1895,1706,189
2021,Flintshire 018A,W01000303,1681,1506,175
2021,Flintshire 003E,W01000304,2008,1776,232
2021,Flintshire 003F,W01000305,1854,1593,261
2021,Flintshire 002A,W01000306,2360,2015,345
2021,Flintshire 020B,W01000307,1392,1239,153
2021,Flintshire 020C,W01000308,1158,1003,155
2021,Flintshire 019C,W01000309,2058,1811,247
2021,Flintshire 020D,W01000310,1851,1565,286
2021,Flintshire 011A,W01000311,1634,1506,128
2021,Flintshire 011B,W01000312,1567,1459,108
2021,Flintshire 016A,W01000313,1554,1285,269
2021,Flintshire 016B,W01000314,1100,938,162
2021,Flintshire 016C,W01000315,1904,1628,276
2021,Flintshire 016D,W01000316,1199,902,297
2021,Flintshire 016E,W01000317,1563,1111,452
2021,Flintshire 016F,W01000318,1163,1040,123
2021,Flintshire 016G,W01000319,1396,1183,213
2021,Flintshire 002B,W01000320,1831,1589,242
2021,Flintshire 014D,W01000321,1598,1398,200
2021,Flintshire 014E,W01000322,1344,1162,182
2021,Flintshire 012C,W01000323,1536,1317,219
2021,Flintshire 012D,W01000324,1471,1249,222
2021,Flintshire 010D,W01000325,1760,1575,185
2021,Flintshire 018B,W01000326,2151,1891,260
2021,Flintshire 018C,W01000327,2385,2123,262
2021,Flintshire 011C,W01000328,1866,1744,122
2021,Flintshire 015D,W01000329,1555,1465,90
2021,Flintshire 015E,W01000330,2013,1918,95
2021,Flintshire 015F,W01000331,1421,1346,75
2021,Flintshire 009A,W01000332,1765,1644,121
2021,Flintshire 009B,W01000333,1425,1343,82
2021,Flintshire 009C,W01000334,1701,1584,117
2021,Flintshire 009D,W01000335,1145,1070,75
2021,Flintshire 009E,W01000336,1389,1267,122
2021,Flintshire 009F,W01000337,2095,1928,167
2021,Flintshire 001C,W01000338,1725,1418,307
2021,Flintshire 019D,W01000339,1635,1311,324
2021,Flintshire 002C,W01000340,2191,1828,363
2021,Wrexham 023C,W01000341,1508,1348,160
2021,Wrexham 023E,W01000342,1487,1329,158
2021,Wrexham 023B,W01000343,1010,899,111
2021,Wrexham 023A,W01000344,1221,1085,136
2021,Wrexham 018A,W01000345,1559,1424,135
2021,Wrexham 018B,W01000346,1460,1377,83
2021,Wrexham 006A,W01000347,2701,2308,393
2021,Wrexham 006B,W01000348,1374,1223,151
2021,Wrexham 011A,W01000349,2204,1916,288
2021,Wrexham 011B,W01000350,1759,1574,185
2021,Wrexham 005A,W01000351,1995,1761,234
2021,Wrexham 017A,W01000354,1604,1413,191
2021,Wrexham 017B,W01000355,1687,1481,206
2021,Wrexham 017C,W01000356,1574,1397,177
2021,Wrexham 019C,W01000359,1159,1040,119
2021,Wrexham 019D,W01000360,1194,1106,88
2021,Wrexham 019E,W01000361,1925,1748,177
2021,Wrexham 006C,W01000362,1443,1224,219
2021,Wrexham 006D,W01000363,1429,1185,244
2021,Wrexham 006E,W01000364,1429,1176,253
2021,Wrexham 011C,W01000365,1985,1658,327
2021,Wrexham 014A,W01000366,1419,1295,124
2021,Wrexham 014B,W01000367,1248,1109,139
2021,Wrexham 008A,W01000368,1935,1683,252
2021,Wrexham 021B,W01000369,1237,1121,116
2021,Wrexham 021D,W01000370,1507,1353,154
2021,Wrexham 008B,W01000371,1029,900,129
2021,Wrexham 008C,W01000372,1484,1321,163
2021,Wrexham 005B,W01000373,1698,1530,168
2021,Wrexham 003A,W01000374,1328,1166,162
2021,Wrexham 003B,W01000375,2034,1764,270
2021,Wrexham 003C,W01000376,1305,1135,170
2021,Wrexham 004A,W01000377,1497,1288,209
2021,Wrexham 004B,W01000378,1248,1122,126
2021,Wrexham 004C,W01000379,1559,1398,161
2021,Wrexham 004D,W01000380,1417,1187,230
2021,Wrexham 012A,W01000381,1084,957,127
2021,Wrexham 012B,W01000382,1338,1139,199
2021,Wrexham 022C,W01000384,1067,993,74
2021,Wrexham 014C,W01000385,1692,1444,248
2021,Wrexham 015A,W01000386,1388,1244,144
2021,Wrexham 008D,W01000387,1105,996,109
2021,Wrexham 008E,W01000388,1073,949,124
2021,Wrexham 017D,W01000389,1943,1663,280
2021,Wrexham 021A,W01000390,1695,1515,180
2021,Wrexham 003D,W01000391,1403,1238,165
2021,Wrexham 003E,W01000392,1561,1432,129
2021,Wrexham 023G,W01000393,1889,1659,230
2021,Wrexham 016A,W01000394,1136,1038,98
2021,Wrexham 016B,W01000395,1015,898,117
2021,Wrexham 013A,W01000398,1189,994,195
2021,Wrexham 013B,W01000399,1061,882,179
2021,Wrexham 005C,W01000400,1775,1559,216
2021,Wrexham 005D,W01000401,1944,1723,221
2021,Wrexham 011D,W01000402,2467,2198,269
2021,Wrexham 018C,W01000403,1284,1185,99
2021,Wrexham 018D,W01000404,1957,1787,170
2021,Wrexham 015B,W01000405,2204,1734,470
2021,Wrexham 013C,W01000406,2095,1737,358
2021,Wrexham 016C,W01000407,1360,1187,173
2021,Wrexham 013D,W01000408,1195,998,197
2021,Wrexham 017E,W01000409,1782,1637,145
2021,Wrexham 014D,W01000410,1644,1303,341
2021,Wrexham 015C,W01000411,1470,1193,277
2021,Wrexham 015D,W01000412,1446,1084,362
2021,Wrexham 010C,W01000413,1251,1148,103
2021,Wrexham 010D,W01000414,1153,1061,92
2021,Wrexham 023F,W01000415,1392,1251,141
2021,Wrexham 023D,W01000416,1142,1029,113
2021,Wrexham 022B,W01000417,1499,1383,116
2021,Wrexham 022A,W01000418,1704,1518,186
2021,Wrexham 016D,W01000419,1389,1210,179
2021,Wrexham 016E,W01000420,1481,1280,201
2021,Wrexham 008F,W01000422,2093,1868,225
2021,Wrexham 012D,W01000423,2104,1845,259
2021,Wrexham 012E,W01000424,1240,1079,161
2021,Wrexham 010E,W01000425,1969,1825,144
2021,Powys 021A,W01000426,1385,990,395
2021,Powys 011A,W01000427,1311,1193,118
2021,Powys 005A,W01000428,1300,1143,157
2021,Powys 010A,W01000429,2272,1848,424
2021,Powys 015A,W01000430,1290,1141,149
2021,Powys 014A,W01000431,1226,1055,171
2021,Powys 014B,W01000432,1178,1015,163
2021,Powys 006A,W01000433,2219,1689,530
2021,Powys 007A,W01000434,1704,1638,66
2021,Powys 012A,W01000438,1203,1103,100
2021,Powys 007B,W01000439,1983,1743,240
2021,Powys 020A,W01000440,1286,1102,184
2021,Powys 005B,W01000441,1493,1343,150
2021,Powys 004A,W01000442,1999,980,1019
2021,Powys 015B,W01000443,2236,2051,185
2021,Powys 002A,W01000444,2199,1912,287
2021,Powys 015C,W01000445,1458,1378,80
2021,Powys 015D,W01000446,1641,1542,99
2021,Powys 007C,W01000447,1955,1764,191
2021,Powys 011B,W01000448,1350,1257,93
2021,Powys 011C,W01000449,1495,1383,112
2021,Powys 014C,W01000450,1364,1176,188
2021,Powys 012B,W01000451,1160,1052,108
2021,Powys 004B,W01000452,1964,1131,833
2021,Powys 010B,W01000453,1352,1125,227
2021,Powys 013A,W01000454,1242,1114,128
2021,Powys 013B,W01000455,2125,1914,211
2021,Powys 013C,W01000456,2119,1894,225
2021,Powys 002B,W01000457,2098,1862,236
2021,Powys 002C,W01000458,1814,1610,204
2021,Powys 014D,W01000459,1184,1055,129
2021,Powys 006B,W01000460,1668,1127,541
2021,Powys 001A,W01000461,1548,1093,455
2021,Powys 011D,W01000464,1155,1072,83
2021,Powys 018E,W01000465,1018,910,108
2021,Powys 010C,W01000466,1289,1081,208
2021,Powys 010D,W01000467,1422,1198,224
2021,Powys 001D,W01000470,1948,1645,303
2021,Powys 014E,W01000471,1723,1455,268
2021,Powys 012C,W01000472,1160,1034,126
2021,Powys 004C,W01000473,2092,1194,898
2021,Powys 020B,W01000474,1708,1309,399
2021,Powys 001E,W01000475,2349,1740,609
2021,Powys 005C,W01000476,1250,1127,123
2021,Powys 012D,W01000477,1487,1337,150
2021,Powys 009A,W01000478,1797,1591,206
2021,Powys 009B,W01000479,1401,1231,170
2021,Powys 008A,W01000480,2034,1808,226
2021,Powys 008B,W01000481,2139,1854,285
2021,Powys 008C,W01000482,1853,1606,247
2021,Powys 009C,W01000483,1772,1561,211
2021,Powys 011E,W01000484,1650,1540,110
2021,Powys 011F,W01000485,1553,1455,98
2021,Powys 011G,W01000486,1039,973,66
2021,Powys 012E,W01000487,2029,1754,275
2021,Powys 006C,W01000488,2124,1721,403
2021,Powys 017A,W01000489,1741,1514,227
2021,Powys 017D,W01000492,1492,1317,175
2021,Powys 017E,W01000493,1692,1496,196
2021,Powys 015E,W01000494,1661,1485,176
2021,Powys 021B,W01000496,2036,1585,451
2021,Powys 005D,W01000497,1337,1222,115
2021,Powys 003A,W01000498,1439,1301,138
2021,Powys 003B,W01000499,1208,1093,115
2021,Powys 003C,W01000500,1644,1448,196
2021,Powys 003D,W01000501,2157,1891,266
2021,Powys 021C,W01000502,2023,1401,622
2021,Powys 020C,W01000503,1034,885,149
2021,Powys 021D,W01000504,1097,869,228
2021,Powys 021E,W01000505,1399,978,421
2021,Ceredigion 005A,W01000506,1250,572,678
2021,Ceredigion 009A,W01000507,1112,649,463
2021,Ceredigion 009B,W01000508,1011,614,397
2021,Ceredigion 009C,W01000509,1819,922,897
2021,Ceredigion 009D,W01000510,1151,661,490
2021,Ceredigion 009E,W01000511,1134,723,411
2021,Ceredigion 002A,W01000512,1341,779,562
2021,Ceredigion 002B,W01000513,2085,1575,510
2021,Ceredigion 003A,W01000515,1276,888,388
2021,Ceredigion 003B,W01000516,1580,1136,444
2021,Ceredigion 002D,W01000517,1157,890,267
2021,Ceredigion 003C,W01000518,990,676,314
2021,Ceredigion 010A,W01000519,1721,906,815
2021,Ceredigion 010B,W01000522,1181,670,511
2021,Ceredigion 001C,W01000523,1835,929,906
2021,Ceredigion 005B,W01000524,1877,972,905
2021,Ceredigion 011A,W01000525,1209,670,539
2021,Ceredigion 008A,W01000527,1129,661,468
2021,Ceredigion 008B,W01000528,1311,712,599
2021,Ceredigion 010C,W01000531,1721,952,769
2021,Ceredigion 010D,W01000533,1312,612,700
2021,Ceredigion 011B,W01000534,1485,749,736
2021,Ceredigion 008C,W01000535,1996,1021,975
2021,Ceredigion 011E,W01000536,1336,731,605
2021,Ceredigion 008D,W01000537,1368,821,547
2021,Ceredigion 005C,W01000538,1507,737,770
2021,Ceredigion 005D,W01000539,1153,642,511
2021,Ceredigion 005E,W01000540,1117,615,502
2021,Ceredigion 008E,W01000541,1699,847,852
2021,Ceredigion 011F,W01000542,2151,1105,1046
2021,Ceredigion 011C,W01000543,1959,1060,899
2021,Ceredigion 007D,W01000545,1944,1119,825
2021,Ceredigion 009F,W01000546,1115,663,452
2021,Ceredigion 009G,W01000547,1120,549,571
2021,Ceredigion 001D,W01000548,1727,915,812
2021,Ceredigion 001E,W01000549,1716,858,858
2021,Ceredigion 011G,W01000550,1128,525,603
2021,Ceredigion 010E,W01000551,1346,719,627
2021,Ceredigion 011D,W01000552,1954,900,1054
2021,Pembrokeshire 011A,W01000553,1209,1088,121
2021,Pembrokeshire 009A,W01000554,1812,1630,182
2021,Pembrokeshire 008A,W01000555,1490,1300,190
2021,Pembrokeshire 008B,W01000556,1150,1006,144
2021,Pembrokeshire 014A,W01000557,1488,1310,178
2021,Pembrokeshire 001A,W01000558,2066,1177,889
2021,Pembrokeshire 001B,W01000559,1429,771,658
2021,Pembrokeshire 001C,W01000560,1268,578,690
2021,Pembrokeshire 001D,W01000561,1269,594,675
2021,Pembrokeshire 002A,W01000562,1576,917,659
2021,Pembrokeshire 011B,W01000563,1100,972,128
2021,Pembrokeshire 011C,W01000564,1267,1138,129
2021,Pembrokeshire 002B,W01000565,1796,1331,465
2021,Pembrokeshire 002C,W01000566,1549,1116,433
2021,Pembrokeshire 002D,W01000567,1968,1442,526
2021,Pembrokeshire 005B,W01000569,1065,950,115
2021,Pembrokeshire 005C,W01000570,1366,1225,141
2021,Pembrokeshire 006A,W01000571,2354,2085,269
2021,Pembrokeshire 005D,W01000572,1781,1584,197
2021,Pembrokeshire 006B,W01000573,2496,2174,322
2021,Pembrokeshire 015A,W01000574,1685,1531,154
2021,Pembrokeshire 008C,W01000575,2716,2443,273
2021,Pembrokeshire 011D,W01000576,2244,2007,237
2021,Pembrokeshire 007A,W01000577,1521,1266,255
2021,Pembrokeshire 014B,W01000578,1679,1520,159
2021,Pembrokeshire 003A,W01000579,2305,1641,664
2021,Pembrokeshire 009B,W01000580,2264,2022,242
2021,Pembrokeshire 003B,W01000581,1376,914,462
2021,Pembrokeshire 004A,W01000582,1636,1008,628
2021,Pembrokeshire 004B,W01000583,1391,815,576
2021,Pembrokeshire 014C,W01000584,2023,1815,208
2021,Pembrokeshire 007B,W01000585,1332,1112,220
2021,Pembrokeshire 006C,W01000586,2143,1911,232
2021,Pembrokeshire 010A,W01000587,1935,1776,159
2021,Pembrokeshire 010B,W01000588,2260,2071,189
2021,Pembrokeshire 012A,W01000589,1105,1037,68
2021,Pembrokeshire 012B,W01000590,1110,1051,59
2021,Pembrokeshire 012C,W01000591,1587,1481,106
2021,Pembrokeshire 012D,W01000592,1279,1181,98
2021,Pembrokeshire 012E,W01000594,2103,1955,148
2021,Pembrokeshire 007C,W01000595,2300,1847,453
2021,Pembrokeshire 007D,W01000596,1677,1388,289
2021,Pembrokeshire 002E,W01000597,1038,661,377
2021,Pembrokeshire 009C,W01000598,2108,1960,148
2021,Pembrokeshire 009D,W01000599,1949,1795,154
2021,Pembrokeshire 013A,W01000600,1559,1424,135
2021,Pembrokeshire 013B,W01000601,1462,1376,86
2021,Pembrokeshire 013C,W01000602,1185,1078,107
2021,Pembrokeshire 013D,W01000603,1754,1620,134
2021,Pembrokeshire 013E,W01000604,1654,1530,124
2021,Pembrokeshire 013F,W01000605,1743,1633,110
2021,Pembrokeshire 015B,W01000606,1603,1515,88
2021,Pembrokeshire 015C,W01000607,2375,2161,214
2021,Pembrokeshire 015D,W01000608,1393,1275,118
2021,Pembrokeshire 014D,W01000609,2375,2160,215
2021,Pembrokeshire 016A,W01000610,1676,1460,216
2021,Pembrokeshire 004C,W01000611,2042,1717,325
2021,Pembrokeshire 003C,W01000612,1733,1356,377
2021,Pembrokeshire 001E,W01000613,2011,1228,783
2021,Pembrokeshire 008D,W01000614,1353,1197,156
2021,Pembrokeshire 002F,W01000617,1485,1075,410
2021,Pembrokeshire 003D,W01000618,1685,1366,319
2021,Pembrokeshire 016B,W01000619,1958,1731,227
2021,Pembrokeshire 008E,W01000622,1392,1221,171
2021,Pembrokeshire 004D,W01000623,1961,1575,386
2021,Carmarthenshire 005A,W01000624,2280,1113,1167
2021,Carmarthenshire 013A,W01000625,1087,685,402
2021,Carmarthenshire 013B,W01000626,1573,903,670
2021,Carmarthenshire 013C,W01000627,2324,1314,1010
2021,Carmarthenshire 024A,W01000628,1493,1142,351
2021,Carmarthenshire 024B,W01000629,1596,1273,323
2021,Carmarthenshire 024C,W01000630,1530,1212,318
2021,Carmarthenshire 024D,W01000631,1765,1538,227
2021,Carmarthenshire 021A,W01000632,1304,917,387
2021,Carmarthenshire 021B,W01000633,1383,1058,325
2021,Carmarthenshire 021C,W01000634,1271,906,365
2021,Carmarthenshire 025A,W01000635,2329,1778,551
2021,Carmarthenshire 025B,W01000636,2268,1735,533
2021,Carmarthenshire 007A,W01000637,1336,953,383
2021,Carmarthenshire 007B,W01000638,1101,830,271
2021,Carmarthenshire 007C,W01000639,1457,999,458
2021,Carmarthenshire 007D,W01000640,1187,698,489
2021,Carmarthenshire 008A,W01000641,1998,1439,559
2021,Carmarthenshire 008B,W01000642,1714,1142,572
2021,Carmarthenshire 006A,W01000643,1621,1239,382
2021,Carmarthenshire 006B,W01000644,1812,1142,670
2021,Carmarthenshire 006C,W01000645,1898,1243,655
2021,Carmarthenshire 003A,W01000646,2077,1222,855
2021,Carmarthenshire 002A,W01000647,1394,839,555
2021,Carmarthenshire 006D,W01000648,1393,752,641
2021,Carmarthenshire 006E,W01000649,1506,809,697
2021,Carmarthenshire 002B,W01000650,1521,889,632
2021,Carmarthenshire 020A,W01000651,1465,1107,358
2021,Carmarthenshire 020B,W01000652,1732,1396,336
2021,Carmarthenshire 023A,W01000653,1426,998,428
2021,Carmarthenshire 023B,W01000654,1617,1275,342
2021,Carmarthenshire 020C,W01000655,1850,1419,431
2021,Carmarthenshire 010A,W01000656,1987,1130,857
2021,Carmarthenshire 010B,W01000657,1130,673,457
2021,Carmarthenshire 010C,W01000658,1287,751,536
2021,Carmarthenshire 026A,W01000659,1712,1432,280
2021,Carmarthenshire 026B,W01000660,1444,1208,236
2021,Carmarthenshire 016A,W01000662,2107,1093,1014
2021,Carmarthenshire 016B,W01000663,2402,1067,1335
2021,Carmarthenshire 016C,W01000664,2508,1266,1242
2021,Carmarthenshire 017A,W01000665,1768,1147,621
2021,Carmarthenshire 017B,W01000666,1596,1089,507
2021,Carmarthenshire 023C,W01000667,2039,1402,637
2021,Carmarthenshire 018A,W01000670,1532,1065,467
2021,Carmarthenshire 018B,W01000671,2088,1403,685
2021,Carmarthenshire 027E,W01000672,1462,1191,271
2021,Carmarthenshire 027F,W01000673,1082,845,237
2021,Carmarthenshire 027A,W01000674,2044,1151,893
2021,Carmarthenshire 012A,W01000675,2021,964,1057
2021,Carmarthenshire 004A,W01000676,1488,839,649
2021,Carmarthenshire 004B,W01000677,1411,887,524
2021,Carmarthenshire 002C,W01000678,1344,932,412
2021,Carmarthenshire 002D,W01000679,1204,773,431
2021,Carmarthenshire 011A,W01000680,2248,1230,1018
2021,Carmarthenshire 011B,W01000681,2020,1127,893
2021,Carmarthenshire 005B,W01000682,1363,614,749
2021,Carmarthenshire 005C,W01000683,1039,681,358
2021,Carmarthenshire 005D,W01000684,1718,979,739
2021,Carmarthenshire 001A,W01000685,1502,808,694
2021,Carmarthenshire 001B,W01000686,1187,551,636
2021,Carmarthenshire 004C,W01000687,1906,1066,840
2021,Carmarthenshire 003B,W01000688,1657,927,730
2021,Carmarthenshire 003C,W01000689,1696,923,773
2021,Carmarthenshire 019A,W01000690,1729,1110,619
2021,Carmarthenshire 019B,W01000691,1800,1259,541
2021,Carmarthenshire 019C,W01000692,1500,988,512
2021,Carmarthenshire 008C,W01000693,1099,643,456
2021,Carmarthenshire 008D,W01000694,1464,831,633
2021,Carmarthenshire 012B,W01000695,2164,1283,881
2021,Carmarthenshire 012C,W01000696,1609,815,794
2021,Carmarthenshire 015A,W01000697,1876,913,963
2021,Carmarthenshire 015B,W01000698,1908,888,1020
2021,Carmarthenshire 015C,W01000699,1434,778,656
2021,Carmarthenshire 027G,W01000700,1938,1228,710
2021,Carmarthenshire 001C,W01000701,1564,830,734
2021,Carmarthenshire 001D,W01000702,1148,623,525
2021,Carmarthenshire 022A,W01000703,1719,1350,369
2021,Carmarthenshire 022B,W01000704,1609,1116,493
2021,Carmarthenshire 022C,W01000705,1852,1470,382
2021,Carmarthenshire 025C,W01000706,1505,1190,315
2021,Carmarthenshire 025D,W01000707,1392,1081,311
2021,Carmarthenshire 025E,W01000708,1329,1088,241
2021,Carmarthenshire 004D,W01000709,2145,1248,897
2021,Carmarthenshire 021D,W01000710,2124,1430,694
2021,Carmarthenshire 021E,W01000711,1975,1563,412
2021,Carmarthenshire 015D,W01000712,1643,843,800
2021,Carmarthenshire 015E,W01000713,1329,647,682
2021,Carmarthenshire 013D,W01000714,1377,872,505
2021,Carmarthenshire 013E,W01000715,1252,678,574
2021,Carmarthenshire 016D,W01000716,1371,618,753
2021,Carmarthenshire 016E,W01000717,1405,660,745
2021,Carmarthenshire 010D,W01000718,1361,651,710
2021,Carmarthenshire 010E,W01000719,1404,687,717
2021,Carmarthenshire 027B,W01000720,1770,1028,742
2021,Carmarthenshire 027C,W01000721,1355,785,570
2021,Carmarthenshire 012D,W01000722,1321,691,630
2021,Carmarthenshire 012E,W01000723,1344,871,473
2021,Carmarthenshire 011C,W01000724,1889,1123,766
2021,Carmarthenshire 011D,W01000725,2262,1307,955
2021,Carmarthenshire 003D,W01000728,2022,1170,852
2021,Carmarthenshire 018C,W01000729,1197,690,507
2021,Carmarthenshire 018D,W01000730,1237,820,417
2021,Carmarthenshire 017C,W01000731,2337,1519,818
2021,Carmarthenshire 026D,W01000732,1263,1040,223
2021,Carmarthenshire 026E,W01000733,1156,983,173
2021,Carmarthenshire 026F,W01000734,1343,1100,243
2021,Carmarthenshire 027D,W01000735,2319,1558,761
2021,Swansea 028A,W01000736,1721,1521,200
2021,Swansea 028B,W01000737,1452,1289,163
2021,Swansea 014A,W01000738,1660,1559,101
2021,Swansea 014B,W01000739,2152,1982,170
2021,Swansea 014C,W01000740,1525,1403,122
2021,Swansea 014D,W01000741,1798,1640,158
2021,Swansea 016A,W01000742,1604,1495,109
2021,Swansea 016B,W01000744,1472,1362,110
2021,Swansea 025B,W01000745,2404,2185,219
2021,Swansea 025C,W01000746,1377,1250,127
2021,Swansea 024A,W01000747,1552,1382,170
2021,Swansea 026A,W01000749,1951,1772,179
2021,Swansea 002A,W01000750,1414,1127,287
2021,Swansea 002B,W01000751,1366,1041,325
2021,Swansea 002C,W01000752,1427,1238,189
2021,Swansea 002D,W01000753,1383,1136,247
2021,Swansea 002E,W01000754,1512,1255,257
2021,Swansea 017A,W01000755,1919,1742,177
2021,Swansea 017B,W01000756,1428,1287,141
2021,Swansea 017C,W01000757,1394,1256,138
2021,Swansea 017D,W01000758,1842,1621,221
2021,Swansea 012A,W01000759,1506,1324,182
2021,Swansea 013A,W01000760,1527,1349,178
2021,Swansea 013B,W01000761,1518,1366,152
2021,Swansea 013C,W01000762,1611,1519,92
2021,Swansea 015A,W01000763,1363,1252,111
2021,Swansea 015B,W01000764,1520,1402,118
2021,Swansea 015C,W01000765,1583,1451,132
2021,Swansea 015D,W01000766,1448,1320,128
2021,Swansea 015E,W01000767,1388,1315,73
2021,Swansea 032A,W01000768,1315,1196,119
2021,Swansea 032B,W01000769,1355,1248,107
2021,Swansea 032D,W01000770,1484,1362,122
2021,Swansea 032G,W01000771,1274,1145,129
2021,Swansea 018A,W01000772,1451,1293,158
2021,Swansea 005B,W01000774,1562,1316,246
2021,Swansea 030A,W01000775,1602,1461,141
2021,Swansea 030B,W01000776,1749,1534,215
2021,Swansea 012B,W01000777,1672,1475,197
2021,Swansea 012C,W01000778,1733,1529,204
2021,Swansea 012D,W01000779,1417,1237,180
2021,Swansea 032E,W01000781,1587,1380,207
2021,Swansea 032F,W01000782,1049,965,84
2021,Swansea 007A,W01000784,1263,1078,185
2021,Swansea 007B,W01000785,1718,1434,284
2021,Swansea 007C,W01000786,1229,1031,198
2021,Swansea 016C,W01000787,1395,1243,152
2021,Swansea 016D,W01000788,1439,1321,118
2021,Swansea 016E,W01000789,1368,1289,79
2021,Swansea 016F,W01000790,2619,2420,199
2021,Swansea 004A,W01000791,1377,1215,162
2021,Swansea 004B,W01000792,1536,1228,308
2021,Swansea 004C,W01000793,1813,1513,300
2021,Swansea 010A,W01000794,2135,1754,381
2021,Swansea 006A,W01000795,1524,1296,228
2021,Swansea 010B,W01000797,1475,1269,206
2021,Swansea 010C,W01000798,1383,1222,161
2021,Swansea 010D,W01000799,1783,1612,171
2021,Swansea 006C,W01000800,1424,1188,236
2021,Swansea 006D,W01000801,1666,1540,126
2021,Swansea 007D,W01000802,2286,1953,333
2021,Swansea 002F,W01000803,1778,1253,525
2021,Swansea 028C,W01000804,1404,1207,197
2021,Swansea 028D,W01000805,1119,980,139
2021,Swansea 003A,W01000806,1367,1202,165
2021,Swansea 003B,W01000807,1267,1151,116
2021,Swansea 003C,W01000808,1365,1194,171
2021,Swansea 008A,W01000809,1463,1315,148
2021,Swansea 003D,W01000810,1303,1192,111
2021,Swansea 008B,W01000811,1347,1218,129
2021,Swansea 008C,W01000812,1409,1303,106
2021,Swansea 008D,W01000813,1531,1295,236
2021,Swansea 008E,W01000814,1380,1254,126
2021,Swansea 003E,W01000815,1459,1193,266
2021,Swansea 003F,W01000816,1725,1527,198
2021,Swansea 009A,W01000817,1880,1717,163
2021,Swansea 009B,W01000818,1447,1285,162
2021,Swansea 009C,W01000819,1411,1246,165
2021,Swansea 009D,W01000820,1352,1225,127
2021,Swansea 009E,W01000821,1431,1342,89
2021,Swansea 009F,W01000822,1171,1049,122
2021,Swansea 031A,W01000823,1789,1585,204
2021,Swansea 031B,W01000824,1625,1414,211
2021,Swansea 031C,W01000825,1247,1095,152
2021,Swansea 031D,W01000826,1236,1058,178
2021,Swansea 031E,W01000827,1227,1090,137
2021,Swansea 018B,W01000828,1606,1414,192
2021,Swansea 018C,W01000829,1873,1654,219
2021,Swansea 011A,W01000830,1696,1597,99
2021,Swansea 013D,W01000831,1668,1505,163
2021,Swansea 011B,W01000832,1522,1424,98
2021,Swansea 011C,W01000833,1567,1468,99
2021,Swansea 011D,W01000834,1393,1257,136
2021,Swansea 013E,W01000835,1405,1302,103
2021,Swansea 011E,W01000836,2281,2061,220
2021,Swansea 004D,W01000837,2237,1863,374
2021,Swansea 004E,W01000838,1225,1100,125
2021,Swansea 030C,W01000839,1024,919,105
2021,Swansea 030D,W01000840,1588,1415,173
2021,Swansea 005C,W01000841,1428,1257,171
2021,Swansea 005D,W01000842,1384,1207,177
2021,Swansea 005E,W01000843,1349,1150,199
2021,Swansea 005F,W01000844,1456,1291,165
2021,Swansea 001A,W01000845,1960,1440,520
2021,Swansea 001B,W01000846,1985,1490,495
2021,Swansea 001C,W01000847,1230,922,308
2021,Swansea 001D,W01000848,1168,987,181
2021,Swansea 021A,W01000849,2119,1942,177
2021,Swansea 021C,W01000851,1564,1457,107
2021,Swansea 021D,W01000852,1432,1343,89
2021,Swansea 022A,W01000853,1633,1426,207
2021,Swansea 022B,W01000854,1462,1267,195
2021,Swansea 022C,W01000855,1390,1220,170
2021,Swansea 022D,W01000856,1695,1574,121
2021,Swansea 022E,W01000857,1873,1683,190
2021,Swansea 027A,W01000858,1603,1366,237
2021,Swansea 027B,W01000859,1375,1216,159
2021,Swansea 027C,W01000860,1503,1257,246
2021,Swansea 027D,W01000861,1932,1663,269
2021,Swansea 019A,W01000862,1492,1387,105
2021,Swansea 019B,W01000863,1561,1489,72
2021,Swansea 019C,W01000864,1568,1490,78
2021,Swansea 019D,W01000865,1367,1294,73
2021,Swansea 019E,W01000866,1134,1072,62
2021,Swansea 019F,W01000867,1238,1148,90
2021,Swansea 024B,W01000868,1066,907,159
2021,Swansea 024C,W01000869,1501,1311,190
2021,Swansea 024D,W01000870,1348,1174,174
2021,Swansea 026B,W01000871,1737,1558,179
2021,Swansea 024E,W01000872,1363,1137,226
2021,Swansea 026C,W01000873,1513,1328,185
2021,Swansea 024F,W01000874,1774,1523,251
2021,Swansea 026D,W01000875,1880,1674,206
2021,Swansea 026E,W01000876,1616,1402,214
2021,Swansea 007E,W01000877,1630,1350,280
2021,Swansea 007F,W01000878,1237,1044,193
2021,Swansea 029A,W01000879,1647,1435,212
2021,Swansea 029B,W01000880,1517,1322,195
2021,Swansea 029C,W01000881,1291,1165,126
2021,Swansea 029D,W01000882,1689,1512,177
2021,Neath Port Talbot 016A,W01000883,1300,1214,86
2021,Neath Port Talbot 017A,W01000884,1231,1132,99
2021,Neath Port Talbot 017B,W01000885,1405,1307,98
2021,Neath Port Talbot 017C,W01000886,1564,1468,96
2021,Neath Port Talbot 021C,W01000887,2316,2002,314
2021,Neath Port Talbot 004A,W01000888,2630,2038,592
2021,Neath Port Talbot 015A,W01000889,1762,1571,191
2021,Neath Port Talbot 015B,W01000890,1504,1364,140
2021,Neath Port Talbot 015C,W01000891,1401,1275,126
2021,Neath Port Talbot 015D,W01000892,1908,1716,192
2021,Neath Port Talbot 003A,W01000893,1869,1625,244
2021,Neath Port Talbot 013A,W01000894,1426,1288,138
2021,Neath Port Talbot 013B,W01000895,1421,1299,122
2021,Neath Port Talbot 013C,W01000896,1525,1364,161
2021,Neath Port Talbot 013D,W01000897,1279,1166,113
2021,Neath Port Talbot 014A,W01000898,1421,1240,181
2021,Neath Port Talbot 014B,W01000899,1817,1548,269
2021,Neath Port Talbot 014C,W01000900,1527,1356,171
2021,Neath Port Talbot 014D,W01000901,1618,1391,227
2021,Neath Port Talbot 006C,W01000904,1439,1238,201
2021,Neath Port Talbot 006D,W01000905,1451,1279,172
2021,Neath Port Talbot 007B,W01000907,1681,1512,169
2021,Neath Port Talbot 006E,W01000908,1553,1343,210
2021,Neath Port Talbot 009A,W01000909,1152,1053,99
2021,Neath Port Talbot 009B,W01000910,1339,1203,136
2021,Neath Port Talbot 009C,W01000911,1124,994,130
2021,Neath Port Talbot 010A,W01000912,1169,1064,105
2021,Neath Port Talbot 010B,W01000913,1120,993,127
2021,Neath Port Talbot 010C,W01000914,1598,1473,125
2021,Neath Port Talbot 010D,W01000915,1089,975,114
2021,Neath Port Talbot 010E,W01000916,1154,1033,121
2021,Neath Port Talbot 002A,W01000918,1883,1542,341
2021,Neath Port Talbot 020A,W01000919,1120,586,534
2021,Neath Port Talbot 021G,W01000921,1405,1315,90
2021,Neath Port Talbot 007C,W01000922,1541,1389,152
2021,Neath Port Talbot 003B,W01000925,1486,1264,222
2021,Neath Port Talbot 003C,W01000926,1798,1412,386
2021,Neath Port Talbot 020B,W01000927,1993,1519,474
2021,Neath Port Talbot 020C,W01000928,1544,857,687
2021,Neath Port Talbot 020D,W01000929,1223,777,446
2021,Neath Port Talbot 021F,W01000930,1111,1042,69
2021,Neath Port Talbot 020E,W01000931,1316,744,572
2021,Neath Port Talbot 019A,W01000932,1001,926,75
2021,Neath Port Talbot 019B,W01000933,1943,1718,225
2021,Neath Port Talbot 008A,W01000934,1205,1111,94
2021,Neath Port Talbot 008B,W01000935,1508,1387,121
2021,Neath Port Talbot 012A,W01000936,1327,1231,96
2021,Neath Port Talbot 013E,W01000937,1873,1678,195
2021,Neath Port Talbot 008C,W01000938,1358,1164,194
2021,Neath Port Talbot 008D,W01000939,1123,1033,90
2021,Neath Port Talbot 008E,W01000940,1228,1113,115
2021,Neath Port Talbot 012B,W01000941,1487,1353,134
2021,Neath Port Talbot 012C,W01000942,1735,1600,135
2021,Neath Port Talbot 012D,W01000943,1442,1264,178
2021,Neath Port Talbot 002B,W01000944,1145,987,158
2021,Neath Port Talbot 014E,W01000945,1131,987,144
2021,Neath Port Talbot 004B,W01000946,1750,1355,395
2021,Neath Port Talbot 004C,W01000947,2109,1635,474
2021,Neath Port Talbot 004D,W01000948,1777,1330,447
2021,Neath Port Talbot 018A,W01000949,1291,1159,132
2021,Neath Port Talbot 018B,W01000950,1417,1284,133
2021,Neath Port Talbot 018C,W01000951,1736,1569,167
2021,Neath Port Talbot 018D,W01000952,1135,1026,109
2021,Neath Port Talbot 021B,W01000953,1559,1361,198
2021,Neath Port Talbot 021A,W01000954,1312,1164,148
2021,Neath Port Talbot 004E,W01000955,1340,1038,302
2021,Neath Port Talbot 004F,W01000956,1174,951,223
2021,Neath Port Talbot 017D,W01000957,1570,1459,111
2021,Neath Port Talbot 016B,W01000958,1513,1427,86
2021,Neath Port Talbot 017E,W01000959,1687,1541,146
2021,Neath Port Talbot 017F,W01000960,1717,1601,116
2021,Neath Port Talbot 016C,W01000961,1542,1419,123
2021,Neath Port Talbot 016D,W01000962,1487,1363,124
2021,Neath Port Talbot 016E,W01000963,1798,1666,132
2021,Neath Port Talbot 016F,W01000964,1755,1631,124
2021,Neath Port Talbot 002C,W01000965,1968,1574,394
2021,Neath Port Talbot 018E,W01000966,1401,1280,121
2021,Neath Port Talbot 019C,W01000967,1372,1296,76
2021,Neath Port Talbot 019D,W01000968,1906,1733,173
2021,Neath Port Talbot 009D,W01000969,1498,1302,196
2021,Neath Port Talbot 021D,W01000970,1081,966,115
2021,Neath Port Talbot 004G,W01000971,1360,956,404
2021,Neath Port Talbot 020F,W01000973,1296,892,404
2021,Bridgend 006A,W01000974,2301,2058,243
2021,Bridgend 004A,W01000975,2164,2000,164
2021,Bridgend 003A,W01000976,1060,982,78
2021,Bridgend 003B,W01000977,1380,1256,124
2021,Bridgend 004B,W01000978,1725,1557,168
2021,Bridgend 015A,W01000979,1558,1401,157
2021,Bridgend 016A,W01000980,1303,1196,107
2021,Bridgend 016B,W01000981,1202,1077,125
2021,Bridgend 016C,W01000982,1393,1265,128
2021,Bridgend 015B,W01000983,1467,1305,162
2021,Bridgend 016D,W01000984,2104,1870,234
2021,Bridgend 015C,W01000985,1236,1108,128
2021,Bridgend 007A,W01000986,1617,1395,222
2021,Bridgend 007B,W01000987,2334,2124,210
2021,Bridgend 013A,W01000989,1530,1344,186
2021,Bridgend 017B,W01000990,1508,1392,116
2021,Bridgend 001A,W01000991,1103,1007,96
2021,Bridgend 001B,W01000992,1348,1243,105
2021,Bridgend 001C,W01000993,1315,1223,92
2021,Bridgend 001D,W01000994,1351,1236,115
2021,Bridgend 001E,W01000995,1328,1177,151
2021,Bridgend 008A,W01000996,1496,1344,152
2021,Bridgend 012A,W01000997,1651,1525,126
2021,Bridgend 010A,W01000999,1355,1222,133
2021,Bridgend 010B,W01001000,1686,1508,178
2021,Bridgend 010C,W01001001,1758,1570,188
2021,Bridgend 010D,W01001002,2338,2123,215
2021,Bridgend 015D,W01001003,1310,1181,129
2021,Bridgend 009A,W01001004,1013,904,109
2021,Bridgend 009B,W01001005,1556,1391,165
2021,Bridgend 009C,W01001006,2187,1926,261
2021,Bridgend 009D,W01001007,1830,1632,198
2021,Bridgend 011B,W01001008,2474,2186,288
2021,Bridgend 004C,W01001009,1208,1066,142
2021,Bridgend 012B,W01001010,1126,1040,86
2021,Bridgend 012C,W01001011,1246,1148,98
2021,Bridgend 005A,W01001012,1469,1226,243
2021,Bridgend 005B,W01001013,1437,1212,225
2021,Bridgend 002A,W01001014,1575,1392,183
2021,Bridgend 002B,W01001015,1423,1239,184
2021,Bridgend 005C,W01001016,1595,1408,187
2021,Bridgend 002C,W01001017,1426,1202,224
2021,Bridgend 002D,W01001018,1253,1080,173
2021,Bridgend 005D,W01001019,1539,1341,198
2021,Bridgend 002E,W01001020,1316,1179,137
2021,Bridgend 014A,W01001021,1558,1423,135
2021,Bridgend 014B,W01001022,1381,1276,105
2021,Bridgend 014C,W01001023,1607,1491,116
2021,Bridgend 003C,W01001024,1106,1017,89
2021,Bridgend 003D,W01001025,1195,1092,103
2021,Bridgend 012D,W01001026,1941,1782,159
2021,Bridgend 017C,W01001027,1461,1330,131
2021,Bridgend 014D,W01001028,1843,1644,199
2021,Bridgend 019A,W01001029,1684,1535,149
2021,Bridgend 019B,W01001030,1918,1721,197
2021,Bridgend 018A,W01001031,1443,1319,124
2021,Bridgend 018B,W01001032,1726,1544,182
2021,Bridgend 003E,W01001033,1701,1558,143
2021,Bridgend 003F,W01001034,1299,1178,121
2021,Bridgend 014E,W01001035,1689,1536,153
2021,Bridgend 017D,W01001036,1585,1359,226
2021,Bridgend 013B,W01001037,1763,1564,199
2021,Bridgend 011C,W01001038,2494,2241,253
2021,Bridgend 009E,W01001039,1661,1489,172
2021,Bridgend 009F,W01001040,1521,1389,132
2021,Bridgend 013C,W01001041,2240,1990,250
2021,Bridgend 004D,W01001042,1221,1042,179
2021,Bridgend 004E,W01001043,1132,993,139
2021,Bridgend 019C,W01001044,1555,1465,90
2021,Bridgend 019D,W01001045,1668,1551,117
2021,Bridgend 018C,W01001046,1886,1742,144
2021,Bridgend 018D,W01001047,1633,1467,166
2021,Bridgend 008B,W01001048,1381,1260,121
2021,Bridgend 008C,W01001049,1259,1140,119
2021,Bridgend 008D,W01001050,1501,1344,157
2021,Bridgend 008E,W01001051,1764,1596,168
2021,Bridgend 008F,W01001052,1240,1140,100
2021,Bridgend 018E,W01001053,992,848,144
2021,Bridgend 018F,W01001054,1332,1211,121
2021,Bridgend 007C,W01001055,1164,1071,93
2021,Bridgend 007D,W01001056,1152,1043,109
2021,Bridgend 006B,W01001057,1678,1517,161
2021,Bridgend 006C,W01001058,1840,1633,207
2021,Vale of Glamorgan 015A,W01001059,1702,1443,259
2021,Vale of Glamorgan 015B,W01001060,1385,1194,191
2021,Vale of Glamorgan 013A,W01001062,1304,1100,204
2021,Vale of Glamorgan 012A,W01001063,1544,1384,160
2021,Vale of Glamorgan 013B,W01001064,1370,1233,137
2021,Vale of Glamorgan 012B,W01001065,1518,1316,202
2021,Vale of Glamorgan 015D,W01001066,1575,1359,216
2021,Vale of Glamorgan 009A,W01001067,1344,1225,119
2021,Vale of Glamorgan 009B,W01001068,1603,1467,136
2021,Vale of Glamorgan 012C,W01001069,1474,1346,128
2021,Vale of Glamorgan 009C,W01001070,994,906,88
2021,Vale of Glamorgan 009D,W01001071,1436,1307,129
2021,Vale of Glamorgan 009E,W01001072,2630,2295,335
2021,Vale of Glamorgan 015E,W01001073,2017,1830,187
2021,Vale of Glamorgan 004A,W01001075,1143,982,161
2021,Vale of Glamorgan 004B,W01001076,1343,1199,144
2021,Vale of Glamorgan 004C,W01001077,1384,1241,143
2021,Vale of Glamorgan 004D,W01001078,1255,1075,180
2021,Vale of Glamorgan 012E,W01001079,1438,1269,169
2021,Vale of Glamorgan 012F,W01001080,1525,1380,145
2021,Vale of Glamorgan 007A,W01001081,1675,1484,191
2021,Vale of Glamorgan 002A,W01001082,1526,1305,221
2021,Vale of Glamorgan 002B,W01001083,1668,1411,257
2021,Vale of Glamorgan 002C,W01001084,1626,1398,228
2021,Vale of Glamorgan 002D,W01001085,1610,1367,243
2021,Vale of Glamorgan 006A,W01001086,1468,1255,213
2021,Vale of Glamorgan 006B,W01001087,1472,1299,173
2021,Vale of Glamorgan 006C,W01001088,2073,1876,197
2021,Vale of Glamorgan 006D,W01001089,1553,1401,152
2021,Vale of Glamorgan 006E,W01001090,1412,1226,186
2021,Vale of Glamorgan 010A,W01001091,1589,1410,179
2021,Vale of Glamorgan 007B,W01001092,2046,1771,275
2021,Vale of Glamorgan 013C,W01001093,1719,1535,184
2021,Vale of Glamorgan 007C,W01001094,1195,1075,120
2021,Vale of Glamorgan 007D,W01001095,1321,1186,135
2021,Vale of Glamorgan 007E,W01001096,1274,1149,125
2021,Vale of Glamorgan 007F,W01001097,1469,1348,121
2021,Vale of Glamorgan 010B,W01001098,1010,895,115
2021,Vale of Glamorgan 013D,W01001099,1165,1035,130
2021,Vale of Glamorgan 010C,W01001100,1452,1273,179
2021,Vale of Glamorgan 013E,W01001101,1473,1301,172
2021,Vale of Glamorgan 013F,W01001102,1467,1258,209
2021,Vale of Glamorgan 010D,W01001103,1151,1039,112
2021,Vale of Glamorgan 004E,W01001104,2039,1812,227
2021,Vale of Glamorgan 001A,W01001105,2757,2352,405
2021,Vale of Glamorgan 011A,W01001106,1415,1272,143
2021,Vale of Glamorgan 011B,W01001107,1476,1345,131
2021,Vale of Glamorgan 014A,W01001108,1755,1567,188
2021,Vale of Glamorgan 011C,W01001109,1347,1188,159
2021,Vale of Glamorgan 011D,W01001110,1659,1483,176
2021,Vale of Glamorgan 011E,W01001111,1314,1205,109
2021,Vale of Glamorgan 011F,W01001112,1279,1114,165
2021,Vale of Glamorgan 003A,W01001113,2263,1937,326
2021,Vale of Glamorgan 008A,W01001114,1545,1323,222
2021,Vale of Glamorgan 008B,W01001115,2100,1862,238
2021,Vale of Glamorgan 005A,W01001116,1903,1631,272
2021,Vale of Glamorgan 014B,W01001117,1263,1148,115
2021,Vale of Glamorgan 003B,W01001119,1817,1590,227
2021,Vale of Glamorgan 014D,W01001120,1320,1194,126
2021,Vale of Glamorgan 014E,W01001121,1659,1507,152
2021,Vale of Glamorgan 014F,W01001122,2369,2166,203
2021,Vale of Glamorgan 005B,W01001123,1446,1251,195
2021,Vale of Glamorgan 005C,W01001124,1421,1239,182
2021,Vale of Glamorgan 005D,W01001125,1386,1211,175
2021,Vale of Glamorgan 001B,W01001127,1589,1384,205
2021,Vale of Glamorgan 001C,W01001128,1638,1430,208
2021,Vale of Glamorgan 004F,W01001129,1598,1419,179
2021,Vale of Glamorgan 005F,W01001130,1240,1070,170
2021,Vale of Glamorgan 008C,W01001131,1650,1455,195
2021,Vale of Glamorgan 008D,W01001132,1307,1175,132
2021,Vale of Glamorgan 008E,W01001133,2187,1969,218
2021,Vale of Glamorgan 008F,W01001134,1084,968,116
2021,Vale of Glamorgan 003C,W01001135,2240,1947,293
2021,Vale of Glamorgan 003D,W01001136,1465,1310,155
2021,Rhondda Cynon Taf 005A,W01001137,2289,2073,216
2021,Rhondda Cynon Taf 005B,W01001138,1289,1166,123
2021,Rhondda Cynon Taf 005C,W01001139,1356,1230,126
2021,Rhondda Cynon Taf 005D,W01001140,1363,1236,127
2021,Rhondda Cynon Taf 005E,W01001141,1463,1338,125
2021,Rhondda Cynon Taf 005F,W01001142,1840,1645,195
2021,Rhondda Cynon Taf 012A,W01001143,1433,1244,189
2021,Rhondda Cynon Taf 012B,W01001144,1672,1530,142
2021,Rhondda Cynon Taf 012C,W01001145,1686,1485,201
2021,Rhondda Cynon Taf 012D,W01001146,1366,1171,195
2021,Rhondda Cynon Taf 004A,W01001147,1760,1528,232
2021,Rhondda Cynon Taf 002A,W01001148,1683,1483,200
2021,Rhondda Cynon Taf 003A,W01001149,1357,1192,165
2021,Rhondda Cynon Taf 003B,W01001150,1820,1597,223
2021,Rhondda Cynon Taf 003C,W01001151,1770,1532,238
2021,Rhondda Cynon Taf 002B,W01001152,1883,1606,277
2021,Rhondda Cynon Taf 002C,W01001153,1515,1340,175
2021,Rhondda Cynon Taf 003D,W01001154,1371,1224,147
2021,Rhondda Cynon Taf 002D,W01001155,1482,1302,180
2021,Rhondda Cynon Taf 003E,W01001156,1375,1135,240
2021,Rhondda Cynon Taf 028A,W01001157,1269,1110,159
2021,Rhondda Cynon Taf 028B,W01001158,1437,1268,169
2021,Rhondda Cynon Taf 028C,W01001159,1513,1266,247
2021,Rhondda Cynon Taf 029A,W01001160,1586,1402,184
2021,Rhondda Cynon Taf 025A,W01001162,2434,2009,425
2021,Rhondda Cynon Taf 019A,W01001164,1516,1299,217
2021,Rhondda Cynon Taf 019B,W01001165,1307,1126,181
2021,Rhondda Cynon Taf 016A,W01001166,1325,1247,78
2021,Rhondda Cynon Taf 016B,W01001167,1363,1208,155
2021,Rhondda Cynon Taf 004B,W01001168,1359,1221,138
2021,Rhondda Cynon Taf 004C,W01001169,2443,2219,224
2021,Rhondda Cynon Taf 004D,W01001170,1164,1022,142
2021,Rhondda Cynon Taf 017A,W01001171,1256,1121,135
2021,Rhondda Cynon Taf 020A,W01001172,1352,1184,168
2021,Rhondda Cynon Taf 020B,W01001173,1315,1218,97
2021,Rhondda Cynon Taf 020C,W01001174,1364,1266,98
2021,Rhondda Cynon Taf 009A,W01001175,1260,1103,157
2021,Rhondda Cynon Taf 013A,W01001176,1400,1221,179
2021,Rhondda Cynon Taf 009B,W01001177,1256,1140,116
2021,Rhondda Cynon Taf 023A,W01001178,1570,1410,160
2021,Rhondda Cynon Taf 023B,W01001179,1660,1530,130
2021,Rhondda Cynon Taf 015A,W01001180,1479,1292,187
2021,Rhondda Cynon Taf 015B,W01001181,1348,1186,162
2021,Rhondda Cynon Taf 026A,W01001184,2023,1773,250
2021,Rhondda Cynon Taf 022A,W01001185,2005,1764,241
2021,Rhondda Cynon Taf 001A,W01001186,1689,1402,287
2021,Rhondda Cynon Taf 001B,W01001187,1322,1091,231
2021,Rhondda Cynon Taf 001C,W01001188,1266,1124,142
2021,Rhondda Cynon Taf 029C,W01001189,1462,1295,167
2021,Rhondda Cynon Taf 029D,W01001190,2879,2418,461
2021,Rhondda Cynon Taf 031B,W01001192,1380,1227,153
2021,Rhondda Cynon Taf 030A,W01001193,1112,919,193
2021,Rhondda Cynon Taf 030B,W01001194,2058,1700,358
2021,Rhondda Cynon Taf 030C,W01001195,1424,1163,261
2021,Rhondda Cynon Taf 027B,W01001196,1401,1149,252
2021,Rhondda Cynon Taf 027C,W01001197,1184,884,300
2021,Rhondda Cynon Taf 027D,W01001198,1458,1268,190
2021,Rhondda Cynon Taf 027E,W01001199,1613,1370,243
2021,Rhondda Cynon Taf 009C,W01001202,1712,1559,153
2021,Rhondda Cynon Taf 009D,W01001203,1316,1196,120
2021,Rhondda Cynon Taf 006A,W01001204,1471,1258,213
2021,Rhondda Cynon Taf 006B,W01001205,1426,1248,178
2021,Rhondda Cynon Taf 006C,W01001206,1424,1282,142
2021,Rhondda Cynon Taf 006D,W01001207,1231,1103,128
2021,Rhondda Cynon Taf 006E,W01001208,1473,1311,162
2021,Rhondda Cynon Taf 008A,W01001209,1403,1253,150
2021,Rhondda Cynon Taf 008B,W01001210,1415,1291,124
2021,Rhondda Cynon Taf 008C,W01001211,1474,1337,137
2021,Rhondda Cynon Taf 008D,W01001212,1263,1145,118
2021,Rhondda Cynon Taf 011B,W01001214,1272,1066,206
2021,Rhondda Cynon Taf 011D,W01001216,1462,1294,168
2021,Rhondda Cynon Taf 018A,W01001217,1082,970,112
2021,Rhondda Cynon Taf 018B,W01001218,1476,1353,123
2021,Rhondda Cynon Taf 018C,W01001219,1178,1100,78
2021,Rhondda Cynon Taf 018D,W01001220,1448,1307,141
2021,Rhondda Cynon Taf 001D,W01001221,1387,1249,138
2021,Rhondda Cynon Taf 001E,W01001222,1499,1362,137
2021,Rhondda Cynon Taf 031C,W01001223,1691,1470,221
2021,Rhondda Cynon Taf 031D,W01001224,1982,1445,537
2021,Rhondda Cynon Taf 031E,W01001225,1537,1254,283
2021,Rhondda Cynon Taf 031F,W01001226,1644,1368,276
2021,Rhondda Cynon Taf 021C,W01001227,1233,971,262
2021,Rhondda Cynon Taf 021D,W01001228,1575,1302,273
2021,Rhondda Cynon Taf 017B,W01001229,1365,1186,179
2021,Rhondda Cynon Taf 017C,W01001230,1506,1277,229
2021,Rhondda Cynon Taf 017D,W01001231,1387,1202,185
2021,Rhondda Cynon Taf 020D,W01001232,1237,1077,160
2021,Rhondda Cynon Taf 001F,W01001233,1779,1495,284
2021,Rhondda Cynon Taf 021E,W01001234,1452,1250,202
2021,Rhondda Cynon Taf 021F,W01001235,1601,1417,184
2021,Rhondda Cynon Taf 021G,W01001236,1563,1321,242
2021,Rhondda Cynon Taf 022B,W01001237,1409,1273,136
2021,Rhondda Cynon Taf 022C,W01001238,1651,1485,166
2021,Rhondda Cynon Taf 026B,W01001239,1266,1105,161
2021,Rhondda Cynon Taf 026C,W01001240,1856,1613,243
2021,Rhondda Cynon Taf 026D,W01001241,1612,1361,251
2021,Rhondda Cynon Taf 030D,W01001242,1322,1116,206
2021,Rhondda Cynon Taf 030E,W01001243,1368,1208,160
2021,Rhondda Cynon Taf 025B,W01001244,1353,1155,198
2021,Rhondda Cynon Taf 025C,W01001245,1201,1019,182
2021,Rhondda Cynon Taf 025D,W01001246,1308,1125,183
2021,Rhondda Cynon Taf 016C,W01001247,1544,1375,169
2021,Rhondda Cynon Taf 016D,W01001248,1932,1702,230
2021,Rhondda Cynon Taf 024A,W01001249,1418,1268,150
2021,Rhondda Cynon Taf 024B,W01001250,1490,1288,202
2021,Rhondda Cynon Taf 024C,W01001251,1451,1305,146
2021,Rhondda Cynon Taf 024D,W01001252,1521,1351,170
2021,Rhondda Cynon Taf 023C,W01001253,1406,1261,145
2021,Rhondda Cynon Taf 023E,W01001255,1939,1726,213
2021,Rhondda Cynon Taf 019C,W01001256,1155,997,158
2021,Rhondda Cynon Taf 019D,W01001257,1203,999,204
2021,Rhondda Cynon Taf 019E,W01001258,1210,1056,154
2021,Rhondda Cynon Taf 018E,W01001259,1558,1422,136
2021,Rhondda Cynon Taf 014C,W01001260,1138,988,150
2021,Rhondda Cynon Taf 018F,W01001261,1208,1080,128
2021,Rhondda Cynon Taf 022D,W01001262,1534,1388,146
2021,Rhondda Cynon Taf 022E,W01001263,1642,1498,144
2021,Rhondda Cynon Taf 022F,W01001264,1884,1684,200
2021,Rhondda Cynon Taf 007A,W01001265,1493,1240,253
2021,Rhondda Cynon Taf 007B,W01001266,1332,1177,155
2021,Rhondda Cynon Taf 007C,W01001267,1440,1283,157
2021,Rhondda Cynon Taf 007D,W01001268,1277,1064,213
2021,Rhondda Cynon Taf 010A,W01001269,1410,1184,226
2021,Rhondda Cynon Taf 010B,W01001270,1406,1200,206
2021,Rhondda Cynon Taf 010C,W01001271,1479,1263,216
2021,Rhondda Cynon Taf 010D,W01001272,1426,1207,219
2021,Rhondda Cynon Taf 010E,W01001273,1708,1367,341
2021,Rhondda Cynon Taf 013B,W01001274,1144,1035,109
2021,Rhondda Cynon Taf 013C,W01001275,1729,1495,234
2021,Rhondda Cynon Taf 013D,W01001276,1225,1100,125
2021,Rhondda Cynon Taf 028D,W01001277,1089,973,116
2021,Rhondda Cynon Taf 028E,W01001278,1107,963,144
2021,Rhondda Cynon Taf 028F,W01001279,1069,972,97
2021,Rhondda Cynon Taf 017E,W01001280,1518,1381,137
2021,Rhondda Cynon Taf 017F,W01001281,1629,1377,252
2021,Rhondda Cynon Taf 015C,W01001282,1962,1699,263
2021,Rhondda Cynon Taf 015D,W01001283,1406,1173,233
2021,Rhondda Cynon Taf 015E,W01001284,1046,831,215
2021,Rhondda Cynon Taf 014D,W01001285,1332,1150,182
2021,Rhondda Cynon Taf 014E,W01001286,1420,1196,224
2021,Rhondda Cynon Taf 014F,W01001287,1417,1253,164
2021,Rhondda Cynon Taf 014G,W01001288,1384,1179,205
2021,Merthyr Tydfil 006A,W01001289,1313,1167,146
2021,Merthyr Tydfil 007A,W01001290,2304,2057,247
2021,Merthyr Tydfil 003A,W01001291,2002,1748,254
2021,Merthyr Tydfil 004A,W01001292,1762,1623,139
2021,Merthyr Tydfil 004B,W01001293,1638,1484,154
2021,Merthyr Tydfil 003B,W01001294,1628,1460,168
2021,Merthyr Tydfil 002A,W01001295,1454,1357,97
2021,Merthyr Tydfil 002B,W01001296,1521,1365,156
2021,Merthyr Tydfil 002C,W01001297,1762,1613,149
2021,Merthyr Tydfil 002D,W01001298,1678,1550,128
2021,Merthyr Tydfil 008A,W01001299,1617,1529,88
2021,Merthyr Tydfil 008B,W01001300,1677,1568,109
2021,Merthyr Tydfil 008C,W01001301,1835,1746,89
2021,Merthyr Tydfil 006B,W01001302,1370,1207,163
2021,Merthyr Tydfil 003C,W01001305,1193,1097,96
2021,Merthyr Tydfil 003D,W01001306,1387,1250,137
2021,Merthyr Tydfil 004C,W01001307,1490,1374,116
2021,Merthyr Tydfil 008D,W01001308,1194,1142,52
2021,Merthyr Tydfil 008E,W01001309,1256,1182,74
2021,Merthyr Tydfil 002E,W01001310,1494,1351,143
2021,Merthyr Tydfil 002F,W01001311,1103,1019,84
2021,Merthyr Tydfil 006E,W01001312,1433,1304,129
2021,Merthyr Tydfil 006F,W01001313,1435,1317,118
2021,Merthyr Tydfil 005A,W01001314,2050,1839,211
2021,Merthyr Tydfil 004D,W01001315,1658,1510,148
2021,Merthyr Tydfil 005C,W01001317,1693,1485,208
2021,Merthyr Tydfil 005D,W01001318,1438,1285,153
2021,Merthyr Tydfil 007B,W01001319,1566,1320,246
2021,Merthyr Tydfil 007C,W01001320,1385,1228,157
2021,Merthyr Tydfil 007D,W01001321,1566,1391,175
2021,Merthyr Tydfil 007E,W01001322,1578,1398,180
2021,Merthyr Tydfil 003E,W01001324,1878,1675,203
2021,Caerphilly 003A,W01001325,1603,1400,203
2021,Caerphilly 003B,W01001326,2079,1841,238
2021,Caerphilly 014A,W01001327,2361,2086,275
2021,Caerphilly 014B,W01001328,1465,1301,164
2021,Caerphilly 014C,W01001329,1447,1312,135
2021,Caerphilly 018A,W01001330,1401,1133,268
2021,Caerphilly 018B,W01001331,1679,1434,245
2021,Caerphilly 018C,W01001332,1781,1539,242
2021,Caerphilly 018D,W01001333,1421,1230,191
2021,Caerphilly 005A,W01001334,1396,1274,122
2021,Caerphilly 005B,W01001335,1237,1093,144
2021,Caerphilly 004A,W01001336,1369,1226,143
2021,Caerphilly 004B,W01001337,1407,1295,112
2021,Caerphilly 004C,W01001338,1663,1523,140
2021,Caerphilly 004D,W01001339,1367,1232,135
2021,Caerphilly 020A,W01001340,1826,1584,242
2021,Caerphilly 020B,W01001341,1651,1499,152
2021,Caerphilly 021A,W01001342,1158,1051,107
2021,Caerphilly 021B,W01001343,1071,930,141
2021,Caerphilly 020C,W01001344,1631,1464,167
2021,Caerphilly 021C,W01001345,1337,1229,108
2021,Caerphilly 020D,W01001346,1477,1327,150
2021,Caerphilly 005C,W01001347,1452,1324,128
2021,Caerphilly 009A,W01001348,1700,1581,119
2021,Caerphilly 009B,W01001349,1680,1473,207
2021,Caerphilly 009C,W01001350,1681,1547,134
2021,Caerphilly 005D,W01001351,1373,1259,114
2021,Caerphilly 007A,W01001352,1699,1583,116
2021,Caerphilly 007B,W01001353,1493,1397,96
2021,Caerphilly 014D,W01001354,1631,1490,141
2021,Caerphilly 015A,W01001355,1494,1380,114
2021,Caerphilly 006A,W01001356,1168,1073,95
2021,Caerphilly 006B,W01001357,1656,1506,150
2021,Caerphilly 006C,W01001358,1441,1330,111
2021,Caerphilly 006D,W01001359,1365,1260,105
2021,Caerphilly 002A,W01001360,1267,1139,128
2021,Caerphilly 002B,W01001361,1120,1031,89
2021,Caerphilly 003C,W01001362,1941,1737,204
2021,Caerphilly 012A,W01001363,1746,1530,216
2021,Caerphilly 012B,W01001364,1723,1577,146
2021,Caerphilly 012C,W01001365,1888,1667,221
2021,Caerphilly 019A,W01001366,1528,1363,165
2021,Caerphilly 019B,W01001367,1410,1260,150
2021,Caerphilly 019C,W01001368,1391,1241,150
2021,Caerphilly 012D,W01001369,2350,2104,246
2021,Caerphilly 023A,W01001370,1791,1543,248
2021,Caerphilly 022A,W01001371,1835,1584,251
2021,Caerphilly 022B,W01001372,1759,1476,283
2021,Caerphilly 022C,W01001373,1877,1570,307
2021,Caerphilly 001A,W01001374,1375,1280,95
2021,Caerphilly 001B,W01001375,1435,1239,196
2021,Caerphilly 001C,W01001376,1378,1257,121
2021,Caerphilly 013A,W01001377,1418,1251,167
2021,Caerphilly 013B,W01001378,1459,1315,144
2021,Caerphilly 013C,W01001379,1485,1278,207
2021,Caerphilly 010A,W01001380,1733,1605,128
2021,Caerphilly 010B,W01001381,1429,1336,93
2021,Caerphilly 010C,W01001382,1506,1380,126
2021,Caerphilly 010D,W01001383,1410,1279,131
2021,Caerphilly 002C,W01001384,1448,1339,109
2021,Caerphilly 002D,W01001385,1476,1382,94
2021,Caerphilly 002E,W01001386,1527,1439,88
2021,Caerphilly 007C,W01001387,1162,1014,148
2021,Caerphilly 007D,W01001388,1741,1546,195
2021,Caerphilly 007E,W01001389,1072,934,138
2021,Caerphilly 006E,W01001390,2045,1830,215
2021,Caerphilly 006F,W01001391,1582,1432,150
2021,Caerphilly 009D,W01001392,1890,1728,162
2021,Caerphilly 019D,W01001393,1302,1143,159
2021,Caerphilly 023B,W01001394,1257,1102,155
2021,Caerphilly 023C,W01001395,1282,1139,143
2021,Caerphilly 023D,W01001396,1498,1333,165
2021,Caerphilly 019E,W01001397,1533,1283,250
2021,Caerphilly 024A,W01001398,2683,2284,399
2021,Caerphilly 023E,W01001399,1222,1096,126
2021,Caerphilly 019F,W01001400,1358,1210,148
2021,Caerphilly 011A,W01001401,2002,1855,147
2021,Caerphilly 011B,W01001402,1548,1416,132
2021,Caerphilly 011C,W01001403,1543,1398,145
2021,Caerphilly 011D,W01001404,1321,1209,112
2021,Caerphilly 011E,W01001405,1734,1558,176
2021,Caerphilly 001D,W01001406,1776,1617,159
2021,Caerphilly 016A,W01001407,1276,1193,83
2021,Caerphilly 016B,W01001408,1388,1300,88
2021,Caerphilly 016C,W01001409,1532,1417,115
2021,Caerphilly 016D,W01001410,1746,1611,135
2021,Caerphilly 017A,W01001411,1571,1454,117
2021,Caerphilly 017B,W01001412,1605,1491,114
2021,Caerphilly 017C,W01001413,1767,1635,132
2021,Caerphilly 008A,W01001414,1525,1356,169
2021,Caerphilly 008B,W01001415,1673,1476,197
2021,Caerphilly 008C,W01001416,1341,1194,147
2021,Caerphilly 008D,W01001417,1343,1167,176
2021,Caerphilly 008E,W01001418,1355,1191,164
2021,Caerphilly 021D,W01001419,1570,1377,193
2021,Caerphilly 022D,W01001420,1184,1023,161
2021,Caerphilly 022E,W01001421,1390,1282,108
2021,Caerphilly 022F,W01001422,1421,1269,152
2021,Caerphilly 024B,W01001423,1341,1181,160
2021,Caerphilly 024C,W01001424,1369,1185,184
2021,Caerphilly 024D,W01001425,1685,1419,266
2021,Caerphilly 024E,W01001426,1411,1181,230
2021,Caerphilly 024F,W01001427,1798,1531,267
2021,Caerphilly 001E,W01001428,1187,1110,77
2021,Caerphilly 001F,W01001429,1129,968,161
2021,Caerphilly 015B,W01001430,2307,2108,199
2021,Caerphilly 015C,W01001431,1534,1403,131
2021,Caerphilly 013D,W01001432,2657,2241,416
2021,Caerphilly 013E,W01001433,1325,1126,199
2021,Caerphilly 013F,W01001434,1340,1121,219
2021,Blaenau Gwent 008A,W01001435,1315,1234,81
2021,Blaenau Gwent 008B,W01001436,1329,1270,59
2021,Blaenau Gwent 008C,W01001437,1402,1320,82
2021,Blaenau Gwent 004A,W01001438,1437,1352,85
2021,Blaenau Gwent 004B,W01001439,1560,1460,100
2021,Blaenau Gwent 001A,W01001440,1303,1214,89
2021,Blaenau Gwent 001B,W01001441,1115,1063,52
2021,Blaenau Gwent 001C,W01001442,1070,979,91
2021,Blaenau Gwent 005A,W01001443,1200,1137,63
2021,Blaenau Gwent 005B,W01001444,1901,1769,132
2021,Blaenau Gwent 005C,W01001445,1306,1191,115
2021,Blaenau Gwent 002A,W01001446,1197,1106,91
2021,Blaenau Gwent 002B,W01001447,1424,1320,104
2021,Blaenau Gwent 002C,W01001448,1129,1056,73
2021,Blaenau Gwent 002D,W01001449,1330,1240,90
2021,Blaenau Gwent 007A,W01001450,1182,1118,64
2021,Blaenau Gwent 007B,W01001451,1258,1187,71
2021,Blaenau Gwent 007C,W01001452,1398,1294,104
2021,Blaenau Gwent 008D,W01001453,1443,1354,89
2021,Blaenau Gwent 008E,W01001454,1239,1177,62
2021,Blaenau Gwent 008F,W01001455,1615,1529,86
2021,Blaenau Gwent 004C,W01001456,1218,1141,77
2021,Blaenau Gwent 004D,W01001457,1719,1658,61
2021,Blaenau Gwent 004E,W01001458,1572,1489,83
2021,Blaenau Gwent 007D,W01001459,1152,1101,51
2021,Blaenau Gwent 007E,W01001460,1686,1551,135
2021,Blaenau Gwent 007F,W01001461,1232,1158,74
2021,Blaenau Gwent 006A,W01001462,1747,1614,133
2021,Blaenau Gwent 006B,W01001463,1740,1625,115
2021,Blaenau Gwent 009A,W01001464,1397,1322,75
2021,Blaenau Gwent 009B,W01001465,1484,1386,98
2021,Blaenau Gwent 009C,W01001466,1408,1350,58
2021,Blaenau Gwent 005D,W01001467,1824,1690,134
2021,Blaenau Gwent 005E,W01001468,1285,1193,92
2021,Blaenau Gwent 005F,W01001469,1267,1180,87
2021,Blaenau Gwent 001D,W01001470,1368,1294,74
2021,Blaenau Gwent 001E,W01001471,1564,1498,66
2021,Blaenau Gwent 003A,W01001472,1342,1219,123
2021,Blaenau Gwent 003B,W01001473,1226,1178,48
2021,Blaenau Gwent 003C,W01001474,1382,1295,87
2021,Blaenau Gwent 003D,W01001475,1089,1009,80
2021,Blaenau Gwent 006C,W01001478,1328,1225,103
2021,Blaenau Gwent 006D,W01001479,1408,1336,72
2021,Blaenau Gwent 003E,W01001480,1419,1317,102
2021,Blaenau Gwent 006E,W01001481,1598,1492,106
2021,Torfaen 002A,W01001482,1196,1054,142
2021,Torfaen 002B,W01001483,1376,1244,132
2021,Torfaen 002C,W01001484,1594,1441,153
2021,Torfaen 002D,W01001485,1213,1095,118
2021,Torfaen 002E,W01001486,1428,1287,141
2021,Torfaen 001A,W01001487,1611,1436,175
2021,Torfaen 001B,W01001488,1443,1338,105
2021,Torfaen 001C,W01001489,1396,1272,124
2021,Torfaen 001D,W01001490,1367,1242,125
2021,Torfaen 004A,W01001491,1633,1529,104
2021,Torfaen 012A,W01001492,2359,2159,200
2021,Torfaen 008A,W01001493,1753,1644,109
2021,Torfaen 008B,W01001494,1499,1365,134
2021,Torfaen 008C,W01001495,1745,1590,155
2021,Torfaen 004B,W01001496,1404,1300,104
2021,Torfaen 011A,W01001497,1346,1240,106
2021,Torfaen 011B,W01001498,1210,1095,115
2021,Torfaen 011C,W01001499,1117,1008,109
2021,Torfaen 011D,W01001500,1213,1128,85
2021,Torfaen 009A,W01001501,1278,1169,109
2021,Torfaen 011E,W01001502,1175,1103,72
2021,Torfaen 009B,W01001503,1192,1099,93
2021,Torfaen 013A,W01001504,2251,2080,171
2021,Torfaen 013B,W01001505,2547,2327,220
2021,Torfaen 010A,W01001506,1479,1386,93
2021,Torfaen 008D,W01001507,1894,1766,128
2021,Torfaen 013C,W01001508,1160,1078,82
2021,Torfaen 013D,W01001509,1365,1243,122
2021,Torfaen 005A,W01001510,1555,1460,95
2021,Torfaen 005B,W01001511,1491,1386,105
2021,Torfaen 005C,W01001512,1270,1221,49
2021,Torfaen 005D,W01001513,1429,1319,110
2021,Torfaen 006A,W01001514,1054,962,92
2021,Torfaen 006B,W01001515,1366,1232,134
2021,Torfaen 006C,W01001516,1381,1270,111
2021,Torfaen 006D,W01001517,2373,2136,237
2021,Torfaen 006E,W01001518,1111,1025,86
2021,Torfaen 007A,W01001519,1236,1159,77
2021,Torfaen 007B,W01001520,2493,2241,252
2021,Torfaen 007C,W01001521,1370,1248,122
2021,Torfaen 007D,W01001522,1561,1432,129
2021,Torfaen 004C,W01001523,1378,1265,113
2021,Torfaen 004D,W01001524,1809,1664,145
2021,Torfaen 003A,W01001525,1793,1659,134
2021,Torfaen 010B,W01001526,1331,1211,120
2021,Torfaen 010C,W01001527,1151,1064,87
2021,Torfaen 010D,W01001528,1697,1524,173
2021,Torfaen 003B,W01001529,1936,1792,144
2021,Torfaen 003C,W01001530,1704,1578,126
2021,Torfaen 003D,W01001531,1621,1497,124
2021,Torfaen 010E,W01001532,1706,1570,136
2021,Torfaen 012B,W01001533,1469,1342,127
2021,Torfaen 012C,W01001534,1365,1262,103
2021,Torfaen 012D,W01001535,1221,1159,62
2021,Torfaen 009C,W01001536,1091,1009,82
2021,Torfaen 007E,W01001537,1141,1039,102
2021,Torfaen 009D,W01001538,1288,1194,94
2021,Torfaen 009E,W01001539,1386,1272,114
2021,Torfaen 004E,W01001540,1229,1124,105
2021,Torfaen 004F,W01001541,1130,1019,111
2021,Monmouthshire 009A,W01001542,2067,1889,178
2021,Monmouthshire 009B,W01001543,1739,1547,192
2021,Monmouthshire 001A,W01001545,1497,1345,152
2021,Monmouthshire 002A,W01001546,1509,1364,145
2021,Monmouthshire 001B,W01001548,2049,1852,197
2021,Monmouthshire 007A,W01001549,1371,1252,119
2021,Monmouthshire 010C,W01001551,1137,1052,85
2021,Monmouthshire 004A,W01001552,1485,1374,111
2021,Monmouthshire 004C,W01001554,1510,1400,110
2021,Monmouthshire 006A,W01001555,1122,1009,113
2021,Monmouthshire 006B,W01001556,1331,1198,133
2021,Monmouthshire 001C,W01001557,1769,1590,179
2021,Monmouthshire 002C,W01001558,1543,1400,143
2021,Monmouthshire 008A,W01001559,1248,1154,94
2021,Monmouthshire 006C,W01001560,1349,1248,101
2021,Monmouthshire 003A,W01001561,1560,1421,139
2021,Monmouthshire 003B,W01001562,1329,1186,143
2021,Monmouthshire 003C,W01001563,1108,1004,104
2021,Monmouthshire 006D,W01001565,1780,1646,134
2021,Monmouthshire 005C,W01001568,1742,1574,168
2021,Monmouthshire 003E,W01001569,1315,1181,134
2021,Monmouthshire 001D,W01001571,1460,1303,157
2021,Monmouthshire 011A,W01001572,1576,1432,144
2021,Monmouthshire 011B,W01001573,1392,1249,143
2021,Monmouthshire 011C,W01001574,1276,1160,116
2021,Monmouthshire 005D,W01001575,1218,1107,111
2021,Monmouthshire 004D,W01001576,1042,974,68
2021,Monmouthshire 004E,W01001577,1256,1164,92
2021,Monmouthshire 009C,W01001578,2425,2222,203
2021,Monmouthshire 001E,W01001579,1539,1408,131
2021,Monmouthshire 002E,W01001580,1712,1553,159
2021,Monmouthshire 005E,W01001581,1901,1718,183
2021,Monmouthshire 011D,W01001582,1728,1557,171
2021,Monmouthshire 007B,W01001583,1491,1352,139
2021,Monmouthshire 008B,W01001584,1716,1586,130
2021,Monmouthshire 007C,W01001585,1252,1145,107
2021,Monmouthshire 007D,W01001586,2424,2171,253
2021,Monmouthshire 008C,W01001587,1818,1695,123
2021,Monmouthshire 010D,W01001588,1578,1459,119
2021,Monmouthshire 010E,W01001589,1382,1280,102
2021,Monmouthshire 009D,W01001590,2077,1922,155
2021,Monmouthshire 011E,W01001591,1534,1369,165
2021,Monmouthshire 008D,W01001592,1581,1459,122
2021,Monmouthshire 008E,W01001593,1573,1473,100
2021,Monmouthshire 007E,W01001594,1374,1247,127
2021,Monmouthshire 007F,W01001595,1261,1182,79
2021,Monmouthshire 006E,W01001596,1202,1118,84
2021,Monmouthshire 006F,W01001597,1390,1286,104
2021,Monmouthshire 010F,W01001598,1607,1482,125
2021,Monmouthshire 004F,W01001599,2082,1925,157
2021,Newport 012A,W01001600,1783,1609,174
2021,Newport 006A,W01001601,1491,1361,130
2021,Newport 012B,W01001602,1573,1415,158
2021,Newport 012C,W01001603,1481,1344,137
2021,Newport 012D,W01001604,1454,1331,123
2021,Newport 014A,W01001605,1424,1292,132
2021,Newport 008A,W01001606,1234,1111,123
2021,Newport 015A,W01001607,1304,1212,92
2021,Newport 008B,W01001608,1450,1318,132
2021,Newport 015B,W01001609,1828,1699,129
2021,Newport 015C,W01001610,1279,1186,93
2021,Newport 011A,W01001611,1162,1091,71
2021,Newport 011B,W01001612,1481,1384,97
2021,Newport 011C,W01001613,1458,1319,139
2021,Newport 005A,W01001614,1529,1431,98
2021,Newport 005B,W01001615,1528,1428,100
2021,Newport 005C,W01001616,1368,1248,120
2021,Newport 003A,W01001617,1392,1302,90
2021,Newport 003B,W01001618,1089,1023,66
2021,Newport 003C,W01001619,1308,1225,83
2021,Newport 003D,W01001620,1621,1495,126
2021,Newport 003E,W01001621,1379,1281,98
2021,Newport 003F,W01001622,1174,1096,78
2021,Newport 001A,W01001623,1382,1270,112
2021,Newport 001B,W01001624,1184,1105,79
2021,Newport 001C,W01001625,1162,1071,91
2021,Newport 001D,W01001626,1468,1331,137
2021,Newport 001E,W01001627,1574,1443,131
2021,Newport 001F,W01001628,1026,965,61
2021,Newport 017A,W01001629,1346,1269,77
2021,Newport 017B,W01001630,1585,1503,82
2021,Newport 017C,W01001631,1295,1218,77
2021,Newport 017D,W01001632,1367,1291,76
2021,Newport 019A,W01001633,1623,1523,100
2021,Newport 019B,W01001634,1440,1322,118
2021,Newport 016A,W01001635,1295,1189,106
2021,Newport 020A,W01001636,1874,1695,179
2021,Newport 016B,W01001637,2064,1893,171
2021,Newport 016C,W01001638,1182,1066,116
2021,Newport 004A,W01001639,2092,1912,180
2021,Newport 004B,W01001640,1088,1012,76
2021,Newport 004C,W01001641,1334,1226,108
2021,Newport 013A,W01001642,1587,1495,92
2021,Newport 013B,W01001643,1822,1702,120
2021,Newport 015D,W01001645,1250,1174,76
2021,Newport 015E,W01001646,1569,1429,140
2021,Newport 015G,W01001648,1509,1424,85
2021,Newport 004E,W01001650,1612,1512,100
2021,Newport 002A,W01001651,1400,1313,87
2021,Newport 002B,W01001652,1593,1523,70
2021,Newport 002C,W01001653,1327,1238,89
2021,Newport 002D,W01001654,1536,1431,105
2021,Newport 002E,W01001655,1528,1434,94
2021,Newport 020C,W01001657,1413,1293,120
2021,Newport 020D,W01001658,2018,1839,179
2021,Newport 018A,W01001659,1831,1737,94
2021,Newport 018B,W01001660,2588,2372,216
2021,Newport 018C,W01001661,2847,2657,190
2021,Newport 018D,W01001662,1628,1490,138
2021,Newport 008C,W01001663,1352,1273,79
2021,Newport 010A,W01001664,1171,1107,64
2021,Newport 008D,W01001665,1598,1480,118
2021,Newport 010B,W01001666,1452,1365,87
2021,Newport 010C,W01001667,1259,1191,68
2021,Newport 010D,W01001668,1183,1097,86
2021,Newport 009A,W01001669,1232,1135,97
2021,Newport 009B,W01001670,2227,2007,220
2021,Newport 016D,W01001671,2206,2030,176
2021,Newport 009D,W01001673,1389,1293,96
2021,Newport 009E,W01001674,1515,1398,117
2021,Newport 007A,W01001675,1524,1427,97
2021,Newport 007B,W01001676,1779,1616,163
2021,Newport 007C,W01001677,1350,1254,96
2021,Newport 005D,W01001678,1578,1472,106
2021,Newport 007D,W01001679,1079,966,113
2021,Newport 007E,W01001680,1240,1120,120
2021,Newport 006B,W01001681,1282,1189,93
2021,Newport 006C,W01001682,1353,1281,72
2021,Newport 006D,W01001683,1058,969,89
2021,Newport 006E,W01001684,1366,1244,122
2021,Newport 014B,W01001685,1642,1524,118
2021,Newport 014C,W01001686,1266,1157,109
2021,Newport 014D,W01001687,2263,2145,118
2021,Newport 019D,W01001689,2018,1850,168
2021,Newport 013D,W01001690,2106,1958,148
2021,Newport 011D,W01001691,1641,1560,81
2021,Newport 011E,W01001692,2192,2030,162
2021,Newport 013E,W01001693,2743,2604,139
2021,Cardiff 036A,W01001694,1931,1783,148
2021,Cardiff 036B,W01001695,3932,3615,317
2021,Cardiff 036C,W01001696,1478,1343,135
2021,Cardiff 036D,W01001697,1865,1669,196
2021,Cardiff 036E,W01001698,2013,1817,196
2021,Cardiff 049A,W01001699,2421,2240,181
2021,Cardiff 045A,W01001702,1721,1537,184
2021,Cardiff 045B,W01001703,1163,1072,91
2021,Cardiff 041A,W01001704,1612,1470,142
2021,Cardiff 045C,W01001705,1900,1725,175
2021,Cardiff 041B,W01001706,1338,1202,136
2021,Cardiff 041C,W01001707,1958,1764,194
2021,Cardiff 045D,W01001708,1597,1447,150
2021,Cardiff 040B,W01001710,1775,1365,410
2021,Cardiff 040C,W01001711,2026,1791,235
2021,Cardiff 040D,W01001712,1411,1091,320
2021,Cardiff 040E,W01001713,1672,1217,455
2021,Cardiff 035A,W01001714,1527,999,528
2021,Cardiff 035B,W01001715,1519,1098,421
2021,Cardiff 035C,W01001716,1242,908,334
2021,Cardiff 035D,W01001717,1470,1121,349
2021,Cardiff 028A,W01001718,1728,1504,224
2021,Cardiff 028B,W01001719,1985,1743,242
2021,Cardiff 028C,W01001720,2223,1948,275
2021,Cardiff 032A,W01001721,2875,2606,269
2021,Cardiff 028D,W01001722,1747,1553,194
2021,Cardiff 032C,W01001724,2391,2126,265
2021,Cardiff 032D,W01001725,2299,2051,248
2021,Cardiff 028E,W01001726,1758,1543,215
2021,Cardiff 014A,W01001727,1171,946,225
2021,Cardiff 014B,W01001728,1384,1019,365
2021,Cardiff 014C,W01001729,2787,2373,414
2021,Cardiff 008A,W01001730,1516,1317,199
2021,Cardiff 008B,W01001731,1419,1212,207
2021,Cardiff 019A,W01001732,1697,1476,221
2021,Cardiff 019B,W01001733,1465,1280,185
2021,Cardiff 019C,W01001734,1566,1335,231
2021,Cardiff 019D,W01001735,1998,1731,267
2021,Cardiff 008C,W01001736,1457,1254,203
2021,Cardiff 039A,W01001737,1572,1443,129
2021,Cardiff 039B,W01001738,1365,1277,88
2021,Cardiff 039C,W01001739,1407,1291,116
2021,Cardiff 039D,W01001740,1449,1333,116
2021,Cardiff 039E,W01001741,1572,1454,118
2021,Cardiff 043A,W01001742,1534,1397,137
2021,Cardiff 043B,W01001743,1412,1263,149
2021,Cardiff 043C,W01001744,1646,1525,121
2021,Cardiff 043D,W01001745,1235,1117,118
2021,Cardiff 041D,W01001746,1475,1344,131
2021,Cardiff 027A,W01001747,1626,1430,196
2021,Cardiff 027B,W01001748,1509,1367,142
2021,Cardiff 027C,W01001749,1491,1327,164
2021,Cardiff 031A,W01001750,1562,1390,172
2021,Cardiff 027D,W01001751,1731,1570,161
2021,Cardiff 031B,W01001752,1541,1346,195
2021,Cardiff 031C,W01001753,1589,1436,153
2021,Cardiff 031D,W01001754,1563,1366,197
2021,Cardiff 025A,W01001755,1448,1207,241
2021,Cardiff 025B,W01001756,4209,3774,435
2021,Cardiff 025C,W01001757,1420,1182,238
2021,Cardiff 025D,W01001758,2141,1803,338
2021,Cardiff 046A,W01001759,1531,1376,155
2021,Cardiff 046B,W01001760,1596,1395,201
2021,Cardiff 046C,W01001761,1711,1431,280
2021,Cardiff 046D,W01001762,1757,1562,195
2021,Cardiff 044A,W01001764,1962,1712,250
2021,Cardiff 044B,W01001765,1389,1217,172
2021,Cardiff 044C,W01001766,1627,1395,232
2021,Cardiff 044D,W01001767,1756,1533,223
2021,Cardiff 044E,W01001768,1605,1411,194
2021,Cardiff 018A,W01001769,1539,1257,282
2021,Cardiff 018B,W01001770,1013,842,171
2021,Cardiff 018C,W01001771,1612,1344,268
2021,Cardiff 021A,W01001772,1361,1169,192
2021,Cardiff 012A,W01001773,2465,2192,273
2021,Cardiff 018D,W01001774,1359,1122,237
2021,Cardiff 021B,W01001775,1550,1363,187
2021,Cardiff 021C,W01001776,1257,1106,151
2021,Cardiff 001A,W01001777,1715,1482,233
2021,Cardiff 001B,W01001778,1714,1467,247
2021,Cardiff 026A,W01001779,1473,1225,248
2021,Cardiff 026B,W01001780,1606,1270,336
2021,Cardiff 026C,W01001781,1638,1234,404
2021,Cardiff 026D,W01001782,1416,1102,314
2021,Cardiff 026E,W01001783,1183,1044,139
2021,Cardiff 026F,W01001784,1279,1117,162
2021,Cardiff 023A,W01001785,1167,1048,119
2021,Cardiff 023B,W01001786,1440,1195,245
2021,Cardiff 023C,W01001787,1340,1188,152
2021,Cardiff 023D,W01001788,1538,1383,155
2021,Cardiff 023E,W01001789,1497,1199,298
2021,Cardiff 023F,W01001790,1178,1049,129
2021,Cardiff 005A,W01001791,1774,1510,264
2021,Cardiff 005B,W01001792,1566,1403,163
2021,Cardiff 002A,W01001793,1316,1139,177
2021,Cardiff 001C,W01001794,1297,1124,173
2021,Cardiff 002B,W01001795,1456,1258,198
2021,Cardiff 002C,W01001796,1392,1208,184
2021,Cardiff 005C,W01001797,1390,1208,182
2021,Cardiff 002D,W01001798,1359,1193,166
2021,Cardiff 001D,W01001799,1242,1041,201
2021,Cardiff 005D,W01001800,1371,1219,152
2021,Cardiff 007A,W01001802,1656,1568,88
2021,Cardiff 015A,W01001803,1616,1505,111
2021,Cardiff 015B,W01001804,1538,1414,124
2021,Cardiff 015C,W01001805,1495,1335,160
2021,Cardiff 015D,W01001806,1666,1464,202
2021,Cardiff 007B,W01001807,1592,1461,131
2021,Cardiff 007C,W01001808,1659,1533,126
2021,Cardiff 017A,W01001809,1185,1054,131
2021,Cardiff 017B,W01001810,1682,1550,132
2021,Cardiff 009A,W01001811,1521,1390,131
2021,Cardiff 017C,W01001812,1237,1152,85
2021,Cardiff 017D,W01001813,1772,1603,169
2021,Cardiff 017E,W01001814,1401,1289,112
2021,Cardiff 008D,W01001815,1350,1253,97
2021,Cardiff 009B,W01001816,2675,2405,270
2021,Cardiff 009C,W01001817,1346,1234,112
2021,Cardiff 009D,W01001818,1501,1363,138
2021,Cardiff 014D,W01001819,2327,1851,476
2021,Cardiff 006A,W01001820,1170,894,276
2021,Cardiff 024A,W01001821,1693,1503,190
2021,Cardiff 029A,W01001822,1797,1556,241
2021,Cardiff 029B,W01001823,1232,1011,221
2021,Cardiff 029C,W01001824,1510,1290,220
2021,Cardiff 029D,W01001825,1907,1615,292
2021,Cardiff 024B,W01001826,1343,1120,223
2021,Cardiff 024C,W01001827,1608,1385,223
2021,Cardiff 024D,W01001828,1472,1239,233
2021,Cardiff 033A,W01001829,1963,1790,173
2021,Cardiff 033B,W01001830,1595,1423,172
2021,Cardiff 030A,W01001831,1462,1259,203
2021,Cardiff 033C,W01001832,1743,1583,160
2021,Cardiff 033D,W01001833,1500,1283,217
2021,Cardiff 033E,W01001834,1609,1415,194
2021,Cardiff 033F,W01001835,2161,1962,199
2021,Cardiff 030B,W01001836,1300,1094,206
2021,Cardiff 030C,W01001837,1439,1293,146
2021,Cardiff 030D,W01001838,1596,1354,242
2021,Cardiff 030E,W01001839,1554,1342,212
2021,Cardiff 007D,W01001840,1884,1752,132
2021,Cardiff 003A,W01001841,1858,1661,197
2021,Cardiff 003B,W01001842,1696,1507,189
2021,Cardiff 003D,W01001844,1833,1622,211
2021,Cardiff 006C,W01001846,1700,1398,302
2021,Cardiff 006D,W01001847,1508,1306,202
2021,Cardiff 012B,W01001848,1416,1173,243
2021,Cardiff 004A,W01001849,1518,1293,225
2021,Cardiff 012C,W01001850,1868,1531,337
2021,Cardiff 012D,W01001851,1519,1333,186
2021,Cardiff 004B,W01001852,1826,1542,284
2021,Cardiff 004C,W01001853,1569,1378,191
2021,Cardiff 004D,W01001854,1498,1316,182
2021,Cardiff 042A,W01001855,1726,1473,253
2021,Cardiff 042B,W01001856,1661,1508,153
2021,Cardiff 042C,W01001857,2014,1805,209
2021,Cardiff 034A,W01001858,1556,1238,318
2021,Cardiff 034B,W01001859,1462,1112,350
2021,Cardiff 034C,W01001860,1614,1256,358
2021,Cardiff 034D,W01001861,1501,1140,361
2021,Cardiff 042D,W01001862,1805,1602,203
2021,Cardiff 022A,W01001863,1457,1319,138
2021,Cardiff 022B,W01001864,1432,1314,118
2021,Cardiff 022C,W01001865,1255,1115,140
2021,Cardiff 016A,W01001866,1523,1407,116
2021,Cardiff 016B,W01001867,1366,1250,116
2021,Cardiff 022D,W01001868,1470,1345,125
2021,Cardiff 038A,W01001869,1346,1208,138
2021,Cardiff 037A,W01001870,1404,1199,205
2021,Cardiff 037B,W01001871,1586,1448,138
2021,Cardiff 038B,W01001872,1555,1395,160
2021,Cardiff 038C,W01001873,1759,1554,205
2021,Cardiff 038D,W01001874,1467,1291,176
2021,Cardiff 037D,W01001876,1570,1441,129
2021,Cardiff 011A,W01001877,1770,1588,182
2021,Cardiff 011B,W01001878,1521,1387,134
2021,Cardiff 013A,W01001879,1831,1685,146
2021,Cardiff 013B,W01001880,1582,1462,120
2021,Cardiff 013C,W01001881,1423,1320,103
2021,Cardiff 011C,W01001882,1679,1520,159
2021,Cardiff 016C,W01001883,1607,1489,118
2021,Cardiff 013D,W01001884,1375,1247,128
2021,Cardiff 011D,W01001885,2494,2264,230
2021,Cardiff 016D,W01001886,1274,1176,98
2021,Cardiff 020A,W01001887,1579,1108,471
2021,Cardiff 010A,W01001888,1605,1304,301
2021,Cardiff 020B,W01001889,1433,1210,223
2021,Cardiff 021D,W01001890,1522,1340,182
2021,Cardiff 020C,W01001891,1584,1298,286
2021,Cardiff 020D,W01001892,1386,1180,206
2021,Cardiff 010B,W01001893,1781,1552,229
2021,Cardiff 010C,W01001894,1483,1212,271
2021,Cardiff 010D,W01001895,1589,1315,274
2021,Cardiff 020E,W01001896,1415,1061,354
2021,Powys 020D,W01001897,1831,1579,252
2021,Merthyr Tydfil 008F,W01001898,1427,1298,129
2021,Powys 021F,W01001899,2137,1470,667
2021,Neath Port Talbot 020G,W01001900,1373,968,405
2021,Powys 017F,W01001901,1773,1559,214
2021,Powys 017G,W01001902,1344,1205,139
2021,Powys 018F,W01001903,2066,1855,211
2021,Powys 018G,W01001904,1614,1460,154
2021,Powys 018H,W01001905,2105,1861,244
2021,Powys 001F,W01001906,1907,1207,700
2021,Powys 001G,W01001907,1347,982,365
2021,Monmouthshire 010G,W01001908,2073,1895,178
2021,Vale of Glamorgan 012G,W01001910,1602,1419,183
2021,Vale of Glamorgan 012H,W01001911,1102,987,115
2021,Newport 020E,W01001912,1485,1379,106
2021,Newport 020F,W01001913,1407,1265,142
2021,Rhondda Cynon Taf 023F,W01001914,1870,1555,315
2021,Rhondda Cynon Taf 027F,W01001915,1599,1253,346
2021,Rhondda Cynon Taf 027G,W01001916,1448,1087,361
2021,Rhondda Cynon Taf 023G,W01001917,1427,1295,132
2021,Bridgend 017E,W01001918,1818,1581,237
2021,Bridgend 017F,W01001919,1327,1186,141
2021,Bridgend 017G,W01001920,1167,1021,146
2021,Bridgend 017H,W01001921,1477,1314,163
2021,Cardiff 032E,W01001922,2009,1787,222
2021,Carmarthenshire 026G,W01001923,1691,1325,366
2021,Carmarthenshire 026H,W01001924,1324,1116,208
2021,Carmarthenshire 023F,W01001925,2139,1535,604
2021,Conwy 011F,W01001926,2064,1458,606
2021,Conwy 010G,W01001927,1312,1157,155
2021,Conwy 010H,W01001928,1059,944,115
2021,Wrexham 012F,W01001929,1131,1046,85
2021,Wrexham 019F,W01001930,2026,1458,568
2021,Wrexham 012G,W01001931,1367,1251,116
2021,Gwynedd 014E,W01001932,2694,737,1957
2021,Gwynedd 017F,W01001933,1878,1134,744
2021,Ceredigion 003E,W01001935,1005,604,401
2021,Ceredigion 003F,W01001936,1434,1026,408
2021,Ceredigion 001F,W01001937,1916,1160,756
2021,Cardiff 048A,W01001940,1027,906,121
2021,Cardiff 049B,W01001942,1536,1381,155
2021,Cardiff 048B,W01001943,1163,1015,148
2021,Cardiff 048C,W01001944,1152,1004,148
2021,Cardiff 049C,W01001946,1284,1165,119
2021,Cardiff 048E,W01001947,1658,1475,183
2021,Cardiff 006E,W01001948,2184,1831,353
2021,Cardiff 005F,W01001949,1267,1129,138
2021,Cardiff 049D,W01001950,1131,1014,117
2021,Cardiff 049E,W01001951,1497,1313,184
2021,Cardiff 049F,W01001952,1848,1709,139
2021,Cardiff 005G,W01001953,1457,1242,215
2021,Cardiff 006F,W01001954,1500,1239,261
2021,Swansea 025F,W01001955,1903,1809,94
2021,Swansea 032C,W01001956,2196,1962,234
2021,Swansea 025H,W01001958,1285,1166,119
2021,Merthyr Tydfil 005E,W01001959,1499,1336,163
2021,Merthyr Tydfil 005F,W01001960,1395,1218,177
2021,Merthyr Tydfil 006G,W01001961,2281,2003,278
2021,Rhondda Cynon Taf 011E,W01001962,2391,2095,296
2021,Rhondda Cynon Taf 014H,W01001963,2189,1984,205
2021,Rhondda Cynon Taf 021H,W01001964,2197,1938,259
2021,Rhondda Cynon Taf 029E,W01001965,1653,1430,223
2021,Rhondda Cynon Taf 029F,W01001966,1650,1329,321
2021,Rhondda Cynon Taf 031G,W01001967,1453,1172,281
2021,Rhondda Cynon Taf 031H,W01001968,1438,1176,262
2021,Wrexham 010F,W01001969,2211,2014,197
2021,Wrexham 021C,W01001970,2111,1902,209
2021,Wrexham 022D,W01001971,2637,2475,162
2021,Wrexham 022E,W01001972,1271,1126,145
2021,Blaenau Gwent 009F,W01001973,2190,2053,137
2021,Monmouthshire 002G,W01001974,1369,1270,99
2021,Monmouthshire 002H,W01001975,1272,1143,129
2021,Monmouthshire 003F,W01001976,1570,1413,157
2021,Monmouthshire 003G,W01001977,1406,1274,132
2021,Monmouthshire 004G,W01001978,1455,1332,123
2021,Monmouthshire 004H,W01001979,1965,1783,182
2021,Monmouthshire 005F,W01001980,2155,1974,181
2021,Bridgend 011D,W01001981,2890,2627,263
2021,Bridgend 011E,W01001982,1270,1097,173
2021,Bridgend 011F,W01001983,1404,1186,218
2021,Bridgend 011G,W01001984,1134,977,157
2021,Neath Port Talbot 006F,W01001985,2005,1720,285
2021,Neath Port Talbot 007E,W01001986,2383,2093,290
2021,Neath Port Talbot 010G,W01001987,1439,1280,159
2021,Neath Port Talbot 010H,W01001988,1408,1182,226
2021,Neath Port Talbot 010I,W01001989,3364,3075,289
2021,Neath Port Talbot 021E,W01001990,2085,1919,166
2021,Swansea 005G,W01001991,1359,1187,172
2021,Swansea 005H,W01001992,1381,1224,157
2021,Swansea 006E,W01001993,1642,1353,289
2021,Swansea 006F,W01001994,1427,1241,186
2021,Swansea 021E,W01001995,1329,1229,100
2021,Swansea 021F,W01001996,1385,1269,116
2021,Swansea 025I,W01001997,1958,1807,151
2021,Vale of Glamorgan 015G,W01001998,2159,1952,207
2021,Carmarthenshire 019F,W01001999,2430,1757,673
2021,Ceredigion 002G,W01002000,2896,2265,631
2021,Ceredigion 002H,W01002001,1403,1115,288
2021,Ceredigion 007E,W01002002,4232,2429,1803
2021,Gwynedd 013E,W01002003,2337,1321,1016
2021,Gwynedd 016F,W01002004,2098,1318,780
2021,Isle of Anglesey 002E,W01002005,2190,1011,1179
2021,Isle of Anglesey 004G,W01002007,2163,1201,962
2021,Isle of Anglesey 007F,W01002008,2047,1110,937
2021,Pembrokeshire 005E,W01002009,1173,1012,161
2021,Pembrokeshire 005F,W01002010,1076,960,116
2021,Pembrokeshire 010D,W01002011,1528,1416,112
2021,Pembrokeshire 010E,W01002012,1393,1291,102
2021,Pembrokeshire 011G,W01002013,2322,2093,229
2021,Pembrokeshire 016E,W01002014,2050,1825,225
2021,Cardiff 003E,W01002016,1155,1023,132
2021,Cardiff 003F,W01002017,1297,1127,170
2021,Cardiff 003G,W01002018,1480,1289,191
2021,Cardiff 032H,W01002019,2584,2377,207
2021,Cardiff 037E,W01002020,1503,1378,125
2021,Cardiff 037F,W01002021,1441,1269,172
2021,Cardiff 040F,W01002022,1150,889,261
2021,Cardiff 040G,W01002023,1749,1389,360
2021,Cardiff 048F,W01002024,1089,973,116
2021,Cardiff 048G,W01002025,1074,956,118
2021,Newport 004F,W01002026,1745,1600,145
2021,Newport 004G,W01002027,1734,1623,111
2021,Newport 009F,W01002028,1891,1742,149
2021,Newport 009G,W01002029,1635,1469,166
2021,Newport 013F,W01002030,1358,1271,87
2021,Newport 013G,W01002031,1605,1463,142
2021,Newport 015H,W01002032,1247,1170,77
2021,Newport 015I,W01002033,1332,1228,104
2021,Newport 019E,W01002034,1631,1465,166
2021,Newport 019F,W01002035,1528,1385,143
2021,Vale of Glamorgan 005G,W01002036,1505,1343,162
2021,Vale of Glamorgan 005H,W01002037,1042,896,146
2021,Vale of Glamorgan 014G,W01002038,1239,1112,127
2021,Vale of Glamorgan 014H,W01002039,1681,1421,260
2021,Vale of Glamorgan 015F,W01002040,1821,1579,242
